PDB ID,Chain,Helix Start,Helix End,Helix Length,Helix Sequence,Is Transmembrane
1oa9,A,14,18,4,PSCGW,0
1oa9,A,46,49,3,GCEG,0
1oa9,A,80,84,4,TEESW,0
1oa9,A,133,139,6,GCTPQFG,0
1oa9,A,151,158,7,SRQECDSF,0
1oa9,A,159,161,2,PEP,0
1oa9,A,162,169,7,LKPGCQWR,0
1oa9,A,189,197,8,PEELVARTG,0
1oa9,A,202,206,4,DDGGF,0
4wi8,B,246,252,6,KPKDTLM,0
4wi8,B,309,315,6,LHQDWLN,0
4wi8,B,354,358,4,SRDEL,0
4wi8,B,414,419,5,KSRWQQ,0
4wi8,B,432,434,2,LHN,0
4wi8,B,309,314,5,LHQDWL,0
4wi8,B,414,420,6,KSRWQQG,0
2wip,D,-3,3,6,PLVDMEN,0
2wip,D,45,56,11,PSTAIREISLLK,0
2wip,D,87,94,7,LKKFMDAS,0
2wip,D,100,121,21,PLPLIKSYLFQLLQGLAFCHSH,0
2wip,D,129,131,2,KPQ,0
2wip,D,165,169,4,TLWYR,0
2wip,D,170,175,5,APEILL,0
2wip,D,182,199,17,TAVDIWSLGCIFAEMVTR,0
2wip,D,207,220,13,SEIDQLFRIFRTLG,0
2wip,D,229,233,4,GVTSM,0
2wip,D,247,252,5,DFSKVV,0
2wip,D,256,267,11,DEDGRSLLSQML,0
2wip,D,276,281,5,SAKAAL,0
2wip,D,282,289,7,AHPFFQDV,0
2wip,D,177,191,14,DYHEDIHTYLREMEV,0
2wip,D,198,203,5,GYMKKQ,0
2wip,D,207,225,18,TNSMRAILVDWLVEVGEEY,0
2wip,D,228,244,16,QNETLHLAVNYIDRFLS,0
2wip,D,249,269,20,LRGKLQLVGTAAMLLASKFEE,0
2wip,D,274,282,8,EVAEFVYIT,0
2wip,D,287,303,16,TKKQVLRMEHLVLKVLT,0
2wip,D,310,321,11,TVNQFLTQYFLH,0
2wip,D,326,341,15,NCKVESLAMFLGELSL,0
2wip,D,343,348,5,DADPYL,0
2wip,D,351,369,18,LPSVIAGAAFHLALYTVTG,0
2wip,D,373,381,8,PESLIRKTG,0
2wip,D,383,401,18,TLESLKPCLMDLHQTYLKA,0
2wip,D,402,404,2,PQH,0
2wip,D,407,413,6,QSIREKY,0
2wip,D,414,419,5,KNSKYH,0
2wip,D,420,424,4,GVSLL,0
2wip,D,0,2,2,DME,0
2wip,D,178,191,13,YHEDIHTYLREMEV,0
2wip,D,287,302,15,TKKQVLRMEHLVLKVL,0
4nga,L,55,60,5,AAHCFN,0
4nga,L,60,62,2,NWR,0
4nga,L,125,128,3,ERTF,0
4nga,L,129,128,-1,,0
4nga,L,164,169,5,MTQDCL,0
4nga,L,191,195,4,CKGDS,0
4nga,L,234,243,9,YIEWLQKLMR,0
4nga,L,93,98,5,NENGGC,0
4nga,L,138,143,5,IPILEK,0
5f7h,F,68,72,4,TIPRG,0
5f7h,F,82,86,4,SESDS,0
2wqw,B,44,48,4,IKQIF,0
2wqw,B,50,61,11,DDAFAETIKDNL,0
2wqw,B,71,76,5,TQNELN,0
2wqw,B,113,119,6,IKPLANL,0
2wqw,B,135,139,4,LSSLK,0
2wqw,B,179,185,6,ITVLSRL,0
2wqw,B,201,207,6,IVPLACL,0
2wqw,B,223,227,4,LRALC,0
1qez,F,1112,1114,2,PSF,0
1qez,F,1120,1122,2,IND,0
1qez,F,1125,1137,12,QATKNKIVHFFEH,0
1qez,F,1155,1168,13,ATEAKNRIQLAIKR,0
1qez,F,2112,2114,2,PSF,0
1qez,F,2120,2122,2,IND,0
1qez,F,2125,2137,12,QATKNKIVHFFEH,0
1qez,F,2155,2168,13,ATEAKNRIQLAIKR,0
1qez,F,3112,3114,2,PSF,0
1qez,F,3120,3122,2,IND,0
1qez,F,3125,3137,12,QATKNKIVHFFEH,0
1qez,F,3155,3168,13,ATEAKNRIQLAIKR,0
1qez,F,4112,4114,2,PSF,0
1qez,F,4120,4122,2,IND,0
1qez,F,4125,4137,12,QATKNKIVHFFEH,0
1qez,F,4155,4168,13,ATEAKNRIQLAIKR,0
1qez,F,5112,5114,2,PSF,0
1qez,F,5120,5122,2,IND,0
1qez,F,5125,5137,12,QATKNKIVHFFEH,0
1qez,F,5155,5168,13,ATEAKNRIQLAIKR,0
1qez,F,6112,6114,2,PSF,0
1qez,F,6120,6122,2,IND,0
1qez,F,6125,6137,12,QATKNKIVHFFEH,0
1qez,F,6155,6168,13,ATEAKNRIQLAIKR,0
1i4j,B,13,25,12,SPRKVRLVVDLIR,0
1i4j,B,28,39,11,SLEEARNILRYT,0
1i4j,B,43,61,18,GAYFVAKVLESAAANAVNN,0
1i4j,B,65,67,2,LED,0
1i4j,B,43,62,19,GAYFVAKVLESAAANAVNNH,0
2dnw,A,12,27,15,TLEGIQDRVLYVLKLY,0
2dnw,A,48,63,15,DSLDQVEIIMAMEDEF,0
2dnw,A,68,73,5,PDIDAE,0
2dnw,A,77,89,12,CPQEIVDYIADKK,0
5x1e,F,5,16,11,ISKCMAKIAASM,0
5x1e,F,28,33,5,SFDEVF,0
5x1e,F,38,55,17,LLPAIAKRADQLCSLCLG,0
5x1e,F,81,100,19,PNVLRLLCMTDVMNELIQGG,0
5x1e,F,109,114,5,DELMYD,0
5x1e,F,5,15,10,SHEASAKYWFE,0
5x1e,F,19,30,11,PMIYRVITFMES,0
5x1e,F,39,53,14,NPELEEAMKQLGQEL,0
5x1e,F,60,64,4,DLGLL,0
5x1e,F,66,75,9,EEDKFIRIVG,0
5x1e,F,78,91,13,KSGRGLRLLQAIDT,0
5x1e,F,95,108,13,GSASRVLIHAEETS,0
5x1e,F,113,135,22,DPAGFFLKRNIVFERLRLLSRVF,0
5x1e,F,136,148,12,CQYRLKLVLRALE,0
5x1e,F,694,700,6,DKEVFSE,0
5x1e,F,704,719,15,PINETRNQMITIERLA,0
5x1e,F,722,741,19,KDKYAGTVANELIKDFQIAT,0
5x1e,F,752,773,21,DVQELTGIIRDLSAKISAEREK,0
5x1e,F,66,77,11,EEDKFIRIVGNI,0
5x1e,F,78,93,15,KSGRGLRLLQAIDTVH,0
5x1e,F,136,149,13,CQYRLKLVLRALEG,0
5x1e,F,722,724,2,KDK,0
5x1e,F,725,742,17,YAGTVANELIKDFQIATS,0
3hjf,A,42,54,12,VYPLLAQVARRAG,0
3hjf,A,69,73,4,PPEVL,0
3hjf,A,102,123,21,DPGERSVLSALARRLLQERLRR,0
3hjf,A,178,184,6,SLEAWLA,0
3hjf,A,222,230,8,SLLDYHASK,0
3hjf,A,282,301,19,PWEERRRRTREIASWIGRRL,0
3hjf,A,329,331,2,KPA,0
3hjf,A,332,337,5,DALRVG,0
3hjf,A,358,371,13,PEFLRRALLRAFGA,0
3hjf,A,384,387,3,HPSQ,0
3hjf,A,388,401,13,GLAFREALRKAKEE,0
3hjf,A,414,428,14,AWEDRNRLKALLLRE,0
3hjf,A,443,459,16,ERHRWENALLGLLAKAG,0
3hjf,A,515,532,17,PQEVVWDLLEETLWAFRR,0
3hjf,A,554,564,10,FALALEALARE,0
3hjf,A,627,639,12,PLEALAHQIFHLT,0
3hjf,A,653,670,17,PAPLHLADRLVKEVGRLG,0
3hjf,A,673,677,4,HLKEV,0
2kkm,A,17,33,16,RVHELARVKFMQDVVNS,0
2kkm,A,43,69,26,DHAHTREFIQSFIERDDTELDELKKKR,0
2kkm,A,70,72,2,RSN,0
2kkm,A,77,95,18,NRQVLLQQRRDQELKEFKA,0
2kkm,A,104,113,9,DAKNMEFLRN,0
2kkm,A,119,124,5,GLLNTL,0
3bm7,A,-7,-3,4,HENLY,0
3bm7,A,14,33,19,KAAEFEKVFLDLAAKVKANE,0
3bm7,A,59,69,10,SDALKHHGGT,0
3bm7,A,69,80,11,TDYFKAAGAAG,0
5ori,A,5,15,10,SEIAHRFNDLG,0
5ori,A,15,31,16,GEENFQGLVLIAFSQYL,0
5ori,A,35,56,21,PFDEHVKLVKELTEFAKTCVAD,0
5ori,A,65,78,13,SLHTLFGDELCKVA,0
5ori,A,88,93,5,ADCCEK,0
5ori,A,96,105,9,PERNECFLKH,0
5ori,A,118,129,11,EPDTLCAEFKAD,0
5ori,A,129,145,16,DEKKFWGKYLYEVARRH,0
5ori,A,149,168,19,YAPELLYYANKYNGVFQECC,0
5ori,A,172,222,50,DKGACLLPKIETMREKVLASSARQRLRCASIQKFGERALKAWSVARLSQKF,0
5ori,A,226,246,20,DFTDVTKIVTDLTKVHKECCH,0
5ori,A,248,266,18,DLLECADDRADLAKYICDH,0
5ori,A,267,270,3,QDTL,0
5ori,A,271,277,6,SSKLKEC,0
5ori,A,281,291,10,PVLEKSHCIAE,0
5ori,A,304,309,5,LTADFA,0
5ori,A,313,321,8,EVCKNYQEA,0
5ori,A,321,336,15,AKDVFLGSFLYEYSRR,0
5ori,A,341,360,19,AVSVLLRLAKEYEATLEDCC,0
5ori,A,364,370,6,DPHACYA,0
5ori,A,371,380,9,TVFDKLKHLV,0
5ori,A,381,414,33,DEPQNLIKKNCELFEKHGEYGFQNALIVRYTRKA,0
5ori,A,418,437,19,STPTLVEISRSLGKVGTKCC,0
5ori,A,440,466,26,PESERMPCTEDYLSLILNRLCVLHEKT,0
5ori,A,469,479,10,SEKVTKCCTES,0
5ori,A,482,490,8,NRRPCFSDL,0
5ori,A,509,514,5,HADICT,0
5ori,A,516,535,19,PDTEKQIKKQTALVELLKHK,0
5ori,A,539,559,20,TDEQLKTVMENFVAFVDKCCA,0
5ori,A,562,582,20,DKEGCFLLEGPKLVASTQAAL,0
5il7,B,2,15,13,SDLDVIRQIEQELG,0
5il7,B,50,61,11,DTLDRIIQPLES,0
5il7,B,78,84,6,ISPLASL,0
5il7,B,100,106,6,IAPLASL,0
5il7,B,122,126,4,IAPLE,0
5il7,B,144,150,6,IAPLASL,0
5il7,B,166,170,4,IAPLE,0
5il7,B,188,194,6,IAPLASL,0
5il7,B,210,216,6,IAPLESL,0
5il7,B,232,238,6,IAPLESL,0
5il7,B,254,258,4,IAPLA,0
5il7,B,276,280,4,IAPLE,0
5il7,B,298,302,4,IAPLA,0
5il7,B,320,326,6,IAPLASL,0
5il7,B,342,348,6,IAPLASL,0
5il7,B,364,370,6,ISPLASL,0
5il7,B,387,393,6,PETITGF,0
5il7,B,419,424,5,PPEIVK,0
5il7,B,426,439,13,GKEAVRQYFQSIEE,0
5il7,B,3,15,12,DLDVIRQIEQELG,0
5il7,B,50,62,12,DTLDRIIQPLESL,0
5il7,B,122,128,6,IAPLESL,0
5il7,B,166,172,6,IAPLESL,0
5il7,B,210,214,4,IAPLE,0
5il7,B,232,236,4,IAPLE,0
5il7,B,254,260,6,IAPLASL,0
5il7,B,320,324,4,IAPLA,0
5il7,B,364,368,4,ISPLA,0
5il7,B,387,392,5,PETITG,0
5il7,B,426,441,15,GKEAVRQYFQSIEEAR,0
3qdw,B,12,16,4,NPGRG,0
3qdw,B,27,30,3,HYAN,0
3qdw,B,88,93,5,TALVIN,0
3qdw,B,94,97,3,PQYY,0
3qdw,B,102,109,7,RAYTREKQ,0
3qdw,B,102,108,6,RAYTREK,0
4fto,A,51,62,11,NIKKEICINKML,0
4fto,A,93,96,3,FDRI,0
4fto,A,103,124,21,PEPDAQRFFHQLMAGVVYLHGI,0
4fto,A,132,134,2,KPE,0
4fto,A,170,174,4,TLPYV,0
4fto,A,175,181,6,APELLKR,0
4fto,A,185,204,19,HAEPVDVWSCGIVLTAMLAG,0
4fto,A,215,223,8,CQEYSDWKE,0
4fto,A,230,234,4,PWKKI,0
4fto,A,235,246,11,DSAPLALLHKIL,0
4fto,A,255,260,5,TIPDIK,0
5esk,A,8,24,16,VGEALEYVNIGLSHFLA,0
5esk,A,26,50,24,PLAQRISLIIIIPFIYNIVWQLLYS,0
5esk,A,68,75,7,SAVVYGMK,0
5esk,A,75,88,13,KPYEFFEECQKKYG,0
5esk,A,105,114,9,GPKGHEFVFN,0
5esk,A,122,135,13,AEAAYAHLTTPVFG,0
5esk,A,143,156,13,PNSRLMEQKKFVKG,0
5esk,A,159,181,22,TKEAFKSYVPLIAEEVYKYFRDS,0
5esk,A,196,213,17,VMVTQPEMTIFTASRSLL,0
5esk,A,214,220,6,GKEMRAK,0
5esk,A,221,224,3,LDTD,0
5esk,A,225,235,10,FAYLYSDLDKG,0
5esk,A,236,242,6,FTPINFV,0
5esk,A,248,275,27,LEHYRKRDHAQKAISGTYMSLIKERRKN,0
5esk,A,282,290,8,DLIDSLMKN,0
5esk,A,300,332,32,TDQEIANLLIGVLMGGQHTSAATSAWILLHLAE,0
5esk,A,333,348,15,RPDVQQELYEEQMRVL,0
5esk,A,349,352,3,DGGK,0
5esk,A,356,362,6,TYDLLQE,0
5esk,A,363,377,14,MPLLNQTIKETLRMH,0
5esk,A,409,415,6,SPGYTHL,0
5esk,A,427,432,5,NIHRWN,0
5esk,A,465,469,4,GGRHR,0
5esk,A,472,490,18,GEHFAYCQLGVLMSIFIRT,0
1tes,A,5,20,15,EGEWQLVLHVWAKVEA,0
1tes,A,22,36,14,VAGHGQDILIRLFKS,0
1tes,A,38,43,5,PETLEK,0
1tes,A,53,58,5,EAEMKA,0
1tes,A,60,79,19,EDLKKHGVTVLTALGAILKK,0
1tes,A,84,96,12,EAELKPLAQSHAT,0
1tes,A,102,119,17,IKYLEFISEAIIHVLHSR,0
1tes,A,121,123,2,PGN,0
1tes,A,126,150,24,ADAQGAMNKALELFRKDIAAKYKEL,0
4im3,A,49,62,13,VDVQMREFEVLKKL,0
4im3,A,94,100,6,LYTVLEE,0
4im3,A,101,104,3,PSNA,0
4im3,A,108,129,21,PESEFLIVLRDVVGGMNHLREN,0
4im3,A,201,217,16,TVDLWSIGVTFYHAATG,0
4im3,A,230,240,10,NKEVMYKIITG,0
4im3,A,270,285,15,SRGLQVLLTPVLANIL,0
4im3,A,288,292,4,DQEKC,0
4im3,A,294,307,13,GFDQFFAETSDILH,0
4im3,A,331,344,13,TATIFHELVYKQTK,0
4im3,A,346,350,4,ISSNQ,0
4im3,A,366,370,4,LAQHF,0
4im3,A,407,471,64,DLDGDASMAKAITGVVCYACRIASTLLLYQELMRKGIRWLIELIKDDYNETVHKKTEVVITLDFC,0
4im3,A,472,480,8,IRNIEKTVK,0
4im3,A,493,527,34,AELGEISDIHTKLLRLSSSQGTIETSLQDIDSRLS,0
4im3,A,535,540,5,AWAHQE,0
4im3,A,543,546,3,HPKD,0
4im3,A,547,572,25,RNVEKLQVLLNCMTEIYYQFKKDKAE,0
4im3,A,576,604,28,AYNEEQIHKFDKQKLYYHATKAMTHFTDE,0
4im3,A,604,645,41,ECVKKYEAFLNKSEEWIRKMLHLRKQLLSLTNQCFDIEEEVS,0
3nad,B,76,78,2,PEE,0
3nad,B,88,94,6,PKWVHER,0
3nad,B,95,99,4,PDITV,0
3nad,B,101,104,3,YQND,0
3nad,B,105,116,11,YIDLMKESREKY,0
3nad,B,151,160,9,GMTDEIRAGR,0
3nad,B,151,159,8,GMTDEIRAG,0
4h0f,B,40,51,11,YPMYAMTKEVSG,0
4h0f,B,64,68,4,GIHSF,0
4h0f,B,71,81,10,SVNDVAAIYDA,0
4h0f,B,92,98,6,EAWARDL,0
4h0f,B,99,104,5,DPNLKK,0
4h0f,B,146,165,19,DPVLAGEEAVNIAKELGHLD,0
4h0f,B,168,196,28,HKDSYTKKAKAFKKEAEQLTEEYTQKFKK,0
4h0f,B,209,216,7,FSYLAKRF,0
4h0f,B,233,247,14,SPRQLKEIQDFVKEY,0
4h0f,B,260,270,10,PKIAHAIAKST,0
4h0f,B,289,305,16,TYLENLRANLEVLYQQL,0
4h0f,B,71,80,9,SVNDVAAIYD,0
4dk0,A,90,121,31,STTQINTLNTRKAALASYQAQLVARKTAYDVA,0
4dk0,A,124,131,7,NYQRLSKL,0
4dk0,A,132,134,2,YGQ,0
4dk0,A,138,140,2,SLD,0
4dk0,A,141,176,35,TLNTAKATLNNAKAEDVVQENIKQAEIEVNTAETN,0
4dk0,A,326,330,4,PNLAV,0
1o83,D,1,6,5,MAKEFG,0
1o83,D,8,21,13,PAAVAGTVLNVVEA,0
1o83,D,24,36,12,WVTTIVSILTAVG,0
1o83,D,36,46,10,GSGGLSLLAAA,0
1o83,D,50,63,13,SIKAYLKKEIKKKG,0
1o83,D,63,70,7,GKRAVIAW,0
1o83,D,36,47,11,GSGGLSLLAAAG,0
3lfv,B,91,100,9,MEHMASMTRK,0
3lfv,B,101,107,6,ISASEFD,0
3lfv,B,147,161,14,DQSSRLLELVKDISS,0
3lfv,B,164,178,14,DVTALCHKIFLHIHG,0
3lfv,B,227,237,10,KGIVGHVAALG,0
3lfv,B,244,248,4,DAYED,0
3lfv,B,253,260,7,AEVDQITG,0
3lfv,B,298,341,43,KDEKDFAAYLAFCGIVLHNAQLYETSLLENKRNQVLLDLASLIF,0
3lfv,B,346,363,17,SLEVILKKIAATIISFMQ,0
3lfv,B,409,419,10,YMYAQYVKNTM,0
3lfv,B,485,518,33,NRNDEQFLEAFVIFCGLGIQNTQMYEAVERAMAK,0
3lfv,B,91,95,4,MEHMA,0
3lfv,B,147,160,13,DQSSRLLELVKDIS,0
3lfv,B,296,341,45,TEKDEKDFAAYLAFCGIVLHNAQLYETSLLENKRNQVLLDLASLIF,0
3lfv,B,410,419,9,MYAQYVKNTM,0
3lfv,B,485,517,32,NRNDEQFLEAFVIFCGLGIQNTQMYEAVERAMA,0
5mmp,A,10,22,12,IKVLKGLDAVRKR,0
5mmp,A,22,28,6,RPGMYIG,0
5mmp,A,33,53,20,GTGLHHMVFEVVDNAIDEALA,0
5mmp,A,89,97,8,SAAEVIMTV,0
5mmp,A,119,126,7,GVSVVNAL,0
5mmp,A,183,197,14,EYEILAKRLRELSFL,0
4ky6,A,54,69,15,YGPEASAFTKKMVENA,0
4ky6,A,99,106,7,VNEALVRQ,0
4ky6,A,121,135,14,HEQLLRKAEAQAKKE,0
4ky6,A,137,141,4,LNIWS,0
3a8g,B,17,31,14,PVSDRAWALFRALDG,0
3a8g,B,38,50,12,GYVEGWKKTFEED,0
3a8g,B,52,66,14,SPRRGAELVARAWTD,0
3a8g,B,66,76,10,DPEFRQLLLTD,0
3a8g,B,76,84,8,DGTAAVAQY,0
3a8g,B,116,121,5,AWPILG,0
3a8g,B,124,129,5,PTWYKS,0
3a8g,B,129,136,7,SFEYRARV,0
3a8g,B,139,148,9,EPRKVLSEMG,0
3a8g,B,182,190,8,SQEQLQEIV,0
3a8g,B,191,197,6,TKDCLIG,0
3a8g,B,34,46,12,HLPYSLMFAGVAE,0
3a8g,B,51,61,10,SVDEVRYVVER,0
3a8g,B,63,70,7,EPRHYMMT,0
3a8g,B,71,87,16,PYYERYVIGVATLMVEK,0
3a8g,B,91,100,9,TQDELESLAG,0
3a8g,B,143,147,4,PAYCR,0
3a8g,B,163,168,5,FPDAIG,0
3a8g,B,186,191,5,AEELFG,0
1fvr,B,820,824,4,DWNDI,0
1fvr,B,833,835,2,GNF,0
1fvr,B,867,877,10,RDFAGELEVLC,0
1fvr,B,909,916,7,NLLDFLRK,0
1fvr,B,918,923,5,RVLETD,0
1fvr,B,923,930,7,DPAFAIAN,0
1fvr,B,937,958,21,SSQQLLHFAADVARGMDYLSQK,0
1fvr,B,966,968,2,AAR,0
1fvr,B,974,976,2,ENY,0
1fvr,B,1006,1013,7,AIESLNYS,0
1fvr,B,1016,1033,17,TTNSDVWSYGVLLWEIVS,0
1fvr,B,1043,1051,8,TCAELYEKL,0
1fvr,B,1052,1054,2,PQG,0
1fvr,B,1064,1075,11,DDEVYDLMRQCW,0
1fvr,B,1078,1082,4,KPYER,0
1fvr,B,1084,1098,14,SFAQILVSLNRMLEE,0
1fvr,B,1117,1121,4,DCSAE,0
1fvr,B,867,878,11,RDFAGELEVLCK,0
1fvr,B,909,917,8,NLLDFLRKS,0
1fvr,B,937,957,20,SSQQLLHFAADVARGMDYLSQ,0
1fvr,B,1001,1005,4,PVRWM,0
3oyk,B,8,18,10,LDAELDQLLQG,0
3oyk,B,50,64,14,PQSDRQKIVLQAHNL,0
3oyk,B,68,78,10,GREATLLKIAN,0
3oyk,B,84,94,10,NMRKDVVKQLG,0
3oyk,B,96,103,7,CQQCLITN,0
3oyk,B,162,175,13,STSATVKSLNVLTS,0
3oyk,B,187,192,5,GAAFTS,0
3oyk,B,192,201,9,SSTFAEWAKE,0
3oyk,B,213,216,3,HPQS,0
3oyk,B,217,236,19,HGKVERKNSDIKRLLTKLLV,0
3oyk,B,242,244,2,WYD,0
3oyk,B,245,255,10,LLPVVQLALNN,0
3oyk,B,264,271,7,TPHQLLFG,0
3oyk,B,287,301,14,TREEELSLLQEIRTS,0
3oyk,B,162,174,12,STSATVKSLNVLT,0
3oyk,B,192,202,10,SSTFAEWAKER,0
3oyk,B,218,236,18,GKVERKNSDIKRLLTKLLV,0
3oyk,B,241,255,14,KWYDLLPVVQLALNN,0
3oyk,B,287,298,11,TREEELSLLQEI,0
5v0r,A,10,29,19,KMSSSSKLRLLSDLQQLQKD,0
5v0r,A,100,104,4,LDIVQ,0
5v0r,A,112,124,12,TVDSILTSILSLL,0
5v0r,A,134,144,10,NPEAAKLFVND,0
5v0r,A,144,154,10,DPKEYKKRVRK,0
4gp2,B,4,27,23,DVVSRLHQKYGAEVEKALVRYLSI,0
4gp2,B,30,32,2,AED,0
4gp2,B,33,43,10,FREAVLYQVKT,0
4gp2,B,47,62,15,RLRPLLTLAAAEAVSG,0
4gp2,B,64,66,2,WRP,0
4gp2,B,67,89,22,ALPAAAIVELIHNYSLIYDDIID,0
4gp2,B,99,105,6,TVRKAFG,0
4gp2,B,105,126,21,GDNAAILVGIWYREAIEEAVLD,0
4gp2,B,129,154,25,KPTLFAKEVAEVIKAIDEGERLDILF,0
4gp2,B,161,167,6,DPYFVQA,0
4gp2,B,173,185,12,TLDDYIKMVSLKT,0
4gp2,B,185,199,14,TGALIAAAAKWGVLS,0
4gp2,B,203,232,29,DRGLAEAAWNFGMAAGVAFQIIDDVLDIYG,0
4gp2,B,242,247,5,GKDIKE,0
4gp2,B,252,262,10,NAVVAVALSHL,0
4gp2,B,263,275,12,GEGERRRLLEILA,0
4gp2,B,280,294,14,EEADVREAVALLDSV,0
4gp2,B,295,316,21,GAREEALRLAARYREEAERHLA,0
4gp2,B,321,332,11,NGTLKELLDFIV,0
4gp2,B,333,342,9,AREYAENLYF,0
4gp2,B,5,27,22,VVSRLHQKYGAEVEKALVRYLSI,0
4gp2,B,33,40,7,FREAVLYQ,0
4gp2,B,41,43,2,VKT,0
4gp2,B,185,201,16,TGALIAAAAKWGVLSVS,0
4gp2,B,280,293,13,EEADVREAVALLDS,0
4gp2,B,333,340,7,AREYAENL,0
5xsb,A,3,24,21,SVDQKAISTIRLLAVDAVAAAN,0
5xsb,A,28,45,17,PGAPLGLAPAAHAVFKKM,0
5xsb,A,64,66,2,NGH,0
5xsb,A,67,78,11,ACALLYSMLVLY,0
5xsb,A,83,89,6,TVEDLKK,0
5xsb,A,117,138,21,GQGICNGVGIALAQAQFAATYN,0
5xsb,A,154,160,6,GDGCLME,0
5xsb,A,160,173,13,EGVSSEASSLAGHL,0
5xsb,A,194,196,2,EVA,0
5xsb,A,200,208,8,DVIARYKSY,0
5xsb,A,221,235,14,DITAIAAAIDEAKKV,0
5xsb,A,257,261,4,THGVH,0
5xsb,A,266,278,12,KADDIKQLKTKWG,0
5xsb,A,288,320,32,PAEVTASYNEHVAENQKIQQQWNELFAAYKQKY,0
5xsb,A,320,332,12,YPELGAELQRRLD,0
5xsb,A,338,343,5,NWDKAL,0
5xsb,A,355,367,12,TRKLSEIVLSKII,0
5xsb,A,380,385,5,LTPSNL,0
5xsb,A,396,400,4,PAATG,0
5xsb,A,414,429,15,REHAMGAIMNGIAAFG,0
5xsb,A,440,444,4,LNFVS,0
5xsb,A,446,457,11,AAGAVRLSALSE,0
5xsb,A,468,472,4,SIGLG,0
5xsb,A,482,489,7,ETLAHFRA,0
5xsb,A,500,514,14,DGNETSAAYKSAIES,0
5xsb,A,535,540,5,SIEKAS,0
5xsb,A,561,576,15,SEVSLAVDALKVLEGQ,0
5xsb,A,587,593,6,DQLTFDK,0
5xsb,A,595,603,8,SEEYKLSVL,0
5xsb,A,619,623,4,GWSKY,0
5xsb,A,638,646,8,KAPEIFKLF,0
5xsb,A,649,664,15,TPEGVAERAAKTVAFY,0
4x33,B,10,12,2,EDM,0
4x33,B,35,40,5,LDDMFE,0
4x33,B,213,217,4,ELKQQ,0
2ys8,A,13,25,12,TKEQADAIRRIRN,0
2ys8,A,28,34,6,DSWDMLG,0
2ys8,A,40,56,16,SRDEVNKAYRKLAVLLH,0
2ys8,A,64,84,20,GSEDAFKAVVNARTALLKNIK,0
4pdc,F,119,129,10,NWYESQASCMS,0
4pdc,F,143,149,6,QDLLKLV,0
4pdc,F,119,130,11,NWYESQASCMSQ,0
4pdc,F,41,45,4,IPFMI,0
4pdc,F,49,64,15,IFLPFYKNVFSEFFSL,0
4pdc,F,111,126,15,TNKNMWLTTSEFRLKK,0
4pdc,F,129,146,17,DGEDCIMHLRSLVRKMED,0
4pdc,F,111,125,14,TNKNMWLTTSEFRLK,0
2zbv,C,13,26,13,HYVGVAKAVIKRIN,0
2zbv,C,42,55,13,NVRKASHVLYRASL,0
2zbv,C,96,104,8,LTVVAEEYG,0
2zbv,C,113,117,4,NRELF,0
2zbv,C,126,131,5,FHGRDI,0
2zbv,C,131,141,10,IFAPVAAHLD,0
2zbv,C,144,148,4,PLERV,0
2zbv,C,189,193,4,FDLFL,0
2zbv,C,194,196,2,KLS,0
2zbv,C,219,223,4,AFGDV,0
2zbv,C,246,252,6,DASQVLS,0
2zbv,C,189,194,5,FDLFLK,0
2zbv,C,246,251,5,DASQVL,0
2e4o,D,28,44,16,LVEEVSKEVDGYFLQHW,0
2e4o,D,48,59,11,NEKARKKFVAAG,0
2e4o,D,59,68,9,GFSRVTCLYF,0
2e4o,D,75,93,18,RIHFACRLLTVLFLIDDLL,0
2e4o,D,94,96,2,EYM,0
2e4o,D,97,113,16,SFEEGSAYNEKLIPISR,0
2e4o,D,122,157,35,IPVEYIIYDLWESMRAHDREMADEILEPVFLFMRAQ,0
2e4o,D,167,177,10,GLGGYLEYRER,0
2e4o,D,178,192,14,DVGKELLAALMRFSM,0
2e4o,D,197,204,7,SPSELQRV,0
2e4o,D,204,228,24,VREIDANCSKHLSVVNDIYSYEKEL,0
2e4o,D,243,253,10,TSVQILAQEAD,0
2e4o,D,255,284,29,TAEAAKRVLFVMCREWELRHQLLVARLSAE,0
2e4o,D,288,312,24,TPGLAAYVEGLEYQMSGNELWSQTT,0
2e4o,D,313,316,3,LRYS,0
2e4o,D,75,94,19,RIHFACRLLTVLFLIDDLLE,0
2e4o,D,122,139,17,IPVEYIIYDLWESMRAHD,0
2e4o,D,139,146,7,DREMADEI,0
2e4o,D,146,157,11,ILEPVFLFMRAQ,0
2e4o,D,97,114,17,SFEEGSAYNEKLIPISRG,0
2e4o,D,122,146,24,IPVEYIIYDLWESMRAHDREMADEI,0
2e4o,D,146,155,9,ILEPVFLFMR,0
2e4o,D,167,176,9,GLGGYLEYRE,0
2e4o,D,197,203,6,SPSELQR,0
2e4o,D,99,107,8,EEGSAYNEK,0
2e4o,D,107,114,7,KLIPISRG,0
2e4o,D,122,145,23,IPVEYIIYDLWESMRAHDREMADE,0
2e4o,D,178,193,15,DVGKELLAALMRFSMG,0
2e4o,D,204,224,20,VREIDANCSKHLSVVNDIYSY,0
2e4o,D,225,229,4,EKELY,0
2vmq,A,3,8,5,YLPQQD,0
2vmq,A,8,25,17,DPQVFAAIEQERKRQHAK,0
2vmq,A,36,44,8,SRAVMEAQG,0
2vmq,A,45,50,5,SVLTNK,0
2vmq,A,64,83,19,CEYVDIVEELARERAKQLFG,0
2vmq,A,93,106,13,SGAQANMAVYFTVL,0
2vmq,A,122,126,4,HLTHG,0
2vmq,A,130,136,6,NFSGVQY,0
2vmq,A,151,163,12,DYDDVREKARLHR,0
2vmq,A,179,191,12,DFAKFREIADEVG,0
2vmq,A,201,207,6,IAGLVAA,0
2vmq,A,239,251,12,QEQFAKQIDKAIF,0
2vmq,A,259,274,15,LMHVIAAKAVAFGEAL,0
2vmq,A,275,299,24,QDDFKAYAKRVVDNAKRLASALQNE,0
2vmq,A,305,307,2,SGG,0
2vmq,A,318,321,3,RPQQ,0
2vmq,A,323,334,11,TGKTAEKVLDEV,0
2vmq,A,360,366,6,TAAVTTR,0
2vmq,A,369,385,16,GLEEMDEIAAIIGLVLK,0
2vmq,A,389,405,16,SEQALEEARQRVAALTD,0
2bi2,B,15,25,10,PKPALERAQKE,0
2bi2,B,35,39,4,SVMEL,0
2bi2,B,43,62,19,SQSYEEVHEQAQNLLRELLQ,0
2bi2,B,74,88,14,GGASLQFTMLPMNLL,0
2bi2,B,100,112,12,GSWSEKALKEAKL,0
2bi2,B,123,126,3,KANS,0
2bi2,B,132,136,4,DFSEF,0
2bi2,B,183,187,4,KVNQF,0
2bi2,B,210,214,4,KDLLN,0
2bi2,B,221,224,3,PTML,0
2bi2,B,225,232,7,QYATHIKS,0
2bi2,B,240,257,17,PTFSIYMLRNVLDWIKDL,0
2bi2,B,258,280,22,GGAEAIAKQNEEKAKIIYDTIDE,0
2bi2,B,290,293,3,EKGS,0
2bi2,B,305,319,14,NEELNQQFLAKAKEQ,0
2bi2,B,342,359,17,PIDACIALRELMIQFKEN,0
2bi2,B,28,32,4,NFNDT,0
2bi2,B,100,114,14,GSWSEKALKEAKLLG,0
2bi2,B,225,233,8,QYATHIKSD,0
2bi2,B,342,360,18,PIDACIALRELMIQFKENA,0
1lsc,A,4,15,11,GRCELAAAMKRH,0
1lsc,A,24,37,13,SLGNWVCAAKFESN,0
1lsc,A,80,85,5,CSALLS,0
1lsc,A,88,100,12,ITASVNCAKKIVS,0
1lsc,A,103,107,4,NGMNA,0
1lsc,A,108,115,7,WVAWRNRC,0
1lsc,A,119,125,6,DVQAWIR,0
5anj,A,45,56,11,PSTAIREISLLK,0
5anj,A,87,94,7,LKKFMDAS,0
5anj,A,100,121,21,PLPLIKSYLFQLLQGLAFCHSH,0
5anj,A,129,131,2,KPQ,0
5anj,A,147,153,6,GLARAFG,0
5anj,A,170,175,5,APEILL,0
5anj,A,182,199,17,TAVDIWSLGCIFAEMVTR,0
5anj,A,207,220,13,SEIDQLFRIFRTLG,0
5anj,A,229,233,4,GVTSM,0
5anj,A,247,252,5,DFSKVV,0
5anj,A,256,267,11,DEDGRSLLSQML,0
5anj,A,276,282,6,SAKAALA,0
5anj,A,283,287,4,HPFFQ,0
2l4n,A,57,69,12,ELWVQQLMQHLDK,0
1ksi,B,15,28,13,KEEFLAVQTIVQNK,0
1ksi,B,48,56,8,KDHVLRYET,0
1ksi,B,58,60,2,PTL,0
1ksi,B,105,117,12,VDEQSLAIKLPLK,0
1ksi,B,119,127,8,PPFIDSVKK,0
1ksi,B,132,134,2,LSE,0
1ksi,B,167,169,2,IYV,0
1ksi,B,300,304,4,DSGEF,0
1ksi,B,421,423,2,KDE,0
1ksi,B,492,495,3,ESDA,0
1ksi,B,540,544,4,YPQIR,0
1ksi,B,546,549,3,AFTN,0
1ksi,B,578,584,6,LAVWTKQ,0
1ksi,B,607,609,2,QED,0
1ksi,B,207,209,2,VSK,0
1nlp,C,58,60,2,SNY,0
4xh5,A,59,74,15,NYEDALKAIAFELEKR,0
4xh5,A,76,78,2,LTD,0
4xh5,A,101,112,11,TDEIIDNIRRVS,0
4xh5,A,115,133,18,APLHNYANLSGIDAARHLF,0
4xh5,A,144,150,6,TSFHQTL,0
4xh5,A,151,156,5,APEAYL,0
4xh5,A,160,168,8,PWEYFSSLG,0
4xh5,A,175,190,15,HGTSHRYVSRRAYELL,0
4xh5,A,241,253,12,DFGAMAWIAKETG,0
4xh5,A,255,266,11,TLSDLERVVNKE,0
4xh5,A,267,274,7,SGLLGISG,0
4xh5,A,278,288,10,DLRVLEKAWHE,0
4xh5,A,290,313,23,HERARLAIKTFVHRIARHIAGHAA,0
4xh5,A,325,331,6,GGIGENS,0
4xh5,A,331,341,10,SVLIRQLVIEH,0
4xh5,A,342,346,4,LGVLG,0
4xh5,A,350,356,6,DVEMNKQ,0
4xh5,A,357,361,4,PNSHG,0
4xh5,A,380,393,13,NEEKMIALDAIHLG,0
3wvl,N,9,29,20,GNDARVKMLRGVNVLADAVKV,0
3wvl,N,52,60,8,AGVSVAREI,0
3wvl,N,64,85,21,DKFENMGAQMVKEVASKANDAA,0
3wvl,N,88,109,21,GTTTATVLAQAIITEGLKAVAA,0
3wvl,N,112,135,23,NPMDLKRGIDKAVTAAVEELKALS,0
3wvl,N,140,152,12,DSKAIAQVGTISA,0
3wvl,N,155,170,15,DETVGKLIAEAMDKVG,0
3wvl,N,230,232,2,IRE,0
3wvl,N,233,242,9,MLPVLEAVAK,0
3wvl,N,255,268,13,EGEALATLVVNTMR,0
3wvl,N,282,297,15,GDRRKAMLQDIATLTG,0
3wvl,N,338,350,12,EEAAIQGRVAQIR,0
3wvl,N,351,356,5,QQIEEA,0
3wvl,N,357,370,13,TSDYDREKLQERVA,0
3wvl,N,385,410,25,TEVEMKEKKARVEAALHATRAAVEEG,0
3wvl,N,416,426,10,GVALIRVASKL,0
3wvl,N,427,429,2,ADL,0
3wvl,N,433,447,14,NEDQNVGIKVALRAM,0
3wvl,N,448,458,10,EAPLRQIVLNC,0
3wvl,N,461,471,10,EPSVVANTVKG,0
3wvl,N,488,492,4,MIDMG,0
3wvl,N,497,515,18,TKVTRSALQYAASVAGLMI,0
3wvl,N,233,244,11,MLPVLEAVAKAG,0
3wvl,N,338,354,16,EEAAIQGRVAQIRQQIE,0
3wvl,N,359,371,12,DYDREKLQERVAK,0
3wvl,N,448,459,11,EAPLRQIVLNCG,0
3wvl,N,461,472,11,EPSVVANTVKGG,0
3wvl,N,360,371,11,YDREKLQERVAK,0
3wvl,N,281,297,16,FGDRRKAMLQDIATLTG,0
3wvl,N,358,371,13,SDYDREKLQERVAK,0
3wvl,N,359,370,11,DYDREKLQERVA,0
2y4t,C,34,50,16,MADVEKHLELGKKLLAA,0
2y4t,C,52,67,15,QLADALSQFHAAVDGD,0
2y4t,C,70,84,14,NYIAYYRRATVFLAM,0
2y4t,C,86,101,15,KSKAALPDLTKVIQLK,0
2y4t,C,104,118,14,FTAARLQRGHLLLKQ,0
2y4t,C,120,133,13,KLDEAEDDFKKVLK,0
2y4t,C,137,168,31,SENEEKEAQSQLIKSDEMQRLRSQALNAFGSG,0
2y4t,C,169,184,15,DYTAAIAFLDKILEVC,0
2y4t,C,187,201,14,DAELRELRAECFIKE,0
2y4t,C,203,206,3,EPRK,0
2y4t,C,207,219,12,AISDLKAASKLKN,0
2y4t,C,221,235,14,NTEAFYKISTLYYQL,0
2y4t,C,237,252,15,DHELSLSEVRECLKLD,0
2y4t,C,255,282,27,HKRCFAHYKQVKKLNKLIESAEELIRDG,0
2y4t,C,283,298,15,RYTDATSKYESVMKTE,0
2y4t,C,301,318,17,IAEYTVRSKERICHCFSK,0
2y4t,C,321,336,15,KPVEAIRVCSEVLQME,0
2y4t,C,339,353,14,NVNALKDRAEAYLIE,0
2y4t,C,355,368,13,MYDEAIQDYETAQE,0
2y4t,C,373,392,19,DQQIREGLEKAQRLLKQSQK,0
2y4t,C,395,399,4,YYKIL,0
2y4t,C,408,421,13,QEIIKAYRKLALQW,0
2y4t,C,422,426,4,HPDNF,0
2y4t,C,428,449,21,NEEEKKKAEKKFIDIAAAKEVL,0
2y4t,C,450,455,5,SDPEMR,0
2y4t,C,35,51,16,ADVEKHLELGKKLLAAG,0
2y4t,C,120,134,14,KLDEAEDDFKKVLKS,0
2y4t,C,139,168,29,NEEKEAQSQLIKSDEMQRLRSQALNAFGSG,0
2y4t,C,187,202,15,DAELRELRAECFIKEG,0
2y4t,C,207,218,11,AISDLKAASKLK,0
2y4t,C,255,281,26,HKRCFAHYKQVKKLNKLIESAEELIRD,0
2y4t,C,301,319,18,IAEYTVRSKERICHCFSKD,0
2y4t,C,355,370,15,MYDEAIQDYETAQEHN,0
2y4t,C,450,454,4,SDPEM,0
2y4t,C,36,50,14,DVEKHLELGKKLLAA,0
2y4t,C,70,85,15,NYIAYYRRATVFLAMG,0
2y4t,C,104,119,15,FTAARLQRGHLLLKQG,0
2y4t,C,428,450,22,NEEEKKKAEKKFIDIAAAKEVLS,0
2y4t,C,451,454,3,DPEM,0
2qbx,B,35,37,2,TTA,0
2qbx,B,104,108,4,DCSSI,0
5oo6,W,27,38,11,TEDHLESLICKV,0
5oo6,W,45,79,34,SLESNLEGLAGVLEADLPNYKSKILRLLCTVARLL,0
5oo6,W,82,97,15,KLTIYTTLVGLLNARN,0
5oo6,W,97,118,21,NYNFGGEFVEAMIRQLKESLKA,0
5oo6,W,120,137,17,NYNEAVYLVRFLSDLVNC,0
5oo6,W,141,154,13,AAPSMVAMFENFVS,0
5oo6,W,155,157,2,VTQ,0
5oo6,W,162,175,13,PQVRRDWYVYAFLS,0
5oo6,W,176,188,12,SLPWVGKELYEKK,0
5oo6,W,188,206,18,KDAEMDRIFANTESYLKRR,0
5oo6,W,210,215,5,HVPMLQ,0
5oo6,W,227,242,15,EYLDCLWAQIQKLKKD,0
5oo6,W,251,255,4,RPYLA,0
5oo6,W,256,262,6,FDSILCE,0
5oo6,W,293,297,4,DYTDD,0
5oo6,W,308,326,18,SVERFVIEENLHCIIKSHW,0
5oo6,W,328,338,10,ERKTCAAQLVS,0
5oo6,W,346,360,14,PLNYHIVEVIFAELF,0
5oo6,W,368,383,15,IDVMYTTLLIELCKLQ,0
5oo6,W,386,401,15,SLPQVLAQATEMLYMR,0
5oo6,W,402,405,3,LDTM,0
5oo6,W,406,423,17,NTTCVDRFINWFSHHLSN,0
5oo6,W,429,437,8,SWEDWSDCL,0
5oo6,W,443,460,17,SPKPKFVREVLEKCMRLS,0
5oo6,W,461,469,8,YHQRILDIV,0
5oo6,W,498,510,12,HSVALCLAVAFKS,0
5oo6,W,513,521,8,TNDEIFSIL,0
5oo6,W,541,555,14,PLKIEVFVQTLLHLA,0
5oo6,W,558,569,11,SFSHSFSALAKF,0
5oo6,W,569,577,8,FHEVFKTLA,0
5oo6,W,579,595,16,SDEGKLHVLRVMFEVWR,0
5oo6,W,597,611,14,HPQMIAVLVDKMIRT,0
5oo6,W,615,625,10,DCAAVANWIFS,0
5oo6,W,626,629,3,SELS,0
5oo6,W,634,670,36,RLFVWEILHSTIRKMNKHVLKIQKELEEAKEKLARQH,0
5oo6,W,688,732,44,LEEQIERLQEKVESAQSEQKNLFLVIFQRFIMILTEHLVRCETDG,0
5oo6,W,737,754,17,TPWYKNCIERLQQIFLQH,0
5oo6,W,754,759,5,HHQIIQ,0
5oo6,W,761,769,8,YMVTLENLL,0
5oo6,W,775,788,13,DPHILAVFQQFCAL,0
5oo6,W,6,11,5,LKALRS,0
5oo6,W,28,37,9,DNEEQEKLLK,0
5oo6,W,52,61,9,TEEQIYELFS,0
5oo6,W,62,64,2,KSG,0
5oo6,W,90,101,11,SRADAENAMRYI,0
5oo6,W,134,139,5,VRDEYR,0
5oo6,W,143,147,4,DAGRG,0
5oo6,W,28,38,10,EDHLESLICKV,0
5oo6,W,497,510,13,GHSVALCLAVAFKS,0
5oo6,W,684,732,48,KDGVLEEQIERLQEKVESAQSEQKNLFLVIFQRFIMILTEHLVRCETDG,0
2hti,A,13,24,11,DEKKITEFLNKA,0
2hti,A,59,68,9,GRKIKIEAN,0
2hti,A,108,124,16,AIEEGTEAQQLDKYV,0
3s3v,A,27,40,13,LRNEFRYFKRMTTT,0
3s3v,A,54,60,6,KKTWFSI,0
3s3v,A,61,65,4,PEKFR,0
3s3v,A,92,100,8,SLDDALKLT,0
3s3v,A,117,127,10,GSSVYKEAMNH,0
3vyj,A,128,139,11,SWNESEEKCSHM,0
3vyj,A,148,158,10,SQAEQDFITSN,0
3vyj,A,186,190,4,NKSAT,0
4rqk,A,78,80,2,RPE,0
4rqk,A,115,121,6,KRHIIKE,0
4rqk,A,123,135,12,KVPYVTRERDVMS,0
4rqk,A,166,175,9,ELLKYIRKIG,0
4rqk,A,178,199,21,DETCTRFYTAEIVSALEYLHGK,0
4rqk,A,207,209,2,KPE,0
4rqk,A,245,249,4,TAQYV,0
4rqk,A,250,257,7,SPELLTEK,0
4rqk,A,260,278,18,CKSSDLWALGCIIYQLVAG,0
4rqk,A,286,296,10,NEGLIFAKIIK,0
4rqk,A,306,317,11,FPKARDLVEKLL,0
4rqk,A,320,324,4,DATKR,0
4rqk,A,327,331,4,CEEME,0
4rqk,A,332,338,6,GYGPLKA,0
4rqk,A,339,343,4,HPFFE,0
4rqk,A,349,353,4,NLHQQ,0
2h0g,B,4,12,8,PAPVKAIEK,0
2h0g,B,24,26,2,PGG,0
2h0g,B,62,73,11,NLSNTLIEKEIY,0
2h0g,B,74,77,3,APAG,0
2h0g,B,78,86,8,REMWQRMEQ,0
2h0g,B,109,119,10,CPYCKQFWQQA,0
2h0g,B,119,125,6,ARPWVDS,0
2h0g,B,141,152,11,ESPATAAAILAS,0
2h0g,B,154,165,11,DPAKTWQQYEAS,0
2h0g,B,178,195,17,STEQMKVLSDNEKLMDDL,0
2h0g,B,220,228,8,DQKTLNIIM,0
2h0g,B,73,87,14,YAPAGREMWQRMEQS,0
2h0g,B,119,124,5,ARPWVD,0
2ari,A,5,21,16,IGALFLGFLGAAGSTMG,0
3txg,A,4,15,11,GRCELAAAMKRH,0
3txg,A,19,23,4,NYRGY,0
3txg,A,24,37,13,SLGNWVCAAKFESN,0
3txg,A,79,85,6,PCSALLS,0
3txg,A,88,100,12,ITASVNCAKKIVS,0
3txg,A,103,107,4,NGMNA,0
3txg,A,108,115,7,WVAWRNRC,0
3txg,A,119,125,6,DVQAWIR,0
6cdo,B,28,32,4,AFSDY,0
6cdo,B,87,91,4,TSEDS,0
6cdo,B,132,134,2,SSK,0
6cdo,B,161,163,2,SGA,0
6cdo,B,192,194,2,SSL,0
6cdo,B,206,209,3,KPSN,0
6cdo,B,222,226,4,DKGLE,0
6cdo,B,84,88,4,ETEDL,0
6cdo,B,126,132,6,SDEQLKS,0
6cdo,B,188,193,5,KADYEK,0
1kaa,A,54,68,14,YGPEASAFTKKMVEN,0
1kaa,A,99,106,7,VNEALVRQ,0
1kaa,A,121,135,14,HEQHLRKSEAQAKKE,0
1kaa,A,137,141,4,LNIWS,0
2dam,A,15,30,15,TQEQTEKLLQFQDLTG,0
2dam,A,33,45,12,SMDQCRHTLEQHN,0
2dam,A,47,58,11,NIEAAVQDRLNE,0
3kyk,L,28,32,4,TFSIY,0
3kyk,L,87,91,4,RAEDT,0
3kyk,L,133,135,2,SSK,0
3kyk,L,162,164,2,SGA,0
3kyk,L,193,196,3,SSLG,0
3kyk,L,79,83,4,QSEDF,0
3kyk,L,122,127,5,DEQLKS,0
3kyk,L,183,187,4,KADYE,0
4q5p,C,2,14,12,SAKKGATLFKTRC,0
4q5p,C,34,38,4,GIFGR,0
4q5p,C,50,56,6,DANIKKN,0
4q5p,C,60,68,8,DENNMSEYL,0
4q5p,C,87,102,15,KEKDRNDLITYLKKAS,0
4q5p,C,1,14,13,GSAKKGATLFKTRC,0
4q5p,C,52,56,4,NIKKN,0
4q5p,C,60,70,10,DENNMSEYLTN,0
4q5p,C,87,103,16,KEKDRNDLITYLKKASE,0
1e6q,M,21,25,4,NSSSF,0
1e6q,M,36,41,5,SAYQIE,0
1e6q,M,49,58,9,NIWDGFTHRY,0
1e6q,M,58,63,5,YPNKSG,0
1e6q,M,74,79,5,DSFSYW,0
1e6q,M,78,90,12,YWQKDIDVLDELN,0
1e6q,M,99,104,5,AWSRII,0
1e6q,M,108,112,4,KRSRG,0
1e6q,M,114,131,17,NEKGIDYYHGLISGLIKK,0
1e6q,M,145,153,8,PQTLQDEYE,0
1e6q,M,154,158,4,GFLDP,0
1e6q,M,159,176,17,QIIDDFKDYADLCFEEFG,0
1e6q,M,189,197,8,YSVPTRGYG,0
1e6q,M,221,245,24,TEPYIVAHHQLLAHAKVVDLYRKNY,0
1e6q,M,246,249,3,THQG,0
1e6q,M,268,283,15,DRHSIAATERMKEFFL,0
1e6q,M,283,293,10,LGWFMGPLTNG,0
1e6q,M,296,304,8,PQIMIDTVG,0
1e6q,M,305,307,2,ERL,0
1e6q,M,311,319,8,SPEESNLVK,0
1e6q,M,348,353,5,TAMMDA,0
1e6q,M,377,381,4,DSTDN,0
1e6q,M,386,400,14,PKGIYSVMDYFKNKY,0
1e6q,M,419,425,6,NRNQSML,0
1e6q,M,426,448,22,DYTRIDYLCSHLCFLNKVIKEKD,0
1e6q,M,489,500,11,KKSGQWYQSFIS,0
1o20,A,2,19,17,DELLEKAKKVREAWDVLR,0
1o20,A,22,40,18,TTREKNKAIKKIAEKLDER,0
1o20,A,40,58,18,RRKEILEANRIDVEKARER,0
1o20,A,61,69,8,KESLVDRLA,0
1o20,A,71,88,17,NDKRIDEIKACETVIGL,0
1o20,A,125,138,13,PNVTVETTILALKS,0
1o20,A,147,149,2,GSD,0
1o20,A,150,166,16,ALNSNKAIVSAIREALK,0
1o20,A,171,173,2,PES,0
1o20,A,183,190,7,RSLVLEI,0
1o20,A,204,215,11,GYGLISFVRDNA,0
1o20,A,236,250,14,DLKKAVPVIINAKTQ,0
1o20,A,265,282,17,EKIAKEFLPVIVEELRKH,0
1o20,A,289,296,7,CEKTREIV,0
1o20,A,303,307,4,TEDDW,0
1o20,A,323,335,12,NVDEAIEHIKKYS,0
1o20,A,346,357,11,NYSNAKKFVSEI,0
1o20,A,367,371,4,STRFT,0
1o20,A,397,399,2,LRE,0
2x7m,A,14,31,17,MLSSIVDRFEEHVSEYLG,0
2x7m,A,43,45,2,PEH,0
2x7m,A,56,65,9,ARALLDTLRG,0
2x7m,A,111,131,20,DPELYLERVVKELTHELGHTF,0
2x7m,A,148,155,7,SLLEVDRK,0
2x7m,A,160,172,12,CRRCTELLQRNLK,0
2zio,A,191,202,11,TKSQTDRLEVLL,0
2zio,A,215,237,22,PFRELESELLSRRKKDLQQIYAE,0
2zio,A,241,257,16,NYLGKLEREITRFFVDR,0
2zio,A,270,275,5,LEYIER,0
2zio,A,301,313,12,LAPNLYNYLRKLD,0
2zio,A,355,371,16,TRENLESIITDFLNHLG,0
2zio,A,405,412,7,IPLDREWG,0
2zio,A,424,433,9,LERLLKVKHD,0
2zio,A,436,440,4,NIKRA,0
3a57,A,24,27,3,TFNT,0
3a57,A,106,115,9,SYDSVASFVG,0
3a57,A,117,121,4,DEDSI,0
3a57,A,157,162,5,SFFECK,0
2wpz,C,1,30,29,RMKQLEDKVEENLSKVYHNENEVARLKKLV,0
4nt3,A,74,83,9,LAREVSNKIV,0
4nt3,A,98,112,14,LLFMQWGQIVDHDLD,0
4nt3,A,149,154,5,PKLKTQ,0
4nt3,A,189,194,5,ASLVYG,0
4nt3,A,196,203,7,EPLASRL,0
4nt3,A,235,240,5,SPCEFI,0
4nt3,A,259,284,25,QILLATAHTLLLREHNRLARELKKLN,0
4nt3,A,288,311,23,NGEKLYQEARKILGAFIQIITFRD,0
4nt3,A,311,318,7,DYLPIVLG,0
4nt3,A,320,325,5,EMQKWI,0
4nt3,A,342,347,5,VFTFAF,0
4nt3,A,348,354,6,RFGHMEV,0
4nt3,A,377,380,3,HTLF,0
4nt3,A,383,388,5,TWRIIK,0
4nt3,A,392,402,10,IDPLVRGLLAK,0
4nt3,A,414,419,5,TSELRN,0
4nt3,A,432,444,12,DLAAINLQRCRDH,0
4nt3,A,448,456,8,GYNSWRGFC,0
4nt3,A,463,472,9,TLKGLQTVLK,0
4nt3,A,473,485,12,NKILAKKLMDLYK,0
4nt3,A,491,499,8,DIWIGGNAE,0
4nt3,A,508,525,17,GPLLACLLGRQFQQIRDG,0
4nt3,A,537,545,8,TEKQRDSLQ,0
4nt3,A,548,557,9,SFSRLICDNT,0
4nt3,A,587,591,4,LSPWA,0
1up8,D,9,28,19,SRAKASFDTRVAAAELALNR,0
1up8,D,37,42,5,GEELLY,0
1up8,D,72,86,14,DPDDFLAFVRAINSG,0
1up8,D,87,93,6,DEKEIAD,0
1up8,D,111,118,7,SDLANSLE,0
1up8,D,128,132,4,SAGLT,0
1up8,D,153,169,16,SPELVAEIAELYLMALG,0
1up8,D,174,177,3,FSEF,0
1up8,D,179,181,2,SPK,0
1up8,D,182,195,13,NAEYIQFAIDQLNG,0
1up8,D,196,201,5,LEWFNT,0
1up8,D,208,215,7,PPAEIRRR,0
1up8,D,239,243,4,SQYII,0
1up8,D,263,269,6,NAADEFD,0
1up8,D,295,304,9,DLKVFLDVQD,0
1up8,D,323,334,11,TIRDLATWVHFD,0
1up8,D,337,350,13,YEAYLNACLILLAN,0
1up8,D,363,368,5,EDKLDN,0
1up8,D,376,401,25,GSAHVLSLVTEVATRALKAVRYQKFN,0
1up8,D,407,424,17,RPEATGGLISVNKIAAQK,0
1up8,D,429,431,2,FPE,0
1up8,D,432,439,7,VDLAVEEL,0
1up8,D,439,457,18,LGDILEKAEISNRKQNIAD,0
1up8,D,484,501,17,SGHAVVAGACVTILKAFF,0
1up8,D,530,550,20,TVAGELNKLADNIAIGRNMAG,0
1up8,D,553,576,23,YFSDQFESLLLGEQVAIGILEEQS,0
1up8,D,577,579,2,LTY,0
1up8,D,9,27,18,SRAKASFDTRVAAAELALN,0
1up8,D,111,117,6,SDLANSL,0
1up8,D,153,168,15,SPELVAEIAELYLMAL,0
1up8,D,182,194,12,NAEYIQFAIDQLN,0
1up8,D,407,423,16,RPEATGGLISVNKIAAQ,0
1up8,D,530,549,19,TVAGELNKLADNIAIGRNMA,0
5i0m,D,9,22,13,TNAERLHEFHRAIG,0
5i0m,D,33,64,31,PPELLRLRQTLLDEESAEVRAEIDHLLARQAA,0
5i0m,D,70,72,2,AGD,0
5i0m,D,73,94,21,LAPLAHALADLLYVTYGALDQL,0
5i0m,D,97,111,14,DADAVFAEVHRANLS,0
5i0m,D,133,143,10,DVRGVIERLQH,0
5i0m,D,33,65,32,PPELLRLRQTLLDEESAEVRAEIDHLLARQAAG,0
5i0m,D,133,144,11,DVRGVIERLQHA,0
5i0m,D,133,142,9,DVRGVIERLQ,0
4df6,A,29,41,12,DLADRFAELERRY,0
4df6,A,69,71,2,CST,0
4df6,A,72,84,12,FKAPLVAAVLHQN,0
4df6,A,85,90,5,PLTHLD,0
4df6,A,96,100,4,TSDDI,0
4df6,A,117,127,10,IGQLCDAAIRY,0
4df6,A,129,141,12,DGTAANLLLADLG,0
4df6,A,142,145,3,GPGG,0
4df6,A,146,157,11,GTAAFTGYLRSL,0
4df6,A,169,173,4,PELNR,0
4df6,A,184,197,13,TPHAIALVLQQLVL,0
4df6,A,202,215,13,PPDKRALLTDWMAR,0
4df6,A,222,227,5,RIRAGF,0
4df6,A,267,271,4,RAGGG,0
4df6,A,277,293,16,REALLAEAATCVAGVLA,0
4ume,A,1,9,8,MNEIYQKAK,0
4ume,A,40,53,13,YVQDGLGLQALKQS,0
4ume,A,65,76,11,SAMVDRRAKELG,0
4ume,A,86,99,13,DKLTALVGLTKKLG,0
4ume,A,101,103,2,ELS,0
4ume,A,111,113,2,DLP,0
4ume,A,114,121,7,DLKAVREA,0
4ume,A,131,137,6,CEQTRAV,0
4ume,A,149,162,13,GAVREVCELILKAQ,0
4ume,A,164,171,7,NFDAFIAT,0
5fza,A,38,43,5,SWEEFA,0
5fza,A,44,57,13,DPFAFIHKIRPIAE,0
5fza,A,379,395,16,LRTFGEMADAFKSDYFN,0
5fza,A,402,415,13,PTELVEKEFWRLVS,0
5fza,A,448,454,6,SPEEEEY,0
5fza,A,463,467,4,NMPVM,0
5fza,A,479,484,5,ICGMKL,0
5fza,A,501,505,4,EDHWS,0
5fza,A,523,525,2,PGY,0
5fza,A,526,538,12,AAEQLENVMKKLA,0
5fza,A,539,543,4,PELFV,0
5fza,A,547,550,3,DLLH,0
5fza,A,557,564,7,NPNTLMTH,0
5fza,A,607,622,15,WLPLGRQCVEHYRLLH,0
5fza,A,628,638,10,SHDEMICKMAS,0
5fza,A,639,643,4,KADVL,0
5fza,A,644,672,28,DVVVASTVQKDMAIMIEDEKALRETVRKL,0
5fza,A,681,685,4,DFELL,0
5fza,A,686,690,4,PDDER,0
5fza,A,715,722,7,CLHHVKEL,0
5fza,A,726,728,2,PPY,0
5fza,A,737,753,16,TLDDLYPMMNALKLRAE,0
6f4n,B,191,199,8,SLQHFREQF,0
6f4n,B,215,221,6,WPCMQKW,0
6f4n,B,222,231,9,SLEYIQEIAG,0
6f4n,B,244,246,2,TDE,0
6f4n,B,255,263,8,VNEFISKYI,0
6f4n,B,277,282,5,QLFDQI,0
6f4n,B,283,289,6,PELKQDI,0
6f4n,B,292,298,6,PDYCSLG,0
6f4n,B,342,350,8,SPQESGALY,0
6f4n,B,373,379,6,FPKFAKA,0
6f4n,B,282,287,5,IPELKQ,0
6f4n,B,301,305,4,EEEEI,0
4b1u,M,54,61,7,VGDEAQSK,0
4b1u,M,78,92,14,NWDDMEKIWHHTFYN,0
4b1u,M,97,101,4,APEEH,0
4b1u,M,112,126,14,PKANREKMTQIMFET,0
4b1u,M,137,145,8,QAVLSLYAS,0
4b1u,M,172,175,3,PHAI,0
4b1u,M,181,196,15,AGRDLTDYLMKILTER,0
4b1u,M,202,217,15,TTAEREIVRDIKEKLC,0
4b1u,M,222,228,6,DFENEMA,0
4b1u,M,252,263,11,NERFRCPETLFQ,0
4b1u,M,264,268,4,PSFIG,0
4b1u,M,273,284,11,GIHETTYNSIMK,0
4b1u,M,286,288,2,DID,0
4b1u,M,289,295,6,IRKDLYA,0
4b1u,M,301,305,4,GGTTM,0
4b1u,M,308,321,13,GIADRMQKEITALA,0
4b1u,M,334,336,2,ERK,0
4b1u,M,337,349,12,YSVWIGGSILASL,0
4b1u,M,350,353,3,STFQ,0
4b1u,M,359,366,7,KQEYDEAG,0
4b1u,M,368,374,6,SIVHRKC,0
4b1u,M,136,146,10,TSAALERKISM,0
4b1u,M,149,156,7,SREELIKR,0
1xqp,A,3,15,12,AESQLKRVIETLR,0
1xqp,A,18,27,9,GIEEVLKLER,0
1xqp,A,29,43,14,DPQYRAVCNVVKRHG,0
1xqp,A,43,57,14,GETVGSRLAMLNALI,0
1xqp,A,64,78,14,KGEEHWEYFGKYFSQ,0
1xqp,A,83,95,12,DLCRDFLKYIETS,0
1xqp,A,101,113,12,GVEARKKRALKAC,0
1xqp,A,121,134,13,DLGLTLRQLSHIVG,0
1xqp,A,139,158,19,QKTLVFTIKILNYAYMCSRG,0
1xqp,A,172,182,10,DYRVARLTWCA,0
1xqp,A,188,195,7,PPEEALRR,0
1xqp,A,195,211,16,RYEAVQKIWDAVARETG,0
1xqp,A,213,231,18,PPLHLDTLLWLAGRAVLYG,0
1xqp,A,238,245,7,PKEVIALF,0
5h2w,C,89,97,8,LPQMTQQLN,0
5h2w,C,100,116,16,DMQEQLSATVKFRQILS,0
5h2w,C,122,129,7,PIDVVIQA,0
5h2w,C,131,138,7,VVPRLVEF,0
5h2w,C,144,160,16,PEMLQLEAAWALTNIAS,0
5h2w,C,162,172,10,TSAQTKVVVDA,0
5h2w,C,174,185,11,AVPLFIQLLYTG,0
5h2w,C,186,202,16,SVEVKEQAIWALGNVAG,0
5h2w,C,204,214,10,STDYRDYVLQC,0
5h2w,C,216,223,7,AMEPILGL,0
5h2w,C,224,226,2,FNS,0
5h2w,C,228,244,16,KPSLIRTATWTLSNLCR,0
5h2w,C,251,256,5,DWSVVS,0
5h2w,C,258,266,8,ALPTLAKLI,0
5h2w,C,270,285,15,DTETLVDACWAISYLS,0
5h2w,C,288,298,10,PQEAIQAVIDV,0
5h2w,C,300,308,8,IPKRLVELL,0
5h2w,C,312,327,15,STLVQTPALRAVGNIV,0
5h2w,C,330,340,10,NDLQTQVVINA,0
5h2w,C,341,350,9,GVLPALRLLL,0
5h2w,C,354,369,15,KENIKKEACWTISNIT,0
5h2w,C,372,382,10,NTEQIQAVIDA,0
5h2w,C,384,395,11,LIPPLVKLLEVA,0
5h2w,C,396,412,16,EYKTKKEACWAISNASS,0
5h2w,C,413,415,2,GGL,0
5h2w,C,418,427,9,PDIIRYLVSQ,0
5h2w,C,429,437,8,CIKPLCDLL,0
5h2w,C,441,465,24,DNRIIEVTLDALENILKMGEADKEA,0
5h2w,C,472,480,8,ENADFIEKA,0
5h2w,C,481,489,8,GGMEKIFNC,0
5h2w,C,490,492,2,QQN,0
5h2w,C,494,509,15,NDKIYEKAYKIIETYF,0
5h2w,C,90,97,7,PQMTQQLN,0
5h2w,C,122,128,6,PIDVVIQ,0
5h2w,C,228,243,15,KPSLIRTATWTLSNLC,0
5h2w,C,299,307,8,RIPKRLVEL,0
5h2w,C,308,310,2,LSH,0
5h2w,C,441,462,21,DNRIIEVTLDALENILKMGEAD,0
3cwu,D,11,21,10,DWSWMLGFLAA,0
3cwu,D,65,69,4,AGLEP,0
3cwu,D,70,83,13,VAAECLAKMSRLFD,0
3cwu,D,87,101,14,NPQIVNGALGRLGAA,0
3cwu,D,112,123,11,DAFEQGVRAILG,0
3cwu,D,127,143,16,SVAMAAKLTARVAQLYG,0
3cwu,D,157,163,6,TPQRLAA,0
3cwu,D,165,172,7,DPQALKAL,0
3cwu,D,175,191,16,PLKRAEALIHLANAALE,0
3cwu,D,201,211,10,DVEQAMKTLQT,0
3cwu,D,216,228,12,GRWTANYFALRGW,0
3cwu,D,238,245,7,DYLIKQRF,0
3cwu,D,249,258,9,TPAQIRRYAE,0
3cwu,D,259,261,2,RWK,0
3cwu,D,263,274,11,WRSYALLHIWYT,0
3cwu,D,11,22,11,DWSWMLGFLAAR,0
3cwu,D,70,82,12,VAAECLAKMSRLF,0
3cwu,D,87,96,9,NPQIVNGALG,0
3cwu,D,97,100,3,RLGA,0
3cwu,D,165,174,9,DPQALKALGM,0
3cwu,D,201,210,9,DVEQAMKTLQ,0
3cwu,D,249,257,8,TPAQIRRYA,0
3cwu,D,258,261,3,ERWK,0
3cwu,D,263,273,10,WRSYALLHIWY,0
3cwu,D,54,56,2,IAR,0
3cwu,D,157,162,5,TPQRLA,0
3cwu,D,165,171,6,DPQALKA,0
3cwu,D,175,192,17,PLKRAEALIHLANAALEG,0
3cwu,D,65,68,3,AGLE,0
3cwu,D,112,122,10,DAFEQGVRAIL,0
3cwu,D,175,189,14,PLKRAEALIHLANAA,0
3cwu,D,216,227,11,GRWTANYFALRG,0
4r7e,A,632,647,15,DEALVEELANFRTLVY,0
4r7e,A,668,678,10,CENCCKERLAA,0
4r7e,A,691,693,2,SSN,0
2lla,A,1508,1510,2,NSL,0
2lla,A,1534,1538,4,VKDCG,0
2lla,A,1621,1624,3,SLAC,0
3qje,D,3,18,15,SPADKTNVKAAWGKVG,0
3qje,D,20,36,16,HAGEYGAEALERMFLSF,0
3qje,D,37,43,6,PTTKTYF,0
3qje,D,52,72,20,SAQVKGHGKKVADALTNAVAH,0
3qje,D,75,80,5,DMPNAL,0
3qje,D,80,90,10,LSALSDLHAHK,0
3qje,D,95,113,18,PVNFKLLSHCLLVTLAAHL,0
3qje,D,118,138,20,TPAVHASLDKFLASVSTVLTS,0
3qje,D,4,16,12,TPEEKSAVTALWG,0
3qje,D,19,35,16,NVDEVGGEALGRLLVVY,0
3qje,D,36,42,6,PWTQRFF,0
3qje,D,50,57,7,TPDAVMGN,0
3qje,D,57,75,18,NPKVKALGKKVLGAFSDGL,0
3qje,D,76,79,3,AHLD,0
3qje,D,80,95,15,NLKGTFATLSELHCDK,0
3qje,D,100,119,19,PENFRLLGNVLVCVLAHHFG,0
3qje,D,120,122,2,KEF,0
3qje,D,123,143,20,TPPVQAAYQKVVAGVANALAH,0
3qje,D,76,78,2,AHL,0
3amy,A,20,25,5,PREYWD,0
3amy,A,74,89,15,KKKKIKREIKILENLR,0
3amy,A,122,128,6,KQLYQTL,0
3amy,A,129,150,21,TDYDIRFYMYEILKALDYCHSM,0
3amy,A,158,160,2,KPH,0
3amy,A,166,169,3,HEHR,0
3amy,A,194,198,4,SRYFK,0
3amy,A,199,204,5,GPELLV,0
3amy,A,211,227,16,YSLDMWSLGCMLASMIF,0
3amy,A,237,250,13,DNYDQLVRIAKVLG,0
3amy,A,251,261,10,TEDLYDYIDKY,0
3amy,A,268,274,6,RFNDILG,0
3amy,A,280,285,5,RWERFV,0
3amy,A,289,293,4,NQHLV,0
3amy,A,294,305,11,SPEALDFLDKLL,0
3amy,A,308,312,4,DHQSR,0
3amy,A,314,320,6,TAREAME,0
3amy,A,321,325,4,HPYFY,0
4mh6,A,-7,61,68,NLYFQSNAIERLLEIKKIRADRADKAVQRQEYRVANVAAELQKAERSVADYHVWRQEEEERRFAKAKQ,0
4mh6,A,65,144,79,LLKELETLRQEIALLREREAELKQRVAEVKVTLEQERTLLKQKQQEALQAHKTKEKFVQLQQQEIAEQSRQQQYQEELEQ,0
4mh6,A,145,147,2,EEF,0
2vrx,D,89,91,2,TID,0
2vrx,D,126,133,7,KSQLEKEG,0
2vrx,D,134,147,13,VEHQLRREIEIQSH,0
2vrx,D,178,186,8,LYKELQKHG,0
2vrx,D,189,209,20,DEQRSATFMEELADALHYCHE,0
2vrx,D,218,220,2,KPE,0
2vrx,D,252,256,4,TLDYL,0
2vrx,D,257,262,5,PPEMIE,0
2vrx,D,269,285,16,KVDLWCAGVLCYEFLVG,0
2vrx,D,293,303,10,SHTETHRRIVN,0
2vrx,D,313,324,11,SDGSKDLISKLL,0
2vrx,D,327,331,4,HPPQR,0
2vrx,D,333,339,6,PLKGVME,0
2vrx,D,340,347,7,HPWVKANS,0
2vrx,D,126,130,4,KSQLE,0
2vrx,D,134,146,12,VEHQLRREIEIQS,0
2vrx,D,189,210,21,DEQRSATFMEELADALHYCHER,0
2vrx,D,333,340,7,PLKGVMEH,0
2vrx,D,799,802,3,PAWA,0
2vrx,D,803,817,14,SGNLLTQAIRQQYYK,0
2vrx,D,820,825,5,DVDRMY,0
2vrx,D,832,837,5,KLEELF,0
2vrx,D,832,836,4,KLEEL,0
4mmu,B,73,97,24,DAKVKLIKQELDKYKNAVTELQLLM,0
4mmu,B,137,142,5,FLGFLL,0
4mmu,B,148,160,12,IASGVAVCKVLHL,0
4mmu,B,163,171,8,EVNKIKSAL,0
4mmu,B,195,203,8,LKNYIDKQL,0
4mmu,B,203,208,5,LLPILN,0
4mmu,B,216,240,24,NIETVIEFQQKNNRLLEITREFSVN,0
4mmu,B,253,263,10,TNSELLSLIND,0
4mmu,B,267,277,10,TNDQKKLMSNN,0
4mmu,B,277,285,8,NVQIVRQQS,0
4mmu,B,354,358,4,QAETC,0
4mmu,B,370,372,2,MNS,0
4mmu,B,380,385,5,NLCNVD,0
4mmu,B,473,478,5,PIINFY,0
4mmu,B,491,509,18,SISQVNEKINQSLAFIRKS,0
3q4d,I,58,74,16,SMDTAFIVGQYLAKGLI,0
3q4d,I,80,92,12,DIVSNSLLMDAII,0
3q4d,I,95,115,20,NSCIKSAFNIALYDLAAQHAG,0
3q4d,I,117,122,5,PLYAFL,0
3q4d,I,140,154,14,EPHKMAADAVQIKKN,0
3q4d,I,166,182,16,SKELDVERIRMIREAAG,0
3q4d,I,196,208,12,SVETAIETLTLLE,0
3q4d,I,220,225,5,SRNLYT,0
3q4d,I,226,234,8,ALPKIRQAC,0
3q4d,I,246,256,10,NSFDAERLIQI,0
3q4d,I,271,285,14,GITNALNIIRLAEQA,0
3q4d,I,297,309,12,SRLGFTAAAHVAL,0
3q4d,I,320,325,5,DTPLMF,0
3q4d,I,358,362,4,YLSGL,0
3q4d,I,209,211,2,PYN,0
5cwc,A,3,24,21,SEKEELRERLVKICVENAKRKG,0
5cwc,A,26,48,22,DTEEAREAAREAFELVREAAERA,0
5cwc,A,52,74,22,SSEVLELAIRLIKECVENAQREG,0
5cwc,A,76,99,23,DISEACRAAAEAFKRVAEAAKRAG,0
5cwc,A,102,124,22,SSEVLELAIRLIKECVENAQREG,0
5cwc,A,126,149,23,DISEACRAAAEAFKRVAEAAKRAG,0
5cwc,A,152,174,22,SSETLKRAIEEIRKRVEEAQREG,0
5cwc,A,176,198,22,DISEACRQAAEEFRKKAEELKRR,0
5u3t,B,170,190,20,PQVADLKAFSKHIYNAYLKNF,0
5u3t,B,193,202,9,TKKKARSILT,0
5u3t,B,215,226,11,DIETLWQAEKGL,0
5u3t,B,231,235,4,LVNGL,0
5u3t,B,240,266,26,EISVHVFYRCQTTVETVRELTEFAKS,0
5u3t,B,267,272,5,IPSFSS,0
5u3t,B,274,295,21,FLNDQVTLLKYGVHEAIFAMLA,0
5u3t,B,314,319,5,REFLRS,0
5u3t,B,323,340,17,PFSDIIEPKFEFAVKFNA,0
5u3t,B,344,357,13,DDSDLALFIAAIIL,0
5u3t,B,366,389,23,NVPRVEAIQDTILRALEFHLQANH,0
5u3t,B,394,424,30,YLFPKLLQKMADLRQLVTEHAQMMQRIKKTE,0
5u3t,B,430,438,8,HPLLQEIYK,0
5u3t,B,174,190,16,DLKAFSKHIYNAYLKNF,0
4pev,C,93,110,17,SFNDAALGADRAAEELG,0
4pev,C,120,122,2,SLA,0
4pev,C,123,135,12,VESVLDAASRSG,0
4pev,C,147,155,8,WQEPLEKVA,0
4pev,C,156,158,2,PRY,0
4pev,C,184,207,23,EQEVASLVGIIAADIANNISKATG,0
4pev,C,220,242,22,IPPLWRFHIGYLYGVQYYNQAG,0
4pev,C,257,271,14,DPTLGKTTAEQLQQ,0
4pev,C,282,297,15,LTHVGFNAVKEAAAR,0
4pev,C,310,314,4,QEWYD,0
4pev,C,325,339,14,RVDVAVYTAIKDVVE,0
4pev,C,360,373,13,DEEIIRYFAEIAAE,0
4pev,C,382,398,16,TPEKVVEIVSQREKWI,0
4pev,C,399,415,16,SNDGWRLVEELKQKIIS,0
4pev,C,425,438,13,DHDTYDSIIEELKA,0
4pev,C,440,445,5,NLEAAL,0
4pev,C,280,282,2,AGL,0
4pev,C,283,297,14,THVGFNAVKEAAAR,0
4pev,C,360,375,15,DEEIIRYFAEIAAETG,0
4pev,C,123,134,11,VESVLDAASRS,0
4pev,C,147,158,11,WQEPLEKVAPRY,0
4pev,C,183,207,24,REQEVASLVGIIAADIANNISKATG,0
4pev,C,220,240,20,IPPLWRFHIGYLYGVQYYNQA,0
4pev,C,360,374,14,DEEIIRYFAEIAAET,0
3ea4,A,99,110,11,GADILVEALERQ,0
3ea4,A,120,122,2,GGA,0
3ea4,A,123,133,10,SMEIHQALTRS,0
3ea4,A,143,159,16,HEQGGVFAAEGYARSSG,0
3ea4,A,169,174,5,GPGATN,0
3ea4,A,175,186,11,LVSGLADALLDS,0
3ea4,A,197,201,4,PRRMI,0
3ea4,A,210,216,6,PIVEVTR,0
3ea4,A,217,219,2,SIT,0
3ea4,A,227,229,2,DVE,0
3ea4,A,230,244,14,DIPRIIEEAFFLATS,0
3ea4,A,256,261,5,KDIQQQ,0
3ea4,A,273,279,6,LPGYMSR,0
3ea4,A,285,299,14,EDSHLEQIVRLISES,0
3ea4,A,308,311,3,GGCL,0
3ea4,A,313,325,12,SSDELGRFVELTG,0
3ea4,A,354,364,10,TVYANYAVEHS,0
3ea4,A,375,380,5,DDRVTG,0
3ea4,A,381,385,4,KLEAF,0
3ea4,A,397,401,4,DSAEI,0
3ea4,A,414,429,15,DVKLALQGMNKVLENR,0
3ea4,A,429,434,5,RAEELK,0
3ea4,A,437,451,14,FGVWRNELNVQKQKF,0
3ea4,A,463,476,13,PPQYAIKVLDELTD,0
3ea4,A,486,496,10,GQHQMWAAQFY,0
3ea4,A,515,527,12,FGLPAAIGASVAN,0
3ea4,A,538,544,6,DGSFIMN,0
3ea4,A,546,554,8,QELATIRVE,0
3ea4,A,568,579,11,LGMVMQWEDRFY,0
3ea4,A,590,594,4,DPAQE,0
3ea4,A,600,608,8,NMLLFAAAC,0
3ea4,A,617,619,2,KKA,0
3ea4,A,620,631,11,DLREAIQTMLDT,0
3ea4,A,656,660,4,TFNDV,0
5ctx,B,16,31,15,AGQIQVLEGLEAVRKR,0
5ctx,B,31,37,6,RPGMYIG,0
5ctx,B,40,61,21,SERGLHHLVWEIVDNSIDEALA,0
5ctx,B,73,75,2,KDN,0
5ctx,B,97,128,31,PAVEVILTS,0
5ctx,B,129,134,5,SVVNAL,0
5ctx,B,191,206,15,NYETLQQRIRELAFLN,0
5ctx,B,21,31,10,VLEGLEAVRKR,0
5ctx,B,97,104,7,PAVEVILT,0
5dcx,K,14,19,5,DLDGHL,0
5dcx,K,23,33,10,SDSFVNWVAEK,0
5dcx,K,44,48,4,DLNLI,0
5dcx,K,49,72,23,EQAPLTVAEKLQRDFLTEWRRVSK,0
5dcx,K,101,120,19,KSMVLGRFLSQIREKLIQRI,0
5dcx,K,151,157,6,SYIPNYL,0
5dcx,K,172,176,4,MEQYL,0
5dcx,K,181,206,25,NLTERKRLVAQHLTHVSQTQEQNKEN,0
5dcx,K,172,177,5,MEQYLS,0
5dcx,K,181,202,21,NLTERKRLVAQHLTHVSQTQEQ,0
5dcx,K,181,207,26,NLTERKRLVAQHLTHVSQTQEQNKENQ,0
5dcx,K,181,198,17,NLTERKRLVAQHLTHVSQ,0
5dcx,K,101,103,2,KSM,0
5dcx,K,104,122,18,VLGRFLSQIREKLIQRIYR,0
5dcx,K,181,193,12,NLTERKRLVAQHL,0
5dcx,K,101,119,18,KSMVLGRFLSQIREKLIQR,0
5dcx,K,151,156,5,SYIPNY,0
5dcx,K,181,203,22,NLTERKRLVAQHLTHVSQTQEQN,0
5dcx,K,104,120,16,VLGRFLSQIREKLIQRI,0
5dcx,K,181,194,13,NLTERKRLVAQHLT,0
5dcx,K,149,153,4,DESYI,0
5dcx,K,181,191,10,NLTERKRLVAQ,0
5dcx,K,101,121,20,KSMVLGRFLSQIREKLIQRIY,0
4eix,A,1,14,13,SLLEFGKMILEETG,0
4eix,A,17,22,5,LAIPSY,0
4eix,A,39,53,14,DATDRCCFVHDCCYG,0
4eix,A,89,108,19,TSCENRICECDKAAAICFRQ,0
4eix,A,109,113,4,NLNTY,0
4eix,A,114,118,4,SKKYM,0
4eix,A,121,126,5,PDFLC,0
3ep3,A,31,35,4,DLRTI,0
3ep3,A,36,47,11,PRSEWDILLKDV,0
3ep3,A,86,89,3,LLLK,0
3ep3,A,90,103,13,ALVPLLKLARDYSG,0
3ep3,A,119,123,4,KPSHQ,0
3ep3,A,129,139,10,NFQEEIEFLNA,0
3ep3,A,185,190,5,DPAVMD,0
3ep3,A,191,193,2,QFY,0
3ep3,A,199,207,8,TAKDVTRES,0
3ep3,A,247,250,3,EPEF,0
3ep3,A,264,276,12,YDDLIRKVVEVFK,0
2qw6,D,242,253,11,DVISAFQKSIRG,0
2qw6,D,255,269,14,DVDAALHYLARLVEA,0
2qw6,D,271,286,15,DLASICRRLMVIGYED,0
2qw6,D,291,309,18,NPAAAARTVNAVLAAEKLG,0
2qw6,D,313,327,14,ARIPLADVVVDLCLS,0
2qw6,D,255,270,15,DVDAALHYLARLVEAG,0
2qw6,D,313,326,13,ARIPLADVVVDLCL,0
3m5n,D,1012,1023,11,GEEGCQETSQTG,0
3m5n,D,1056,1060,4,YHGAG,0
3m5n,D,1133,1136,3,SYLK,0
3m5n,D,1172,1180,8,VESLETTMR,0
3m5n,D,1078,1080,2,VDK,0
3m5n,D,1132,1136,4,ISYLK,0
3m5n,D,1172,1179,7,VESLETTM,0
3m5n,D,1133,1135,2,SYL,0
4hxw,A,25,32,7,GLEAVRKR,0
4hxw,A,33,38,5,PGMYIG,0
4hxw,A,41,62,21,SGEGLHHLVWEIVDNSIDEALA,0
4hxw,A,98,106,8,PAVETVFTV,0
4hxw,A,128,135,7,GSSVVNAL,0
4hxw,A,192,207,15,DFDKLATRVRELAFLN,0
4mrb,B,74,82,8,DTKSYWKAL,0
6byt,B,135,139,4,GFRGD,0
6byt,B,195,199,4,GAADV,0
6byt,B,200,204,4,PDDEF,0
6byt,B,205,209,4,TLEQF,0
6byt,B,231,239,8,NLQDKENFS,0
6byt,B,290,294,4,DQKTH,0
6byt,B,362,365,3,NSDE,0
6byt,B,370,375,5,EPGDYI,0
6byt,B,290,295,5,DQKTHG,0
4j5b,A,71,84,13,VPKTAENFRALCTG,0
4j5b,A,161,165,4,TDWLD,0
4j5b,A,177,187,10,GMDVVKKIESF,0
3bvf,F,3,33,30,SKDIIKLLNEQVNKEMNSSNLYMSMSSWCYT,0
3bvf,F,36,64,28,LDGAGLFLFDHAAEEYEHAKKLIIFLNEN,0
3bvf,F,82,111,29,GLTQIFQKAYEHEQHISESINNIVDHAIKS,0
3bvf,F,113,120,7,DHATFNFL,0
3bvf,F,120,145,25,LQWYVAEQHEEEVLFKDILDKIELIG,0
3bvf,F,149,166,17,HGLYLADQYVKGIAKSRK,0
3bvf,F,149,165,16,HGLYLADQYVKGIAKSR,0
3bvf,F,82,112,30,GLTQIFQKAYEHEQHISESINNIVDHAIKSK,0
3bvf,F,3,34,31,SKDIIKLLNEQVNKEMNSSNLYMSMSSWCYTH,0
4qu0,A,56,60,4,HKSTG,0
4qu0,A,66,81,15,GTDVDAANLRETFRNL,0
4qu0,A,92,105,13,TREEIVELMRDVSK,0
4qu0,A,136,142,6,LKKITNF,0
4qu0,A,148,152,4,CRSLT,0
4qu0,A,214,227,13,WFIQSLCAMLKQYA,0
4qu0,A,231,247,16,EFMHILTRVNRKVATEF,0
4qu0,A,253,257,4,DATFH,0
1y88,A,3,17,14,NLYFQGHMVARLLEE,0
1y88,A,62,77,15,GLKEAMYTYARFLDVE,0
1y88,A,78,80,2,KHG,0
1y88,A,93,104,11,SEEAKKYAGCVG,0
1y88,A,117,124,7,GIEVLLES,0
1y88,A,129,133,4,PITIL,0
1y88,A,136,146,10,DKEVLDELVRA,0
1y88,A,150,158,8,FCRDVVSAG,0
1y88,A,158,165,7,GEEKLREI,0
1y88,A,168,185,17,SAKKAREVIAEAKKVIGG,0
5vux,B,320,325,5,TLHLKS,0
5vux,B,355,374,19,TKDQLFPLAKEFIDQYYSSI,0
5vux,B,379,397,18,SKAHMERLEEVNKEIDTTS,0
5vux,B,402,416,14,KDTELIYGAKHAWRN,0
5vux,B,422,426,4,GRIQW,0
5vux,B,439,456,17,TAHGMFNYICNHVKYATN,0
5vux,B,457,459,2,KGN,0
5vux,B,503,513,10,NVQFTEICIQQ,0
5vux,B,542,546,4,PPELV,0
5vux,B,558,563,5,WFKDLG,0
5vux,B,595,600,5,GTEIGV,0
5vux,B,600,605,5,VRDYCD,0
5vux,B,611,619,8,ILEEVAKKM,0
5vux,B,625,628,3,KTSS,0
5vux,B,629,649,20,LWKDQALVEINIAVLYSFQSD,0
5vux,B,655,675,20,DHHSATESFIKHMENEYRCRG,0
5vux,B,680,685,5,DWVWIV,0
5vux,B,689,698,9,SGSITPVFHQ,0
5vux,B,714,718,4,DPWNT,0
5vux,B,503,514,11,NVQFTEICIQQG,0
5vux,B,559,563,4,FKDLG,0
4q10,B,5,11,6,SFWDIAG,0
4q10,B,12,14,2,PTA,0
4q10,B,18,23,5,RLESLE,0
4q10,B,33,41,8,IWIYQFLKA,0
4q10,B,52,68,16,NSHITGFFRRICKLLYF,0
4q10,B,81,87,6,PVLKRET,0
4q10,B,768,781,13,TMDMIKEVQELLSR,0
4q10,B,792,803,11,EAEAQCAELLQL,0
4q10,B,814,819,5,SDVFLF,0
4q10,B,839,848,9,DAESILKLLG,0
4q10,B,850,862,12,DRKNMIELAQLLG,0
4q10,B,873,885,12,GPVSSIEVIAEFG,0
4q10,B,886,900,14,NLKNFKDWYNNGQFD,0
4q10,B,902,907,5,RKQETE,0
4q10,B,908,921,13,NKFEKDLRKKLVNN,0
4q10,B,931,940,9,SVMVYDAYMR,0
4q10,B,956,968,12,DLDMLRSFMKTQL,0
4q10,B,971,985,14,PHEKSDEILIPLIRD,0
4q10,B,33,42,9,IWIYQFLKAV,0
4q10,B,81,89,8,PVLKRETIR,0
4q10,B,768,782,14,TMDMIKEVQELLSRF,0
4q10,B,886,896,10,NLKNFKDWYNN,0
4q10,B,909,922,13,KFEKDLRKKLVNNE,0
4q10,B,956,969,13,DLDMLRSFMKTQLG,0
4q10,B,971,980,9,PHEKSDEILI,0
4q10,B,981,983,2,PLI,0
1cxp,D,60,69,9,LARAVSNEIV,0
1cxp,D,72,76,4,PTDQL,0
1cxp,D,84,98,14,LMFMQWGQLLDHDLD,0
1cxp,D,173,178,5,ASMVYG,0
1cxp,D,180,187,7,EEPLARNL,0
1cxp,D,219,225,6,DPCLLTN,0
1cxp,D,243,268,25,MPELTSMHTLLLREHNRLATELKSLN,0
1cxp,D,272,295,23,DGERLYQEARKIVGAMVQIITYRD,0
1cxp,D,296,302,6,YLPLVLG,0
1cxp,D,302,310,8,GPTAMRKYL,0
1cxp,D,325,332,7,ANVFTNAF,0
1cxp,D,333,339,6,RYGHTLI,0
1cxp,D,362,364,2,SRV,0
1cxp,D,367,374,7,ASWRVVLE,0
1cxp,D,376,386,10,GIDPILRGLMA,0
1cxp,D,399,404,5,VDEIRE,0
1cxp,D,416,428,12,DLPALNMQRSRDH,0
1cxp,D,432,440,8,GYNAWRRFC,0
1cxp,D,447,456,9,TVGQLGTVLR,0
1cxp,D,457,469,12,NLKLARKLMEQYG,0
1cxp,D,475,483,8,DIWMGGVSE,0
1cxp,D,492,509,17,GPLLACIIGTQFRKLRDG,0
1cxp,D,521,529,8,SMQQRQALA,0
1cxp,D,532,541,9,SLPRIICDNT,0
1cxp,D,565,567,2,STL,0
1cxp,D,572,576,4,LASWR,0
1cxp,D,219,224,5,DPCLLT,0
1cxp,D,368,374,6,SWRVVLE,0
1cxp,D,377,387,10,IDPILRGLMAT,0
1cxp,D,407,411,4,FEQVM,0
5n84,A,561,579,18,DNQTLDSYRNEIAYLNKLQ,0
5n84,A,609,615,6,LNSWLKK,0
5n84,A,620,641,21,DPWERKSYWKNMLEAVHTIHQH,0
5n84,A,649,651,2,KPA,0
5n84,A,692,697,5,PEAIKD,0
5n84,A,713,730,17,PKSDVWSLGCILYYMTYG,0
5n84,A,739,749,10,NQISKLHAIID,0
5n84,A,761,772,11,EKDLQDVLKCCL,0
5n84,A,781,787,6,SIPELLA,0
5n84,A,788,793,5,HPYVQI,0
6apm,A,4,15,11,GRCELAAAMKRH,0
6apm,A,19,23,4,NYRGY,0
6apm,A,24,37,13,SLGNWVCAAKFESN,0
6apm,A,79,85,6,PCSALLS,0
6apm,A,88,100,12,ITASVNCAKKIVS,0
6apm,A,101,102,1,DG,0
6apm,A,103,107,4,NGMNA,0
6apm,A,108,115,7,WVAWRNRC,0
6apm,A,119,125,6,DVQAWIR,0
3hoa,B,2,33,31,TPEAAYQNLLEFQRETAYLASLGALAAWDQRT,0
3hoa,B,36,38,2,PKK,0
3hoa,B,39,59,20,GHEHRARQMAALARLLHQRMT,0
3hoa,B,60,71,11,DPRIGEWLEKVE,0
3hoa,B,73,77,4,SPLVQ,0
3hoa,B,81,100,19,SDAAVNVREWRQAYERARAI,0
3hoa,B,101,123,22,PERLAVELAQAESEAESFWEEAR,0
3hoa,B,127,151,24,DWRGFLPYLKRVYALTKEKAEVLFA,0
3hoa,B,163,173,10,ELYDALLDGYE,0
3hoa,B,177,201,24,RARELLPLFAELKEGLKGLLDRILG,0
3hoa,B,207,213,6,DTSILHR,0
3hoa,B,216,232,16,PVEAQRRFALELLSACG,0
3hoa,B,234,236,2,DLE,0
3hoa,B,266,287,21,FFNAGIFGTLHEMGHALYEQGL,0
3hoa,B,288,292,4,PKEHW,0
3hoa,B,294,298,4,TPRGD,0
3hoa,B,301,314,13,SLGVHESQSRTWEN,0
3hoa,B,319,334,15,SLGFWERFFPRAREVF,0
3hoa,B,335,338,3,ASLG,0
3hoa,B,341,349,8,SLEDFHFAV,0
3hoa,B,357,361,4,IRVEA,0
3hoa,B,365,382,17,TYNLHILVRLELELALFR,0
3hoa,B,386,388,2,SPE,0
3hoa,B,389,403,14,DLPEAWAEKYRDHLG,0
3hoa,B,427,449,22,FPTYTLGNLYAAQFFQKAEAELG,0
3hoa,B,450,457,7,PLEPRFAR,0
3hoa,B,460,471,11,FQPFLDWTRARI,0
3hoa,B,472,475,3,HAEG,0
3hoa,B,479,489,10,RPRVLVERVTG,0
3hoa,B,494,509,15,ARPFLAYLEKKYAALY,0
3hoa,B,2,34,32,TPEAAYQNLLEFQRETAYLASLGALAAWDQRTM,0
3hoa,B,124,126,2,PRD,0
3hoa,B,127,152,25,DWRGFLPYLKRVYALTKEKAEVLFAL,0
3hoa,B,164,173,9,LYDALLDGYE,0
3hoa,B,234,238,4,DLEAG,0
3hoa,B,362,382,20,DEVTYNLHILVRLELELALFR,0
3hoa,B,417,422,5,VHWAGG,0
3hoa,B,451,456,5,LEPRFA,0
5f9k,C,64,72,8,RSGLAWKNF,0
5gyb,A,15,19,4,DPSTA,0
5gyb,A,95,100,5,PYSHYE,0
5gyb,A,135,138,3,NSNE,0
5gyb,A,162,167,5,GINTTG,0
5gyb,A,218,228,10,ITEHFRKWERL,0
1sfq,E,7,11,4,FEKKS,0
1sfq,E,14,13,-1,,0
1sfq,E,55,58,3,AAHC,0
1sfq,E,60,59,-1,,0
1sfq,E,60,62,2,TEN,0
1sfq,E,125,130,5,DRETLL,0
1sfq,E,164,171,7,ERPVCKDS,0
1sfq,E,234,245,11,LKKWIQKVIDQF,0
1sfq,E,185,185,0,K,0
1sfq,E,234,243,9,LKKWIQKVID,0
3gsr,A,49,55,6,APWIEQE,0
3gsr,A,56,85,29,GPEYWDGETRKVKAHSQTHRVDLGTLRGYY,0
3gsr,A,137,150,13,DMAAQTTKHKWEAA,0
3gsr,A,151,162,11,HVAEQLRAYLEG,0
3gsr,A,162,175,13,GTCVEWLRRYLENG,0
3gsr,A,175,180,5,GKETLQ,0
3gsr,A,253,255,2,QEQ,0
2p71,A,1,13,12,SQEVMKNLSLNFG,0
2p71,A,15,20,5,ALDECK,0
2p71,A,26,36,10,TDAINEDFYNF,0
2p71,A,45,59,14,NRETGCAIMCLSTKL,0
2p71,A,69,80,11,HHGNAMEFAKKH,0
2p71,A,83,101,18,DETMAQQLIDIVHGCEKST,0
2p71,A,106,125,19,DKCIWTLGVATCFKAEIHKL,0
3dc2,B,15,19,4,PSTVA,0
3dc2,B,34,42,8,DRDKLLAAV,0
3dc2,B,43,45,2,PEA,0
3dc2,B,57,64,7,DAEVLAAA,0
3dc2,B,81,88,7,DVDAATAR,0
3dc2,B,99,116,17,NIHSAAEHALALLLAASR,0
3dc2,B,117,128,11,QIPAADASLREH,0
3dc2,B,131,135,4,KRSSF,0
3dc2,B,151,164,13,GRIGQLVAQRIAAF,0
3dc2,B,176,183,7,SPARAAQL,0
3dc2,B,189,197,8,SLDDLLARA,0
3dc2,B,215,220,5,DKEALA,0
3dc2,B,238,248,10,DEAALADAITG,0
3dc2,B,267,272,5,SPLFEL,0
3dc2,B,285,305,20,TAEAQDRAGTDVAESVRLALA,0
3dc2,B,326,341,15,PWLDLVRKLGVLAGVL,0
3dc2,B,357,360,3,LAAE,0
3dc2,B,362,374,12,VEVLRLSALRGLF,0
3dc2,B,375,378,3,SAVI,0
3dc2,B,386,395,9,NAPALAAERG,0
3dc2,B,466,478,12,GALGKIGTLLGTA,0
3dc2,B,507,519,12,PDDVRTAIAAAVD,0
3dc2,B,14,22,8,APSTVAALG,0
3dc2,B,57,63,6,DAEVLAA,0
3dc2,B,99,117,18,NIHSAAEHALALLLAASRQ,0
3dc2,B,117,127,10,QIPAADASLRE,0
3dc2,B,151,163,12,GRIGQLVAQRIAA,0
3dc2,B,326,342,16,PWLDLVRKLGVLAGVLS,0
3dc2,B,362,376,14,VEVLRLSALRGLFSA,0
3dc2,B,385,393,8,VNAPALAAE,0
2v6a,P,20,25,5,YRLTYY,0
2v6a,P,49,61,12,PPEECGAAVAAES,0
2v6a,P,69,75,6,VWTDGLT,0
2v6a,P,76,81,5,SLDRYK,0
2v6a,P,104,108,4,IDLF,0
2v6a,P,112,122,10,SVTNMFTSIVG,0
2v6a,P,123,126,3,NVFG,0
2v6a,P,141,146,5,PPAYVK,0
2v6a,P,154,163,9,GIQVERDKLN,0
2v6a,P,181,195,14,SAKNYGRAVYECLRG,0
2v6a,P,213,233,20,RWRDRFLFVAEAIYKAQAETG,0
2v6a,P,246,255,9,TCEEMMKRAV,0
2v6a,P,269,288,19,YLTGGFTANTSLAIYCRDNG,0
2v6a,P,297,303,6,MHAVIDR,0
2v6a,P,310,322,12,HFRVLAKALRMSG,0
2v6a,P,338,351,13,EREVTLSFVDLMRD,0
2v6a,P,358,361,3,RSRG,0
2v6a,P,383,385,2,HVW,0
2v6a,P,386,395,9,HMPALVEIFG,0
2v6a,P,403,408,5,GGGTLG,0
2v6a,P,412,433,21,GNAPGAAANRVALEACTQARNE,0
2v6a,P,436,463,27,DLAREGGDVIRSACKWSPELAAACEVWK,0
2v6a,P,22,36,14,TDEQIAAQVDYIVAN,0
2v6a,P,46,50,4,EADKA,0
2v6a,P,54,60,6,NESAIRF,0
2v6a,P,85,100,15,DPMQVLREIVACTKAF,0
2v6a,P,134,138,4,PANKR,0
2v6a,P,22,37,15,TDEQIAAQVDYIVANG,0
2l09,A,6,15,9,TSEAKTKLKN,0
2l09,A,17,19,2,PFF,0
2l09,A,20,35,15,ARSQAKARIEQLARQA,0
2l09,A,41,56,15,TPELVEQARLEFGQLE,0
4l3w,A,37,53,16,TAAQIKELTNYAGVAAT,0
4l3w,A,54,56,2,AYC,0
4l3w,A,67,74,7,CKQCLKYV,0
4l3w,A,86,89,3,LLTD,0
4l3w,A,112,119,7,SFRSAITD,0
4l3w,A,137,161,24,AGFLSSYNQVVKDYFPVVQDQLTAY,0
4l3w,A,172,189,17,SLGGAQALLAGMDLYQRE,0
4l3w,A,209,220,11,NNAFAYYVDSTG,0
4l3w,A,232,236,4,IVPHV,0
4l3w,A,238,242,4,PQAFG,0
4l3w,A,271,276,5,CSNSIV,0
4l3w,A,281,284,3,IADH,0
4yv3,C,162,238,76,DQLTNDKARVEVERDNLAEDIRLREKLQEELQREEAENTLQSFRQDVDNASLARLDLERKVESLQEEIAFLKKLH,0
4yv3,C,165,237,72,TNDKARVEVERDNLAEDIRLREKLQEELQREEAENTLQSFRQDVDNASLARLDLERKVESLQEEIAFLKKL,0
4yv3,C,178,237,59,LAEDIRLREKLQEELQREEAENTLQSFRQDVDNASLARLDLERKVESLQEEIAFLKKL,0
4aac,A,61,78,17,SIIHAKRTYRELRLLKHM,0
4aac,A,95,99,4,SLEEF,0
4aac,A,123,144,21,TDDHVQFLIYQILRGLKYIHSA,0
4aac,A,152,154,2,KPS,0
4aac,A,185,189,4,TRWYR,0
4aac,A,190,195,5,APEIML,0
4aac,A,202,219,17,QTVDIWSVGCIMAELLTG,0
4aac,A,227,240,13,DHIDQLKLILRLVG,0
4aac,A,243,248,5,GAELLK,0
4aac,A,252,262,10,SESARNYIQSL,0
4aac,A,269,274,5,NFANVF,0
4aac,A,278,289,11,NPLAVDLLEKML,0
4aac,A,298,304,6,TAAQALA,0
4aac,A,305,309,4,HAYFA,0
4aac,A,313,317,4,DPDDE,0
4aac,A,325,330,5,QSFESR,0
4aac,A,333,348,15,LIDEWKSLTYDEVISF,0
5u1s,B,53,74,21,SIGILAMHNNIIRDFTKIASNN,0
5u1s,B,74,81,7,NIDLAIED,0
5u1s,B,81,99,18,DITTVDHSLNSIYSLLKSH,0
5u1s,B,102,121,19,WGHINSTVKQHLMIIVKLIN,0
5u1s,B,124,140,16,ALGLASSEIIFLFNETN,0
5u1s,B,146,152,6,SLKNILL,0
5u1s,B,162,177,15,YLSNLKILALQIILKR,0
5u1s,B,179,193,14,LVDEYLPHILELFSH,0
5u1s,B,193,198,5,HDKRYL,0
5u1s,B,205,220,15,KAHALTKIVLSFFSVT,0
5u1s,B,223,238,15,CKVLFGLKFLQYIKQF,0
5u1s,B,250,257,7,TVECFSKN,0
5u1s,B,268,271,3,PNKI,0
5u1s,B,272,282,10,YLNSFYLSYSM,0
5u1s,B,291,295,4,MLLDI,0
5u1s,B,297,310,13,SYEETTEVQRAIKS,0
5u1s,B,335,344,9,LNVILENATN,0
5u1s,B,354,370,16,SATLKCLVCLWSTIRLE,0
5u1s,B,375,392,17,NKDILRQFDCTVIYINSN,0
5u1s,B,399,420,21,ESAAALLSELLGVLSEICIDYK,0
5u1s,B,421,440,19,EPKRLSNIISVLFNASVLFK,0
5u1s,B,441,460,19,SHSFLLKTANLEISNVLISN,0
5u1s,B,463,479,16,KTSHRTILKFEKFISSA,0
5u1s,B,481,493,12,SAQKKIEIFSCLF,0
5u1s,B,494,498,4,NVYCM,0
5u1s,B,503,517,14,TLSFVFDFCQNAFIH,0
5u1s,B,518,523,5,CFTRLK,0
5u1s,B,534,544,10,SEIMLSVLYGN,0
5u1s,B,551,555,4,PSENW,0
5u1s,B,556,567,11,SQLSRMIFCSLR,0
5u1s,B,586,589,3,LLNK,0
5u1s,B,590,606,16,YELLIRIVYLLNLDMSK,0
5u1s,B,611,623,12,NLSKITKLYINKW,0
5u1s,B,626,631,5,KSDEKA,0
5u1s,B,635,652,17,SSFEMDFVKMLLCYLNFN,0
5u1s,B,654,668,14,FDKLSIELSLCIKSK,0
5u1s,B,668,673,5,KEKYYS,0
5u1s,B,675,690,15,IVPYADNYLLEAYLSL,0
5u1s,B,692,707,15,MIDDALMMKNQLQKTM,0
5u1s,B,713,723,10,KIEQALLHASS,0
5u1s,B,724,725,1,LI,0
5u1s,B,726,731,5,NVHLWD,0
5u1s,B,733,743,10,DLTAFQIYFGK,0
5u1s,B,743,749,6,KTLPAMK,0
5u1s,B,750,753,3,PELF,0
5u1s,B,762,786,24,PMSLYIKVILLNIKIFNESAKLNIK,0
5u1s,B,789,809,20,NVISAVIDCRKAQNLALSLLK,0
5u1s,B,815,840,25,SQGSRLALLKSLSFSFFQLIKIHIRI,0
5u1s,B,842,860,18,SARDCEFYSKELSRIISDL,0
5u1s,B,862,880,18,EPIIVYRCLHFLHRYYMIT,0
5u1s,B,882,897,15,QTCLQNITLGKANKAF,0
5u1s,B,898,900,2,DYL,0
5u1s,B,905,916,11,DITSLTMFLYDN,0
5u1s,B,918,931,13,EFVKLEQSLVLYFG,0
5u1s,B,932,937,5,DQLEKT,0
5u1s,B,938,948,10,FLPNLWKLHLG,0
5u1s,B,952,956,4,DDSIC,0
5u1s,B,957,959,2,LSE,0
5u1s,B,960,981,21,YMPKNVINRVHNMWQKVMSQLE,0
5u1s,B,983,988,5,DPFFKG,0
5u1s,B,1045,1061,16,DRIAAISKLKQMKELLE,0
5u1s,B,1064,1068,4,KLDTL,0
5u1s,B,1069,1091,22,DNHELSKISSLSSLTLTILSNIT,0
5u1s,B,1095,1107,12,NAESSLITNFSLT,0
5u1s,B,1108,1124,16,DLPRHMPLLFDKVLNNI,0
5u1s,B,1125,1131,6,DNKNYRE,0
5u1s,B,1144,1162,18,STITESIRVSAAQKDLMES,0
5u1s,B,1213,1233,20,SFPEATKKLLSIINESNQTTS,0
5u1s,B,1233,1238,5,SVEVTN,0
5u1s,B,1242,1271,29,TREERKSWWTTRYDLDKRMQQLLNNIENSW,0
5u1s,B,1275,1279,4,VQGFF,0
5u1s,B,1285,1304,19,DNSLFEKFKDKFYEILHQNL,0
5u1s,B,1304,1310,6,LPSRKLY,0
5u1s,B,1312,1316,4,NPAMF,0
5u1s,B,1320,1329,9,EDWVIELFLK,0
5u1s,B,1336,1355,19,DFLSKMEDLIYFVLDILLFH,0
5u1s,B,1360,1364,4,AYDEI,0
5u1s,B,1365,1382,17,DFSMLHVQLEEQIKKYRA,0
5u1s,B,1404,1408,4,PWECL,0
5u1s,B,1421,1432,11,SYVCLNKLLSRF,0
5u1s,B,1456,1474,18,LSRTESKFKGMFQKIIDAK,0
5u1s,B,1486,1496,10,EEETLLKMLQN,0
5u1s,B,1513,1518,5,RSKEIK,0
5u1s,B,1546,1554,8,GTIYTYLLG,0
5u1s,B,1567,1583,16,TDKDIDKFSEELFEKMG,0
5u1s,B,1597,1604,7,SVSYAVSK,0
5u1s,B,1605,1609,4,SRGVC,0
5u1s,B,280,288,8,QQDDIEKLK,0
5u1s,B,364,373,9,DPEELEDLVT,0
4uw5,F,114,118,4,PLARV,0
3q5e,G,49,58,9,DETALNRILL,0
3q5e,G,59,64,5,SEAVRD,0
3q5e,G,79,92,13,GKSFLMDFMLRYMY,0
3q5e,G,153,171,18,SQSTLRDSATVFALSTMIS,0
3q5e,G,183,189,6,QEDDLQH,0
3q5e,G,190,205,15,LQLFTEYGRLAMEETF,0
3q5e,G,228,241,13,GADGGAKFLEKRLK,0
3q5e,G,249,260,11,ELQNVRKHIHSC,0
3q5e,G,273,278,5,GLKVAT,0
3q5e,G,285,289,4,KLKEI,0
3q5e,G,290,306,16,DDEFIKNLKILIPWLLS,0
3q5e,G,321,336,15,TCRGLVEYFKAYIKIY,0
3q5e,G,343,376,33,HPKSMLQATAEANNLAAVATAKDTYNKKMEEICG,0
3q5e,G,383,405,22,APNDLQTKHLQLKEESVKLFRGV,0
3q5e,G,410,437,27,GEEFSRRYLQQLESEIDELYIQYIKHND,0
3q5e,G,79,93,14,GKSFLMDFMLRYMYN,0
3q5e,G,161,171,10,ATVFALSTMIS,0
3q5e,G,183,188,5,QEDDLQ,0
3q5e,G,189,191,2,HLQ,0
3q5e,G,192,198,6,LFTEYGR,0
3q5e,G,200,205,5,AMEETF,0
3q5e,G,231,241,10,GGAKFLEKRLK,0
3q5e,G,252,260,8,NVRKHIHSC,0
3q5e,G,290,299,9,DDEFIKNLKI,0
3q5e,G,300,306,6,LIPWLLS,0
3q5e,G,307,310,3,PESL,0
3q5e,G,321,333,12,TCRGLVEYFKAYI,0
3q5e,G,343,370,27,HPKSMLQATAEANNLAAVATAKDTYNKK,0
3q5e,G,390,403,13,KHLQLKEESVKLFR,0
3q5e,G,410,426,16,GEEFSRRYLQQLESEID,0
3q5e,G,427,438,11,ELYIQYIKHNDS,0
3q5e,G,160,171,11,SATVFALSTMIS,0
3q5e,G,192,205,13,LFTEYGRLAMEETF,0
3q5e,G,256,260,4,HIHSC,0
3q5e,G,383,403,20,APNDLQTKHLQLKEESVKLFR,0
3q5e,G,409,435,26,GGEEFSRRYLQQLESEIDELYIQYIKH,0
3q5e,G,185,205,20,DDLQHLQLFTEYGRLAMEETF,0
3q5e,G,254,260,6,RKHIHSC,0
3q5e,G,321,337,16,TCRGLVEYFKAYIKIYQ,0
3q5e,G,390,400,10,KHLQLKEESVK,0
3q5e,G,409,431,22,GGEEFSRRYLQQLESEIDELYIQ,0
4no7,A,5,21,16,NLYFQGMKKEKVEQILA,0
4no7,A,22,24,2,EFQ,0
4no7,A,26,46,20,QEEDLKKVMRRMQKEMDRGLR,0
4no7,A,111,116,5,PEDAMT,0
4no7,A,118,137,19,TAEMLFDYISECISDFLDKH,0
4no7,A,180,193,13,NVVGLLRDAIKRRG,0
4no7,A,204,217,13,NDTVATMISCYYED,0
4no7,A,239,241,2,QNV,0
4no7,A,256,260,4,EWGAF,0
4no7,A,266,270,4,LDEFL,0
4no7,A,271,280,9,LEYDRLVDES,0
4no7,A,287,292,5,QLYEKL,0
4no7,A,294,312,18,GGKYMGELVRLVLLRLVDE,0
4no7,A,315,319,4,LFHGE,0
4no7,A,331,341,10,ETRFVSQVESD,0
4no7,A,345,355,10,RKQIYNILSTL,0
4no7,A,360,397,37,STTDCDIVRRACESVSTRAAHMCSAGLAGVINRMRESR,0
4no7,A,410,416,6,GSVYKLH,0
4no7,A,418,431,13,SFKERFHASVRRLT,0
4no7,A,443,458,15,EGSGRGAALVSAVACK,0
3uf4,A,155,164,9,GRKDAERQLL,0
3uf4,A,223,234,11,TLQQLVQHYSEK,0
4z8d,B,19,24,5,NADLEK,0
4z8d,B,29,38,9,SDEWIVTRTG,0
4z8d,B,50,67,17,TVSTMGFEAATRAIEMAG,0
4z8d,B,69,73,4,EKDQI,0
4z8d,B,89,99,10,SAACQIQSMLG,0
4z8d,B,110,112,2,AAC,0
4z8d,B,113,128,15,AGFTYALSVADQYVKS,0
4z8d,B,141,146,5,VLARTC,0
4z8d,B,183,187,4,GSYGE,0
4z8d,B,208,231,23,AGNEVFKVAVTELAHIVDETLAAN,0
4z8d,B,234,238,4,DRSQL,0
4z8d,B,247,258,11,NLRIISATAKKL,0
4z8d,B,261,265,4,SMDNV,0
4z8d,B,268,273,5,TLDRHG,0
4z8d,B,275,277,2,TSA,0
4z8d,B,278,290,12,ASVPCALDEAVRD,0
4z8d,B,19,26,7,NADLEKMV,0
4z8d,B,89,98,9,SAACQIQSML,0
4z8d,B,142,146,4,LARTC,0
4z8d,B,150,155,5,DRGTII,0
4z8d,B,247,259,12,NLRIISATAKKLG,0
3vwv,B,107,110,3,TDYR,0
3vwv,B,128,137,9,PTEIIAFGDR,0
3vwv,B,137,144,7,RIEEFKSI,0
3vwv,B,155,164,9,SQFTHLAWIN,0
3vwv,B,166,170,4,PRRQG,0
3vwv,B,185,191,6,HQISKDY,0
3vwv,B,225,245,20,GRSVDETLRLVQAFQYTDKHG,0
3vwv,B,137,143,6,RIEEFKS,0
1pe8,A,64,66,2,ASY,0
1pe8,A,67,89,22,DAPAVDAHYYAGVTYDYYKNVHN,0
1pe8,A,132,135,3,PLSG,0
1pe8,A,136,152,16,GIDVVAHELTHAVTDYT,0
1pe8,A,158,180,22,QNESGAINEAISDIFGTLVEFYA,0
1pe8,A,207,212,5,DPAKYG,0
1pe8,A,216,220,4,HYSKR,0
1pe8,A,224,230,6,TQDNGGV,0
1pe8,A,233,247,14,NSGIINKAAYLISQG,0
1pe8,A,259,274,15,GRDKLGKIFYRALTQY,0
1pe8,A,280,297,17,NFSQLRAAAVQSATDLYG,0
1pe8,A,300,313,13,SQEVASVKQAFDAV,0
3eit,B,80,96,16,HRVTLRKATLASLQSL,0
3eit,B,98,107,9,GESSNRVWN,0
3eit,B,113,117,4,LLIAR,0
3eit,B,118,133,15,DPREIKNAIEKSVTDF,0
3eit,B,135,144,9,GLENYKELTG,0
3eit,B,155,169,14,VGLSANNIFKLTE,0
3eit,B,186,194,8,SFAEHVNTL,0
3eit,B,243,252,9,RVEDWISRRG,0
3eit,B,257,265,8,SLDELNQLL,0
3eit,B,266,272,6,SKDFSK,0
3eit,B,273,286,13,PDDVQTRLLASILQ,0
3eit,B,290,294,4,DPHKV,0
3eit,B,295,299,4,DIKKL,0
3eit,B,313,326,13,DFRQFQRNAQYVAG,0
3eit,B,98,106,8,GESSNRVW,0
3eit,B,135,143,8,GLENYKELT,0
3eit,B,175,179,4,DPTSI,0
3eit,B,186,192,6,SFAEHVN,0
3eit,B,268,272,4,DFSK,0
4o3v,B,92,110,18,PYISVANIMLQNYVKQREK,0
4o3v,B,112,114,2,NYD,0
4o3v,B,115,127,12,TLKEQFTFIKNAS,0
4o3v,B,128,140,12,TSIVYMQFANFMN,0
4o3v,B,146,152,6,SPVIRYQ,0
4o3v,B,115,126,11,TLKEQFTFIKNA,0
4o3v,B,212,216,4,MPFHF,0
3dxk,G,55,59,4,VDDLD,0
3dxk,G,63,68,5,GDEAIE,0
3dxk,G,85,99,14,DWDLMERFMEQVIFK,0
3dxk,G,104,108,4,EPEDH,0
3dxk,G,119,133,14,TPENREYTAEIMFES,0
3dxk,G,144,153,9,QAVLALAASW,0
3dxk,G,154,156,2,TSR,0
3dxk,G,187,190,3,GSCI,0
3dxk,G,196,210,14,AGRDITYFIQQLLRD,0
3dxk,G,216,218,2,PPE,0
3dxk,G,219,232,13,QSLETAKAVKERYS,0
3dxk,G,237,248,11,DLVKEFNKYDTD,0
3dxk,G,249,252,3,GSKW,0
3dxk,G,273,281,8,YERFLGPEI,0
3dxk,G,282,283,1,FF,0
3dxk,G,284,288,4,HPEFA,0
3dxk,G,295,307,12,PISEVVDEVIQNC,0
3dxk,G,308,317,9,PIDVRRPLYK,0
3dxk,G,323,327,4,GGSTM,0
3dxk,G,330,354,24,DFGRRLQRDLKRTVDARLKLSEELS,0
3dxk,G,372,374,2,MQR,0
3dxk,G,375,385,10,YAVWFGGSMLA,0
3dxk,G,388,393,5,PEFYQV,0
3dxk,G,397,404,7,KKDYEEIG,0
3dxk,G,405,410,5,PSICRH,0
3dxk,G,141,149,8,QAVLTLYAQ,0
3dxk,G,185,199,14,AGRDITRYLIKLLLL,0
3dxk,G,209,221,12,DFETVRMIKEKLC,0
3dxk,G,226,237,11,NIEQEQKLALET,0
3dxk,G,256,261,5,GERFEA,0
3dxk,G,262,266,4,PEALF,0
3dxk,G,267,272,5,QPHLIN,0
3dxk,G,276,288,12,VGVAELLFNTIQA,0
3dxk,G,293,299,6,TRSEFYK,0
3dxk,G,305,309,4,GGSTM,0
3dxk,G,312,329,17,GLPSRLERELKQLYLERV,0
3dxk,G,348,352,4,PRRKH,0
3dxk,G,232,234,2,DKK,0
3dxk,G,359,366,7,VRSLESAL,0
3dxk,G,8,25,17,NRIIEETLALKFENAAAG,0
3dxk,G,48,51,3,PNGD,0
3dxk,G,63,69,6,FYKELQA,0
3dxk,G,71,81,10,GADELLKRVYG,0
3dxk,G,105,114,9,SKDSIVHQAG,0
3dxk,G,115,133,18,MLKRNCFASVFEKYFQFQE,0
3dxk,G,171,187,16,DDDDVVIGKVFMQEFKE,0
3dxk,G,188,191,3,GRRA,0
3dxk,G,206,210,4,PLELK,0
3dxk,G,228,233,5,FPRHTN,0
3dxk,G,236,245,9,ARDNTINLIH,0
3dxk,G,246,279,33,TFRDYLHYHIKCSKAYIHTRMRAKTSDFLKVLNR,0
3dxk,G,40,53,13,DIVDEAIYYFKANV,0
3dxk,G,62,83,21,NEADRTLIYITLYISECLKKLQ,0
3dxk,G,89,101,12,SQGEKEMYTLGIT,0
3dxk,G,122,149,27,NKQEDEVMRAYLQQLRQETGLRLCEKVF,0
3dxk,G,157,162,5,SKWWTC,0
3dxk,G,163,166,3,FVKR,0
3dxk,G,167,171,4,QFMNK,0
3dxk,G,4,20,16,TLRPYLSAVRATLQAAL,0
3dxk,G,36,41,5,PEVEVR,0
3dxk,G,43,47,4,SKELL,0
3dxk,G,80,96,16,DEIEKILCHKFMRFMMM,0
3dxk,G,120,126,6,NFHTEQM,0
3dxk,G,127,166,39,YKHKLVDFVIHFMEEIDKEISEMKLSVNARARIVAEEFLK,0
3dxk,G,15,20,5,DVGEYD,0
3dxk,G,38,48,10,DEGEVDSCLRQ,0
3dxk,G,50,59,9,NMTAALQAAL,0
3dxk,G,68,85,17,SQAVKDRAGSIVLKVLIS,0
3dxk,G,87,89,2,KAN,0
3dxk,G,90,96,6,DIEKAVQ,0
3dxk,G,99,114,15,DKNGVDLLMKYIYKGF,0
3dxk,G,120,147,27,NSSAVLLQWHEKALAAGGVGSIVRVLTA,0
6aps,B,16,36,20,TEAELHTRMRGVAQRIADDYS,0
6aps,B,37,39,2,NCN,0
6aps,B,56,70,14,SFVFTADMVRILGDF,0
6aps,B,119,131,12,ALTLREVVDSLKK,0
6aps,B,146,149,3,PGGR,0
6aps,B,188,202,14,KPSVYETWGKELERR,0
6aps,B,16,35,19,TEAELHTRMRGVAQRIADDY,0
6aps,B,36,39,3,SNCN,0
6aps,B,188,205,17,KPSVYETWGKELERRKAA,0
3a17,H,6,10,4,GEHLQ,0
3a17,H,52,54,2,DED,0
3a17,H,55,69,14,QRPAALQAMRDIVAG,0
3a17,H,70,72,2,FDL,0
3a17,H,101,111,10,DVSSQHRWSTS,0
3a17,H,111,120,9,STPIASWWES,0
3a17,H,121,125,4,EDRLS,0
3a17,H,138,140,2,RAE,0
3a17,H,153,159,6,PGVGAVM,0
3a17,H,173,179,6,GSMRERF,0
3a17,H,180,184,4,PISQT,0
3a17,H,199,203,4,DPAVG,0
3a17,H,227,237,10,EADERSLYLDE,0
3a17,H,238,252,14,ILPTLQSGMDFLRDN,0
3a17,H,285,296,11,SLDQLERWSESH,0
3a17,H,296,310,14,HPTHLRIFTTFFRVA,0
3a17,H,311,313,2,AGL,0
3a17,H,326,328,2,DAA,0
3a17,H,341,345,4,TGMLR,0
3a17,H,-3,1,4,RGSHM,0
3a17,H,227,238,11,EADERSLYLDEI,0
3a17,H,252,257,5,NGPAVG,0
5ibv,A,121,131,10,QFGPVQALGAQ,0
5ibv,A,171,179,8,TSWSGLGAR,0
5ibv,A,195,200,5,KPSDLG,0
5ibv,A,214,218,4,NASDT,0
5ibv,A,295,305,10,SHFARTAVEHS,0
5ibv,A,342,349,7,FNWLVKGG,0
5ibv,A,372,378,6,SYQDALS,0
2mlt,B,1,11,10,GIGAVLKVLTT,0
2mlt,B,14,26,12,PALISWIKRKRQQ,0
1wtq,A,51,64,13,PKELLDMLARAERE,0
5on8,B,26,34,8,QMFAQSMVY,0
5on8,B,80,93,13,DAEAAAENFRAVLD,0
5on8,B,94,99,5,NRQRHA,0
5on8,B,102,106,4,ELANQ,0
5on8,B,128,134,6,PFLQELA,0
5on8,B,143,145,2,APS,0
5on8,B,201,211,10,DPTTRAVAFET,0
5on8,B,225,235,10,PLDTFARFSQN,0
5on8,B,262,273,11,ELAVREALNYAV,0
5on8,B,274,283,9,NKKSLIDNAL,0
5on8,B,311,322,11,DPQKAKALLEKA,0
5on8,B,350,366,16,DALSKSMAEIIQADMRQ,0
5on8,B,377,388,11,EESSIYARQRDG,0
5on8,B,404,411,7,PHAFLSSM,0
5on8,B,416,423,7,HADFQAQQ,0
5on8,B,427,440,13,DKPLIDKEIGEVLA,0
5on8,B,443,461,18,DETQRQALYRDILTRLHDE,0
5on8,B,478,481,3,PELG,0
5on8,B,493,497,4,PFEQI,0
5on8,B,101,106,5,LELANQ,0
5on8,B,225,234,9,PLDTFARFSQ,0
5on8,B,416,422,6,HADFQAQ,0
5on8,B,427,441,14,DKPLIDKEIGEVLAT,0
3gmm,A,59,89,30,SNQQWEKLQHMFQVYRVSFTRDIQELVKMMS,0
3gmm,A,140,142,2,PSW,0
3gmm,A,143,153,10,LDLPIKVLNAD,0
3gmm,A,153,166,13,DQGTSATVQMLLND,0
3gmm,A,166,179,13,DTCPLFVRGLLEAG,0
3gmm,A,179,184,5,GKSDLE,0
3gmm,A,267,271,4,HSSLG,0
1hut,H,125,130,5,DRETLL,0
1hut,H,164,169,5,ERPVCK,0
1hut,H,234,245,11,LKKWIQKVIDQF,0
4jse,B,315,320,5,TLHLKS,0
4jse,B,351,369,18,KDQLFPLAKEFLDQYYSSI,0
4jse,B,374,392,18,SKAHMDRLEEVNKEIESTS,0
4jse,B,397,411,14,KDTELIYGAKHAWRN,0
4jse,B,417,421,4,GRIQW,0
4jse,B,434,451,17,TAHGMFNYICNHVKYATN,0
4jse,B,452,454,2,KGN,0
4jse,B,498,508,10,NVQFTEICIQQ,0
4jse,B,537,541,4,PPELV,0
4jse,B,553,558,5,WFKDLG,0
4jse,B,590,595,5,GTEIGV,0
4jse,B,595,600,5,VRDYCD,0
4jse,B,606,614,8,ILEEVAKKM,0
4jse,B,620,623,3,KTSS,0
4jse,B,624,644,20,LWKDQALVEINIAVLYSFQSD,0
4jse,B,650,670,20,DHHSATESFIKHMENEYRCRG,0
4jse,B,675,680,5,DWVWIV,0
4jse,B,684,688,4,SGSIT,0
4jse,B,709,713,4,DPWNT,0
4jse,B,350,369,19,TKDQLFPLAKEFLDQYYSSI,0
4jse,B,709,714,5,DPWNTH,0
4uvb,B,173,181,8,GVEGAAFQS,0
4uvb,B,189,196,7,TSQEAACF,0
4uvb,B,196,201,5,FPDIIS,0
4uvb,B,203,224,21,PQQTQKVFLFIRNRTLQLWLDN,0
4uvb,B,230,237,7,TFEATLQQ,0
4uvb,B,245,259,14,DTVLVHRVHSYLERH,0
4uvb,B,287,300,13,GVSGLAAARQLQSF,0
4uvb,B,340,349,9,NPMAVVSKQV,0
4uvb,B,371,395,24,PKEKDEMVEQEFNRLLEATSYLSHQ,0
4uvb,B,407,468,61,SLGQALEVVIQLQEKHVKDEQIEHWKKIVKTQEELKELLNKMVNLKEKIKELHQQYKEASEV,0
4uvb,B,473,514,41,DITAEFLVKSKHRDLTALCKEYDELAETQGKLEEKLQELEAN,0
4uvb,B,522,540,18,SSRDRQILDWHFANLEFAN,0
4uvb,B,555,559,4,DDDFE,0
4uvb,B,572,580,8,SCVPVALAE,0
4uvb,B,626,632,6,PLGVLKQ,0
4uvb,B,644,654,10,PEWKTSAVQRM,0
4uvb,B,708,716,8,AGEAAGIME,0
4uvb,B,719,736,17,SDDVIVGRCLAILKGIFG,0
4uvb,B,770,778,8,GNDYDLMAQ,0
4uvb,B,800,804,4,GEHTI,0
4uvb,B,810,830,20,TVHGALLSGLREAGRIADQFL,0
4uvb,B,317,325,8,SQEDVEAVS,0
4uvb,B,329,363,34,TAATTVLRQLDMELVSVKRQIQNIKQTNSALKEKL,0
4uvb,B,367,371,4,IEPYR,0
4uvb,B,384,399,15,TTEEQLLAVQAIRKYG,0
4uvb,B,401,410,9,DFQAISDVIG,0
4uvb,B,413,424,11,SVVQVKNFFVNY,0
4uvb,B,429,439,10,NIDEVLQEWEA,0
2hpz,A,7,14,7,PWGLARIS,0
2hpz,A,46,50,4,HPEFE,0
2hpz,A,68,79,11,GHGTHCAGTVGS,0
2hpz,A,103,118,15,QYSTIIAGMDFVASDK,0
2hpz,A,119,121,2,NNR,0
2hpz,A,138,151,13,SSSVNSAAARLQSS,0
2hpz,A,165,167,2,DAR,0
2hpz,A,222,240,18,GTSMATPHVAGLAAYLMTL,0
2hpz,A,247,255,8,SACRYIADT,0
3dbu,A,12,19,7,GPEHWHKD,0
3dbu,A,20,25,5,FPIAKG,0
3dbu,A,127,129,2,KYG,0
3dbu,A,130,135,5,DFGKAV,0
3dbu,A,154,156,2,KPG,0
3dbu,A,157,163,6,LQKVVDV,0
3dbu,A,164,167,3,LDSI,0
3dbu,A,180,185,5,DPRGLL,0
3dbu,A,219,227,8,SSEQVLKFR,0
3m6q,A,8,12,4,DPILR,0
3m6q,A,22,40,18,DENLKNLVDAMFDVMYKTD,0
3m6q,A,47,50,3,PQVG,0
3m6q,A,124,139,15,SRLPARIFQHEYDHLE,0
3m6q,A,142,146,4,LFFDR,0
3m6q,A,148,171,23,TDQVLDSIREELEALEKKYEEKTG,0
3m6q,A,177,181,4,RVEAR,0
2n3e,A,11,28,17,SKANADAFINSFISAASN,0
2n3e,A,33,41,8,SQDQMENMS,0
2n3e,A,44,55,11,GNTLMAAMDNMG,0
2n3e,A,59,80,21,TPSKLQALDMAFASSVAQIAAS,0
2n3e,A,84,104,20,DLGVTTNAIADALTSAFYQTT,0
2n3e,A,107,131,24,VNSRFISEIRSLIGMFAQASANDVY,0
3ws2,C,8,25,17,QTREVLDPIVASLMEAQQ,0
3ws2,C,66,81,15,LSKTLTATLASLAEVE,0
3ws2,C,89,93,4,PVSRY,0
3ws2,C,94,98,4,LPELE,0
3ws2,C,100,104,4,SAFDD,0
3ws2,C,106,112,6,SGLNLGT,0
3ws2,C,128,139,11,DRASLMAWYREW,0
3ws2,C,152,167,15,SNLGIGLLGLETAASL,0
3ws2,C,170,179,9,EFVPTMRAKV,0
3ws2,C,179,184,5,VLAPLG,0
3ws2,C,193,200,7,PEARMADY,0
3ws2,C,218,223,5,LDDEAY,0
3ws2,C,228,240,12,TAADLAKLVRANL,0
3ws2,C,246,256,10,DAELQQAIDAT,0
3ws2,C,280,288,8,APETLRAGQ,0
3ws2,C,289,294,5,GYDMIL,0
3ws2,C,331,334,3,PGKH,0
3ws2,C,346,361,15,PNDARVEAAYRILSGL,0
3ws2,C,9,25,16,TREVLDPIVASLMEAQQ,0
3ws2,C,64,66,2,GSL,0
3ws2,C,67,81,14,SKTLTATLASLAEVE,0
3ws2,C,246,257,11,DAELQQAIDATR,0
3ws2,C,8,24,16,QTREVLDPIVASLMEAQ,0
1jy8,A,38,53,15,DVALHALTDALLGAAA,0
1jy8,A,56,61,5,DIGKLF,0
1jy8,A,65,69,4,DPAFK,0
1jy8,A,72,87,15,DSRELLREAWRRIQAK,0
1jy8,A,105,107,2,MLP,0
1jy8,A,108,120,12,HIPQMRVFIAEDL,0
1jy8,A,123,125,2,HMD,0
1jy8,A,137,142,5,LGFTGR,0
4pn0,D,55,68,13,PDTTKVISNFLTHY,0
4pn0,D,106,111,5,NPEFNL,0
4pn0,D,120,138,18,TASEHKYLNEFLNQAFRDS,0
4pn0,D,265,278,13,NIADLRDRAQKAKD,0
4pn0,D,281,300,19,EAPLFRRVQLFMDNVRILRR,0
4pn0,D,55,70,15,PDTTKVISNFLTHYLI,0
4pn0,D,106,110,4,NPEFN,0
4pn0,D,265,279,14,NIADLRDRAQKAKDG,0
4pn0,D,281,301,20,EAPLFRRVQLFMDNVRILRRE,0
4pn0,D,55,67,12,PDTTKVISNFLTH,0
1pla,A,52,56,4,AEKIS,0
1yyv,B,21,31,10,PSREVLKHVTS,0
1yyv,B,31,41,10,SRWGVLILVAL,0
1yyv,B,42,44,2,RDG,0
1yyv,B,48,55,7,FSDLRR,0
1yyv,B,59,74,15,SELAQSLQALEQDG,0
1yyv,B,93,119,26,TPLGEQVSDVAALADWIELNLPQVLA,0
1yyv,B,59,73,14,SELAQSLQALEQD,0
1yyv,B,93,113,20,TPLGEQVSDVAALADWIELN,0
1yyv,B,113,123,10,NLPQVLAQRER,0
2r2h,B,79,83,4,QAEDL,0
2r2h,B,120,126,6,SSEQLTS,0
2r2h,B,182,186,4,KDEYE,0
2r2h,B,211,213,2,NEC,0
2r2h,B,28,32,4,TFTDY,0
2r2h,B,52,51,-1,,0
2r2h,B,83,87,4,RAEDS,0
2r2h,B,154,156,2,SGS,0
2r2h,B,198,201,3,PASS,0
3ni5,A,20,25,5,FPIAKG,0
3ni5,A,127,129,2,KYG,0
3ni5,A,130,135,5,DFGKAV,0
3ni5,A,154,156,2,KPG,0
3ni5,A,157,164,7,LQKVVDVL,0
3ni5,A,180,185,5,DPRGLL,0
3ni5,A,219,227,8,SSEQVLKFR,0
5tq5,A,845,847,2,EER,0
5tq5,A,888,905,17,TEEHLRDFEREIEILKSL,0
5tq5,A,921,924,3,GRRN,0
5tq5,A,936,945,9,SLRDYLQKHK,0
5tq5,A,946,948,2,ERI,0
5tq5,A,949,970,21,DHIKLLQYTSQICKGMEYLGTK,0
5tq5,A,978,980,2,ATR,0
5tq5,A,1017,1021,4,PIFWY,0
5tq5,A,1022,1029,7,APESLTES,0
5tq5,A,1032,1049,17,SVASDVWSFGVVLYELFT,0
5tq5,A,1052,1055,3,EKSK,0
5tq5,A,1056,1066,10,SPPAEFMRMIG,0
5tq5,A,1073,1084,11,SIVTHLIELLKN,0
5tq5,A,1095,1106,11,PDEIYMIMTECW,0
5tq5,A,1109,1113,4,NVNQR,0
5tq5,A,1115,1131,16,SFRDLALRVDQIRDNMA,0
5b11,O,264,272,8,KLDEIKNAL,0
5aqe,A,5,11,6,PWGISRV,0
5aqe,A,12,19,7,QAPAAHNR,0
5aqe,A,63,74,11,GHGTHVAGTIAA,0
5aqe,A,103,117,14,SVSSIAQGLEWAGNN,0
5aqe,A,132,145,13,SATLEQAVNSATSR,0
5aqe,A,219,238,19,GTSMATPHVAGAAALVKQKN,0
5aqe,A,242,253,11,SNVQIRNHLKNT,0
5aqe,A,259,264,5,STNLYG,0
5aqe,A,269,274,5,NAEAAT,0
1lr6,A,8,15,7,TLEEIQKH,0
1lr6,A,32,39,7,LTKFLEEH,0
1lr6,A,43,50,7,EEYLREQA,0
1lr6,A,54,61,7,ATENFEDV,0
1lr6,A,64,75,11,STDARELSKTFI,0
1lr6,A,80,84,4,HPDDR,0
1jg2,A,14,31,17,EKELYEKWMRTVEMLKAE,0
1jg2,A,36,46,10,SKEVERAFLKY,0
1jg2,A,47,52,5,PRYLSV,0
1jg2,A,53,60,7,EDKYKKYA,0
1jg2,A,76,88,12,APHMVAIMLEIAN,0
1jg2,A,103,114,11,GWNAALISEIVK,0
1jg2,A,123,137,14,IPELVEFAKRNLERA,0
1jg2,A,148,152,4,DGSKG,0
1jg2,A,153,157,4,FPPKA,0
1jg2,A,172,178,6,PEPLIEQ,0
2am3,A,119,131,12,TVRRCLDKLLHYR,0
2am3,A,147,156,9,HEETAQVIAS,0
2am3,A,157,161,4,YGSAV,0
2am3,A,178,180,2,HRK,0
2am3,A,181,200,19,FQGYYKIARHYRWALGQIFH,0
2am3,A,219,234,15,DFFEYFQATYPLLKAD,0
2am3,A,248,252,4,KEQMV,0
2am3,A,275,282,7,AELWAELE,0
2am3,A,283,285,2,PKW,0
2am3,A,289,295,6,FWDDWMR,0
2am3,A,296,301,5,RPEQRK,0
2am3,A,324,330,6,GQFFDQH,0
2am3,A,331,334,3,LKFI,0
2am3,A,342,346,4,PFTQL,0
2am3,A,348,351,3,LSYL,0
2am3,A,352,367,15,QQEAYDRDFLARVYGA,0
2am3,A,371,377,6,QVEKVRT,0
2am3,A,392,403,11,GRDSFKAFAKAL,0
4uys,A,49,56,7,FNWHMDQQ,0
4uys,A,89,91,2,DLK,0
4uys,A,156,166,10,QGSAAQYASSW,0
4uys,A,200,202,2,DCD,0
4gri,B,17,34,17,HIGGIRTALFNYFFAKSC,0
4gri,B,51,66,15,SPEAENDLYSSLKWLG,0
4gri,B,83,86,3,VQSQ,0
4gri,B,87,101,14,RSAIYKQYAKYLIES,0
4gri,B,110,124,14,SPERLERIKKIQNIN,0
4gri,B,138,148,10,SNEEVENALIK,0
4gri,B,179,181,2,KDI,0
4gri,B,195,207,12,TYHLANVVDDYLM,0
4gri,B,217,220,3,EWVS,0
4gri,B,221,233,12,SGPLHVLLYKAFK,0
4gri,B,261,269,8,ALRQFIEDG,0
4gri,B,271,282,11,LPEAIINYVTLL,0
4gri,B,294,302,8,SKNDLEQFF,0
4gri,B,303,307,4,SIEKI,0
4gri,B,315,330,15,DYHKLDFFNSYYIREK,0
4gri,B,331,346,15,KDEDLFNLLLPFFQKK,0
4gri,B,354,370,16,TLEENQKLKLLIPLIKS,0
4gri,B,376,382,6,SDALNMT,0
4gri,B,382,387,5,TKFFYE,0
4gri,B,393,397,4,NLDEF,0
4gri,B,406,419,13,EVCSILELIKPILE,0
4gri,B,420,424,4,GFEKR,0
4gri,B,425,440,15,SSEENDKIFYDFAESN,0
4gri,B,445,456,11,GEILLPIRIAAL,0
4gri,B,463,472,9,PLFDSLKLIG,0
4gri,B,472,488,16,GKSKVFERIKLAQEFLR,0
4gri,B,331,347,16,KDEDLFNLLLPFFQKKG,0
4gri,B,374,376,2,KLS,0
4gri,B,377,382,5,DALNMT,0
4gri,B,393,398,5,NLDEFL,0
4gri,B,403,419,16,TAKEVCSILELIKPILE,0
4gri,B,472,490,18,GKSKVFERIKLAQEFLRIN,0
2b0m,A,34,41,7,DERFYAEH,0
2b0m,A,41,48,7,HLMPTLQG,0
2b0m,A,51,65,14,DPESAHRLAVRFTSL,0
2b0m,A,76,80,4,SDMLE,0
2b0m,A,104,111,7,AVDGLYKM,0
2b0m,A,138,140,2,PED,0
2b0m,A,153,163,10,GLSVVEHRLRA,0
2b0m,A,164,174,10,RQQKQAKLTED,0
2b0m,A,190,203,13,DAAEDYAEGVRVLG,0
2b0m,A,204,206,2,PLA,0
2b0m,A,221,225,4,LRSLQ,0
2b0m,A,226,243,17,GKAELRRLLTKVLQERDG,0
2b0m,A,245,249,4,RRVHR,0
2b0m,A,261,276,15,TSQDKEDIASVVKELG,0
2b0m,A,309,324,15,LRDLSTQTIREMYALT,0
2b0m,A,338,349,11,SGQDALEKIRAG,0
2b0m,A,356,363,7,YTALTFWG,0
2b0m,A,364,381,17,PPVVGKVKRELEALLKEQ,0
2b0m,A,385,390,5,GVTDAI,0
2b0m,A,391,396,5,GADHRR,0
3p93,H,41,53,12,REMAVAAYLDEHV,0
3p93,H,53,58,5,VVPALI,0
3p93,H,64,76,12,RIEDTWQYLYRGA,0
3p93,H,81,104,23,GPVTMTAIAAVDMALWDIKAKAAG,0
3p93,H,106,112,6,PLYQLLG,0
3p93,H,129,143,14,TIEDCLGEVARHVEL,0
3p93,H,185,205,20,STEKYLNHAPKLFAAVRERFG,0
3p93,H,219,231,12,TPIEAARLGKAVE,0
3p93,H,232,234,2,PYH,0
3p93,H,246,249,3,NQES,0
3p93,H,250,257,7,LRLIREHT,0
3p93,H,269,272,3,SIHD,0
3p93,H,273,279,6,CRELIQN,0
3p93,H,293,307,14,GGITAMRRVADLASL,0
3p93,H,321,335,14,SPVCLGAAIHFDTWV,0
3p93,H,347,354,7,TDETDAVF,0
3p93,H,378,383,5,DEELAA,0
3p93,H,64,74,10,RIEDTWQYLYR,0
3p93,H,293,308,15,GGITAMRRVADLASLY,0
3p93,H,81,103,22,GPVTMTAIAAVDMALWDIKAKAA,0
3p93,H,129,144,15,TIEDCLGEVARHVELG,0
3p93,H,106,111,5,PLYQLL,0
3p93,H,41,52,11,REMAVAAYLDEH,0
3p93,H,129,142,13,TIEDCLGEVARHVE,0
3p93,H,219,230,11,TPIEAARLGKAV,0
3p93,H,231,234,3,EPYH,0
1sk9,A,18,23,5,SPATSH,0
1sk9,A,24,29,5,LWGQYS,0
1sk9,A,65,83,18,TSSKSKKYKKLVTAIQANA,0
1sk9,A,87,95,8,KGKFAFLKT,0
1sk9,A,106,124,18,TPFGEQQLVNSGIKFYQRY,0
1sk9,A,124,129,5,YKALAR,0
1sk9,A,140,160,20,SDRVIASGEKFIEGFQQAKLA,0
1sk9,A,192,197,5,CTKFEA,0
1sk9,A,199,224,25,QLGDEVAANFTALFAPDIRARAEKHL,0
1sk9,A,230,249,19,TDEDVVSLMDMCSFDTVART,0
1sk9,A,258,262,4,FCQLF,0
1sk9,A,263,282,19,THNEWKKYNYLQSLGKYYGY,0
1sk9,A,289,292,3,GPAQ,0
1sk9,A,293,306,13,GIGFTNELIARLTR,0
1sk9,A,316,321,5,NSTLVS,0
1sk9,A,338,349,11,HDNSMVSIFFAL,0
1sk9,A,373,378,5,SASWVV,0
1sk9,A,423,430,7,LNDFVKGL,0
1sk9,A,430,435,5,LSWARS,0
1sk9,A,438,443,5,NWGECF,0
1c3x,C,17,34,17,DPFLVARAAADHIAQATG,0
1c3x,C,65,67,2,HEI,0
1c3x,C,105,109,4,HLYEG,0
1c3x,C,111,125,14,GVRAVVHGVRTAAAT,0
1c3x,C,176,187,11,SPRLRELAHRVD,0
1c3x,C,205,215,10,TPAEVRMAGIL,0
1c3x,C,224,234,10,TTLEAIAARHC,0
1c3x,C,257,268,11,SHAEVIEAGQAA,0
1c3x,C,268,282,14,AGPRISALLADIAKR,0
1c3x,C,257,280,23,SHAEVIEAGQAAGPRISALLADIA,0
1c3x,C,111,116,5,GVRAVV,0
1c3x,C,116,125,9,VHGVRTAAAT,0
1c3x,C,205,216,11,TPAEVRMAGILG,0
1c3x,C,257,267,10,SHAEVIEAGQA,0
4dpb,X,51,55,4,DASKI,0
4dpb,X,85,88,3,SPHQ,0
5hex,B,17,26,9,DQVQKVDQYL,0
5hex,B,27,30,3,YHMR,0
5hex,B,32,52,20,SDETLLEISKRFRKEMEKGLG,0
5hex,B,123,141,18,GTQLFDHIAECLANFMDKL,0
5hex,B,184,197,13,DVVALIRKAIQRRG,0
5hex,B,209,221,12,DTVGTMMTCGYDD,0
5hex,B,243,245,2,RHI,0
5hex,B,260,264,4,EWGAF,0
5hex,B,275,284,9,TEFDQEIDMG,0
5hex,B,293,298,5,FEKMIS,0
5hex,B,301,316,15,YMGELVRLILVKMAKE,0
5hex,B,319,323,4,LFGGK,0
5hex,B,335,345,10,ETKDISDIEGE,0
5hex,B,347,359,12,DGIRKAREVLMRL,0
5hex,B,364,402,38,TQEDCVATHRICQIVSTRSASLCAATLAAVLQRIKENKG,0
5hex,B,414,420,6,GSVYKKH,0
5hex,B,422,435,13,HFAKRLHKTVRRLV,0
5hex,B,448,475,27,GSGKGAAMVTAVAYRLADQHRARQKTLE,0
5hex,B,476,478,2,HLQ,0
5hex,B,480,500,20,SHDQLLEVKRRMKVEMERGLS,0
5hex,B,563,569,6,PQEVMHG,0
5hex,B,570,589,19,TGDELFDHIVQCIADFLEYM,0
5hex,B,632,643,11,DVVTLLKEAIHR,0
5hex,B,656,667,11,NDTVGTMMTCGF,0
5hex,B,708,712,4,EWGAF,0
5hex,B,723,733,10,TEFDVAVDELS,0
5hex,B,739,746,7,QRFEKMIS,0
5hex,B,748,764,16,MYLGEIVRNILIDFTKR,0
5hex,B,767,771,4,LFRGR,0
5hex,B,783,793,10,ETKFLSQIESD,0
5hex,B,797,807,10,LLQVRAILQHL,0
5hex,B,812,850,38,TCDDSIIVKEVCTVVARRAAQLCGAGMAAVVDRIRENRG,0
5hex,B,862,868,6,GTLYKLH,0
5hex,B,870,883,13,HFAKVMHETVKDLA,0
5hex,B,899,909,10,KGAALITAVAC,0
5hex,B,18,26,8,QVQKVDQYL,0
5hex,B,55,59,4,THPTA,0
5hex,B,115,121,6,PEDIMRG,0
5hex,B,122,141,19,SGTQLFDHIAECLANFMDKL,0
5hex,B,291,298,7,QLFEKMIS,0
5hex,B,335,343,8,ETKDISDIE,0
5hex,B,348,359,11,GIRKAREVLMRL,0
5hex,B,448,476,28,GSGKGAAMVTAVAYRLADQHRARQKTLEH,0
5hex,B,503,507,4,THASA,0
5hex,B,563,568,5,PQEVMH,0
5hex,B,570,588,18,TGDELFDHIVQCIADFLEY,0
5hex,B,632,644,12,DVVTLLKEAIHRR,0
5hex,B,656,669,13,NDTVGTMMTCGFED,0
5hex,B,718,722,4,LDDFR,0
5hex,B,723,732,9,TEFDVAVDEL,0
5hex,B,774,778,4,ERLKT,0
5hex,B,812,849,37,TCDDSIIVKEVCTVVARRAAQLCGAGMAAVVDRIRENR,0
5hex,B,898,913,15,GKGAALITAVACRIRE,0
4r7s,A,0,35,35,GQSYEELIEKSYDFVDK,0
4r7s,A,37,52,15,DLVSAEESLKAARKE,0
4r7s,A,57,71,14,LNYALLTNLGTIQRR,0
4r7s,A,74,87,13,KLQEALISYTSALS,0
4r7s,A,92,106,14,NITILENRASLYTEL,0
4r7s,A,108,123,15,ETEKALNDYNTLLIEN,0
4r7s,A,126,140,14,HQEALYCRGLLYIQL,0
4r7s,A,142,157,15,NYWAEQDFDKILEVN,0
4r7s,A,160,175,15,SVRARLGHAILEKRG,0
4r7s,A,176,191,15,NYDESERIFNYLISE,0
4r7s,A,195,208,13,WILYEGRADLYF,0
4r7s,A,210,225,15,KNARAADIEKVFTES,0
4r7s,A,228,242,14,TANLYVLRGKIKLAQ,0
4r7s,A,244,257,13,EKERAALDFKKAES,0
4r7s,A,261,271,10,NKEVIKELLKL,0
1top,A,3,12,9,MTDQQAEARA,0
1top,A,16,27,11,EEMIAEFKAAFD,0
1top,A,42,48,6,LGTVMRM,0
1top,A,55,65,10,KEELDAIIEEV,0
1top,A,75,105,30,FEEFLVMMVRQMKEDAKGKSEEELANCFRIF,0
1top,A,115,124,9,IEELGEILRA,0
1top,A,131,141,10,EEDIEDLMKDS,0
1top,A,151,159,8,FDEFLKMME,0
4hzt,A,59,64,5,SFVEMV,0
4hzt,A,114,118,4,QRQLS,0
4hzt,A,184,188,4,YAEIA,0
4hzt,A,196,205,9,PFFDSLVKQT,0
4hzt,A,241,243,2,DHS,0
4hzt,A,277,282,5,DCKEYN,0
4hzt,A,299,313,14,KKVFEAAVKSIKAAS,0
4hzt,A,319,324,5,PDGFWL,0
4hzt,A,337,341,4,PWNIF,0
4hzt,A,362,366,4,LPQQY,0
4hzt,A,395,400,5,GAVIME,0
4hzt,A,450,456,6,TDESRSH,0
3vzj,D,146,155,9,FTNHVNAWKS,0
3vzj,D,146,156,10,FTNHVNAWKSH,0
3vzj,D,146,154,8,FTNHVNAWK,0
3vzj,D,155,157,2,SHG,0
1qpg,A,8,10,2,VQD,0
1qpg,A,37,52,15,QRIVAALPTIKYVLEH,0
1qpg,A,72,74,2,EKY,0
1qpg,A,77,87,10,APVAKELQSLL,0
1qpg,A,100,107,7,PEVEAAVK,0
1qpg,A,120,122,2,LRY,0
1qpg,A,124,127,3,IEEE,0
1qpg,A,141,154,13,KEDVQKFRHELSSL,0
1qpg,A,163,165,2,FGT,0
1qpg,A,171,174,3,SSMV,0
1qpg,A,185,198,13,FLLEKELKYFGKAL,0
1qpg,A,215,227,12,ADKIQLIDNLLDK,0
1qpg,A,238,245,7,AFTFKKVL,0
1qpg,A,257,273,16,KAGAEIVPKLMEKAKAK,0
1qpg,A,315,327,12,PESRKLFAATVAK,0
1qpg,A,343,345,2,EKF,0
1qpg,A,347,362,15,AGTKALLDEVVKSSAA,0
1qpg,A,371,379,8,GDTATVAKK,0
1qpg,A,383,385,2,TDK,0
1qpg,A,394,400,6,GASLELL,0
1qpg,A,406,409,3,PGVA,0
4y69,b,18,31,13,LGQIDYALTAVKQG,0
4y69,b,58,61,3,SETL,0
4y69,b,78,96,18,MGPDYRVLVDKSRKVAHTS,0
4y69,b,97,102,5,YKRIYG,0
4y69,b,106,121,15,PTKLLVSEVAKIMQEA,0
4y69,b,167,179,12,GSVAAKTFLEKRW,0
4y69,b,184,200,16,ELEDAIHIALLTLKESV,0
4y69,b,218,222,4,NPDLL,0
4y69,b,239,249,10,TSQEINDRLEA,0
4y69,b,2,6,4,SRRYD,0
4y69,b,18,29,11,LYQVEYALESIS,0
4y69,b,79,102,23,LTADAEILINTARIHAQNYLKTYN,0
4y69,b,106,124,18,PVEILVRRLSDIKQGYTQH,0
4y69,b,167,179,12,NTSAAQTLLQMDY,0
4y69,b,184,200,16,KVDDAIELALKTLSKTT,0
4y69,b,206,208,2,TYD,0
4y69,b,230,241,11,KPQEIKDILVKT,0
4y69,b,15,28,13,IFQVEYALEAVKRG,0
4y69,b,76,99,23,LNADSRILIEKARVEAQSHRLTLE,0
4y69,b,103,118,15,TVEYLTRYVAGVQQRY,0
4y69,b,165,177,12,NSKTVREFLEKNY,0
4y69,b,185,199,14,TVEECVKLTVRSLLE,0
4y69,b,223,239,16,SSEEINQYVTQIEQEKQ,0
4y69,b,13,25,12,LFQVEYSLEAIKL,0
4y69,b,53,56,3,SDSI,0
4y69,b,76,96,20,DARSMIEHARTAAVTHNLYYD,0
4y69,b,100,110,10,NVESLTQSVCD,0
4y69,b,167,179,12,GSEGAQAELLNEW,0
4y69,b,184,200,16,TLKEAELLVLKILKQVM,0
4y69,b,224,240,16,DNEKTAELIKELKEKEA,0
4y69,b,18,31,13,LFQVEYALEAIKQG,0
4y69,b,76,99,23,LAPDARVLSNYLRQQCNYSSLVFN,0
4y69,b,103,118,15,AVERAGHLLCDKAQKN,0
4y69,b,163,179,16,RSQGAKTYLERTLDTFI,0
4y69,b,184,197,13,NPDELIKAGVEAIS,0
4y69,b,198,200,2,QSL,0
4y69,b,225,233,8,DGEAVAKYI,0
4y69,b,17,30,13,NFQVEYAVKAVENG,0
4y69,b,77,100,23,LIPDGRHLVNRGREEAASFKKLYK,0
4y69,b,104,119,15,PIPAFADRLGQYVQAH,0
4y69,b,164,179,15,GRQSAKAELEKLVDHH,0
4y69,b,184,200,16,SAREAVKQAAKIIYLAH,0
4y69,b,201,204,3,EDNK,0
4y69,b,228,244,16,KGDLLQEAIDFAQKEIN,0
4y69,b,2,6,4,GYDRH,0
4y69,b,16,26,10,LYQVEYAFKAT,0
4y69,b,56,60,4,DPTTV,0
4y69,b,77,100,23,PIPDARNAALRAKAEAAEFRYKYG,0
4y69,b,104,122,18,PCDVLAKRMANLSQIYTQR,0
4y69,b,165,181,16,KQQEITTNLENHFKKSK,0
4y69,b,189,206,17,SWEKVVEFAITHMIDALG,0
4y69,b,228,241,13,SAENIEERLVAIAE,0
4y69,b,48,71,23,TAADTEAVTQLIGSNIELHSLYTS,0
4y69,b,75,90,15,RVVSALQMLKQHLFKY,0
4y69,b,130,142,12,GSLAAMAVLESHW,0
4y69,b,147,166,19,TKEEAIKLASDAIQAGIWND,0
4y69,b,2,6,4,DPSSI,0
4y69,b,55,78,23,LATDVTTLNEMFRYKTNLYKLKEE,0
4y69,b,82,96,14,EPETFTQLVSSSLYE,0
4y69,b,141,153,12,ASDQLFGMCESLY,0
4y69,b,158,175,17,EPEDLFETISQALLNAAD,0
4y69,b,51,72,21,GDTVQFAEYIQANIQLYSIRED,0
4y69,b,76,92,16,SPQAVSSFVRQELAKSI,0
4y69,b,135,148,13,YSGFYTFSLLDHHY,0
4y69,b,153,172,19,TTEEGLDLLKLCVQELEKRM,0
4y69,b,48,71,23,GAADCQFWETWLGSQCRLHELREK,0
4y69,b,75,90,15,SVAAASKILSNLVYQY,0
4y69,b,132,144,12,GQTFAYGVLDSNY,0
4y69,b,149,168,19,SVEDALYLGKRSILAAAHRD,0
4y69,b,193,205,12,VGELFWKVKEEEG,0
4y69,b,57,79,22,FAADGDALVKRFKNSVKWYHFDH,0
4y69,b,85,99,14,SINSAARNIQHLLYG,0
4y69,b,142,154,12,AASLIMPFLDNQV,0
4y69,b,176,195,19,SVEEVIKLVRDSFTSATERH,0
4y69,b,57,76,19,ISDMQHIERLLKDLVTENAY,0
4y69,b,88,106,18,EPSYIFEYLATVMYQRRSK,0
4y69,b,145,156,11,GFGAHMANPLLR,0
4y69,b,161,165,4,RESDI,0
4y69,b,169,188,19,TVQVAEEAIVNAMRVLYYRD,0
4y69,b,219,225,6,WDFAKDI,0
4y69,b,48,71,23,SAADTQAIADIVQYHLELYTSQYG,0
4y69,b,74,89,15,STETAASVFKELCYEN,0
4y69,b,128,133,5,GSGSTF,0
4y69,b,134,142,8,IYGYCDKNF,0
4y69,b,147,166,19,SKEETVDFIKHSLSQAIKWD,0
4y69,b,189,194,5,YPDEYE,0
4y69,b,52,56,4,ESDSI,0
5h0s,C,183,197,14,SEADDRIVGPTVNLF,0
5h0s,C,214,217,3,DTAT,0
5h0s,C,242,260,18,EQSAEYVSGLLMVLFKVMT,0
5h0s,C,274,278,4,MSNTL,0
5h0s,C,279,286,7,STVVNNVL,0
5h0s,C,297,302,5,NPALLR,0
5h0s,C,307,318,11,VNWLNRDITNML,0
5h0s,C,351,369,18,DHFAASVLNINLRALMEAN,0
5h0s,C,372,381,9,ADDRIKALQA,0
5h0s,C,404,419,15,DHDHIIRCLMLAAANY,0
5h0s,C,421,435,14,RLEGIIVQINTGYVA,0
5h0s,C,456,458,2,NQS,0
5h0s,C,459,471,12,AARLVSAVKARAS,0
5h0s,C,477,487,10,SIHLAIAREVS,0
5h0s,C,508,521,13,IVVVLEFILFALFF,0
5h0s,C,521,544,23,FPTEFNRIKGDIQNVLLLFFSRWY,0
5h0s,C,544,555,11,YPVEYGIFIQRG,0
5h0s,C,576,581,5,DQSLYL,0
5h0s,C,588,590,2,LFS,0
5h0s,C,597,606,9,ANTIIAIMRL,0
5h0s,C,616,623,7,DDLAIAAN,0
5h0s,C,646,671,25,NEFASRFRTIVATLANVVNERAVQDD,0
5h0s,C,673,711,38,QKATRSCTKQWLRHLETQFDNIAVAHTDHLSVVYATMSN,0
5h0s,C,759,761,2,DTS,0
5h0s,C,762,769,7,IVWPILCQ,0
5h0s,C,795,814,19,DPSTTLSQSLSVAQVLSKLT,0
5h0s,C,814,824,10,TLPDAFINMIL,0
5h0s,C,852,858,6,YDQYLSH,0
5h0s,C,858,866,8,HIRERLHIT,0
5h0s,C,879,890,11,TPDQIAASVQAT,0
5h0s,C,902,913,11,INGSASTYLREN,0
5h0s,C,948,952,4,IADIF,0
5h0s,C,961,970,9,SDAVRQLRAL,0
5h0s,C,977,988,11,SQIRHAIERIAQ,0
5h0s,C,997,1004,7,YGKLTLRF,0
5h0s,C,1037,1041,4,IEAFR,0
5h0s,C,1043,1047,4,SRYFL,0
5h0s,C,1048,1063,15,DELRLRRLSVGLRLIT,0
5h0s,C,1148,1163,15,SKLVADNIIASVIKSN,0
5h0s,C,1191,1196,5,ESIMTA,0
5h0s,C,1324,1328,4,DVRAI,0
5h0s,C,184,189,5,EADDRI,0
5h0s,C,214,218,4,DTATG,0
5h0s,C,244,249,5,SAEYVS,0
5h0s,C,253,260,7,MVLFKVMT,0
5h0s,C,279,284,5,STVVNN,0
5h0s,C,307,320,13,VNWLNRDITNMLQQ,0
5h0s,C,351,368,17,DHFAASVLNINLRALMEA,0
5h0s,C,371,383,12,TADDRIKALQAHS,0
5h0s,C,420,437,17,PRLEGIIVQINTGYVASA,0
5h0s,C,456,469,13,NQSAARLVSAVKAR,0
5h0s,C,475,483,8,ISSIHLAIA,0
5h0s,C,504,506,2,DPS,0
5h0s,C,507,521,14,SIVVVLEFILFALFF,0
5h0s,C,521,528,7,FPTEFNRI,0
5h0s,C,528,544,16,IKGDIQNVLLLFFSRWY,0
5h0s,C,544,554,10,YPVEYGIFIQR,0
5h0s,C,588,591,3,LFSD,0
5h0s,C,597,605,8,ANTIIAIMR,0
5h0s,C,616,622,6,DDLAIAA,0
5h0s,C,646,659,13,NEFASRFRTIVATL,0
5h0s,C,660,663,3,ANVV,0
5h0s,C,672,699,27,MQKATRSCTKQWLRHLETQFDNIAVAHT,0
5h0s,C,701,710,9,HLSVVYATMS,0
5h0s,C,723,727,4,NHATF,0
5h0s,C,795,824,29,DPSTTLSQSLSVAQVLSKLTLPDAFINMIL,0
5h0s,C,852,865,13,YDQYLSHIRERLHI,0
5h0s,C,881,890,9,DQIAASVQAT,0
5h0s,C,903,912,9,NGSASTYLRE,0
5h0s,C,962,971,9,DAVRQLRALM,0
5h0s,C,976,990,14,TSQIRHAIERIAQIT,0
5h0s,C,1050,1064,14,LRLRRLSVGLRLITN,0
5h0s,C,1150,1162,12,LVADNIIASVIKS,0
3mvd,L,44,57,13,GTVALREIRRYQKS,0
3mvd,L,63,77,14,RKLPFQRLVREIAQD,0
3mvd,L,85,114,29,QSSAVMALQEASEAYLVALFEDTNLCAIHA,0
3mvd,L,120,132,12,MPKDIQLARRIRG,0
3mvd,L,24,29,5,DNIQGI,0
3mvd,L,30,42,12,TKPAIRRLARRGG,0
3mvd,L,49,76,27,LIYEETRGVLKVFLENVIRDAVTYTEHA,0
3mvd,L,82,93,11,TAMDVVYALKRQ,0
3mvd,L,16,21,5,TRSSRA,0
3mvd,L,26,36,10,PVGRVHRLLRK,0
3mvd,L,45,73,28,AGAPVYLAAVLEYLTAEILELAGNAARDN,0
3mvd,L,79,90,11,IPRHLQLAVRND,0
3mvd,L,90,97,7,DEELNKLL,0
3mvd,L,112,116,4,QSVLL,0
3mvd,L,34,46,12,YAIYVYKVLKQVH,0
3mvd,L,52,81,29,SSKAMSIMNSFVNDVFERIAGEASRLAHYN,0
3mvd,L,87,99,12,TSREIQTAVRLLL,0
3mvd,L,100,120,20,PGELAKHAVSEGTKAVTKYTS,0
3mvd,L,30,41,11,TKPAIRRLARRG,0
3mvd,L,45,72,27,AGAPVYLAAVLEYLTAEILELAGNAARD,0
3mvd,L,79,89,10,IPRHLQLAVRN,0
3mvd,L,100,121,21,PGELAKHAVSEGTKAVTKYTSA,0
3mvd,L,320,324,4,PEYGR,0
1nx9,D,67,71,4,MPTDQ,0
1nx9,D,113,118,5,NAKGRA,0
1nx9,D,126,131,5,TMREVL,0
1nx9,D,132,134,2,PQG,0
1nx9,D,135,141,6,DDVFVEG,0
1nx9,D,176,192,16,DETTDAWDTVDWLVHNV,0
1nx9,D,205,216,11,AYEGFTVVMALL,0
1nx9,D,249,259,10,GAFDYFVSQMT,0
1nx9,D,273,282,9,DDYTNFLKAG,0
1nx9,D,283,292,9,SAGSFATQAG,0
1nx9,D,293,295,2,LDQ,0
1nx9,D,296,305,9,YPFWQRMHAH,0
1nx9,D,309,314,5,DAFWQG,0
1nx9,D,316,325,9,ALDKILAQRK,0
1nx9,D,343,355,12,WGAIHAWQALKDA,0
1nx9,D,371,375,4,SGVNY,0
1nx9,D,388,397,9,DTAHQYRRDV,0
1nx9,D,397,407,10,VFRPFFDEYLK,0
1nx9,D,453,455,2,DGH,0
1nx9,D,489,494,5,QSSRWK,0
1nx9,D,495,499,4,PWLVQ,0
1nx9,D,501,506,5,QREAES,0
1nx9,D,558,562,4,DPKMG,0
1nx9,D,576,578,2,RYR,0
1nx9,D,634,638,4,NIFDA,0
1nx9,D,639,643,4,KPADY,0
1nx9,D,653,657,4,GGKEA,0
1nx9,D,67,73,6,MPTDQQR,0
1nx9,D,205,215,10,AYEGFTVVMAL,0
2wfz,A,81,85,4,SEMWN,0
2wfz,A,127,131,4,LDVYN,0
2wfz,A,133,140,7,KYLAYTEE,0
2wfz,A,170,184,14,LLDQRMALQWVHDNI,0
2wfz,A,185,187,2,QFF,0
2wfz,A,215,219,4,SRDLF,0
2wfz,A,242,248,6,RRRAVEL,0
2wfz,A,258,269,11,SDEELIHCLREK,0
2wfz,A,270,278,8,KPQELIDVE,0
2wfz,A,279,282,3,WNVL,0
2wfz,A,304,311,7,SLESMLNS,0
2wfz,A,329,334,5,SFFLLY,0
2wfz,A,348,354,6,SREDFMS,0
2wfz,A,368,376,8,LDAVTLQYT,0
2wfz,A,400,413,13,VICPLMHFVNKYTK,0
2wfz,A,443,448,5,EIEFVF,0
2wfz,A,453,457,4,VKELN,0
2wfz,A,459,479,20,TAEEEALSRRIMHYWATFAKT,0
2wfz,A,517,526,9,RVQMCVFWNQ,0
2wfz,A,526,535,9,QFLPKLLNAT,0
4q3a,D,5,10,5,TPDDLI,0
4q3a,D,11,28,17,NINMQLQKADSAVQEVTG,0
4q3a,D,30,40,10,DIKGICKALYG,0
4q3a,D,62,74,12,NFSASLHAITQYF,0
4q3a,D,84,95,11,PDVSGYYEAVQN,0
4q3a,D,121,135,14,NQPCTGIIYAEIASR,0
4q3a,D,152,163,11,VGFPGAEHLVQK,0
4q3a,D,173,185,12,DETLLERATSNLG,0
4q3a,D,211,213,2,PEA,0
4q3a,D,231,238,7,SEELRDKY,0
4q3a,D,247,259,12,LGIGTASMLYSVL,0
4q3a,D,211,215,4,PEAVL,0
4q3a,D,247,258,11,LGIGTASMLYSV,0
2r5o,B,272,276,4,VYHTR,0
2r5o,B,349,353,4,SFLAS,0
3hn6,F,8,28,20,TYEDISKWAANHVAQKINEFS,0
3hn6,F,45,58,13,PIGMYKNLIELNKN,0
3hn6,F,84,93,9,SYHSFMWNNF,0
3hn6,F,94,97,3,FSHI,0
3hn6,F,100,102,2,KKE,0
3hn6,F,113,128,15,NLKKECEEYEKKIKSF,0
3hn6,F,163,171,8,TQDTIIANS,0
3hn6,F,172,174,2,RFF,0
3hn6,F,189,195,6,GIGTIMD,0
3hn6,F,205,207,2,GHN,0
3hn6,F,208,217,9,KARALKHAIE,0
3hn6,F,224,232,8,WTISALQLH,0
3hn6,F,242,245,3,NATY,0
3hn6,F,248,264,16,KVGTVEYFNDIERKNFN,0
3hn6,F,172,175,3,RFFE,0
3hn6,F,177,181,4,DVNKV,0
3hn6,F,189,196,7,GIGTIMDS,0
3hn6,F,163,172,9,TQDTIIANSR,0
3hn6,F,163,170,7,TQDTIIAN,0
3hn6,F,163,168,5,TQDTII,0
2rpc,A,37,47,10,TMHELVTHVTM,0
2rpc,A,74,82,8,AKYKLVNHI,0
2rpc,A,82,87,5,IRVHTG,0
2rpc,A,104,113,9,RSENLKIHKR,0
2rpc,A,134,141,7,NSSDRKKH,0
6bgu,A,27,30,3,EEFT,0
6bgu,A,31,44,13,DPLSFIGRIRPLAE,0
6bgu,A,80,84,4,LEAMT,0
6bgu,A,363,379,16,LQSFGEMADNFKSDYFN,0
6bgu,A,381,385,4,PVHMV,0
6bgu,A,386,399,13,PTELVEKEFWRLVS,0
6bgu,A,415,419,4,SKDFG,0
6bgu,A,432,434,2,LPE,0
6bgu,A,435,441,6,EEEYALS,0
6bgu,A,444,448,4,NLNNM,0
6bgu,A,454,460,6,SVLAHIN,0
6bgu,A,485,489,4,EDHWS,0
6bgu,A,507,509,2,PSH,0
6bgu,A,510,522,12,AAEQLEEVMRELA,0
6bgu,A,523,528,5,PELFES,0
6bgu,A,530,535,5,PDLLHQ,0
6bgu,A,541,548,7,NPNVLMEH,0
1i8f,G,11,18,7,TLGATLQD,0
1i8f,G,12,20,8,LGATLQDSI,0
1i8f,G,14,20,6,ATLQDSI,0
1i8f,G,11,20,9,TLGATLQDSI,0
1i8f,G,12,19,7,LGATLQDS,0
1i8f,G,13,19,6,GATLQDS,0
1gje,A,6,13,7,LQWLCEKY,0
5x17,B,48,59,11,QLHIESKIYKMM,0
5x17,B,88,96,8,SLEDLFNFC,0
5x17,B,101,122,21,SLKTVLLLADQMISRIEYIHSK,0
5x17,B,130,132,2,KPD,0
5x17,B,138,142,4,LGKKG,0
5x17,B,176,180,4,TARYA,0
5x17,B,181,186,5,SINTHL,0
5x17,B,191,209,18,SRRDDLESLGYVLMYFNLG,0
5x17,B,220,234,14,TKRQKYERISEKKMS,0
5x17,B,236,241,5,PIEVLC,0
5x17,B,246,258,12,SEFATYLNFCRSL,0
5x17,B,265,280,15,DYSYLRQLFRNLFHRQ,0
5x17,B,288,292,4,FDWNM,0
5x17,B,48,60,12,QLHIESKIYKMMQ,0
5x17,B,220,235,15,TKRQKYERISEKKMST,0
5x17,B,245,258,13,PSEFATYLNFCRSL,0
5x17,B,265,281,16,DYSYLRQLFRNLFHRQG,0
3nqo,B,3,36,33,YSNELKELFLNQTYATLFTLTNKIQIEGDKYFG,0
3nqo,B,39,52,13,TSRQYTILSILHL,0
3nqo,B,53,57,4,PEEET,0
3nqo,B,58,67,9,TLNNIARKG,0
3nqo,B,69,83,14,SKQNINRLVANLEKN,0
3nqo,B,103,125,22,TDLGKKVVTCSRTGINFADVF,0
3nqo,B,129,145,16,TKDELETLWSLLKKYR,0
3nqo,B,154,158,4,FEEDA,0
3nqo,B,167,182,15,DKIKSEALEEFAKRRN,0
3nqo,B,39,51,12,TSRQYTILSILH,0
3nqo,B,170,183,13,KSEALEEFAKRRNR,0
2rer,A,14,23,9,PFELVWDVTN,0
2rer,A,24,26,2,DIE,0
2rer,A,27,32,5,AWPELF,0
2rer,A,121,151,30,DNAHMTAHLNTTTRANMERIKKIIEDRHREG,0
1yog,A,4,17,13,EGEWQLVLHVWAKV,0
1yog,A,21,35,14,VAGHGQDILIRLFKS,0
1yog,A,37,42,5,PETLEK,0
1yog,A,52,57,5,EAEMKA,0
1yog,A,59,76,17,EDLKKHGVTVLTALGAIL,0
1yog,A,83,95,12,EAELKPLAQSHAT,0
1yog,A,101,118,17,IKYLEFISEAIIHVLHSR,0
1yog,A,125,149,24,ADAQGAMNKALELFRKDIAAKYKEL,0
5x21,F,31,45,14,GFGVTLGNPLRRILL,0
5x21,F,74,84,10,DVVEIILNLKE,0
5x21,F,152,157,5,PAEKHG,0
5x21,F,206,223,17,TPLEALNQAVEILREHLT,0
5x21,F,224,227,3,YFSN,0
5x21,F,31,47,16,GFGVTLGNPLRRILLSS,0
5x21,F,112,114,2,RDF,0
5x21,F,224,226,2,YFS,0
5x21,F,19,31,12,TEIQVESYRRALQ,0
5x21,F,35,39,4,PPEKR,0
5x21,F,42,52,10,VGIQAAFRETF,0
5x21,F,79,86,7,PQDECREK,0
5x21,F,193,200,7,LVLLLRVL,0
5x21,F,203,212,9,DQETLARELG,0
5x21,F,223,228,5,DESVFA,0
5x21,F,230,243,13,RPEEALIRLFTLLR,0
5x21,F,249,261,12,KRDKAVAYVYGLI,0
5x21,F,270,282,12,GEAGRYKAEEKLG,0
5x21,F,302,316,14,VFLPTLRYLFALTAG,0
5x21,F,335,360,25,TVGELMTDQFRVGLARLARGVRERML,0
5x21,F,368,373,5,TPAKLV,0
5x21,F,375,387,12,SRPLEAAIREFFS,0
5x21,F,399,407,8,NPLSSLRHK,0
5x21,F,431,435,4,HRTHY,0
5x21,F,487,492,5,TATEED,0
5x21,F,525,529,4,SPEEV,0
5x21,F,535,540,5,SPKQVF,0
5x21,F,543,547,4,NTNLI,0
5x21,F,549,553,4,FLEHD,0
5x21,F,554,565,11,DANRALMGSNMQ,0
5x21,F,566,568,2,TQA,0
5x21,F,583,591,8,LEERVVRDS,0
5x21,F,692,697,5,EELLKR,0
5x21,F,768,779,11,TPEERLLRSIFG,0
5x21,F,872,876,4,NPLGV,0
5x21,F,882,898,16,LGQILETHLGLAGYFLG,0
5x21,F,910,932,22,KEPEIKELLAQAFEVYFGKRKGE,0
5x21,F,937,949,12,DKREVEVLRRAEK,0
5x21,F,958,969,11,TPEEQLKELFLQ,0
5x21,F,1000,1005,5,MVEDKM,0
5x21,F,1033,1044,11,GEMEVWALEAYG,0
5x21,F,1045,1054,9,AAHTLQEMLT,0
5x21,F,1059,1072,13,DIEGRNAAYEAIIK,0
5x21,F,1082,1094,12,PESFRVLVKELQA,0
5x21,F,14,22,8,SPEKIRSWS,0
5x21,F,46,51,5,DERIFG,0
5x21,F,82,88,6,KSIVRRY,0
5x21,F,101,107,6,HIWFVKD,0
5x21,F,110,116,6,SKIGTLL,0
5x21,F,119,128,9,SATELEQVLY,0
5x21,F,154,163,9,TDEEYRELRY,0
5x21,F,423,426,3,DGGK,0
5x21,F,456,467,11,MGAEAIQQLLKE,0
5x21,F,469,481,12,DLEALEKELLEEM,0
5x21,F,485,506,21,SRARRAKARKRLEVVRAFLDSG,0
5x21,F,508,511,3,RPEW,0
5x21,F,521,525,4,PPDLR,0
5x21,F,538,561,23,SDLNDLYRRLINRNNRLKKLLAQG,0
5x21,F,563,583,20,PEIIIRNEKRMLQEAVDALLD,0
5x21,F,602,608,6,SLTDILS,0
5x21,F,612,618,6,GRFRQNL,0
5x21,F,646,653,7,KRMALELF,0
5x21,F,653,664,11,FKPFLLKKMEEK,0
5x21,F,669,678,9,NVKAARRMLE,0
5x21,F,679,683,4,RQRDI,0
5x21,F,684,695,11,KDEVWDALEEVI,0
5x21,F,709,711,2,HRL,0
5x21,F,729,734,5,HPLVCE,0
5x21,F,752,762,10,SSFAQAEARIQ,0
5x21,F,783,794,11,RDIILGLYYITQ,0
5x21,F,808,818,10,TPEEALAAHER,0
5x21,F,836,841,5,VGRLKY,0
5x21,F,845,855,10,NPDEALLAVAH,0
5x21,F,876,891,15,SPGRILFARIVAEAVE,0
5x21,F,892,900,8,DEKVAWELI,0
5x21,F,907,923,16,EKNSLKDLVYQAFLRLG,0
5x21,F,923,943,20,GMEKTARLLDALKYYGFTFST,0
5x21,F,950,954,4,GIDDA,0
5x21,F,958,980,22,EEKKQYLEEADRKLLQIEQAYEM,0
5x21,F,984,1015,31,TDRERYDQILQLWTETTEKVTQAVFKNFEENY,0
5x21,F,1018,1026,8,NPLYVMAQS,0
5x21,F,1031,1039,8,NPQQIRQLC,0
5x21,F,1066,1086,20,TVLEYFISSHGARKGGADTAL,0
5x21,F,1087,1103,16,RTADSGYLTRKLVDVTH,0
5x21,F,1136,1145,9,KRADIEAGLY,0
5x21,F,1167,1181,14,SMDDVHLLIKAAEAG,0
5x21,F,1202,1206,4,QKCYG,0
5x21,F,1220,1239,19,AVGIVAAQSIGEPGTQLTMR,0
5x21,F,1240,1244,4,TFHTG,0
5x21,F,1251,1264,13,DITQGLPRVIELFE,0
5x21,F,1331,1339,8,DPHQLLEAK,0
5x21,F,1340,1359,19,GPEAVERYLVEEIQKVYRAQ,0
5x21,F,1364,1376,12,HDKHIEIVVRQMM,0
5x21,F,1397,1408,11,KWDVEALNERLI,0
5x21,F,1423,1430,7,GVTKSALS,0
5x21,F,1433,1439,6,SWLSAAS,0
5x21,F,1442,1454,12,NTTHVLTEAAIAG,0
5x21,F,1461,1469,8,GLKENVILG,0
5x21,F,1474,1477,3,AGTG,0
5x21,F,1478,1483,5,SDFVRF,0
5x21,F,1489,1498,9,QKTLKAIEEA,0
5x21,F,5,13,8,GIDKLFGMV,0
5x21,F,15,34,19,SKYRLTVVVAKRAQQLLRHG,0
5x21,F,59,71,12,NAVTWAMKELLTG,0
5x21,F,81,93,12,PEDRLQKEMERLY,0
5x21,F,79,89,10,DPVRQYLHEIG,0
5x21,F,95,121,26,TLEEEVELARKVEEGMEAIKKLSEITG,0
5x21,F,123,137,14,DPDLIREVVRAKILG,0
5x21,F,152,164,12,DPKTVEEIDQKLK,0
5x21,F,167,191,24,PKEHKRYLHIAREGEAARQHLIEAN,0
5x21,F,191,200,9,NLRLVVSIAK,0
5x21,F,208,226,18,SFLDLIQEGNQGLIRAVEK,0
5x21,F,228,232,4,EYKRR,0
5x21,F,234,255,21,KFSTYATWWIRQAINRAIADQA,0
5x21,F,261,283,22,PVHMVETINKLSRTARQLQQELG,0
5x21,F,287,296,9,TYEEIAEAMG,0
5x21,F,300,311,11,DAKRVEETLKIA,0
5x21,F,329,333,4,YGDFI,0
5x21,F,340,359,19,SPVDAATQSLLSEELEKALS,0
5x21,F,362,373,11,SEREAMVLKLRK,0
5x21,F,382,391,9,TLEEVGAFFG,0
5x21,F,393,416,23,TRERIRQIENKALRKLKYHESRTR,0
5x21,F,417,423,6,KLRDFLD,0
2zds,F,9,12,3,GQWA,0
2zds,F,15,27,12,PLEEVCRLARDFG,0
2zds,F,41,48,7,EVDKALAD,0
2zds,F,50,62,12,SYVDSRHQLLDKY,0
2zds,F,72,77,5,HLVGQA,0
2zds,F,84,91,7,DERHEAIL,0
2zds,F,92,97,5,PARIWG,0
2zds,F,100,123,23,DAEGVRQRAAAEIKDTARAAARLG,0
2zds,F,135,139,4,IWHLV,0
2zds,F,146,172,26,PESIERGYQDFADRWNPILDVFDAEG,0
2zds,F,187,198,11,DYWTTHRALEAV,0
2zds,F,210,216,6,PSHFVWQ,0
2zds,F,219,227,8,DPVGFLWDF,0
2zds,F,274,285,11,PWEDVFRLRSI,0
2zds,F,301,315,14,DRLQGAPEALTRLKA,0
2zds,F,71,76,5,NHLVGQ,0
2zds,F,209,211,2,DPS,0
2zds,F,212,217,5,HFVWQD,0
2zds,F,72,80,8,HLVGQAVCD,0
2zds,F,72,76,4,HLVGQ,0
2zds,F,210,214,4,PSHFV,0
2zds,F,71,80,9,NHLVGQAVCD,0
2zds,F,84,89,5,DERHEA,0
2zds,F,210,217,7,PSHFVWQD,0
1mxy,C,22,26,4,NHEML,0
1mxy,C,27,30,3,EGNE,0
1mxy,C,34,48,14,GYCVDLAAEIAKHCG,0
1mxy,C,72,80,8,NGMVGELVY,0
1mxy,C,93,98,5,TLVREE,0
1mxy,C,123,129,6,SAEDLSK,0
1mxy,C,141,150,9,GSTKEFFRRS,0
1mxy,C,152,165,13,IAVFDKMWTYMRSA,0
1mxy,C,173,184,11,TTAEGVARVRKS,0
1mxy,C,194,202,8,STMNEYIEQ,0
1mxy,C,230,244,14,LGNAVNLAVLKLNEQ,0
1mxy,C,245,256,11,GLLDKLKNKWWY,0
1mxy,C,28,30,2,GNE,0
1mxy,C,245,255,10,GLLDKLKNKWW,0
1mxy,C,34,47,13,GYCVDLAAEIAKHC,0
1mxy,C,123,130,7,SAEDLSKQ,0
1mxy,C,173,183,10,TTAEGVARVRK,0
1mxy,C,230,245,15,LGNAVNLAVLKLNEQG,0
3rz4,A,4,15,11,GRCELAAAMKRH,0
3rz4,A,19,23,4,NYRGY,0
3rz4,A,24,37,13,SLGNWVCAAKFESN,0
3rz4,A,79,85,6,PCSALLS,0
3rz4,A,88,100,12,ITASVNCAKKIVS,0
3rz4,A,101,102,1,DG,0
3rz4,A,103,107,4,NGMNA,0
3rz4,A,108,115,7,WVAWRNRC,0
3rz4,A,119,125,6,DVQAWIR,0
5doi,H,15,24,9,TDKQIDFQVA,0
5doi,H,48,60,12,PKSTIQEQLDKIK,0
5doi,H,64,79,15,SKELAKNKIFKFLSEY,0
5doi,H,151,160,9,TLQLLQAASE,0
5doi,H,15,17,2,TDK,0
5doi,H,18,24,6,QIDFQVA,0
5doi,H,64,77,13,SKELAKNKIFKFLS,0
5doi,H,151,161,10,TLQLLQAASEI,0
5doi,H,48,59,11,PKSTIQEQLDKI,0
5doi,H,12,16,4,ELPSL,0
5doi,H,108,125,17,SADEEMLQYLLIQKYKLS,0
5doi,H,9,16,7,FLKELPSL,0
5doi,H,108,123,15,SADEEMLQYLLIQKYK,0
4msl,A,58,65,7,DFVAKLAN,0
4msl,A,125,129,4,TDLIN,0
4msl,A,134,137,3,RTEF,0
4msl,A,431,437,6,ASYSISQ,0
4msl,A,496,499,3,DSGG,0
4msl,A,580,582,2,EEK,0
4msl,A,636,638,2,SLE,0
4msl,A,662,672,10,KGHDLEFCLYG,0
4msl,A,673,677,4,REEHL,0
4msl,A,703,709,6,LKKKCTS,0
2jka,B,87,89,2,DSK,0
2jka,B,134,137,3,PMND,0
2jka,B,204,213,9,EIRGLMKEAI,0
2jka,B,297,303,6,ARNILAS,0
2jka,B,304,309,5,RITLNL,0
2jka,B,317,322,5,DAASWV,0
2jka,B,331,336,5,WWDMIT,0
2jka,B,356,360,4,DYSKT,0
2jka,B,369,383,14,NTANVKRYIDFAAAH,0
2jka,B,396,400,4,GWEDW,0
2jka,B,419,430,11,DVKEIHRYAARK,0
2jka,B,443,461,18,SVRNYERHMDKAYQFMADN,0
2jka,B,483,500,17,GQWMNNHYLYAVKKAADY,0
2jka,B,514,518,4,GICRT,0
2jka,B,530,536,6,GTEYESF,0
2jka,B,542,546,4,YHTTI,0
2jka,B,546,550,4,ILPFT,0
2jka,B,568,571,3,CNKM,0
2jka,B,582,593,11,TIARQLALYVTM,0
2jka,B,603,610,7,IPENYERF,0
2jka,B,610,620,10,FMDAFQFIKDV,0
2jka,B,296,303,7,DARNILAS,0
2jka,B,530,535,5,GTEYES,0
5pcz,A,1868,1883,15,KDLALCSMILTEMETH,0
5pcz,A,1886,1890,4,AWPFL,0
5pcz,A,1900,1905,5,GYKKVI,0
5pcz,A,1910,1920,10,DFSTIREKLSS,0
5pcz,A,1925,1944,19,NLETFALDVRLVFDNCETFN,0
5pcz,A,1948,1970,22,SDIGRAGHNMRKYFEKKWTDTFK,0
3ahm,B,2,6,4,KFSEF,0
3ahm,B,12,29,17,NIEKLKASFQQALQSFQK,0
3ahm,B,32,64,32,NAEEQNEAMKEINQLRNDFSTMAQICYIRHTID,0
3ahm,B,67,97,30,DEFYKQEQDFFDEVEPIVKGLVNDYYRALVS,0
3ahm,B,100,109,9,FRSQLEGKWG,0
3ahm,B,110,120,10,KQLFALAEAEL,0
3ahm,B,121,123,2,KTY,0
3ahm,B,124,126,2,SPD,0
3ahm,B,127,147,20,IVEDLQLENKLTSEYTKLVAS,0
3ahm,B,159,161,2,LAQ,0
3ahm,B,162,167,5,LQPFVE,0
3ahm,B,170,188,18,DRDMRKRASEARFTFFQEH,0
3ahm,B,188,210,22,HEEKFDEIYDQLVKVRTAIAQKL,0
3ahm,B,214,223,9,NFVELGYARL,0
3ahm,B,229,244,15,NAEMVAKFRKQVEKHI,0
3ahm,B,244,260,16,IVPIAVKLRERQRERIG,0
3ahm,B,265,269,4,KYYDE,0
3ahm,B,283,299,16,DANWIIENGKKMYEELS,0
3ahm,B,299,312,13,SPETGEFFRYMIEH,0
3ahm,B,333,336,3,ENYK,0
3ahm,B,348,367,19,SGDIDVLTHEAGHAFQVYES,0
3ahm,B,372,376,4,IPEYN,0
3ahm,B,379,394,15,TLEACEIHSMSMEFFT,0
3ahm,B,397,403,6,WMKLFFK,0
3ahm,B,405,437,32,DAEKYQFYHLSDALLFLPYGVAVDEFQHFVYEN,0
3ahm,B,441,457,16,TPAERKQAWRAIERKYM,0
3ahm,B,465,470,5,NDYLER,0
3ahm,B,472,476,4,GFWQR,0
3ahm,B,477,483,6,QSHIYTT,0
3ahm,B,487,507,20,YIDYTLAQICAFQFWKRSREN,0
3ahm,B,507,520,13,NYKEAWNDYLTLCR,0
3ahm,B,526,534,8,PFTELVRVA,0
3ahm,B,543,557,14,GCVQSVVGGIEGWLN,0
3ahm,B,558,559,1,SV,0
3ahm,B,560,564,4,DDQSL,0
3ahm,B,12,30,18,NIEKLKASFQQALQSFQKA,0
3ahm,B,67,98,31,DEFYKQEQDFFDEVEPIVKGLVNDYYRALVSS,0
3ahm,B,109,121,12,GKQLFALAEAELK,0
3ahm,B,122,123,1,TY,0
3ahm,B,507,521,14,NYKEAWNDYLTLCRQ,0
3epu,B,3,16,13,SRADRLLRQFSLKL,0
3epu,B,64,78,14,LAFEFLNANLWFAEN,0
3epu,B,104,128,24,SVEKLECEIEVVIRSMENLYHILQD,0
3epu,B,3,19,16,SRADRLLRQFSLKLNTD,0
3epu,B,61,78,17,NNNLAFEFLNANLWFAEN,0
3epu,B,104,129,25,SVEKLECEIEVVIRSMENLYHILQDK,0
4d0n,B,17,27,10,GKTCLLIVFSK,0
4d0n,B,69,74,5,LRPLSY,0
4d0n,B,88,107,19,SPDSLENIPEKWTPEVKHFC,0
4d0n,B,118,122,4,KKDLR,0
4d0n,B,124,133,9,DEHTRRELAK,0
4d0n,B,140,152,12,KPEEGRDMANRIG,0
4d0n,B,166,180,14,GVREVFEMATRAALQ,0
4d0n,B,1970,1975,5,SMSKQL,0
4d0n,B,1979,1984,5,SWSRII,0
4d0n,B,1985,1991,6,DSKFLKQ,0
4d0n,B,1993,2023,30,KKDVVKRQEVIYELMQTEFHHVRTLKIMSGV,0
4d0n,B,2023,2032,9,VYSQGMMADL,0
4d0n,B,2035,2043,8,EQQMVEKLF,0
4d0n,B,2045,2066,21,CLDELISIHSQFFQRILERKKE,0
4d0n,B,2081,2089,8,IGDVLVNQF,0
4d0n,B,2090,2136,46,SGENAERLKKTYGKFCGQHNQSVNYFKDLYAKDKRFQAFVKKKMSSS,0
4d0n,B,2138,2141,3,VRRL,0
4d0n,B,2142,2154,12,GIPECILLVTQRI,0
4d0n,B,2156,2168,12,KYPVLFQRILQCT,0
4d0n,B,2171,2212,41,NEVEQEDLAQSLSLVKDVIGAVDSKVASYEKKVRLNEIYTKT,0
4d0n,B,2229,2231,2,EDL,0
4d0n,B,2321,2340,19,SKEERNSWIQIIQDTINTLN,0
5y89,B,46,56,10,GGALAETAFAL,0
5y89,B,76,82,6,PDAAKRL,0
5y89,B,92,98,6,SAEGLLS,0
5y89,B,112,122,10,PPTAIAQVKGA,0
5y89,B,134,150,16,DVESVRAKITGVAQALD,0
5y89,B,151,175,24,VRDAGAALLQRFDRDWQAARDAVAA,0
5y89,B,204,213,9,TAADAMIRYA,0
5y89,B,229,237,8,TTEALAAAA,0
5y89,B,245,252,7,DEGLAAVG,0
5y89,B,253,259,6,GHAALLA,0
5y89,B,262,265,3,GFGA,0
5y89,B,266,271,5,TPAGRA,0
5y89,B,278,284,6,DALFLLG,0
5y89,B,288,305,17,RLPLAVTTLHRRLSDALA,0
5y89,B,76,81,5,PDAAKR,0
5y89,B,134,149,15,DVESVRAKITGVAQAL,0
5y89,B,245,251,6,DEGLAAV,0
4xa3,B,4,17,13,KPEEHEDILNKLLD,0
4xa3,B,21,231,210,AQSERTEALQQLRVNYGSFVSEYNDLTKSDFYFGKLRNIELICQEN,0
4xa3,B,237,246,9,PVLQRIVDIL,0
4xa3,B,21,1375,1354,AQSERTEALQQLRVNYGSFVSEYNDLTKSDFYFGKLRNIELICQENDPVLQRIVDILLSKANSEVAQWRTKY,0
4xa3,B,1375,231,-1144,,0
4xa3,B,237,244,7,PVLQRIVD,0
3zup,B,18,20,2,LGP,0
3zup,B,21,31,10,AREALERLRAL,0
3zup,B,42,49,7,TRKEVEAL,0
3zup,B,58,60,2,ENG,0
3zup,B,88,104,16,PYRKVRARLREAEALAG,0
3zup,B,110,112,2,YGD,0
3zup,B,114,123,9,TAEAVARLTG,0
3zup,B,125,134,9,SREAARRAKA,0
3zup,B,144,146,2,CPE,0
3zup,B,147,158,11,EVEAVLEALEAV,0
3zup,B,176,188,12,DKGRAVARLRALW,0
3zup,B,190,195,5,DPEEAR,0
3zup,B,203,205,2,SLN,0
3zup,B,206,213,7,DLPLFRAV,0
3zup,B,235,246,11,GPEGFRYAVERY,0
3zup,B,246,253,7,YLLPRLSR,0
3zup,B,20,31,11,PAREALERLRAL,0
3zup,B,125,133,8,SREAARRAK,0
3zup,B,144,158,14,CPEEVEAVLEALEAV,0
3zup,B,176,187,11,DKGRAVARLRAL,0
3zup,B,192,195,3,EEAR,0
3zup,B,206,212,6,DLPLFRA,0
3zup,B,234,247,13,PGPEGFRYAVERYL,0
3zup,B,247,252,5,LLPRLS,0
4x8y,B,74,79,5,TPAELR,0
4x8y,B,103,108,5,GRKFYG,0
4x8y,B,113,117,4,YGVFA,0
4x8y,B,121,128,7,ASRGLATF,0
4x8y,B,131,135,4,DKEAL,0
4x8y,B,141,145,4,DLSDL,0
4x8y,B,146,164,18,TAAQQETLSDWESQFTFKY,0
4x8y,B,68,72,4,SPEFD,0
2k42,B,26,37,11,DPDLRSLFSRAG,0
2k42,B,39,44,5,SEAQLT,0
2k42,B,45,59,14,DAETSKLIYDFIEDQ,0
2k42,B,61,70,9,GLEAVRQEMR,0
2k42,B,78,89,11,DVAQRLMQHLAE,0
2mjq,A,1,10,9,GLLKRIKTLL,0
3nwb,A,4,17,13,TKEQRILRYVQQNA,0
3nwb,A,21,36,15,DPQSVLEAIDTYCTQK,0
3nwb,A,42,58,16,VGDAKGQIMDAVIREYS,0
3nwb,A,70,78,8,GYSAVRMAR,0
3nwb,A,92,106,14,NPDYAAITQQMLNFA,0
3nwb,A,108,110,2,LQD,0
3nwb,A,118,123,5,ASQDLI,0
3nwb,A,125,130,5,QLKKKY,0
3nwb,A,143,145,2,WKD,0
3nwb,A,146,157,11,RYLPDTLLLEKC,0
3nwb,A,176,186,10,TPDFLAYVRGS,0
4jxn,A,7,34,27,AQKPHDRMAAYLESDMAAVSTLIRERMA,0
4jxn,A,41,49,8,IPEVTAHLV,0
4jxn,A,56,68,12,LRPMLTLAAAHLC,0
4jxn,A,73,94,21,PFHINLAATVEFIHTATLLHDD,0
4jxn,A,115,134,19,KSSVLVGDYLFSRSFQLMVE,0
4jxn,A,137,162,25,SLRVLDILANASATIAEGEVLQLTAS,0
4jxn,A,168,180,12,TEEVYLQVVRGKT,0
4jxn,A,180,196,16,TAALFSAATEVGGVIAG,0
4jxn,A,198,224,26,PDDHVAALFEYGDALGIAFQIVDDLLD,0
4jxn,A,237,242,5,GDDFRE,0
4jxn,A,246,254,8,TMPLIKAVA,0
4jxn,A,257,268,11,DAEERAFWVRTI,0
4jxn,A,276,288,12,GDLQHAIALLHKH,0
4jxn,A,289,309,20,AALTDTSVVARTQAARAKAAL,0
4jxn,A,315,330,15,HPVKDMLVDLADYVVE,0
1e5z,D,40,45,5,PKNVMG,0
1e5z,D,55,65,10,DMQGVVTDGMA,0
1e5z,D,66,71,5,SGLDKD,0
1e5z,D,100,102,2,SKL,0
1e5z,D,116,120,4,GHSAL,0
1e5z,D,55,67,12,DMQGVVTDGMASG,0
1e5z,D,68,71,3,LDKD,0
1m1f,B,30,38,8,PAAFNRVTR,0
1m1f,B,81,86,5,DMKARG,0
1m1f,B,94,107,13,PETIMNEVLGRLST,0
1m1f,B,108,110,2,ILT,0
1erj,C,299,304,5,PPFLLD,0
1erj,C,640,642,2,QND,0
1erj,C,287,291,4,PYNQR,0
1erj,C,311,313,2,PDA,0
1erj,C,299,303,4,PPFLL,0
4fxb,B,34,41,7,EYAALRTD,0
4fxb,B,60,69,9,RYDDVRELLS,0
4fxb,B,98,102,4,PFIRT,0
4fxb,B,105,119,14,PEHTRYRRMLLPAFT,0
4fxb,B,120,126,6,VRRVRAM,0
4fxb,B,126,144,18,MRPAVQARVDEILDGMLAA,0
4fxb,B,150,154,4,LVSAY,0
4fxb,B,154,167,13,YANAVSTSVICELL,0
4fxb,B,173,186,13,DLEFFRDVTRISGS,0
4fxb,B,190,215,25,TAEQVSEALGGLFGLLGGLVAERREE,0
4fxb,B,219,227,8,DLISKLVTD,0
4fxb,B,235,268,33,TTEQLLSTLGITINAGRETTTSMIALSTLLLLDR,0
4fxb,B,269,278,9,PELPAELRKD,0
4fxb,B,281,294,13,LMPAAVDELLRVLS,0
4fxb,B,324,330,6,LLAGANH,0
4fxb,B,362,381,19,GQHLARLELEVALETLLRRV,0
4fxb,B,389,393,4,ERDQV,0
4fxb,B,33,41,8,AEYAALRTD,0
4fxb,B,60,70,10,RYDDVRELLSD,0
4fxb,B,107,112,5,HTRYRR,0
4fxb,B,113,118,5,MLLPAF,0
4fxb,B,119,144,25,TVRRVRAMRPAVQARVDEILDGMLAA,0
4fxb,B,154,168,14,YANAVSTSVICELLG,0
4fxb,B,174,185,11,LEFFRDVTRISG,0
4fxb,B,193,213,20,QVSEALGGLFGLLGGLVAERR,0
4fxb,B,219,226,7,DLISKLVT,0
4fxb,B,269,276,7,PELPAELR,0
4fxb,B,324,329,5,LLAGAN,0
4fxb,B,350,354,4,HVAFG,0
4fxb,B,362,380,18,GQHLARLELEVALETLLRR,0
3rta,A,1,11,10,MKEIDELTIKE,0
3rta,A,15,36,21,DSRILMERAGISVVLAMEEELG,0
3rta,A,50,64,14,GNNGGDGFVVARNLL,0
3rta,A,80,93,13,TPDCEYNYGLYKKF,0
3rta,A,102,109,7,EPSILNEF,0
3rta,A,126,139,13,TGEYAEIINLVNKS,0
3rta,A,176,181,5,KIGHIL,0
3rta,A,183,189,6,PGRDLTG,0
3rta,A,199,204,5,PVHLIN,0
3rta,A,212,220,8,TREMVRSLL,0
3rta,A,228,232,4,HKGTY,0
3rta,A,246,258,12,GAPVLSGMGSLKV,0
3rta,A,272,279,7,NLIATSRF,0
3rta,A,295,297,2,SLQ,0
3rta,A,298,307,9,NLQECLELSK,0
3rta,A,321,335,14,NEHVREFVNEFLKTL,0
3rta,A,342,348,6,DADAINV,0
3rta,A,350,357,7,DTSVLKER,0
3rta,A,366,375,9,HPGEMARLVK,0
3rta,A,377,382,5,TVGDVK,0
3rta,A,384,396,12,NYELAEEFAKEND,0
3rta,A,421,425,4,NTGLS,0
3rta,A,428,443,15,GSGDVLTGMIAGFIAQ,0
3rta,A,446,464,18,SPLEASTVSVYLHGFAAEL,0
3rta,A,468,472,4,DERGL,0
3rta,A,473,489,16,TASELLRLIPEAIRRLK,0
2kmd,A,42,52,10,KEMMSQALKAT,0
2kmd,A,54,62,8,SGFTKEQQR,0
2kmd,A,74,87,13,ETHVRDWVMWAVNE,0
2kmd,A,95,98,3,FQKF,0
2kmd,A,102,107,5,GAALCA,0
2kmd,A,109,116,7,GKECFLEL,0
2kmd,A,119,134,15,DFVGDILWEHLEILQK,0
1jhr,A,4,10,6,LHALLRD,0
1jhr,A,15,28,13,DAEAMARTQQHIDG,0
1jhr,A,36,48,12,LGRLETLAVQLAG,0
1jhr,A,49,53,4,MPGLN,0
1jhr,A,71,76,5,GVWDEG,0
1jhr,A,83,94,11,IVTAIQAANMTR,0
1jhr,A,97,107,10,TGVCVLAAQAG,0
1jhr,A,179,192,13,NTTPAAAMVSVFTG,0
1jhr,A,194,199,5,DAKEVV,0
1jhr,A,206,208,2,PPS,0
1jhr,A,230,239,9,DGIDVLSKVG,0
1jhr,A,240,256,16,GFDLVGMTGVMLGAARC,0
1jhr,A,264,278,14,GFLSYSAALAACQIA,0
1jhr,A,279,283,4,PAVRP,0
1jhr,A,295,304,9,GARIALAHLS,0
1jhr,A,318,338,20,GSGAALAMPIVEAACAMFHNM,0
4mrd,A,49,60,11,SRTEAADLCQAF,0
4mrd,A,66,76,10,TMDQMKLALSK,0
3t9g,B,186,188,2,SQS,0
1jsg,A,64,67,3,PTQI,0
5g25,A,44,59,15,QTVVREMENFMERLRQ,0
5g25,A,60,62,2,DPQ,0
5g25,A,63,68,5,GIPALC,0
1zbq,F,19,32,13,AGLGRAYALAFAER,0
1zbq,F,52,65,13,SLAADKVVEEIRRR,0
1zbq,F,75,77,2,SVE,0
1zbq,F,78,91,13,EGEKVVKTALDAFG,0
1zbq,F,107,111,4,SFARI,0
1zbq,F,112,142,30,SDEDWDIIHRVHLRGSFQVTRAAWEHMKKQK,0
1zbq,F,151,157,6,SASGIYG,0
1zbq,F,161,183,22,QANYSAAKLGLLGLANSLAIEGR,0
1zbq,F,206,213,7,PEDLVEAL,0
1zbq,F,214,217,3,KPEY,0
1zbq,F,218,226,8,VAPLVLWLC,0
1zbq,F,265,272,7,TPEAVKAN,0
1zbq,F,272,278,6,NWKKICD,0
1zbq,F,287,304,17,SIQESTGSIIEVLSKIDS,0
1zbq,F,272,277,5,NWKKIC,0
5kdx,B,43,55,12,TQEEILDAALVSG,0
5kdx,B,62,90,28,DSHLVALRLQQQVERIRQTRTQLLDGLYQ,0
5kdx,B,131,134,3,EAGG,0
5kdx,B,142,146,4,NVLTQ,0
5kdx,B,151,153,2,NAA,0
5kdx,B,154,168,14,HAPLLKRAVQWLVNG,0
5kdx,B,186,197,11,DKTAALNGLKSA,0
5kdx,B,211,218,7,DASCASTS,0
5kdx,B,231,242,11,SLSATVRARLQA,0
5kdx,B,257,267,10,SSTGQQILAGL,0
5kdx,B,289,300,11,TRTRSVELGGAY,0
5kdx,B,303,313,10,DPALVQQIVDG,0
5kdx,B,320,324,4,DWSKC,0
5kdx,B,338,359,21,GLSDFSKRVDVLKGALDAYNQK,0
5kdx,B,362,366,4,NLFAL,0
5kdx,B,369,386,17,TTSLRLWLLWADAVRQNI,0
5kdx,B,395,407,12,DTARFQETFVADA,0
5kdx,B,427,433,6,GQRQQSM,0
5kdx,B,485,489,4,RIGST,0
5kdx,B,560,574,14,SSQAIADFIQALDAD,0
5kdx,B,592,604,12,VEKVRGSIDKDYG,0
5kdx,B,606,617,11,DVQRFIRELNEV,0
5kdx,B,618,626,8,FIDDAYTLA,0
5kdx,B,636,646,10,TPAIQQECAAR,0
5kdx,B,652,657,5,SETLHK,0
5kdx,B,691,703,12,GWGESHELGHNLQ,0
5kdx,B,704,708,4,VNRLK,0
5kdx,B,710,715,5,YGGRSG,0
5kdx,B,717,719,2,ISN,0
5kdx,B,720,734,14,QIFPLHKDWRVLREF,0
5kdx,B,744,757,13,NYRNAYNLIVAGRA,0
5kdx,B,760,770,10,DPLAGVYKRLW,0
5kdx,B,778,798,20,LNGERMAFYTQWVHYWADLKN,0
5kdx,B,799,803,4,DPLQG,0
5kdx,B,804,820,16,WDIWTLLYLHQRQVDKS,0
5kdx,B,821,826,5,DWDANK,0
5kdx,B,847,862,15,TDGNDNLLLGLSWLTQ,0
5kdx,B,865,872,7,QRPTFALW,0
5kdx,B,877,888,11,SAAAQAQVAAYG,0
5kdx,B,904,908,4,EYSTV,0
5kdx,B,142,147,5,NVLTQL,0
5kdx,B,338,360,22,GLSDFSKRVDVLKGALDAYNQKA,0
5kdx,B,369,384,15,TTSLRLWLLWADAVRQ,0
5kdx,B,592,602,10,VEKVRGSIDKD,0
5kdx,B,636,647,11,TPAIQQECAARG,0
5kdx,B,720,735,15,QIFPLHKDWRVLREFG,0
5kdx,B,778,797,19,LNGERMAFYTQWVHYWADLK,0
4kzl,D,962,975,13,DKEFQSVEEEMQST,0
4kzl,D,1002,1019,17,NKKLWERYTHRRKEVSEE,0
4kzl,D,1035,1043,8,FVNAIIHKG,0
4kzl,D,1045,1049,4,DERHA,0
4kzl,D,1064,1070,6,NSSKSNQ,0
4kzl,D,1074,1078,4,GIGGG,0
4kzl,D,1143,1145,2,RGE,0
4kzl,D,1002,1020,18,NKKLWERYTHRRKEVSEEN,0
1n9y,D,49,51,2,NAE,0
1n9y,D,115,121,6,TEANAWK,0
1n9y,D,49,53,4,NAESR,0
5c6q,A,2,19,17,SSLSRELVFLILQFLDEE,0
5c6q,A,21,33,12,FKETVHKLEQESG,0
5c6q,A,37,47,10,NMKYFEEKVHA,0
5c6q,A,49,58,9,EWDEVEKYLS,0
5c6q,A,66,87,21,NRYSMKIFFEIRKQKYLEALDR,0
5c6q,A,89,100,11,DRAKAVDILVKD,0
5c6q,A,101,105,4,LKVFS,0
5c6q,A,108,117,9,NEELYKEITQ,0
5c6q,A,118,121,3,LLTL,0
5c6q,A,123,127,4,NFREN,0
5c6q,A,135,154,19,DTKSARSIMLIELKKLIEAN,0
5c6q,A,169,184,15,SRLRTLINQSLNWQHQ,0
4x7h,A,587,592,5,SRYLTD,0
4x7h,A,629,645,16,RELAREKVMREVKALAK,0
4x7h,A,895,902,7,NLKDWMNG,0
4x7h,A,905,909,4,TIEER,0
4x7h,A,910,931,21,ERSVCLHIFLQIAEAVEFLHSK,0
4x7h,A,939,941,2,KPS,0
4x7h,A,992,997,5,SPEQIH,0
4x7h,A,1003,1019,16,HKVDIFSLGLILFELLY,0
4x7h,A,1023,1036,13,TQMERVRTLTDVRN,0
4x7h,A,1040,1047,7,PPLFTQKY,0
4x7h,A,1047,1058,11,YPCEYVMVQDML,0
4x7h,A,1061,1065,4,SPMER,0
4x7h,A,1067,1073,6,EAINIIE,0
4x7h,A,1074,1078,4,NAVFE,0
4b8z,D,17,29,12,GLVGKAIQKVVAD,0
4b8z,D,50,61,11,DTAQTRALFEKV,0
4b8z,D,75,80,5,GLFRNI,0
4b8z,D,82,105,23,YNLDFWRKNVHMNDNVLHSAFEVG,0
4b8z,D,114,118,4,STCIF,0
4b8z,D,140,162,22,NFGYSYAKRMIDVQNRAYFQQYG,0
4b8z,D,186,202,16,HVLPGLIHKVHLAKSSG,0
4b8z,D,220,234,14,SLDLAQLFIWVLREY,0
4b8z,D,245,249,4,GEEDE,0
4b8z,D,252,263,11,IKEAAEAVVEAM,0
4b8z,D,286,293,7,NSKLRTYL,0
4b8z,D,300,315,15,PFKQAVKETCAWFTDN,0
4b8z,D,75,82,7,GLFRNIKY,0
4b8z,D,137,139,2,HNS,0
4f2o,A,22,26,4,NHEQL,0
4f2o,A,27,30,3,EGNE,0
4f2o,A,34,48,14,GYCVDLAYEIAKHVR,0
4f2o,A,72,80,8,NGMVGELVY,0
4f2o,A,93,98,5,TLVREE,0
4f2o,A,123,129,6,SAEDLAK,0
4f2o,A,141,150,9,GSTKEFFRRS,0
4f2o,A,152,165,13,IAVYEKMWSYMKSA,0
4f2o,A,173,184,11,TTADGVARVRKS,0
4f2o,A,194,202,8,STMNEYIEQ,0
4f2o,A,230,244,14,LGNAVNLAVLKLNEQ,0
4f2o,A,245,256,11,GLLDKLKNKWWY,0
1sh0,B,58,72,14,SLQQVMRDQLKPFTE,0
1sh0,B,79,96,17,KPSVLEAAKKTIINVLEQ,0
1sh0,B,105,113,8,SFAQACASL,0
1sh0,B,126,131,5,RKNDCW,0
1sh0,B,138,153,15,GKLADQASKANLMFEE,0
1sh0,B,172,177,5,TDKIYG,0
1sh0,B,188,209,21,DLATMIRCARAFGGLMDELKTH,0
1sh0,B,220,234,14,NMNEDGPIIFERHSR,0
1sh0,B,245,250,5,RWDSTQ,0
1sh0,B,251,265,14,QRAVLAAALEIMVKF,0
1sh0,B,268,281,13,EPHLAQVVAEDLLS,0
1sh0,B,304,326,22,CTSQWNSIAHWLLTLCALSEVTN,0
1sh0,B,328,335,7,SPDIIQAN,0
1sh0,B,354,365,11,DPEKLTAKLKEY,0
1sh0,B,407,416,9,EQSSILRQMY,0
1sh0,B,434,449,15,SQRPIQLMSLLGEAAL,0
1sh0,B,451,469,18,GPAFYSKISKLVIAELKEG,0
1sh0,B,477,488,11,RQEPMFRWMRFS,0
1sh0,B,496,500,4,DRNLA,0
1sh0,B,434,448,14,SQRPIQLMSLLGEAA,0
1s10,A,10,20,10,YFYAQVEEVLN,0
1s10,A,21,24,3,PSLK,0
1s10,A,47,52,5,NYEARK,0
1s10,A,60,68,8,PIVEAKKIL,0
1s10,A,77,93,16,RKEVYQQVSSRIMNLLR,0
1s10,A,94,96,2,EYS,0
1s10,A,117,137,20,DYREAYNLGLEIKNKILEKEK,0
1s10,A,147,159,12,NKVFAKIAADMAK,0
1s10,A,167,178,11,DDEEVKRLIREL,0
1s10,A,179,183,4,DIADV,0
1s10,A,187,196,9,GNITAEKLKK,0
1s10,A,201,207,6,KLVDTLS,0
1s10,A,209,218,9,EFDKLKGMIG,0
1s10,A,218,230,12,GEAKAKYLISLAR,0
1s10,A,257,277,20,NLEEIKPYLFRAIEESYYKLD,0
1s10,A,307,326,19,SKETAYSESVKLLQKILEED,0
1nfb,B,19,25,6,TAQQLFN,0
1nfb,B,45,49,4,TADQV,0
1nfb,B,75,85,10,EAGMAIAMALT,0
1nfb,B,96,110,14,TPEFQANEVRKVKKY,0
1nfb,B,193,204,11,TLKEANEILQRS,0
1nfb,B,254,267,13,EDDKYRLDLLAQAG,0
1nfb,B,280,294,14,SIFQINMIKYIKDKY,0
1nfb,B,306,317,11,TAAQAKNLIDAG,0
1nfb,B,344,355,11,ATAVYKVSEYAR,0
1nfb,B,356,358,2,RFG,0
1nfb,B,369,379,10,NVGHIAKALAL,0
1nfb,B,387,392,5,GSLLAA,0
1nfb,B,452,471,19,SIHKFVPYLIAGIQHSCQDI,0
1nfb,B,475,485,10,SLTQVRAMMYS,0
1ias,E,176,186,10,TLKDLIYDMTT,0
1ias,E,194,203,9,PLLVQRTIAR,0
1ias,E,238,252,14,EERSWFREAEIYQTV,0
1ias,E,270,274,4,NGTWT,0
1ias,E,287,295,8,SLFDYLNRY,0
1ias,E,298,318,20,TVEGMIKLALSTASGLAHLHM,0
1ias,E,335,337,2,KSK,0
1ias,E,360,363,3,SATD,0
1ias,E,375,379,4,TKRYM,0
1ias,E,380,385,5,APEVLD,0
1ias,E,392,413,21,HFESFKRADIYAMGLVFWEIAR,0
1ias,E,437,446,9,SVEEMRKVVC,0
1ias,E,456,460,4,NRWQS,0
1ias,E,461,476,15,CEALRVMAKIMRECWY,0
1ias,E,478,482,4,NGAAR,0
1ias,E,484,498,14,TALRIKKTLSQLSQQ,0
1ias,E,238,253,15,EERSWFREAEIYQTVM,0
1ias,E,176,187,11,TLKDLIYDMTTS,0
1ias,E,484,496,12,TALRIKKTLSQLS,0
1ias,E,497,500,3,QQEG,0
1ias,E,393,413,20,FESFKRADIYAMGLVFWEIAR,0
5nps,A,314,331,17,PTHADSLNNLANIKREQG,0
5nps,A,332,347,15,NIEEAVRLYRKALEVF,0
5nps,A,350,364,14,FAAAHSNLASVLQQQ,0
5nps,A,366,381,15,KLQEALMHYKEAIRIS,0
5nps,A,384,398,14,FADAYSNMGNTLKEM,0
5nps,A,400,415,15,DVQGALQCYTRAIQIN,0
5nps,A,418,433,15,FADAHSNLASIHKDSG,0
5nps,A,434,449,15,NIPEAIASYRTALKLK,0
5nps,A,452,466,14,FPDAYCNLAHCLQIV,0
5nps,A,471,489,18,DYDERMKKLVSIVADQLEK,0
5nps,A,499,503,4,HSMLY,0
5nps,A,506,526,20,SHGFRKAIAERHGNLCLDKIN,0
5nps,A,558,565,7,HPTSHLMQ,0
5nps,A,566,571,5,SIPGMH,0
5nps,A,589,599,10,TNFRVKVMAEA,0
5nps,A,606,608,2,SQI,0
5nps,A,610,622,12,CNGKAADRIHQDG,0
5nps,A,638,643,5,NELFAL,0
5nps,A,675,682,7,PAEVAEQY,0
5nps,A,697,702,5,DHANMF,0
5nps,A,703,706,3,PHLK,0
5nps,A,730,737,7,DLKAFLDS,0
5nps,A,770,783,13,NTIAEAVIEMINRG,0
5nps,A,799,804,5,ATTQIN,0
5nps,A,804,809,5,NNKAAT,0
5nps,A,823,826,3,SQYG,0
5nps,A,839,843,4,QLYKI,0
5nps,A,844,858,14,DPSTLQMWANILKRV,0
5nps,A,869,871,2,PAV,0
5nps,A,872,883,11,GEPNIQQYAQNM,0
5nps,A,897,905,8,PKEEHVRRG,0
5nps,A,906,908,2,QLA,0
5nps,A,920,929,9,HTTGMDVLWA,0
5nps,A,940,943,3,TLAS,0
5nps,A,944,954,10,RVAASQLTCLG,0
5nps,A,955,959,4,CLELI,0
5nps,A,962,976,14,NRQEYEDIAVKLGTD,0
5nps,A,976,994,18,DLEYLKKVRGKVWKQRISS,0
5nps,A,998,1019,21,NTKQYTMELERLYLQMWEHYAA,0
4b2d,D,17,22,5,QLHAAM,0
4b2d,D,25,32,7,TFLEHMCR,0
4b2d,D,57,68,11,SVETLKEMIKSG,0
4b2d,D,80,97,17,THEYHAETIKNVRTATES,0
4b2d,D,145,149,4,DNAYM,0
4b2d,D,163,168,5,NICKVV,0
4b2d,D,222,236,14,SEKDIQDLKFGVEQD,0
4b2d,D,247,259,12,KASDVHEVRKVLG,0
4b2d,D,273,279,6,NHEGVRR,0
4b2d,D,279,287,8,RFDEILEAS,0
4b2d,D,294,301,7,RGDLGIEI,0
4b2d,D,302,304,2,PAE,0
4b2d,D,305,321,16,KVFLAQKMMIGRCNRAG,0
4b2d,D,331,336,5,LESMIK,0
4b2d,D,341,355,14,TRAEGSDVANAVLDG,0
4b2d,D,362,367,5,SGETAK,0
4b2d,D,370,388,18,YPLEAVRMQHLIAREAEAA,0
4b2d,D,390,402,12,YHLQLFEELRRLA,0
4b2d,D,407,423,16,DPTEATAVGAVEASFKC,0
4b2d,D,435,443,8,GRSAHQVAR,0
4b2d,D,456,463,7,NPQTARQA,0
4b2d,D,464,466,2,HLY,0
4b2d,D,481,500,19,AWAEDVDLRVNFAMNVGKAR,0
4b2d,D,222,235,13,SEKDIQDLKFGVEQ,0
3ubh,A,451,454,3,ADGD,0
3ubh,A,496,500,4,DYEEL,0
3ubh,A,786,790,4,SGSNA,0
2aem,A,124,134,10,SESTLECLREL,0
2aem,A,145,147,2,DEN,0
2aem,A,148,154,6,VRKKVLR,0
2aem,A,166,173,7,RVSDLEKA,0
2aem,A,187,202,15,SDSETIHCILGIRKID,0
2aem,A,213,215,2,RYE,0
2aem,A,216,224,8,NIEQLRMAG,0
2aem,A,230,241,11,SPFVISGRLMSR,0
2aem,A,246,257,11,GYEAMFVQDVLA,0
2aem,A,279,284,5,SVLDAD,0
2aem,A,284,290,6,DIHDVTG,0
2aem,A,323,335,12,KPEEIERLKNYIS,0
3aib,H,255,259,4,DAANF,0
3aib,H,280,282,2,DGK,0
3aib,H,296,298,2,LMT,0
3aib,H,302,317,15,DQETQRQYVNYMNAQL,0
3aib,H,328,350,22,SPLQLNLAAQTIQTKIEEKITAE,0
3aib,H,355,367,12,WLRQTISAFVKTQ,0
3aib,H,368,376,8,SAWNSDSEK,0
3aib,H,396,400,4,TSQAN,0
3aib,H,442,457,15,NPVVQAEQLNWLHFLM,0
3aib,H,458,465,7,NFGNIYAN,0
3aib,H,466,470,4,DPDAN,0
3aib,H,478,483,5,AVDNVD,0
3aib,H,484,499,15,ADLLQIAGDYLKAAKG,0
3aib,H,503,509,6,NDKAAND,0
3aib,H,520,528,8,NDTPYLHDD,0
3aib,H,536,547,11,DNRLRLSLLYSL,0
3aib,H,550,554,4,PLNQR,0
3aib,H,558,563,5,NPLITN,0
3aib,H,591,603,12,VQDLIRDIIKAEI,0
3aib,H,613,630,17,TMEEIKKAFEIYNKDLLA,0
3aib,H,639,648,9,NTALSYALLL,0
3aib,H,660,662,2,GDM,0
3aib,H,676,691,15,NYEAIETLLKARIKYV,0
3aib,H,725,730,5,DRITRT,0
3aib,H,781,788,7,DQEAAGLV,0
3aib,H,848,853,5,NAALDS,0
3aib,H,869,872,3,KKEE,0
3aib,H,873,881,8,YTNVVIAKN,0
3aib,H,881,889,8,NVDKFAEWG,0
3aib,H,907,911,4,FLDSV,0
3aib,H,934,948,14,TADDLVKAIKALHSK,0
3aib,H,1002,1008,6,DQQAKYG,0
3aib,H,1011,1019,8,FLEELQAKY,0
3aib,H,1019,1025,6,YPELFAR,0
3aib,H,1044,1046,2,SAK,0
3aib,H,1074,1078,4,VSDNT,0
3aib,H,1081,1086,5,PKSLVN,0
3aib,H,246,250,4,AQYNQ,0
3aib,H,371,376,5,NSDSEK,0
3aib,H,442,458,16,NPVVQAEQLNWLHFLMN,0
3aib,H,503,508,5,NDKAAN,0
3aib,H,613,628,15,TMEEIKKAFEIYNKDL,0
3aib,H,659,663,4,YGDMF,0
3aib,H,756,760,4,GAAHK,0
3aib,H,907,913,6,FLDSVIQ,0
3aib,H,934,947,13,TADDLVKAIKALHS,0
3aib,H,1020,1024,4,PELFA,0
3aib,H,244,248,4,SFAQY,0
3aib,H,328,351,23,SPLQLNLAAQTIQTKIEEKITAEK,0
3aib,H,353,366,13,TNWLRQTISAFVKT,0
3aib,H,367,376,9,QSAWNSDSEK,0
3aib,H,458,464,6,NFGNIYA,0
3aib,H,849,853,4,AALDS,0
3aib,H,245,250,5,FAQYNQ,0
3aib,H,353,367,14,TNWLRQTISAFVKTQ,0
3aib,H,557,563,6,MNPLITN,0
3aib,H,393,400,7,SKLTSQAN,0
3aib,H,458,463,5,NFGNIY,0
3aib,H,881,888,7,NVDKFAEW,0
3aib,H,908,913,5,LDSVIQ,0
3aib,H,244,250,6,SFAQYNQ,0
3aib,H,367,375,8,QSAWNSDSE,0
3aib,H,503,510,7,NDKAANDH,0
3aib,H,613,629,16,TMEEIKKAFEIYNKDLL,0
3aib,H,781,785,4,DQEAA,0
3aib,H,907,912,5,FLDSVI,0
3aib,H,1020,1025,5,PELFAR,0
3aib,H,536,548,12,DNRLRLSLLYSLA,0
3aib,H,639,650,11,NTALSYALLLTN,0
3aib,H,780,785,5,SDQEAA,0
3aib,H,786,788,2,GLV,0
3aib,H,873,889,16,YTNVVIAKNVDKFAEWG,0
3aib,H,295,299,4,LLMTW,0
3aib,H,355,365,10,WLRQTISAFVK,0
3aib,H,366,376,10,TQSAWNSDSEK,0
3aib,H,520,529,9,NDTPYLHDDG,0
6bzg,A,508,510,2,NKV,0
6bzg,A,511,512,1,IE,0
6bzg,A,513,522,9,NQKVIQSLCK,0
6bzg,A,553,555,2,SRF,0
6bzg,A,566,577,11,YDKAVNDLLTEF,0
6bzg,A,587,594,7,SEIIQDVD,0
6bzg,A,596,605,9,DLFWKIKLYL,0
6bzg,A,618,634,16,TTDFFIDWMKYFIARWA,0
6bzg,A,647,654,7,NADILLDL,0
6bzg,A,657,668,11,NILLVRKIFQTY,0
6bzg,A,669,679,10,SLEEFFMAIIK,0
6bzg,A,681,686,5,ESKAVK,0
6bzg,A,689,702,13,TVSQMTRLKKLLTL,0
6bzg,A,30,40,10,TSRLISQLNEE,0
6bzg,A,43,68,25,DEESGVNFIVTQLQLLINNVYEKIQK,0
6bzg,A,90,105,15,SIAYWDILLERSLDLI,0
6bzg,A,107,112,5,GPSKTG,0
6bzg,A,124,132,8,DRSRYVENN,0
6bzg,A,132,144,12,NQYFLAFKANQRL,0
6bzg,A,149,154,5,VDMDEF,0
6bzg,A,156,172,16,DFEILIKQIIFDLFKKN,0
6bzg,A,175,177,2,PDQ,0
6bzg,A,178,186,8,DFEAILSRF,0
6bzg,A,188,196,8,NLESLVVAF,0
1qs7,D,5,20,15,TDEQIAEFKEAFSLFD,0
1qs7,D,28,39,11,TTKELGTVMRSL,0
1qs7,D,44,56,12,TEAELQDMINEVD,0
1qs7,D,65,74,9,FPEFLNLMAR,0
1qs7,D,77,93,16,KDTDSEEELKEAFRVFD,0
1qs7,D,101,113,12,SAAELRHVMTNLG,0
1qs7,D,117,129,12,TDEEVDEMIREAD,0
1qs7,D,137,147,10,NYEEFVQVMMA,0
1qs7,D,5,19,14,QKTGHAVRAIGRLSS,0
1qs7,D,138,146,8,YEEFVQVMM,0
4bhg,A,31,37,6,AVWLRDN,0
4bhg,A,54,58,4,LVEAL,0
4bhg,A,88,94,6,ADWLKKR,0
4bhg,A,97,110,13,SKQARAKLQRELFF,0
4bhg,A,127,133,6,FEDVLRY,0
4bhg,A,133,148,15,YDEHAYKWLSTLKKVG,0
4bhg,A,160,170,10,GEVSKLGKRMG,0
4bhg,A,191,195,4,NVAYT,0
4bhg,A,234,245,11,GFNVCQKLKKNN,0
4bhg,A,245,253,8,NPQAFQILS,0
4bhg,A,303,305,2,PVE,0
4bhg,A,306,323,17,RVQPFYAALKEFVDLMNS,0
4bhg,A,368,384,16,DWDVVMSRLRILRQRVE,0
2q8o,B,99,103,4,DKKYI,0
2q8o,B,150,154,4,SKDHI,0
3o0i,A,23,36,13,QAEIAQLMSLIINT,0
3o0i,A,42,66,24,EIFLRELISNSSDALDKIRYESLTD,0
3o0i,A,67,71,4,PSKLD,0
3o0i,A,99,105,6,TKADLIN,0
3o0i,A,105,124,19,NNLGTIAKSGTKAFMEALQA,0
3o0i,A,127,135,8,DISMIGQFG,0
3o0i,A,136,143,7,VGFYSAYL,0
3o0i,A,192,198,6,EDQTEYL,0
3o0i,A,199,211,12,EERRIKEIVKKHS,0
1cj4,A,12,23,11,PSGLLLGQLLHK,0
1cj4,A,36,40,4,PDYVL,0
1cj4,A,50,58,8,QGMVDLLRE,0
1cj4,A,63,68,5,RRMARD,0
1cj4,A,88,91,3,LKRL,0
1cj4,A,102,116,14,QTEVTRDLMEAREAS,0
1cj4,A,164,167,3,ISRQ,0
1cj4,A,171,173,2,AER,0
1cj4,A,231,233,2,VED,0
1cj4,A,236,246,10,DERFWTELKAR,0
1cj4,A,249,254,5,AEVAEK,0
1cj4,A,285,287,2,GDA,0
1cj4,A,293,295,2,PTG,0
1cj4,A,298,318,20,GLNLAASDVSTLYRLLLKAYR,0
1cj4,A,322,327,5,GELLER,0
1cj4,A,328,350,22,YSAICLRRIWKAERFSWWMTSVL,0
1cj4,A,358,371,13,AFSQRIQQTELEYY,0
1cj4,A,375,386,11,EAGLATIAENYV,0
4s26,B,87,92,5,SFEECF,0
4s26,B,148,158,10,RKEWIDRREKL,0
4s26,B,164,171,7,TQMYYAKQ,0
4s26,B,175,186,11,TEEMLYCATREK,0
4s26,B,188,198,10,DPEFVRSEVAR,0
4s26,B,237,252,15,SIEEEVYKVQWATMWG,0
4s26,B,264,275,11,HIHETREWILRN,0
4s26,B,283,292,9,VPIYQALEKV,0
4s26,B,295,299,4,IAENL,0
4s26,B,300,315,15,NWEVFRETLIEQAEQG,0
4s26,B,326,334,8,LLRYIPLTA,0
4s26,B,342,356,14,SRGGSIHAKWCLAYH,0
4s26,B,359,364,5,NFAYEH,0
4s26,B,364,376,12,HWDDILDICNQYD,0
4s26,B,389,393,4,SIYDA,0
4s26,B,395,415,20,DTAQFAELLTQGELTRRAWEK,0
4s26,B,428,430,2,PMH,0
4s26,B,431,443,12,KIPENMQKQLEWC,0
4s26,B,462,477,15,YDHITSAIGAANIGAL,0
4s26,B,495,517,22,NRDDVKAGVIAYKIAAHAADLAK,0
4s26,B,521,535,14,HAQAWDDALSKARFE,0
4s26,B,537,545,8,RWMDQFALS,0
4s26,B,547,557,10,DPMTAMSFHDE,0
4s26,B,561,567,6,ADGAKVA,0
4s26,B,578,594,16,CSMKITEDIRKYAEENG,0
4s26,B,264,276,12,HIHETREWILRNS,0
4s26,B,522,535,13,AQAWDDALSKARFE,0
4h1i,D,29,44,15,GELQYLGQIQHILRCG,0
4h1i,D,80,94,14,FWKGVLEELLWFIKG,0
4h1i,D,98,103,5,AKELSS,0
4h1i,D,109,113,4,WDANG,0
4h1i,D,116,121,5,DFLDSL,0
4h1i,D,134,141,7,VYGFQWRH,0
4h1i,D,159,171,12,DQLQRVIDTIKTN,0
4h1i,D,186,190,4,DLPLM,0
4h1i,D,221,241,20,LGVPFNIASYALLTYMIAHIT,0
4h1i,D,261,271,10,HIEPLKIQLQR,0
4h1i,D,30,44,14,ELQYLGQIQHILRCG,0
4h1i,D,80,93,13,FWKGVLEELLWFIK,0
4h1i,D,97,103,6,NAKELSS,0
4h1i,D,110,113,3,DANG,0
4h1i,D,114,122,8,SRDFLDSLG,0
4h1i,D,183,190,7,NPRDLPLM,0
4h1i,D,261,270,9,HIEPLKIQLQ,0
4h1i,D,292,294,2,KAE,0
4h1i,D,118,122,4,LDSLG,0
4h1i,D,222,241,19,GVPFNIASYALLTYMIAHIT,0
4h1i,D,261,269,8,HIEPLKIQL,0
4h1i,D,287,291,4,KIDDF,0
4h1i,D,135,142,7,YGFQWRHF,0
4h1i,D,161,171,10,LQRVIDTIKTN,0
4h1i,D,183,187,4,NPRDL,0
3wum,A,4,15,11,GRCELAAAMKRH,0
3wum,A,19,23,4,NYRGY,0
3wum,A,24,37,13,SLGNWVCAAKFESN,0
3wum,A,79,85,6,PCSALLS,0
3wum,A,88,100,12,ITASVNCAKKIVS,0
3wum,A,103,107,4,NGMNA,0
3wum,A,108,115,7,WVAWRNRC,0
3wum,A,119,124,5,DVQAWI,0
2ab0,B,14,28,14,EETEAVTTIDLLVRG,0
2ab0,B,59,63,4,LVEVA,0
2ab0,B,75,85,10,GIKGAECFRDS,0
2ab0,B,85,98,13,STLLVETVKQFHRS,0
2ab0,B,107,113,6,AAPATVL,0
2ab0,B,127,134,7,FPTLKDKI,0
2ab0,B,157,159,2,GPG,0
2ab0,B,160,173,13,TAIDFGLKIIDLLV,0
2ab0,B,174,183,9,GREKAHEVAS,0
2ab0,B,174,184,10,GREKAHEVASQ,0
2rqs,A,19,31,12,KQGEALAVQERLK,0
2rqs,A,35,43,8,KFGKLAKEL,0
2rqs,A,47,53,6,GGSAKRD,0
2rqs,A,65,73,8,VKPFEDAAF,0
4kri,C,2,17,15,PAVERQLIECLHHVIK,0
4kri,C,30,39,9,QDDQRKALTE,0
4kri,C,52,59,7,EVDSLKNL,0
4kri,C,73,76,3,EEIN,0
4kri,C,77,91,14,DSEKLDKFITAALRS,0
4kri,C,111,123,12,KKMAMLTDYFDVF,0
4kri,C,142,150,8,VLDSVYVHQ,0
4kri,C,173,181,8,SFRDFLDRT,0
4kri,C,184,196,12,TDTGIFAYEWIFG,0
4kri,C,203,214,11,GGWNQNLAILKR,0
4kri,C,232,243,11,GGGARQAASEFG,0
4kri,C,252,267,15,STNMLAVALERVHKEK,0
4kri,C,296,300,4,CIQHI,0
4kri,C,302,313,11,DTDKLFSRIYRA,0
4kri,C,333,344,11,SESFKEYVSQRQ,0
4kri,C,349,361,12,NLEQIEEIAKKTG,0
4kri,C,370,388,18,MTPRFKEILLEERERIEQD,0
4kri,C,388,394,6,DKETFLA,0
4kri,C,397,417,20,SQNAYDGLVSGWKSKLQYIAD,0
4kri,C,3,17,14,AVERQLIECLHHVIK,0
4kri,C,1,17,16,MPAVERQLIECLHHVIK,0
4kri,C,30,40,10,QDDQRKALTEQ,0
4kri,C,203,213,10,GGWNQNLAILK,0
4kri,C,214,216,2,RFG,0
4kri,C,252,266,14,STNMLAVALERVHKE,0
4kri,C,388,396,8,DKETFLAKF,0
2h0q,C,383,388,5,RMDVVF,0
2h0q,C,391,397,6,YWLSQCF,0
2h0q,C,420,425,5,GFRDYE,0
2h0q,C,431,448,17,TVFGCMQARLVGEALLES,0
2h0q,C,460,474,14,SLRCVQTAHNILKGL,0
2h0q,C,486,489,3,PGLF,0
2h0q,C,491,495,4,WTKWV,0
2h0q,C,505,512,7,PPSELAAA,0
2h0q,C,525,529,4,PVSKL,0
2h0q,C,534,554,20,SYDTYINRSFQVTKEIISECK,0
2h0q,C,567,574,7,SSLEACTC,0
2h0q,C,575,578,3,QLQG,0
2h0q,C,583,592,9,NSKDFVQMVR,0
2h0q,C,391,396,5,YWLSQC,0
2h0q,C,420,427,7,GFRDYEKD,0
2h0q,C,565,572,7,HASSLEAC,0
2h0q,C,460,475,15,SLRCVQTAHNILKGLQ,0
2h0q,C,567,572,5,SSLEAC,0
3nv3,A,303,307,4,NLPTI,0
6fuy,A,6,32,26,TRTIESILEPVAQQISHLVIMHEEGEV,0
6fuy,A,40,64,24,LTAPVAAVQAAVSNLVRVGKETVQT,0
6fuy,A,67,74,7,DQILKRDM,0
6fuy,A,74,98,24,MPPAFIKVENACTKLVQAAQMLQSD,0
6fuy,A,101,147,46,SVPARDYLIDGSRGILSGTSDLLLTFDEAEVRKIIRVCKGILEYLTV,0
6fuy,A,148,151,3,AEVV,0
6fuy,A,153,181,28,TMEDLVTYTKNLGPGMTKMAKMIDERQQE,0
6fuy,A,184,218,34,HQEHRVMLVNSMNTVKELLPVLISAMKIFVTTKNS,0
6fuy,A,222,249,27,GIEEALKNRNFTVEKMSAEINEIIRVLQ,0
6fuy,A,256,285,29,DAWASKDTEAMKRALASIDSKLNQAKGWLR,0
6fuy,A,293,301,8,DAGEQAIRQ,0
6fuy,A,301,311,10,QILDEAGKVGE,0
6fuy,A,317,340,23,ERREILGTCKMLGQMTDQVADLRA,0
6fuy,A,346,386,40,SPVAMQKAQQVSQGLDVLTAKVENAARKLEAMTNSKQSIAK,0
6fuy,A,388,395,7,IDAAQNWL,0
6fuy,A,404,415,11,GEEQIRGALAEA,0
6fuy,A,464,485,21,KQVATALQNLQTKTNRAVANSR,0
6fuy,A,492,505,13,HLEGKIEQAQRWID,0
6fuy,A,512,531,19,RGVGQAAIRGLVAEGHRLAN,0
6fuy,A,535,542,7,GPYRQDLL,0
6fuy,A,543,561,18,AKCDRVDQLTAQLADLAAR,0
6fuy,A,566,571,5,SPQARA,0
6fuy,A,572,599,27,LASQLQDSLKDLKARMQEAMTQEVSDVF,0
6fuy,A,603,614,11,TTPIKLLAVAAT,0
6fuy,A,621,651,30,NREEVFDERAANFENHSGKLGATAEKAAAVG,0
6fuy,A,654,685,31,NKSTVEGIQASVKTARELTPQVVSAARILLRN,0
6fuy,A,688,716,28,NQAAYEHFETMKNQWIDNVEKMTGLVDEA,0
6fuy,A,718,743,25,DTKSLLDASEEAIKKDLDKCKVAMAN,0
6fuy,A,745,772,27,QPQMLVAGATSIARRANRILLVAKREVE,0
6fuy,A,776,781,5,DPKFRE,0
6fuy,A,783,793,10,VKAASDELSKT,0
6fuy,A,793,805,12,TISPMVMDAKAVA,0
6fuy,A,810,835,25,DPGLQKSFLDSGYRILGAVAKVREAF,0
6fuy,A,896,910,14,QPMMMAARQLHDEAR,0
6fuy,A,917,938,21,NDIIAAAKRMALLMAEMSRLVR,0
6fuy,A,943,970,27,TKRALIQCAKDIAKASDEVTRLAKEVAK,0
6fuy,A,974,987,13,KAAIATNLLQVCER,0
6fuy,A,988,1005,17,IPTISTQLKILSTVKATM,0
6fuy,A,1014,1044,30,EESEQATEMLVHNAQNLMQSVKETVREAEAA,0
3i13,A,60,76,16,DDKLTKELIEMVEKKFQ,0
3i13,A,88,93,5,HADRIG,0
3i13,A,94,102,8,GIKTLKERG,0
3i13,A,108,118,10,TALTAELAKKN,0
3i13,A,168,170,2,CLV,0
3i13,A,187,200,13,NEWSTSIENVLKRY,0
3i13,A,216,226,10,KGLLLHTLDLL,0
4ty1,A,33,37,4,PLESQ,0
4ty1,A,72,74,2,DRI,0
4ty1,A,88,97,9,MEVVLLKKVS,0
4ty1,A,129,137,8,LFDFITERG,0
4ty1,A,140,161,21,QEELARSFFWQVLEAVRHCHNC,0
4ty1,A,169,171,2,KDE,0
4ty1,A,204,208,4,TRVYS,0
4ty1,A,209,216,7,PPEWIRYH,0
4ty1,A,219,238,19,HGRSAAVWSLGILLYDMVCG,0
4ty1,A,244,251,7,HDEEIIRG,0
4ty1,A,260,271,11,SSECQHLIRWCL,0
4ty1,A,274,278,4,RPSDR,0
4ty1,A,280,287,7,TFEEIQNH,0
4ty1,A,288,291,3,PWMQ,0
4ty1,A,295,304,9,LPQETAEIHL,0
4oyj,M,3,24,21,GEEEERAFLVAREELASALRRD,0
4oyj,M,30,39,9,SLEQLRPLLA,0
4oyj,M,43,48,5,PLAARY,0
4oyj,M,52,61,9,DAARLVRCNA,0
4oyj,M,64,88,24,EPRNYLNTLSTALNILEKYGRNLLS,0
4oyj,M,102,108,6,NPVFRST,0
4oyj,M,109,112,3,VDAV,0
4oyj,M,114,123,9,GGRDVLRLYG,0
4oyj,M,142,166,24,DEHQVATVTLEVLLLRTELSLLLQN,0
4oyj,M,170,179,9,RQQALEQLLE,0
4oyj,M,142,165,23,DEHQVATVTLEVLLLRTELSLLLQ,0
4oyj,M,5,24,19,EEERAFLVAREELASALRRD,0
4oyj,M,6,24,18,EERAFLVAREELASALRRD,0
4oyj,M,11,24,13,LVAREELASALRRD,0
4oyj,M,35,39,4,RPLLA,0
1zx5,A,22,28,6,EWIALLK,0
1zx5,A,60,73,13,IELFSKHRDELLG,0
1zx5,A,74,76,2,RAA,0
1zx5,A,102,109,7,SDKAAESL,0
1zx5,A,137,146,9,KIEELEEKLK,0
1zx5,A,151,154,3,DFKT,0
1zx5,A,199,207,8,DWEKVKKVL,0
1zx5,A,213,217,4,EEFEV,0
4p7h,B,3,16,13,DSEMAVFGAAAPYL,0
4p7h,B,19,28,9,SEKERLEAQT,0
4p7h,B,81,85,4,PPKFD,0
4p7h,B,89,93,4,DMAML,0
4p7h,B,97,111,14,HEPAVLYNLKDRYGS,0
4p7h,B,135,142,7,TPEVVAAY,0
4p7h,B,146,150,4,KRSEA,0
4p7h,B,153,168,15,HIFSISDNAYQYMLTD,0
4p7h,B,183,199,16,GKTVNTKRVIQYFAVIA,0
4p7h,B,215,222,7,TLEDQIIQ,0
4p7h,B,223,231,8,ANPALEAFG,0
4p7h,B,270,275,5,KSRVIF,0
4p7h,B,283,290,7,YHIFYQIL,0
4p7h,B,295,302,7,PELLDMLL,0
4p7h,B,306,309,3,NPYD,0
4p7h,B,310,315,5,YAFISQ,0
4p7h,B,324,339,15,DDAEELMATDNAFDVL,0
4p7h,B,342,360,18,TSEEKNSMYKLTGAIMHFG,0
4p7h,B,380,389,9,EADKSAYLMG,0
4p7h,B,393,401,8,ADLLKGLCH,0
4p7h,B,416,447,31,NVQQVIYATGALAKAVYERMFNWMVTRINATL,0
4p7h,B,472,505,33,SFEQLCINFTNEKLQQFFNHHMFVLEQEEYKKEG,0
4p7h,B,512,516,4,DFGMD,0
4p7h,B,517,523,6,LQACIDL,0
4p7h,B,529,538,9,GIMSILEEEC,0
4p7h,B,544,557,13,TDMTFKAKLFDNHL,0
4p7h,B,592,599,7,GWLQKNKD,0
4p7h,B,602,611,9,NETVVGLYQK,0
4p7h,B,614,620,6,LKLLSTL,0
4p7h,B,646,663,17,TVSALHRENLNKLMTNLR,0
4p7h,B,685,696,11,DNPLVMHQLRCN,0
4p7h,B,696,707,11,NGVLEGIRICRK,0
4p7h,B,714,722,8,LYGDFRQRY,0
4p7h,B,737,749,12,DSRKGAEKLLSSL,0
4p7h,B,769,795,26,LLGLLEEMRDERLSRIITRTQAAEELF,0
4p7h,B,843,847,4,PWPTL,0
4p7h,B,855,859,4,VQCFS,0
4p7h,B,865,868,3,MKRH,0
4p7h,B,869,875,6,DFFKSAM,0
4p7h,B,135,140,5,TPEVVA,0
4p7h,B,222,231,9,QANPALEAFG,0
4p7h,B,294,302,8,KPELLDMLL,0
4p7h,B,392,401,9,SADLLKGLCH,0
4p7h,B,416,448,32,NVQQVIYATGALAKAVYERMFNWMVTRINATLE,0
4p7h,B,472,504,32,SFEQLCINFTNEKLQQFFNHHMFVLEQEEYKKE,0
4p7h,B,517,525,8,LQACIDLIE,0
4p7h,B,529,540,11,GIMSILEEECMF,0
4p7h,B,544,556,12,TDMTFKAKLFDNH,0
4p7h,B,592,597,5,GWLQKN,0
4p7h,B,685,694,9,DNPLVMHQLR,0
4p7h,B,697,707,10,GVLEGIRICRK,0
4p7h,B,739,749,10,RKGAEKLLSSL,0
4p7h,B,768,795,27,GLLGLLEEMRDERLSRIITRTQAAEELF,0
4p7h,B,862,868,6,PDHMKRH,0
1ha6,A,16,18,2,PSR,0
1ha6,A,53,67,14,QNWVKRAVNLLSLRV,0
2jax,A,17,34,17,SPAAQVAVRWAARDAELR,0
2jax,A,62,83,21,RWQQDHGRHLIDDALKVVEQAS,0
2jax,A,99,109,10,AAVPTLVDSK,0
2jax,A,130,140,10,GSVSSGLLRHA,0
2jax,A,171,186,15,ASELATAIAFDEASRR,0
2jax,A,208,224,16,DWPATQSAEQVLAERL,0
2jax,A,224,229,5,LAGWQE,0
2jax,A,245,250,5,PARQLV,0
2jax,A,251,254,3,QRSE,0
2jax,A,275,285,10,GSVGETVAQLA,0
4j02,B,24,29,5,NPLSNS,0
4j02,B,33,35,2,HHN,0
4j02,B,41,43,2,TSR,0
4j02,B,44,53,9,SASLRQKKVT,0
4j02,B,61,76,15,DDHYRDVLKEMKAKAS,0
4j02,B,84,91,7,SIEEACKL,0
4j02,B,104,111,7,GAKDVRNL,0
4j02,B,112,129,17,SSRAVNHIRSVWEDLLED,0
4j02,B,164,188,24,DLGVRVCEKMALYDVVSTLPQAVMG,0
4j02,B,189,195,6,SSYGFQY,0
4j02,B,196,211,15,SPKQRVEFLVNTWKSK,0
4j02,B,223,228,5,CFDSTV,0
4j02,B,229,241,12,TESDIRVEESIYQ,0
4j02,B,246,260,14,APEARQAIRSLTERL,0
4j02,B,286,307,21,TTSCGNTLTCYLKATAACRAAK,0
4j02,B,328,346,18,GTQEDAAALRAFTEAMTRY,0
4j02,B,359,363,4,DLELI,0
4j02,B,388,401,13,PTTPLARAAWETAR,0
4j02,B,406,415,9,NSWLGNIIMY,0
4j02,B,418,424,6,TLWARMI,0
4j02,B,424,436,12,ILMTHFFSILLAQ,0
4j02,B,455,457,2,EPL,0
4j02,B,458,468,10,DLPQIIERLHG,0
4j02,B,469,473,4,LSAFT,0
4j02,B,478,493,15,SPGEINRVASCLRKLG,0
4j02,B,496,515,19,PLRTWRHRARSVRAKLLSQG,0
4j02,B,515,526,11,GGRAATCGRYLF,0
4j02,B,527,530,3,NWAV,0
4j02,B,539,545,6,IPAASQL,0
4j02,B,104,110,6,GAKDVRN,0
4j02,B,196,210,14,SPKQRVEFLVNTWKS,0
4j02,B,424,437,13,ILMTHFFSILLAQE,0
4j02,B,539,544,5,IPAASQ,0
5hof,A,100,105,5,DLSKNL,0
5hof,A,105,110,5,LAGSFK,0
5hof,A,116,120,4,DADSK,0
5hof,A,199,203,4,KWTNT,0
5hof,A,204,211,7,NIPKLIEQ,0
5hof,A,218,222,4,RADWF,0
5hof,A,327,331,4,GADGG,0
5hof,A,453,458,5,NKQDVV,0
5hof,A,551,563,12,TDEEIVEDVASDL,0
5hof,A,582,584,2,TRH,0
5hof,A,836,845,9,TPSQVTDLAQ,0
1wid,A,206,211,5,PKHHAE,0
1wid,A,256,264,8,GWSRFVKEK,0
4m3n,C,21,33,12,DPLRAKYIAENFL,0
4m3n,C,41,45,4,QVRN,0
4m3n,C,65,79,14,GIPSASIYIHELVQF,0
4m3n,C,114,120,6,SINNLRF,0
4m3n,C,130,143,13,TFDLLRRAYEQAQS,0
4m3n,C,167,173,6,YQLWAQF,0
4m3n,C,181,193,12,EAAGLYTLAAKFG,0
4m3n,C,213,232,19,TPQERQETFDQIEVALETI,0
4m3n,C,130,144,14,TFDLLRRAYEQAQSR,0
2nrd,A,105,111,6,ALGGGAL,0
2nrd,A,142,148,6,VPWHVTS,0
2nrd,A,199,212,13,PGEAYEDAVKAMRT,0
2nrd,A,229,231,2,GDH,0
2nrd,A,308,312,4,LIEAF,0
4luh,A,1,4,3,DTHK,0
4luh,A,5,15,10,SEIAHRFNDLG,0
4luh,A,15,31,16,GEENFQGLVLIAFSQYL,0
4luh,A,35,56,21,PFDEHVKLVKELTEFAKTCVAD,0
4luh,A,65,76,11,SLHTLFGDELCK,0
4luh,A,79,85,6,TLRETYG,0
4luh,A,86,93,7,DMADCCEK,0
4luh,A,96,105,9,PERNECFLNH,0
4luh,A,118,129,11,EPDTLCAEFKAD,0
4luh,A,129,145,16,DEKKFWGKYLYEVARRH,0
4luh,A,149,160,11,YAPELLYYANKY,0
4luh,A,160,168,8,YNGVFQECC,0
4luh,A,172,206,34,DKGACLLPKIDAMREKVLASSARQRLRCASIQKFG,0
4luh,A,206,222,16,GERALKAWSVARLSQKF,0
4luh,A,226,246,20,DFTDVTKIVTDLTKVHKECCH,0
4luh,A,248,266,18,DLLECADDRADLAKYICDH,0
4luh,A,267,270,3,QDAL,0
4luh,A,271,277,6,SSKLKEC,0
4luh,A,281,291,10,PVLEKSHCIAE,0
4luh,A,304,309,5,LTADFA,0
4luh,A,313,321,8,EVCKNYQEA,0
4luh,A,321,337,16,AKDVFLGSFLYEYSRRH,0
4luh,A,341,362,21,AVSVLLRLAKEYEATLEDCCAK,0
4luh,A,364,370,6,DPHACYA,0
4luh,A,371,414,43,TVFDKLKHLVDEPQNLIKKNCELFEKHGEYGFQNALIVRYTRKA,0
4luh,A,418,437,19,STPTLVEISRSLGKVGTKCC,0
4luh,A,440,466,26,PESERMPCTEDYLSLILNRLCVLHEKT,0
4luh,A,469,478,9,SEKVTKCCTE,0
4luh,A,482,490,8,NRRPCFSDL,0
4luh,A,502,507,5,DEKFFT,0
4luh,A,509,515,6,HADICTL,0
4luh,A,516,535,19,PDTEKQIKKQTALVELLKHK,0
4luh,A,539,560,21,TDEQLKTVMENFVAFVDKCCAA,0
4luh,A,562,583,21,DKEGCFVLEGPKLVASTQAALA,0
1dlg,B,21,32,11,AKNAALPILFAA,0
1dlg,B,47,60,13,LKDIDTTMKLLTQL,0
1dlg,B,83,88,5,PYDLVK,0
1dlg,B,90,95,5,MRASIW,0
1dlg,B,96,105,9,ALGPLVARFG,0
1dlg,B,122,132,10,VDLHIFGLEKL,0
1dlg,B,162,174,12,SVGATVTIMSAAT,0
1dlg,B,188,201,13,EPEIVDTANFLVAL,0
1dlg,B,231,244,13,DRIETGTFLVAAAI,0
1dlg,B,255,258,3,QPDT,0
1dlg,B,259,269,10,LDAVLAKLREA,0
1dlg,B,303,305,2,PTD,0
1dlg,B,306,316,10,MQAQFTLLNLV,0
1dlg,B,333,341,8,MHVPELIRM,0
1dlg,B,369,383,14,DLRASASLVLAGCIA,0
1dlg,B,392,399,7,IYHIDRGY,0
1dlg,B,401,408,7,RIEDKLRA,0
1dlg,B,334,340,6,HVPELIR,0
1dlg,B,401,409,8,RIEDKLRAL,0
5oed,B,44,55,11,NAWVCSLNVIKS,0
5oed,B,63,68,5,ALEDIT,0
5oed,B,83,93,10,IIECENLLKEM,0
5oed,B,101,114,13,SSLFTNIEALQAE,0
5oed,B,117,135,18,NSTVEDDFESFISYELQNH,0
5oed,B,180,192,12,NIDVYDKLTLAFN,0
5oed,B,37,48,11,GKTSIIKRYVHQ,0
5oed,B,83,88,5,AGQERF,0
5oed,B,92,97,5,TRVYYK,0
5oed,B,110,128,18,RSSTFEAVLKWKSDLDSKV,0
5oed,B,160,166,6,QFCKEHG,0
5oed,B,180,195,15,NIEEAARFLVEKILVN,0
5c68,A,15,28,13,DLEASIGFYSKLFG,0
5c68,A,72,86,14,DSAQVGHAARRLKES,0
4z2u,B,15,28,13,GPAGAMSATLLASL,0
4z2u,B,51,61,10,NQRTMEILRDI,0
4z2u,B,63,71,8,LEESAKSLA,0
4z2u,B,75,77,2,EYM,0
4z2u,B,100,111,11,HPQAHAEHELAS,0
4z2u,B,119,135,16,PQLYFEPMVVSEAALRG,0
4z2u,B,182,188,6,SLVAQNA,0
4z2u,B,212,216,4,LSSLC,0
4z2u,B,269,278,9,EAKKIIHEII,0
4z2u,B,312,314,2,GDA,0
4z2u,B,324,345,21,LGLNTSVQDAYNLAWKLALVLK,0
4z2u,B,349,353,4,APTLL,0
4z2u,B,354,376,22,DSYDAERSPVAKQIVERAFKSLS,0
4z2u,B,378,386,8,FPPVFEALS,0
4z2u,B,392,404,12,TESEMAEALVRLK,0
4z2u,B,407,423,16,SEEGAKRRAALRKAMDA,0
4z2u,B,424,428,4,TIIGL,0
4z2u,B,431,437,6,GHGVELN,0
4z2u,B,488,491,3,LDLC,0
4z2u,B,505,519,14,AAWKHEAEQVSQSLG,0
4z2u,B,538,544,6,GEYAKIS,0
4z2u,B,568,583,15,SREGLEQLNVAVKSIL,0
4z2u,B,182,189,7,SLVAQNAG,0
4z2u,B,216,220,4,CEHRK,0
4z2u,B,269,279,10,EAKKIIHEIIG,0
4z2u,B,349,352,3,APTL,0
4z2u,B,353,376,23,LDSYDAERSPVAKQIVERAFKSLS,0
4z2u,B,378,385,7,FPPVFEAL,0
4z2u,B,407,424,17,SEEGAKRRAALRKAMDAT,0
4z2u,B,425,428,3,IIGL,0
4z2u,B,568,584,16,SREGLEQLNVAVKSILG,0
3dgt,A,42,47,5,AGNWGT,0
3dgt,A,112,117,5,TGDAAA,0
3dgt,A,129,131,2,PFR,0
3dgt,A,221,223,2,NQM,0
3dgt,A,224,233,9,DAATWTNATN,0
3dgt,A,246,251,5,GGFPGA,0
5aey,E,69,74,5,NIAWQY,0
5aey,E,75,88,13,SDVNVVAVHHALLT,0
5aey,E,103,108,5,PLTEYY,0
5aey,E,115,126,11,NTENIERKKANF,0
5aey,E,149,152,3,SIPA,0
5aey,E,153,159,6,GYEVLQE,0
5aey,E,199,213,14,VSLVTSAVKDALSLA,0
5aey,E,218,228,10,SSYLADDIIIH,0
5aey,E,231,237,6,DNNYLKQ,0
5aey,E,244,268,24,KISIVTEAMNEALRKLEQRVLNTLN,0
5aey,E,282,294,12,GAELICDAVKKHT,0
5aey,E,297,299,2,RDE,0
5aey,E,306,308,2,NSQ,0
5aey,E,309,317,8,YDLVNGMYL,0
2hve,C,12,18,6,KPDGVQR,0
2hve,C,20,30,10,LVGEIIKRFEQ,0
2hve,C,44,52,8,SEDLLKEHY,0
2hve,C,53,56,3,VDLK,0
2hve,C,60,70,10,FFAGLVKYMHS,0
2hve,C,82,92,10,NVVKTGRVMLG,0
2hve,C,103,109,6,TIRGDFC,0
2hve,C,111,115,4,QVGRN,0
2hve,C,122,134,12,SVESAEKEIGLWF,0
2hve,C,146,151,5,AQNWIY,0
2hve,C,20,32,12,LVGEIIKRFEQKG,0
2hve,C,95,99,4,NPADS,0
2hve,C,135,139,4,HPEEL,0
1ffx,E,10,19,9,GQAGVQIGNA,0
1ffx,E,73,77,4,TVIDE,0
1ffx,E,103,108,5,YARGHY,0
1ffx,E,117,124,7,LVLDRIRK,0
1ffx,E,149,161,12,FTSLLMERLSVDY,0
1ffx,E,182,191,9,VEPYNSILTT,0
1ffx,E,208,213,5,AIYDIC,0
1ffx,E,223,237,14,TYTNLNRLIGQIVSS,0
1ffx,E,239,243,4,TASLR,0
1ffx,E,252,256,4,LTEFQ,0
1ffx,E,293,297,4,NACFE,0
1ffx,E,297,300,3,EPAN,0
1ffx,E,306,310,4,DPRHG,0
1ffx,E,324,337,13,VPKDVNAAIATIKT,0
1ffx,E,383,388,5,AIAEAW,0
1ffx,E,389,391,2,ARL,0
1ffx,E,392,397,5,DHKFDL,0
1ffx,E,402,407,5,RAFVHW,0
1ffx,E,426,432,6,AALEKDY,0
1ffx,E,10,24,14,GQCGNQIGAKFWEVI,0
1ffx,E,113,119,6,ELVDSVL,0
1ffx,E,122,127,5,VRKESE,0
1ffx,E,149,158,9,MGTLLISKIR,0
1ffx,E,185,189,4,YNATL,0
1ffx,E,206,216,10,NEALYDICFRT,0
1ffx,E,228,236,8,NHLVSATMS,0
1ffx,E,253,259,6,RKLAVNM,0
1ffx,E,283,286,3,YRAL,0
1ffx,E,287,295,8,TVPELTQQM,0
1ffx,E,297,301,4,DAKNM,0
1ffx,E,324,337,13,SMKEVDEQMLNVQN,0
1ffx,E,385,390,5,QELFKR,0
1ffx,E,427,437,10,DLVSEYQQYQD,0
1ffx,E,117,127,10,LVLDRIRKLAD,0
1ffx,E,143,147,4,GGTGS,0
1ffx,E,149,158,9,FTSLLMERLS,0
1ffx,E,184,191,7,PYNSILTT,0
1ffx,E,251,255,4,DLTEF,0
1ffx,E,383,397,14,AIAEAWARLDHKFDL,0
1ffx,E,10,19,9,GQCGNQIGAK,0
1ffx,E,254,259,5,KLAVNM,0
1ffx,E,324,333,9,SMKEVDEQML,0
1ffx,E,3,5,2,,0
1ffx,E,6,11,5,,0
1ffx,E,18,29,11,,0
1ffx,E,31,39,8,,0
1ffx,E,45,50,5,,0
1ffx,E,53,65,12,,0
1ffx,E,66,77,11,,0
3zst,B,31,34,3,QRGR,0
3zst,B,109,125,16,DPVTTWRHHARIKIPAG,0
3zst,B,127,145,18,DTDLVLEEGARLYERAAAD,0
3zst,B,148,164,16,GREDRRELLAAVDALRD,0
3zst,B,168,175,7,PAASRLAA,0
3zst,B,178,188,10,TPQVDAVLARH,0
3zst,B,206,210,4,RERAL,0
3zst,B,218,222,4,FPRSE,0
3zst,B,231,236,5,TFRTAA,0
3zst,B,238,245,7,RLPAIAAM,0
3zst,B,265,269,4,GRNNT,0
3zst,B,299,313,14,TLDDFDHFVTEAGKL,0
3zst,B,330,335,5,PWVHKH,0
3zst,B,336,339,3,PEWF,0
3zst,B,368,386,18,DPDGLATETVRILRHWMDH,0
3zst,B,396,399,3,PHTK,0
3zst,B,400,415,15,PVAFWERVIADINGTD,0
3zst,B,427,438,11,RPAMMATLAQIG,0
3zst,B,445,449,4,YFTWR,0
3zst,B,451,464,13,TKQELTEYLTELSG,0
3zst,B,465,469,4,EAASY,0
3zst,B,483,505,22,HAYLQHGGRPAFEVRAVLAATLS,0
3zst,B,541,549,8,DWTRAAREG,0
3zst,B,552,566,14,IAPLVTRLNTIRREN,0
3zst,B,567,571,4,PALRQ,0
3zst,B,616,621,5,DMPQLG,0
3zst,B,148,163,15,GREDRRELLAAVDALR,0
3zst,B,427,437,10,RPAMMATLAQI,0
5pwq,B,742,754,12,CIFCRIKTIQERC,0
5pwq,B,755,759,4,PESQS,0
5pwq,B,762,769,7,QESEVLMR,0
5pwq,B,772,788,16,LPEEQLKCEFLLLKVYC,0
5pwq,B,789,791,2,DSK,0
5pwq,B,792,797,5,SCFFAS,0
5pwq,B,814,824,10,WLNKVKTSLNE,0
5pwq,B,829,849,20,RVEGFVQDMRLIFHNHKEFYR,0
5pwq,B,853,872,19,FTRLGIQVQDIFEKNFRNIF,0
5pwq,B,742,753,11,CIFCRIKTIQER,0
1nso,A,35,39,4,KLEDW,0
1nso,A,94,103,9,GRDLLSQMKI,0
5lry,M,18,26,8,TCCTESFIR,0
5lry,M,31,39,8,LAKDVILSL,0
5lry,M,52,67,15,AGTQAEEVFEDIITQY,0
5lry,M,82,86,4,GEQGM,0
5lry,M,95,105,10,FIEKLKRAAAG,0
5lry,M,113,118,5,GTCASW,0
5lry,M,120,124,4,CVQAA,0
5lry,M,133,137,4,PIDKV,0
5lry,M,152,167,15,IPDVMSAIITYMVTFD,0
5lry,M,178,183,5,PLMFYG,0
5lry,M,185,190,5,RIHDKC,0
5lry,M,192,199,7,RRAHFDAG,0
5lry,M,209,213,4,AARKG,0
5lry,M,216,220,4,LYKMG,0
5lry,M,222,226,4,KGPTT,0
5lry,M,256,260,4,GFWDR,0
5lry,M,55,60,5,GLEIIL,0
5lry,M,64,66,2,DPR,0
5lry,M,67,74,7,DAWAFVER,0
5lry,M,81,96,15,GVHALASVYAIEDAIG,0
5lry,M,100,126,26,PDNANIIRNIMLATLWCHDHLVHFYQL,0
5lry,M,127,131,4,AGMDW,0
5lry,M,134,140,6,VLDALKA,0
5lry,M,141,153,12,DPRKTSELAQSLS,0
5lry,M,159,176,17,SPGYFFDVQNRLKKFVEG,0
5lry,M,179,183,4,LGIFR,0
5lry,M,195,217,22,PPEANLMGFAHYLEALDFQREIV,0
5lry,M,217,225,8,VKIHAVFGG,0
5lry,M,247,251,4,GAVGA,0
5lry,M,253,274,21,NMERLNLVQSIITRTADFINNV,0
5lry,M,274,286,12,VMIPDALAIGQFN,0
5lry,M,287,292,5,KPWSEI,0
5lry,M,294,299,5,TGLSDK,0
5lry,M,364,368,4,HPFDG,0
5lry,M,411,422,11,GPLARTLIAYHK,0
5lry,M,424,439,15,DAATVESVDRMMSALN,0
5lry,M,441,446,5,PLSGIQ,0
5lry,M,447,479,32,STLGRILCRAHEAQWAAGKLQYFFDKLMTNLKN,0
5lry,M,491,495,4,EPATW,0
5lry,M,530,536,6,VPTTWNA,0
5lry,M,546,553,7,GAYEAALM,0
5lry,M,563,573,10,PLEILRTLHSF,0
5lry,M,576,582,6,LACSTH,0
5lry,M,81,86,5,LGEQGM,0
5lry,M,185,189,4,RIHDK,0
5lry,M,192,198,6,RRAHFDA,0
5lry,M,207,212,5,DDAARK,0
5lry,M,159,175,16,SPGYFFDVQNRLKKFVE,0
5lry,M,411,423,12,GPLARTLIAYHKG,0
5lry,M,424,438,14,DAATVESVDRMMSAL,0
3hdz,A,538,546,8,RELQSLAAA,0
3hdz,A,550,555,5,SAQTLK,0
3hdz,A,567,582,15,SDLETALCTIRMFTDL,0
3hdz,A,591,605,14,KHEVLCRWILSVKKN,0
3hdz,A,614,631,17,NWRHAFNTAQCMFAALKA,0
3hdz,A,634,638,4,IQNKL,0
3hdz,A,639,653,14,TDLEILALLIAALSH,0
3hdz,A,661,668,7,SNQFLINT,0
3hdz,A,670,676,6,SELALMY,0
3hdz,A,680,695,15,SLEHHHFDQCLMILNS,0
3hdz,A,705,723,18,SIEEYKTTLKIIKQAILAT,0
3hdz,A,724,741,17,DLALYIKRRGEFFELIRK,0
3hdz,A,748,765,17,DPHEKELFLAMLMTACDL,0
3hdz,A,766,770,4,SAITK,0
3hdz,A,771,798,27,PWPIQQRIAELVATEFFDQGDRERKELN,0
3hdz,A,802,811,9,TDLMNREKKN,0
3hdz,A,812,824,12,KIPSMQVGFIDAI,0
3hdz,A,825,836,11,CLQLYEALTHVS,0
3hdz,A,839,858,19,CFPLLDGCRKNRQKWQALAE,0
2l1r,B,3,11,8,DIYKAAVEQ,0
2l1r,B,13,28,15,TEEQKNEFKAAFDIFV,0
2l1r,B,37,49,12,STKELGKVMRMLG,0
2l1r,B,53,65,12,TPEELQEMIDEVD,0
2l1r,B,73,86,13,DFDEFLVMMVRCMK,0
2l1r,B,149,158,9,SADAMMQALL,0
5m4z,B,20,37,17,NQEELNYLNQLKDIIDHG,0
5m4z,B,61,64,3,RDDI,0
5m4z,B,74,87,13,FWRGVVEELLWFIS,0
5m4z,B,91,98,7,NAKQLSEK,0
5m4z,B,108,115,7,SREFLDSR,0
5m4z,B,128,136,8,VYGFQWRHF,0
5m4z,B,153,165,12,DQLQQCIKMIREE,0
5m4z,B,177,184,7,NPCDLEKV,0
5m4z,B,215,235,20,LGVPFNIASYSLLTRMIAHIT,0
5m4z,B,255,264,9,HVDALKVQME,0
5m4z,B,281,285,4,NIDDF,0
5m4z,B,286,288,2,RAE,0
5m4z,B,74,88,14,FWRGVVEELLWFISG,0
5m4z,B,91,97,6,NAKQLSE,0
5m4z,B,104,107,3,DGNS,0
6c97,C,49,54,5,GAWVWE,0
6c97,C,59,83,24,WYWEKETTDLRIKEKLFLEAFKALG,0
6c97,C,131,143,12,WPEALAISQRWQQ,0
6c97,C,146,157,11,KAANKELTFLLF,0
6c97,C,157,170,13,FSCPHRLREHLERG,0
6c97,C,170,175,5,GRGNLE,0
6c97,C,246,248,2,DEH,0
3qew,A,64,79,15,NMRDASQWIKRMEDIG,0
3qew,A,87,97,10,DFKLAYLSDTY,0
3qew,A,104,108,4,DHTKI,0
3qew,A,163,169,6,SIEIAAK,0
3qew,A,170,174,4,LQEQG,0
3qew,A,179,184,5,PSEIID,0
3qew,A,193,208,15,NEKELLMEYLNFWQQK,0
3qew,A,221,235,14,FAIPYVYNRIKNIFG,0
3qew,A,235,240,5,GESTAK,0
3qew,A,241,243,2,RLS,0
3qew,A,272,281,9,DYIDLYKKFS,0
3qew,A,289,299,10,SLDYISEFELN,0
3qew,A,308,310,2,PIS,0
3qew,A,311,316,5,KLRESN,0
3qew,A,316,339,23,NHQRYISYNIIAVYRVLQIDAKRQ,0
3qew,A,339,352,13,QFINLSLDMGYYAK,0
3qew,A,354,359,5,QIQSVF,0
3qew,A,360,375,15,SPIKTWDAIIFNSLKE,0
3qew,A,414,424,10,SLYPSIIRQVN,0
3qew,A,426,428,2,SPE,0
3qew,A,438,444,6,PLHDYIN,0
3qew,A,469,503,34,GVVPTEITKVFNQRKEHKGYMLAAQRNGEIIKEAL,0
3qew,A,523,531,8,SDEIKEKIK,0
3qew,A,534,570,36,SAKSLNEMLFRAQRTEVAGMTAQINRKALINGLAGAL,0
3qew,A,579,610,31,DLRNATAITTFGQMALQWIERKVNEYLNEVCG,0
3qew,A,629,637,8,ADKIIDKVG,0
3qew,A,638,641,3,ESKF,0
3qew,A,643,658,15,DTNHWVDFLDKFARER,0
3qew,A,658,674,16,RMEPAIDRGFREMCEYM,0
3qew,A,730,734,4,LETQK,0
3qew,A,738,755,17,PKAVQKALKECIRRMLQE,0
3qew,A,756,771,15,GEESLQEYFKEFEKEF,0
3qew,A,772,774,2,RQL,0
3qew,A,775,780,5,NYISIA,0
3qew,A,788,790,2,IAK,0
3qew,A,802,815,13,PFHIRGILTYNRAI,0
3qew,A,855,866,11,TDLIKDDVLHWM,0
3qew,A,867,876,9,DYTVLLEKTF,0
3qew,A,876,887,11,FIKPLEGFTSAA,0
3qew,A,896,901,5,SLFDMF,0
1cfn,B,80,82,2,YED,0
1cfn,B,122,127,5,SEQLTS,0
1cfn,B,183,187,4,KDEYE,0
1cfn,B,29,31,2,FTD,0
1cfn,B,74,76,2,KSS,0
1cfn,B,88,90,2,SED,0
1cfn,B,154,156,2,NSG,0
1cfn,B,186,189,3,TWPS,0
1cfn,B,199,201,2,PAS,0
5aho,A,17,22,5,SLRRAG,0
5aho,A,33,37,4,HSDHT,0
5aho,A,51,62,11,SPITAHLLHRHL,0
5aho,A,124,130,6,TPSMLKE,0
5aho,A,130,134,4,EPALT,0
5aho,A,157,171,14,SRQEAAHQIVQLIRK,0
5aho,A,186,197,11,KESLLEQLALEF,0
5aho,A,204,215,11,SPRRLELVQLLG,0
5aho,A,223,227,4,EEKAG,0
5aho,A,235,237,2,MEI,0
5aho,A,238,247,9,CHSNMLRWNQ,0
5aho,A,278,290,12,SYSELRAFVAALK,0
5aho,A,306,310,4,FQDSL,0
2dgw,A,306,315,9,TEKNVMEFLA,0
2dgw,A,342,352,10,NEEEVKQALKC,0
3uld,A,104,123,19,TNNMGEFLAIVHGLRYLKER,0
3uld,A,133,143,10,SQTAIKWVKDK,0
3uld,A,155,170,15,TALIWKLVDEAEEWLN,0
3uld,A,182,187,5,QTDKWG,0
4htr,A,86,88,2,LPG,0
4htr,A,92,107,15,TTKQWQAIDKFAGENT,0
4htr,A,133,140,7,VHQMLHSV,0
4htr,A,163,165,2,ESQ,0
4htr,A,166,181,15,LHAEAYEWAKKISEHL,0
4htr,A,229,233,4,DLHAN,0
4htr,A,281,297,16,HTLAVAEAVVTTQRDWG,0
4htr,A,306,315,9,KTKYTLERVG,0
4htr,A,315,328,13,GVETFKAEVERRAG,0
4htr,A,362,364,2,IEN,0
4htr,A,375,386,11,LKTGLLEIAKIH,0
4htr,A,407,418,11,EKAKIEKIAKES,0
4htr,A,425,430,5,TPQREN,0
4htr,A,450,465,15,FLPSFIDNIDNLMAKH,0
4htr,A,485,489,4,RAMLA,0
4htr,A,524,542,18,EPEILASLDELIGRWAKER,0
4htr,A,547,555,8,GFGDFTVRA,0
4htr,A,563,568,5,DPARDL,0
5gxv,A,18,34,16,GYNGLAEVGKKFEKDTG,0
5gxv,A,44,55,11,KLEEKFPQVAAT,0
5gxv,A,68,75,7,RFGGYAQS,0
5gxv,A,84,89,5,DKAFQD,0
5gxv,A,92,97,5,YPFTWD,0
5gxv,A,133,144,11,EIPALDKELKAK,0
5gxv,A,155,164,9,EPYFTWPLIA,0
5gxv,A,187,203,16,NAGAKAGLTFLVDLIKN,0
5gxv,A,211,221,10,DYSIAEAAFNK,0
5gxv,A,230,237,7,GPWAWSNI,0
5gxv,A,274,285,11,NKELAKEFLENY,0
5gxv,A,288,299,11,TDEGLEAVNKDK,0
5gxv,A,306,314,8,LKSYEEELA,0
5gxv,A,316,328,12,DPRIAATMENAQK,0
5gxv,A,337,354,17,QMSAFWYAVRTAVINAAS,0
5gxv,A,358,388,30,TVDEALKDAQTNAAAHMLESKLIQHIATQYL,0
5gxv,A,410,424,14,ASIFDLVDFLRQESH,0
5gxv,A,428,432,4,GMHEI,0
5gxv,A,433,438,5,HPANFA,0
5gxv,A,439,455,16,SVQAMVALVQRLQAQVA,0
2cs7,C,12,16,4,NASDI,0
2cs7,C,38,40,2,NEL,0
2cs7,C,41,54,13,SASELAAAEAFLSG,0
1ub6,B,28,34,6,TFSRY,0
1ub6,B,88,92,4,RSEDT,0
1ub6,B,203,206,3,PASG,0
1ub6,B,84,88,4,EAEDV,0
1ub6,B,126,132,6,SSEQLTS,0
1ub6,B,188,192,4,KDEYE,0
1vwg,B,50,52,2,AES,0
1vwg,B,116,121,5,EANAWK,0
4rl6,B,10,23,13,GGVAQVAISKICQD,0
4rl6,B,36,48,12,TKSKCDDLKAKLE,0
4rl6,B,64,76,12,KVEEVIALIGSYK,0
4rl6,B,85,87,2,LPY,0
4rl6,B,88,100,12,QDLTIDACLATG,0
4rl6,B,116,130,14,DPEWRAIYEKRCKEL,0
4rl6,B,138,143,5,YSWQWA,0
4rl6,B,144,151,7,YQEKFKEA,0
4rl6,B,164,177,13,GVTSVFSAYALKHY,0
4rl6,B,203,213,10,NPEINLREVSA,0
4rl6,B,250,260,10,HEEIESLAKNI,0
4rl6,B,273,286,13,GQSYLTHKCLENV,0
4rl6,B,303,311,8,PIQFLKALL,0
4rl6,B,350,357,7,HQECYAEV,0
4rl6,B,360,379,19,QAISYTTGVPAIGTKLVN,0
4rl6,B,391,393,2,EEL,0
4rl6,B,395,405,10,PDPFEALNEY,0
4rl6,B,10,22,12,GGVAQVAISKICQ,0
4rl6,B,251,260,9,EEIESLAKNI,0
4rl6,B,303,308,5,PIQFLK,0
4rl6,B,350,355,5,HQECYA,0
4lrz,H,5,22,17,RTQIVNWLTRCGDIFSTE,0
4lrz,H,22,34,12,ESEYLTGLDREIG,0
4lrz,H,37,57,20,DHGLNMNRGFSKVVEKLPAIA,0
4lrz,H,60,76,16,DIGFILKNTGMTLLSSV,0
4lrz,H,79,95,16,ASGPLFGTFFIRAAQAT,0
4lrz,H,103,122,19,LEELYQMFRDGADGVISRGK,0
4lrz,H,130,147,17,MCDVWVPVVESLRQSSEQ,0
4lrz,H,150,169,19,SVPVALEAASSIAESAAQST,0
4lrz,H,170,172,2,ITM,0
4lrz,H,177,187,10,GRASYLGERSI,0
4lrz,H,191,209,18,DPGATSVMFMMQMLALAAK,0
4lrz,H,191,208,17,DPGATSVMFMMQMLALAA,0
4lrz,H,14,27,13,PLIATSWERCNKLM,0
4lrz,H,39,50,11,QGVTFASIYRRK,0
4lrz,H,50,67,17,KKAMLTLGQAALEDAWEY,0
4lrz,H,90,100,10,DPQTLQQLSAL,0
4lrz,H,109,114,5,AEGIIG,0
4lrz,H,116,125,9,CALSLAAISG,0
4lrz,H,133,135,2,DQH,0
4lrz,H,137,141,4,KQVLW,0
4lrz,H,168,170,2,EQT,0
4lrz,H,173,212,39,ADLPLTLAIAREVGNLLLTDSLLAETNRHLNQLNALLESM,0
4lrz,H,229,236,7,NAQAARVL,0
4lrz,H,247,252,5,AITELL,0
4lrz,H,255,264,9,PAVLQQAIKQ,0
4lrz,H,255,265,10,PAVLQQAIKQA,0
3ktm,H,65,77,12,TKEGILQYCQEVY,0
3ktm,H,146,161,15,THLHWHTVAKETCSEK,0
3ktm,H,147,161,14,HLHWHTVAKETCSEK,0
4mdr,A,263,268,5,EFESHR,0
3ooe,F,21,33,12,DPLRAKYIAETFL,0
3ooe,F,41,45,4,NVRGM,0
3ooe,F,65,80,15,GIPSCSIYTKELITDF,0
3ooe,F,114,120,6,KVNRIRF,0
3ooe,F,130,145,15,DFDMVRNAVDAAKALG,0
3ooe,F,165,173,8,EMFDVMEKY,0
3ooe,F,181,193,12,EAAGIYGVAAEFG,0
3ooe,F,213,220,7,TAAERQTT,0
3ooe,F,221,237,16,FNDMIKIALESVLLGDK,0
3ooe,F,130,144,14,DFDMVRNAVDAAKAL,0
3ooe,F,213,237,24,TAAERQTTFNDMIKIALESVLLGDK,0
3ooe,F,65,81,16,GIPSCSIYTKELITDFG,0
3ooe,F,217,237,20,RQTTFNDMIKIALESVLLGDK,0
3ooe,F,214,237,23,AAERQTTFNDMIKIALESVLLGDK,0
3ooe,F,163,173,10,DGEMFDVMEKY,0
3ooe,F,220,237,17,TFNDMIKIALESVLLGDK,0
3ooe,F,222,237,15,NDMIKIALESVLLGDK,0
2c77,A,23,39,16,GKTTLTAALTYVTAAEN,0
2c77,A,46,51,5,DYGDID,0
2c77,A,53,60,7,APEERARG,0
2c77,A,85,87,2,HAD,0
2c77,A,88,97,9,YIKNMITGAA,0
2c77,A,113,127,14,MPQTREHILLARQVG,0
2c77,A,137,141,4,KVDMV,0
2c77,A,143,161,18,DPELLDLVEMEVRDLLNQY,0
2c77,A,174,185,11,SALLALEQMHRN,0
2c77,A,193,210,17,NEWVDKIWELLDAIDEYI,0
2c77,A,294,298,4,SREEV,0
2c77,A,324,328,4,KKEEG,0
4bqm,B,-5,154,159,LYFQSMI,0
4bqm,B,156,172,16,DFEEFTGHVDRIFEDVK,0
4bqm,B,218,220,2,QSC,0
4bqm,B,221,234,13,VKPLTYAISISTLG,0
4bqm,B,234,239,5,GTDYVH,0
4bqm,B,267,278,11,VNAGAIVVSSLI,0
4bqm,B,283,299,16,NKAEKFDFVLQYLNKMA,0
4bqm,B,307,318,11,SNATFQSEKETG,0
4bqm,B,318,331,13,GDRNYAIGYYLKEK,0
4bqm,B,339,352,13,DMMAALDLYFQLCS,0
4bqm,B,356,369,13,TCESGSVMAATLAN,0
4bqm,B,382,397,15,SAEAVRNTLSLMHSCG,0
4bqm,B,398,400,2,MYD,0
4bqm,B,401,409,8,FSGQFAFHV,0
4bqm,B,444,459,15,SHRGTSFCQKLVSLFN,0
4bqm,B,186,190,4,LAKSN,0
4bqm,B,267,277,10,VNAGAIVVSSL,0
1xvx,A,14,30,16,HENLVKSWVDGFTKDTG,0
1xvx,A,39,51,12,GDSELGNQLVQEG,0
1xvx,A,52,54,2,SAS,0
1xvx,A,64,73,9,SPAMVLVDNA,0
1xvx,A,80,87,7,DAVTQAQV,0
1xvx,A,88,92,4,AQEYR,0
1xvx,A,116,120,4,SEAEL,0
1xvx,A,123,133,10,SIMDLAKPEWK,0
1xvx,A,142,157,15,GADFQAIVSAMLELKG,0
1xvx,A,157,171,14,GEKATLEWLKAMKTN,0
1xvx,A,177,187,10,GNSTVMKAVNA,0
1xvx,A,197,205,8,HYYRFVDQA,0
1xvx,A,223,226,3,DPGA,0
1xvx,A,241,254,13,HPKEAQEFVKWITG,0
1xvx,A,254,264,10,GKSGQDILRTN,0
1xvx,A,283,287,4,PLKDL,0
1xvx,A,293,297,4,EPSKL,0
1xvx,A,298,309,11,NSKKVVELMTEA,0
4uus,F,9,23,14,TRYQTLELEKEFHTN,0
4uus,F,27,39,12,TRRRRIEMAHALS,0
4uus,F,41,70,29,TERQIKIWFQNRRMKLKKEIQAIKELNEQE,0
4uus,F,9,23,14,SKQASEILNEYFYSN,0
4uus,F,27,39,12,SEEAKEELARKCG,0
4uus,F,41,56,15,TVSQVSNWFGNKRIRY,0
4uus,F,59,71,12,NIGKAQEEANLYA,0
4uus,F,41,65,24,TERQIKIWFQNRRMKLKKEIQAIKE,0
4uus,F,41,59,18,TVSQVSNWFGNKRIRYKKN,0
4uus,F,59,67,8,NIGKAQEEA,0
1m7q,A,61,78,17,SIIHAKRTYRELRLLKHM,0
1m7q,A,113,119,6,LNNIVKC,0
1m7q,A,123,143,20,TDDHVQFLIYQILRGLKYIHS,0
1m7q,A,152,154,2,KPS,0
1m7q,A,190,195,5,APEIML,0
1m7q,A,203,219,16,TVDIWSVGCIMAELLTG,0
1m7q,A,227,240,13,DHIDQLKLILRLVG,0
1m7q,A,243,249,6,GAELLKK,0
1m7q,A,252,260,8,SESARNYIQ,0
1m7q,A,269,274,5,NFANVF,0
1m7q,A,278,289,11,NPLAVDLLEKML,0
1m7q,A,292,296,4,DSDKR,0
1m7q,A,298,304,6,TAAQALA,0
1m7q,A,305,309,4,HAYFA,0
1m7q,A,325,330,5,QSFESR,0
1m7q,A,333,347,14,LIDEWKSLTYDEVIS,0
5c0x,K,8,21,13,SASESKFILEALRQ,0
5c0x,K,84,88,4,SPMAG,0
5c0x,K,98,112,14,GEDEVLCSRIIEKSV,0
5c0x,K,119,122,3,DVEG,0
5c0x,K,146,162,16,GFIDASCIAVMAGLMHF,0
5c0x,K,205,211,6,DTEENIK,0
5c0x,K,224,229,5,TLKEEL,0
5c0x,K,258,301,43,ALTLMKCCHEAYSIIEKITDQILQLLKEDSEKRNKYAAMLTSEN,0
5c0x,K,94,109,15,ERRVLEIQTSLVRMFE,0
5c0x,K,113,117,4,MLNIY,0
5c0x,K,134,150,16,GIMGSLINGITLALIDA,0
5c0x,K,175,180,5,NSLEEN,0
5c0x,K,207,244,37,LDRLENVLAIGIAGAHRVRDLMDEELRKHAQKRVSNAS,0
5c0x,K,18,26,8,PPEVLARIS,0
5c0x,K,26,36,10,SPELSLQRHLS,0
5c0x,K,60,64,4,SRYAD,0
5c0x,K,123,125,2,IIA,0
5c0x,K,145,162,17,TDEEMTISQKLHDSILHS,0
5c0x,K,226,239,13,VFDLCWNSLMYALQ,0
5c0x,K,303,307,4,DPECQ,0
5c0x,K,335,343,8,DTEAEETSI,0
5c0x,K,370,392,22,TPEMIKRSLLLSRVRADDLSTRF,0
5c0x,K,60,78,18,TTREKVLEDKLRAVLTPLI,0
5c0x,K,79,83,4,TRHCY,0
5c0x,K,105,124,19,SLRELSCCINAAFLALVDAG,0
5c0x,K,150,156,6,TAEQLKI,0
5c0x,K,187,218,31,NEDQLFSLLELGEQKCQELVTNIRRIIQDNIS,0
5c0x,K,4,17,13,SVAEKSYLYDSLAS,0
5c0x,K,89,103,14,ALVVETITSLLNKVL,0
5c0x,K,110,115,5,DSSKLQ,0
5c0x,K,137,150,13,PISLISFAIYSALN,0
5c0x,K,202,209,7,AANESEVA,0
5c0x,K,240,263,23,KPHLLKQGLAMVEKYAPDVVRSLE,0
5c0x,K,106,122,16,NTNELKEVSSFLMGIFN,0
5c0x,K,126,130,4,NLSRY,0
5c0x,K,163,167,4,SQISS,0
5c0x,K,168,184,16,LIPHCITSITLALADAG,0
5c0x,K,205,208,3,KNGE,0
5c0x,K,222,248,26,DLLECLDRCKEQYNRYRDLMISCLMNQ,0
5c0x,K,159,169,10,NLNFARQLLFN,0
5c0x,K,173,180,7,PLLKVLAA,0
5c0x,K,200,218,18,ELSNTLACYRTIMECCQKN,0
5c0x,K,221,235,14,AAFKDIAKRQFKEIL,0
5c0x,K,152,158,6,SESDELQ,0
5c0x,K,158,163,5,QMRSFL,0
5c0x,K,203,207,4,PSSLI,0
5c0x,K,237,243,6,SQMDLAR,0
5c0x,K,290,310,20,SNNIRQAICRYANVIKALAFC,0
5c0x,K,315,326,11,TQQRIVSAYEAS,0
5c0x,K,327,329,2,MVY,0
5c0x,K,331,335,4,NVGEL,0
5c0x,K,337,356,19,EKNVMESIGSDILTAEKMRG,0
5c0x,K,208,210,2,QDV,0
5c0x,K,219,223,4,KVIEC,0
5c0x,K,54,58,4,KCPQI,0
5c0x,K,91,98,7,DTNVVLQA,0
5c0x,K,115,125,10,QIVLDEVRNKS,0
5c0x,K,125,138,13,SYPVYTRLRTLCRD,0
5c0x,K,165,185,20,TINDRNNRAIRKTCQWYSEHL,0
5c0x,K,186,188,2,KPY,0
5c0x,K,199,208,9,RLNREAATKE,0
5c0x,K,217,223,6,SLVQYIE,0
5c0x,K,227,232,5,NADDIR,0
5c0x,K,233,235,2,DSI,0
5c0x,K,260,270,10,STARVMGGLKN,0
5c0x,K,303,308,5,GQKNLN,0
5c0x,K,322,326,4,PQSEW,0
5c0x,K,366,384,18,SDKQRRLLAKDAMIAQRSK,0
5c0x,K,476,488,12,SAQAETEALLLEH,0
5c0x,K,496,501,5,SKKVLE,0
5c0x,K,506,510,4,EGHDW,0
5c0x,K,518,525,7,DPEAVSKD,0
5c0x,K,526,531,5,PLLTKR,0
5c0x,K,573,576,3,VTHF,0
5c0x,K,581,591,10,TALDAEGAARG,0
5c0x,K,605,610,5,PMLLGT,0
5c0x,K,653,664,11,SYEQAQLRIDDK,0
5c0x,K,668,692,24,DELTMGMRALLKLSVKLKQKRLEAG,0
5c0x,K,721,746,25,LATNSLVEEFMLLANISVARKIYDAF,0
5c0x,K,759,773,14,PSTNFEILNEMLNTR,0
5c0x,K,782,792,10,SSKALADSLDR,0
5c0x,K,799,810,11,PYFNTLVRIMST,0
5c0x,K,825,830,5,SYPDFR,0
5c0x,K,848,862,14,RYCDVVAHRQLAGAI,0
5c0x,K,868,872,4,SLTHR,0
5c0x,K,873,907,34,DKNKMDMICRNINRKHRNAQFAGRASIEYYVGQVM,0
5c0x,K,941,945,4,LDNLT,0
5c0x,K,161,166,5,PLSESL,0
5c0x,K,183,190,7,YEYEIDHQ,0
5c0x,K,207,211,4,SWDDS,0
5c0x,K,218,230,12,TSTELESMLEDLK,0
5c0x,K,273,276,3,NLHI,0
5c0x,K,277,282,5,LNEVFT,0
5c0x,K,293,305,12,AFMNIIWLQRDLG,0
5c0x,K,314,322,8,TYHASKAIG,0
5c0x,K,327,336,9,SLAYLLENFA,0
5c0x,K,342,347,5,KKYQLA,0
5c0x,K,355,383,28,SKPMTAYARADTHFLLNIYDQLRNKLIES,0
5c0x,K,385,399,14,KLAGVLYESRNVAKR,0
5c0x,K,403,407,4,YSKYR,0
5c0x,K,533,537,4,LLETI,0
5c0x,K,538,557,19,SVPQIRDVMERFSVLCNSNI,0
5c0x,K,595,615,20,KTEDIRIRAQNFKSALANLED,0
4ol9,A,11,25,14,GAVGTTVAALLHKAG,0
4ol9,A,58,62,4,SPREV,0
4ol9,A,74,76,2,KAT,0
4ol9,A,77,89,12,QNDAARPWLTRLC,0
4ol9,A,103,109,6,EQVEQVQ,0
4ol9,A,110,112,2,PHC,0
4ol9,A,147,160,13,GPAAEQFAGLLRGA,0
4ol9,A,169,191,22,DFTTAAWRKLLVNALAGFMVLSG,0
4ol9,A,193,198,5,RSAMFR,0
4ol9,A,199,220,21,RDDVAALSRRYVAECLAVARAE,0
4ol9,A,227,239,12,DVVDEVVRLVRSA,0
4ol9,A,245,253,8,TSMLADRAA,0
4ol9,A,258,263,5,EWDLRN,0
4ol9,A,263,271,8,NGVIVRKAR,0
4ol9,A,272,274,2,AHG,0
4ol9,A,277,293,16,TPISDVLVPLLAAASDG,0
5njn,A,104,106,2,NEQ,0
5njn,A,115,119,4,SESES,0
2dpe,A,10,14,4,WSQYR,0
2dpe,A,15,19,4,EGDGS,0
2dpe,A,21,25,4,FPDAI,0
2dpe,A,51,61,10,NDVTLYDTLNT,0
2dpe,A,62,65,3,LKNR,0
2dpe,A,81,91,10,GPERFSAIASK,0
2dpe,A,91,110,19,KTQSRRTFIKSVPPFLRTHG,0
2dpe,A,125,144,19,DKRHLTTLVKEMKAEFIREA,0
2dpe,A,145,147,2,QAG,0
2dpe,A,160,168,8,GKIAIDRGY,0
2dpe,A,169,177,8,DIAQISRHL,0
2dpe,A,215,226,11,NADYAVSYMLRL,0
2dpe,A,229,231,2,PAN,0
2dpe,A,275,282,7,YYEICDFL,0
2dpe,A,309,323,14,DQESVKNKARYLKNR,0
2dpe,A,332,336,4,ALDLD,0
2dpe,A,349,361,12,FPLTSAVKDVLAE,0
1nk9,A,308,313,5,TEEMLA,0
1nk9,A,347,352,5,RPETAL,0
1nk9,A,354,363,9,DPQFVAWLGD,0
1nk9,A,372,382,10,DSKRAAVALKW,0
1nk9,A,394,402,8,LLLAAYLLD,0
1nk9,A,403,406,3,PAQG,0
1nk9,A,409,416,7,DVAAAAKM,0
1nk9,A,424,430,6,PDEAVYG,0
1nk9,A,431,435,4,KGAKR,0
1nk9,A,439,468,29,DEPVLAEHLVRKAAAIWELERPFLDELRRN,0
1nk9,A,470,477,7,QDRLLVEL,0
1nk9,A,477,492,15,LEQPLSSILAEMEFAG,0
1nk9,A,496,523,27,DTKRLEQMGKELAEQLGTVEQRIYELAG,0
1nk9,A,530,540,10,SPKQLGVILFE,0
1nk9,A,557,565,8,SADVLEKLA,0
1nk9,A,566,568,2,PYH,0
1nk9,A,569,588,19,EIVENILHYRQLGKLQSTYI,0
1nk9,A,588,595,7,IEGLLKVV,0
1nk9,A,630,635,5,LEEGRK,0
1nk9,A,636,638,2,IRQ,0
1nk9,A,656,667,11,QIELRVLAHIAE,0
1nk9,A,668,677,9,DDNLMEAFRR,0
1nk9,A,680,690,10,DIHTKTAMDIF,0
1nk9,A,693,697,4,SEDEV,0
1nk9,A,698,714,16,TPNMRRQAKAVNFGIVY,0
1nk9,A,717,725,8,SDYGLAQNL,0
1nk9,A,728,743,15,SRKEAAEFIERYFESF,0
1nk9,A,743,761,18,FPGVKRYMENIVQEAKQKG,0
1nk9,A,774,778,4,PDITS,0
1nk9,A,780,818,38,NFNVRSFAERMAMNTPIQGSAADIIKKAMIDLNARLKEE,0
1nk9,A,840,854,14,EMERLCRLVPEVMEQ,0
4gf4,A,65,69,4,LQKIL,0
4gf4,A,126,128,2,FDG,0
4gf4,A,138,142,4,GEGED,0
5a4l,D,136,140,4,YNDGY,0
5a4l,D,193,212,19,KKAFLNQAQIEVRLLELMNK,0
5a4l,D,244,252,8,NLYDLLRNT,0
5a4l,D,258,277,19,SLNLTRKFAQQMCTALLFLA,0
5a4l,D,289,291,2,KPE,0
5a4l,D,324,328,4,SRFYR,0
5a4l,D,329,334,5,SPEVLL,0
5a4l,D,340,357,17,LAIDMWSLGCILVEMHTG,0
5a4l,D,365,378,13,NEVDQMNKIVEVLG,0
5a4l,D,381,386,5,PAHILD,0
5a4l,D,390,393,3,KARK,0
5a4l,D,422,427,5,KLHNIL,0
5a4l,D,433,437,4,GPGGR,0
5a4l,D,445,460,15,TVADYLKFKDLILRML,0
5a4l,D,469,474,5,QPYYAL,0
5a4l,D,476,480,4,HSFFK,0
5a4l,D,244,251,7,NLYDLLRN,0
5a4l,D,329,335,6,SPEVLLG,0
5a4l,D,365,377,12,NEVDQMNKIVEVL,0
5a4l,D,381,388,7,PAHILDQA,0
5a4l,D,390,394,4,KARKF,0
5a4l,D,422,428,6,KLHNILG,0
5a4l,D,475,480,5,QHSFFK,0
5a4l,D,215,220,5,TEMKYY,0
5a4l,D,258,276,18,SLNLTRKFAQQMCTALLFL,0
5a4l,D,390,395,5,KARKFF,0
5a4l,D,447,460,13,ADYLKFKDLILRML,0
5a4l,D,469,475,6,QPYYALQ,0
5a4l,D,217,220,3,MKYY,0
2rdz,D,41,46,5,KNETFA,0
2rdz,D,49,58,9,HPDQYLSWKA,0
2rdz,D,59,62,3,TSEQ,0
2rdz,D,67,72,5,DALAED,0
2rdz,D,73,79,6,PRLVILW,0
2rdz,D,82,86,4,YPFSR,0
2rdz,D,93,95,2,GHA,0
2rdz,D,96,104,8,FAVTDVRET,0
2rdz,D,105,108,3,LRTG,0
2rdz,D,119,124,5,PMACWS,0
2rdz,D,128,138,10,PDVARLIQKDG,0
2rdz,D,138,144,6,GEDGYFH,0
2rdz,D,146,151,5,KWARGG,0
2rdz,D,159,164,5,GCADCH,0
2rdz,D,168,173,5,SPEFAK,0
2rdz,D,182,192,10,RPYAARAMEAI,0
2rdz,D,195,199,4,PFEKA,0
2rdz,D,200,210,10,GRFDQQSMVCG,0
2rdz,D,234,245,11,KVENMEQYYDKI,0
2rdz,D,265,273,8,PEYETWTAG,0
2rdz,D,273,278,5,GIHGKN,0
2rdz,D,281,287,6,TCIDCHM,0
2rdz,D,305,317,12,NPFDNFAQTCANC,0
2rdz,D,321,360,39,DKAALQKVVAERKQSINDLKIKVEDQLVHAHFEAKAALDA,0
2rdz,D,363,386,23,TEAEMKPIQDDIRHAQWRWDLAIA,0
2rdz,D,389,394,5,GIHMHA,0
2rdz,D,394,423,29,APEEGLRMLGTAMDKAADARTKLARLLATK,0
2rdz,D,436,444,8,TKEKAQQAI,0
2rdz,D,447,473,26,NMEQIKAEKQDFIKTVIPQWEEQARKN,0
2rdz,D,128,144,16,PDVARLIQKDGEDGYFH,0
3n0n,A,15,19,4,HWHKD,0
3n0n,A,20,25,5,FPIAKG,0
3n0n,A,127,129,2,KYG,0
3n0n,A,130,135,5,DFGKAV,0
3n0n,A,154,156,2,KPG,0
3n0n,A,157,164,7,LQKVVDVL,0
3n0n,A,165,168,3,DSIK,0
3n0n,A,180,185,5,DPRGLL,0
3n0n,A,219,227,8,SSEQVLKFR,0
2gd0,D,17,29,12,GPGPHAAMILGDL,0
2gd0,D,48,52,4,DAMLR,0
2gd0,D,63,76,13,SDQGLELALKLIAK,0
2gd0,D,87,92,5,GVTERL,0
2gd0,D,95,103,8,GPEECAKVN,0
2gd0,D,126,133,7,HDINYISL,0
2gd0,D,136,140,4,ILHAI,0
2gd0,D,160,179,19,GSMFLLVGILAALWERQSSG,0
2gd0,D,188,196,8,MVDGSSVLI,0
2gd0,D,196,205,9,IQMMWAMRAT,0
2gd0,D,241,253,12,EPQFYAAMLAGLG,0
2gd0,D,255,259,4,DAAEL,0
2gd0,D,264,266,2,DRA,0
2gd0,D,267,281,14,RWPELRALLTEAFAS,0
2gd0,D,283,291,8,DRDHWGAVF,0
2gd0,D,303,309,6,AFGEVHN,0
2gd0,D,310,316,6,EPHIIER,0
2gd0,D,350,359,9,DIEAVLTDWD,0
2gd0,D,63,75,12,SDQGLELALKLIA,0
2gd0,D,87,93,6,GVTERLG,0
2gd0,D,126,131,5,HDINYI,0
2gd0,D,267,280,13,RWPELRALLTEAFA,0
2gd0,D,310,317,7,EPHIIERN,0
2gd0,D,241,252,11,EPQFYAAMLAGL,0
1wod,A,11,28,17,ASLTNAMQDIATQFKKEK,0
1wod,A,39,48,9,SSTLARQIEA,0
1wod,A,60,68,8,QKWMDYAVD,0
1wod,A,74,76,2,TAT,0
1wod,A,106,110,4,WTSLL,0
1wod,A,124,135,11,PAGIYAKEALQK,0
1wod,A,139,145,6,WDTLSPK,0
1wod,A,152,160,8,VRGALALVE,0
1wod,A,171,176,5,GSDAVA,0
1wod,A,188,190,2,EDS,0
1wod,A,207,217,10,ATVKAFYDYLK,0
1wod,A,219,227,8,PQAAEIFKR,0
1o03,A,15,31,16,DTAEYHFRAWKALAEEI,0
1o03,A,37,42,5,DRQFNE,0
1o03,A,48,58,10,SREDSLQKILD,0
1o03,A,65,84,19,SAEEFKELAKRKNDNYVKMI,0
1o03,A,88,92,4,SPADV,0
1o03,A,95,106,11,GILQLLKDLRSN,0
1o03,A,118,126,8,NGPFLLERM,0
1o03,A,128,132,4,LTGYF,0
1o03,A,148,158,10,PDIFIAAAHAV,0
1o03,A,161,163,2,APS,0
1o03,A,171,182,11,SQAGIQAIKDSG,0
1o03,A,190,195,5,RPEDLG,0
1o03,A,203,207,4,DTSHY,0
1o03,A,208,217,9,TLEFLKEVWL,0
4g0k,B,63,76,13,CPWAHRTLIMRKLK,0
4g0k,B,78,80,2,LEP,0
4g0k,B,115,123,8,FLYQLYLHA,0
4g0k,B,148,159,11,ESAEIIRMFNTA,0
4g0k,B,160,164,4,FDALG,0
4g0k,B,172,174,2,PPA,0
4g0k,B,175,190,15,LQTKIDELNGWIYDTV,0
4g0k,B,192,199,7,NGVYKAGF,0
4g0k,B,202,224,22,SQEAYDEAVAKVFESLARLEQIL,0
4g0k,B,236,250,14,TEADIRLWTTLVRFD,0
4g0k,B,252,257,5,VYVTHF,0
4g0k,B,263,266,3,RISD,0
4g0k,B,267,279,12,YLNLYGFLRDIYQ,0
4g0k,B,283,287,4,IAETV,0
4g0k,B,288,300,12,NFDHIRNHYFRSH,0
4g0k,B,322,327,5,GRDVRF,0
4g0k,B,115,122,7,FLYQLYLH,0
4g0k,B,175,189,14,LQTKIDELNGWIYDT,0
4g0k,B,192,200,8,NGVYKAGFA,0
4g0k,B,267,280,13,YLNLYGFLRDIYQM,0
4coc,C,149,153,4,SILDI,0
4coc,C,160,175,15,PFRDYVDRFLKTLRAE,0
4coc,C,178,193,15,SQEVKNWMTETLLVQN,0
4coc,C,195,206,11,NPDCKTILKALG,0
4coc,C,210,219,9,TLEEMMTACQ,0
4coc,C,160,173,13,PFRDYVDRFLKTLR,0
4coc,C,178,194,16,SQEVKNWMTETLLVQNA,0
4coc,C,210,220,10,TLEEMMTACQG,0
4coc,C,195,205,10,NPDCKTILKAL,0
4coc,C,210,218,8,TLEEMMTAC,0
4i2h,A,153,157,4,YACQR,0
4i2h,A,165,182,17,NQLFTDALDILAENDELR,0
4i2h,A,184,201,17,NEGSCLAFMRASSVLKSL,0
4i2h,A,207,212,5,SMKDTE,0
4i2h,A,218,232,14,GDKVKSIIEGIIEDG,0
4i2h,A,234,243,9,SSEAKAVLND,0
4i2h,A,243,254,11,DERYKSFKLFTS,0
4i2h,A,259,269,10,GLKTAEKWFRM,0
4i2h,A,273,279,6,TLSKIQS,0
4i2h,A,286,295,9,TQMQKAGFLY,0
4i2h,A,295,301,6,YYEDLVS,0
4i2h,A,305,323,18,RPEAEAVSMLVKEAVVTFL,0
4i2h,A,331,336,5,TGGFRR,0
4i2h,A,354,373,19,TEDEEQQLLHKVTDFWKQQG,0
4i2h,A,413,415,2,GRV,0
4i2h,A,439,441,2,PYD,0
4i2h,A,442,452,10,RRAFALLGWTG,0
4i2h,A,453,469,16,SRQFERDLRRYATHERK,0
4i2h,A,490,499,9,SEEEIFAHLG,0
4i2h,A,504,508,4,EPWER,0
3cq1,A,5,16,11,NPLEAQAWALLE,0
3cq1,A,58,70,12,DSLGEAVRQALSR,0
3cq1,A,88,92,4,TLARL,0
3cq1,A,94,98,4,EKARR,0
1n27,A,59,61,2,PKD,0
1n27,A,65,68,3,YKEY,0
1n27,A,81,90,9,FNEGLWEIEN,0
4tsz,P,7,19,12,REALLKPLQLVAG,0
4tsz,P,27,30,3,LPVL,0
4tsz,P,72,82,10,ARKLMDICKSL,0
4tsz,P,112,116,4,PANDF,0
4tsz,P,132,141,9,QSKLRRLIDR,0
4tsz,P,142,146,4,TSFAM,0
4tsz,P,152,155,3,RYYL,0
4tsz,P,198,208,10,RKGILELARLL,0
4tsz,P,244,248,4,DYERV,0
4tsz,P,261,273,12,RQQLREAFSRTAI,0
4tsz,P,322,330,8,VSYLLDVLG,0
4tsz,P,244,249,5,DYERVL,0
5nde,B,82,98,16,ENLGTQTLMDWVAKTMK,0
5nde,B,110,115,5,HLDGTG,0
5nde,B,116,123,7,GNEIYKKM,0
5nde,B,131,141,10,DLTKQLRLEEN,0
5nde,B,144,150,6,DRIKAAE,0
5nde,B,154,163,9,NEDLKRRILS,0
5nde,B,174,178,4,DLKQG,0
5nde,B,222,224,2,CMI,0
5nde,B,242,249,7,AWPDSARR,0
5nde,B,298,315,17,PEMVNKTIKVAEKAVGEM,0
5nde,B,154,164,10,NEDLKRRILSS,0
5nde,B,250,253,3,LKKF,0
5nde,B,298,316,18,PEMVNKTIKVAEKAVGEMR,0
1pgv,A,223,233,10,DVESCINRLRE,0
1pgv,A,250,262,12,SKERIRSLIEAAC,0
1pgv,A,278,283,5,SDSEAR,0
1pgv,A,284,292,8,GLIELIETS,0
1pgv,A,306,317,11,TPELLARLLRST,0
1pgv,A,337,351,14,GNQVEMDMMMAIEEN,0
1pgv,A,363,386,23,SMEARHRVSEALERNYERVRLRRL,0
2qdo,D,13,28,15,SFEQEFQMRVMEEQVS,0
2qdo,D,31,62,31,SLQEARELLLQASRLLMMKDNVIRSLVKRAAR,0
2qdo,D,31,59,28,SLQEARELLLQASRLLMMKDNVIRSLVKR,0
3ugh,B,11,18,7,SNAQLSWQ,0
3ugh,B,84,88,4,QWYDM,0
3ugh,B,267,271,4,NPEED,0
3ugh,B,308,316,8,SEVADREKG,0
3ugh,B,343,347,4,EEVES,0
3ugh,B,405,409,4,GGAAE,0
3ugh,B,510,514,4,IYGAA,0
3ugh,B,11,17,6,SNAQLSW,0
3ugh,B,400,404,4,NCTTS,0
188l,A,3,11,8,IFEMLRIDE,0
188l,A,39,50,11,LNAAKSELDKAI,0
188l,A,60,80,20,KDEAEKLFNQDVDAAVRGILR,0
188l,A,82,90,8,AKLKPVYDS,0
188l,A,93,106,13,AVRRAAAINMVFQM,0
188l,A,108,113,5,ETGVAG,0
188l,A,115,123,8,TNSLRMLQQ,0
188l,A,126,134,8,WDEAAVNLA,0
188l,A,137,141,4,RWYNQ,0
188l,A,143,155,12,PNRAKRVITTFRT,0
5w88,A,2,11,9,DDIYKAAVEQ,0
5w88,A,13,28,15,TEEQKNEFKAAFDIFV,0
5w88,A,37,48,11,STKELGKVMRML,0
5w88,A,53,63,10,TPEELQEMIDE,0
5w88,A,73,87,14,DFDEFLVMMVRSMKD,0
5w88,A,149,159,10,SADAMMQALLG,0
1xff,B,12,24,12,VAEILLEGLRRLE,0
1xff,B,25,27,2,YRG,0
1xff,B,50,61,11,KVQMLAQAAEEH,0
1xff,B,103,114,11,NHEPLREELKAR,0
1xff,B,123,137,14,DTEVIAHLVNWELKQ,0
1xff,B,140,149,9,TLREAVLRAI,0
1xff,B,150,152,2,PQL,0
1xff,B,192,196,4,DQLAL,0
1xff,B,12,22,10,VAEILLEGLRR,0
1xff,B,103,115,12,NHEPLREELKARG,0
1wch,A,2174,2180,6,TNDELAV,0
1wch,A,2193,2210,17,TGANLKSVIRVLRGLLDQ,0
1wch,A,2211,2221,10,GIPSKELENLQ,0
1wch,A,2230,2233,3,LIGQ,0
1wch,A,2234,2239,5,TKENRR,0
1wch,A,2286,2288,2,LPT,0
1wch,A,2289,2300,11,TVGDFWQMIWEQ,0
1wch,A,2384,2399,15,QPDDLLTFISYMRHIH,0
1wch,A,2412,2430,18,IGRSGTLICIDVVLGLISQ,0
1wch,A,2435,2445,10,DISDLVRCMRL,0
1wch,A,2453,2476,23,TEDQYIFCYQVILYVLTRLQAEEE,0
1uxr,A,3,7,4,AGLLE,0
1uxr,A,52,66,14,SREEVERTLDVLFKR,0
1uxr,A,66,73,7,RGRWSARD,0
1uxr,A,75,93,18,PGTERLAVLRKAADIIERN,0
1uxr,A,93,106,13,NLDVFAEVLVMNAG,0
1uxr,A,108,125,17,PKSAAVGEVKAAVDRLRL,0
1uxr,A,126,133,7,AELDLKKI,0
1uxr,A,171,184,13,LFDAVNKITYSFIY,0
1uxr,A,197,211,14,PLPAAMAVKALLDAG,0
1uxr,A,223,226,3,PGKE,0
1uxr,A,227,232,5,AEKIVA,0
1uxr,A,244,256,12,STEVGERVVKVGG,0
1uxr,A,277,291,14,DLDLAADKIARGIYS,0
1uxr,A,292,295,3,YAGQ,0
1uxr,A,307,323,16,RPVYGKLVEEVAKRLSS,0
1uxr,A,341,358,17,SPSAVDEMMAAIEDAVEK,0
1uxr,A,382,387,5,PADRVK,0
1uxr,A,389,394,5,MVLYKR,0
1uxr,A,408,418,10,DLDQAIELANG,0
1uxr,A,431,442,11,DVVKIRRAVRLL,0
1uxr,A,478,482,4,AVEAV,0
2d01,A,10,17,7,DIENTLAK,0
2d01,A,19,25,6,DDGQLDG,0
2d01,A,43,51,8,NAAEGDITG,0
2d01,A,53,58,5,DPKQVI,0
2d01,A,67,71,4,APCTD,0
2d01,A,75,86,11,FYGKFKEGVASG,0
5dz6,A,19,24,5,GLFDEF,0
5dz6,A,24,36,12,FKELTDQADEILG,0
5dz6,A,38,46,8,SIKRLCLEN,0
5dz6,A,47,52,5,PYSNLN,0
5dz6,A,53,77,24,KTQFTQPALYVVNALSYLKKIRDEE,0
5dz6,A,88,97,9,LGEYNALFAA,0
5dz6,A,101,118,17,DFETGLQLVRKRGELMSL,0
5dz6,A,131,142,11,NEEQVAKALKEY,0
5dz6,A,164,176,12,KDEIEKAASLFET,0
5dz6,A,194,196,2,SRY,0
5dz6,A,197,209,12,MNKAKEEFEEFLH,0
5dz6,A,230,232,2,TYE,0
5dz6,A,233,241,8,FMKQTLADQ,0
5dz6,A,242,244,2,INH,0
5dz6,A,248,257,9,WTDSISYLMK,0
5dz6,A,270,285,15,NVLTGLIHRIKKDAEA,0
1wnw,C,7,25,18,GLAVELKQSTAQAHEKAEH,0
1wnw,C,26,34,8,STFMSDLLK,0
1wnw,C,38,67,29,GVAEFTRLQEQAWLFYTALEQAVDAVRASG,0
1wnw,C,74,78,4,DPALN,0
1wnw,C,79,92,13,RAEVLARDLDKLNG,0
1wnw,C,95,100,5,EWRSRI,0
1wnw,C,103,120,17,SPAVIDYVNRLEEIRDNV,0
1wnw,C,121,152,31,DGPALVAHHYVRYLGNLSGGQVIARMMQRHYG,0
1wnw,C,154,162,8,DPEALGFYH,0
1wnw,C,168,183,15,KLKVYKDEYREKLNNL,0
1wnw,C,186,213,27,SDEQREHLLKEATDAFVFNHQVFADLGK,0
1wnw,C,7,16,9,GLAVELKQST,0
1wnw,C,16,25,9,TAQAHEKAEH,0
1wnw,C,38,66,28,GVAEFTRLQEQAWLFYTALEQAVDAVRAS,0
1wnw,C,94,99,5,SEWRSR,0
1wnw,C,186,212,26,SDEQREHLLKEATDAFVFNHQVFADLG,0
1kn0,K,32,43,11,TAEEYQAIQKAL,0
1kn0,K,67,80,13,EGHRVINLANEMFG,0
1kn0,K,134,157,23,SKALSLEKARKEAVTDGLKRALRS,0
1kn0,K,158,163,5,FGNALG,0
1kn0,K,168,177,9,DKDYLRSLNK,0
1kn0,K,187,191,4,DLTKA,0
1kn0,K,197,206,9,EPSVEEARYN,0
1kn0,K,32,45,13,TAEEYQAIQKALRQ,0
1kn0,K,158,167,9,FGNALGNCIL,0
1kn0,K,134,156,22,SKALSLEKARKEAVTDGLKRALR,0
1kn0,K,157,163,6,SFGNALG,0
1kn0,K,164,167,3,NCIL,0
1kn0,K,67,79,12,EGHRVINLANEMF,0
1kn0,K,157,167,10,SFGNALGNCIL,0
2gyi,B,14,19,5,LWTVGW,0
2gyi,B,35,45,10,PVETVQRLAEL,0
2gyi,B,64,81,17,DTERESHIKRFRQALDAT,0
2gyi,B,108,128,20,RDVRRYALRKTIRNIDLAVEL,0
2gyi,B,150,171,21,VRVALDRMKEAFDLLGEYVTSQ,0
2gyi,B,195,204,9,VGHALAFIER,0
2gyi,B,217,223,6,VGHEQMA,0
2gyi,B,227,237,10,FPHGIAQALWA,0
2gyi,B,265,276,11,RAAFWLVDLLES,0
2gyi,B,295,321,26,IDGVWASAAGCMRNYLILKERAAAFRA,0
2gyi,B,324,331,7,EVQEALRA,0
2gyi,B,334,338,4,LDELA,0
2gyi,B,346,352,6,VQELLAD,0
2gyi,B,361,366,5,VDAAAA,0
2gyi,B,371,382,11,FERLDQLAMDHL,0
1rqt,B,3,12,9,TKDQIIEAVA,0
1rqt,B,15,30,15,SVMDVVELISAMEEKF,0
5uy7,A,236,254,18,DSKIQYIAYANLKAAVEKF,0
5uy7,A,295,300,5,NRILTD,0
5uy7,A,304,307,3,PGSI,0
5uy7,A,308,319,11,MKPFTVSLALDL,0
5uy7,A,353,360,7,VGGVIQKS,0
5uy7,A,361,370,9,SNIGATKIAM,0
5uy7,A,373,384,11,RPEEMWNMYTSI,0
5uy7,A,404,408,4,PWKSW,0
5uy7,A,409,418,9,RRIEQATMSY,0
5uy7,A,426,438,12,LFQLARAYTAIAH,0
5uy7,A,463,477,14,TPTTAREVRTMLETV,0
5uy7,A,484,488,4,SPDAA,0
5uy7,A,544,563,19,GGQVSGPVFSAIAGDTMRAL,0
5iv9,B,3,8,5,LATQCM,0
5iv9,B,271,278,7,DKVYEDDH,0
5iv9,B,314,319,5,DYFNDF,0
5iv9,B,511,515,4,TGLFR,0
5iv9,B,633,641,8,SPEYIQATL,0
5iv9,B,30,33,3,PTTM,0
5iv9,B,45,58,13,GPLSRAVRNQLRLN,0
5iv9,B,129,131,2,NPQ,0
5iv9,B,132,157,25,AALAKDAEQDMIIQEMYDKAAEQLIR,0
5iv9,B,158,166,8,KLPSVQVAD,0
5e2y,F,65,72,7,SVAGWLLG,0
5e2y,F,73,80,7,NPMCDEFL,0
5e2y,F,104,113,9,DYEELKHLLS,0
5e2y,F,125,127,2,NSW,0
5e2y,F,187,196,9,DATEQTRLYQ,0
5e2y,F,37,57,20,DKESTQKAIDGVTNKVNSIID,0
5e2y,F,58,60,2,KMN,0
5e2y,F,74,127,53,ERRIENLNKKMEDGFLDVWTYNAELLVLMENERTLDFHDSNVKNLYDKVRLQLR,0
5e2y,F,147,154,7,ECMESVRN,0
5e2y,F,159,161,2,YPQ,0
5e2y,F,162,174,12,YSEEARLKREEIS,0
2vg4,D,77,84,7,GNGRWATQ,0
2vg4,D,88,93,5,ARTEGH,0
2vg4,D,95,111,16,MGEAVVIDIACGAIELG,0
2vg4,D,123,127,4,ENWKR,0
2vg4,D,128,154,26,SPEEVRFLMGFNRDVVRRRRDTLKKLG,0
2vg4,D,167,182,15,WRSVINELAVAEEMTK,0
2vg4,D,196,214,18,GGRTEITEATREIAREVAA,0
2vg4,D,223,229,6,TESTIAR,0
2vg4,D,270,274,4,LWPDY,0
2vg4,D,275,289,14,DRRDLWAACEEYASR,0
2vg4,D,88,96,8,ARTEGHKMG,0
2vg4,D,96,109,13,GEAVVIDIACGAIE,0
2vg4,D,130,153,23,EEVRFLMGFNRDVVRRRRDTLKKL,0
2vg4,D,167,181,14,WRSVINELAVAEEMT,0
2vg4,D,218,222,4,NPERI,0
2vg4,D,275,288,13,DRRDLWAACEEYAS,0
2vg4,D,63,67,4,PADRL,0
2vg4,D,77,85,8,GNGRWATQR,0
2vg4,D,89,96,7,RTEGHKMG,0
2vg4,D,96,111,15,GEAVVIDIACGAIELG,0
2vg4,D,121,126,5,STENWK,0
2vg4,D,223,230,7,TESTIARH,0
2vg4,D,97,111,14,EAVVIDIACGAIELG,0
2vg4,D,128,145,17,SPEEVRFLMGFNRDVVRR,0
2vg4,D,146,154,8,RRDTLKKLG,0
2vg4,D,196,215,19,GGRTEITEATREIAREVAAG,0
2vg4,D,218,223,5,NPERIT,0
2vg4,D,224,229,5,ESTIAR,0
2vg4,D,275,287,12,DRRDLWAACEEYA,0
3sir,D,44,56,12,VDCENLTRVLKQL,0
3sir,D,67,80,13,RYKDILRTIEYSAS,0
3sir,D,106,114,8,DTQYKLDNI,0
3sir,D,115,119,4,WSFFT,0
3sir,D,123,127,4,CPSLA,0
3sir,D,192,206,14,SWFMQSLCAELAANG,0
3sir,D,210,224,14,DILTLLTFVCQRVAV,0
3sir,D,43,56,13,NVDCENLTRVLKQL,0
3sir,D,210,225,15,DILTLLTFVCQRVAVD,0
3sir,D,67,79,12,RYKDILRTIEYSA,0
3sir,D,69,80,11,KDILRTIEYSAS,0
1eeo,A,2,14,12,EMEKEFEQIDKSG,0
1eeo,A,15,27,12,SWAAIYQDIRHEA,0
1eeo,A,37,44,7,LPKNKNRN,0
1eeo,A,91,102,11,TCGHFWEMVWEQ,0
1eeo,A,187,201,14,SPASFLNFLFKVRES,0
1eeo,A,219,238,19,IGRSGTFCLADTCLLLMDKR,0
1eeo,A,240,244,4,DPSSV,0
1eeo,A,245,254,9,DIKKVLLEMR,0
1eeo,A,263,282,19,TADQLRFSYLAVIEGAKFIM,0
1eeo,A,286,296,10,SVQDQWKELSH,0
3v1o,A,557,573,16,SAQRAELIALTQALKMA,0
3v1o,A,584,593,9,SRYAFATAHV,0
3v1o,A,593,601,8,VHGEIYRRR,0
3v1o,A,613,624,11,NKNEILALLKAL,0
3v1o,A,643,666,23,SAEARGNRMADQAAREAAMKAVLE,0
5ldm,B,14,29,15,PAEIREQIIHWRAKHF,0
5ldm,B,30,34,4,PPEAG,0
5ldm,B,38,42,4,AADNL,0
5ldm,B,53,66,13,SAEKEKALSLLAGR,0
5ldm,B,96,113,17,PRGLIQLANMLRSQAARS,0
5ldm,B,53,65,12,SAEKEKALSLLAG,0
5ldm,B,96,111,15,PRGLIQLANMLRSQAA,0
5ldm,B,112,114,2,RSG,0
4e9c,A,373,387,14,HLSDMLQQLHSVNAS,0
4e9c,A,388,392,4,KPSER,0
4e9c,A,396,401,5,RQEEAE,0
4e9c,A,402,406,4,DPACI,0
4e9c,A,466,468,2,SSH,0
4e9c,A,469,471,2,PNS,0
4e9c,A,472,490,18,LMKKITLLKYFRNYMSEHL,0
4e9c,A,564,571,7,LSLLEEYG,0
4e9c,A,573,593,20,CKELASRLRYARTMVDKLLSS,0
5e4b,B,30,39,9,TIDKVWSIVG,0
5e4b,B,40,47,7,DYVRVDNW,0
5e4b,B,94,96,2,AAA,0
5e4b,B,110,114,4,GFSLM,0
5e4b,B,127,131,4,PEEDG,0
5e4b,B,149,173,24,TEQKCIEIVFPLYTTALKDLCTHLS,0
5e4b,B,175,177,2,PES,0
5d4b,B,153,157,4,YACQR,0
5d4b,B,165,182,17,NQLFTDALDILAENDELR,0
5d4b,B,185,201,16,EGSCLAFMRASSVLKSL,0
5d4b,B,207,212,5,SMKDTE,0
5d4b,B,218,232,14,GDKVKSIIEGIIEDG,0
5d4b,B,234,243,9,SSEAKAVLND,0
5d4b,B,243,254,11,DERYKSFKLFTS,0
5d4b,B,259,269,10,GLKTAEKWFRM,0
5d4b,B,273,280,7,TLSKIQSD,0
5d4b,B,286,295,9,TQMQKAGFLY,0
5d4b,B,295,301,6,YYEDLVS,0
5d4b,B,305,323,18,RPEAEAVSMLVKEAVVTFL,0
5d4b,B,331,336,5,TGGFRR,0
5d4b,B,354,372,18,TEDEEQQLLHKVTDFWKQQ,0
5d4b,B,413,415,2,GRV,0
5d4b,B,439,441,2,PYD,0
5d4b,B,442,452,10,RRAFALLGWTG,0
5d4b,B,453,469,16,SRQFERDLRRYATHERK,0
5d4b,B,490,499,9,SEEEIFAHLG,0
5d4b,B,504,508,4,EPWER,0
5d4b,B,184,201,17,NEGSCLAFMRASSVLKSL,0
5d4b,B,332,336,4,GGFRR,0
5d4b,B,453,467,14,SRQFERDLRRYATHE,0
1gky,A,13,25,12,GKSTLLKKLFAEY,0
1gky,A,54,64,10,SVDEFKSMIKN,0
1gky,A,82,92,10,VASVKQVSKSG,0
1gky,A,100,109,9,DMQGVKSVKA,0
1gky,A,110,114,4,IPELN,0
1gky,A,124,136,12,SVEDLKKRLEGRG,0
1gky,A,139,158,19,TEESINKRLSAAQAELAYAE,0
1gky,A,170,184,14,DLDKAYKELKDFIFA,0
1bbr,I,14,13,-1,,0
1bbr,I,55,58,3,AAHC,0
1bbr,I,60,59,-1,,0
1bbr,I,60,62,2,TVD,0
1bbr,I,125,130,5,DKQTLL,0
1bbr,I,164,172,8,ERPVCKAST,0
1bbr,I,185,185,0,K,0
1bbr,I,231,243,12,VFRLKKWIQKVID,0
1bbr,I,1,0,-1,,0
1bbr,I,7,11,4,FEKKQ,0
1bbr,I,164,170,6,ERPVCKA,0
1bbr,I,309,314,5,DFLAEG,0
3aut,B,2,6,4,YTDLK,0
3aut,B,17,30,13,TGLGRAMAVRFGQE,0
3aut,B,41,56,15,NEEEALDAKKEVEEAG,0
3aut,B,68,84,16,KEEDVVNLVQTAIKEFG,0
3aut,B,100,104,4,PSHEL,0
3aut,B,105,117,12,SLDNWNKVIDTNL,0
3aut,B,117,134,17,LTGAFLGSREAIKYFVEN,0
3aut,B,145,149,4,SVHEM,0
3aut,B,155,177,22,FVHYAASKGGMKLMTETLALEYA,0
3aut,B,178,180,2,PKG,0
3aut,B,193,202,9,TPINAEKFAD,0
3aut,B,202,212,10,DPVQRADVESM,0
3aut,B,220,233,13,KPEEVAAVAAFLAS,0
3aut,B,234,237,3,SQAS,0
3aut,B,249,260,11,GMTKYPSFQAGR,0
3aut,B,41,55,14,NEEEALDAKKEVEEA,0
3aut,B,202,211,9,DPVQRADVES,0
3vv9,D,34,39,5,GHTQLN,0
3vv9,D,43,50,7,FLETVPVV,0
3vv9,D,54,58,4,VSDES,0
3vv9,D,66,71,5,SLPDIE,0
3vv9,D,82,103,21,GLVDTLAYRSVRTCRWLFDTFS,0
3vv9,D,111,127,16,TESKVISRCLFLETVAG,0
3vv9,D,128,145,17,VPGMVGGMLRHLSSLRYM,0
3vv9,D,151,173,22,WINTLLVEAENERMHLMTFIELR,0
3vv9,D,176,201,25,GLPLRVSIIITQAIMYLFLLVAYVIS,0
3vv9,D,201,230,29,SPRFVHRFVGYLEEEAVITYTGVMRAIDEG,0
3vv9,D,240,247,7,PEVARVYW,0
3vv9,D,254,282,28,TFRDLINVIRADEAEHRVVNHTFADMHEK,0
3vv9,D,289,294,5,NPFVVL,0
3vv9,D,53,57,4,RVSDE,0
3vv9,D,128,144,16,VPGMVGGMLRHLSSLRY,0
3vv9,D,151,171,20,WINTLLVEAENERMHLMTFIE,0
3vv9,D,201,229,28,SPRFVHRFVGYLEEEAVITYTGVMRAIDE,0
3vv9,D,240,248,8,PEVARVYWN,0
3vv9,D,289,293,4,NPFVV,0
3vv9,D,36,40,4,TQLNR,0
3vv9,D,82,98,16,GLVDTLAYRSVRTCRWL,0
3vv9,D,100,108,8,DTFSLYRFG,0
3vv9,D,150,170,20,GWINTLLVEAENERMHLMTFI,0
3vv9,D,66,72,6,SLPDIEN,0
3vv9,D,82,102,20,GLVDTLAYRSVRTCRWLFDTF,0
3vv9,D,115,127,12,VISRCLFLETVAG,0
3vv9,D,150,173,23,GWINTLLVEAENERMHLMTFIELR,0
3vc5,A,51,64,13,DLAHLEQVRAAAAR,0
3vc5,A,72,85,13,ALHRIYRRVADVVG,0
3vc5,A,100,125,25,SRVKTVDRVFAAFEVACLDIQGKAAG,0
3vc5,A,127,132,5,PVADLL,0
3vc5,A,166,182,16,DPDGIVAQARLLIGEYG,0
3vc5,A,194,209,15,PPEQEAEAIQALRDAF,0
3vc5,A,223,234,11,TVETSIRVGRAL,0
3vc5,A,247,256,9,GIDGMARVAA,0
3vc5,A,270,272,2,TPE,0
3vc5,A,273,281,8,HLPAAVERR,0
3vc5,A,289,294,5,DHHYWG,0
3vc5,A,295,309,14,GLVRSAHIATLCATF,0
3vc5,A,321,334,13,LGISLAAMTHLAAA,0
3vc5,A,345,350,5,HTPWQD,0
3vc5,A,380,394,14,DRDALAVMHEQYERC,0
3vc5,A,400,409,9,DDEGYMRSFD,0
1zzs,B,85,90,5,TLCAQS,0
1zzs,B,121,140,19,PAEQLLSQARDFINQYYSSI,0
1zzs,B,145,163,18,SQAHEERLQEVEAEVASTG,0
1zzs,B,168,183,15,RESELVFGAKQAWRNA,0
1zzs,B,188,195,7,GRIQWGKL,0
1zzs,B,205,222,17,SAQEMFTYICNHIKYATN,0
1zzs,B,223,225,2,RGN,0
1zzs,B,269,279,10,NVEITELCIQH,0
1zzs,B,308,312,4,PPELV,0
1zzs,B,322,329,7,LEWFAALG,0
1zzs,B,360,366,6,MSTEIGT,0
1zzs,B,366,371,5,TRDLCD,0
1zzs,B,377,385,8,ILEDVAVM,0
1zzs,B,391,394,3,TTSS,0
1zzs,B,395,415,20,LWKDKAAVEINLAVLHSFQLA,0
1zzs,B,421,441,20,DHHAATVSFMKHLDNEQKARG,0
1zzs,B,446,451,5,DWAWIV,0
1zzs,B,455,464,9,SGSLTPVFHQ,0
1zzs,B,188,192,4,GRIQW,0
1zzs,B,361,366,5,STEIGT,0
1ytq,A,39,44,5,NLKETG,0
1ytq,A,80,84,4,RWDSW,0
1ytq,A,131,135,4,FHAHG,0
1ytq,A,172,177,5,DSSDFG,0
4zsb,A,97,104,7,SYTEDMRA,0
4zsb,A,122,130,8,DDRLAGLLD,0
4zsb,A,165,170,5,ALRRSL,0
4zsb,A,171,173,2,VKY,0
4zsb,A,175,185,10,SLYTALAEVYD,0
4zsb,A,201,208,7,TPREAGLL,0
3vr2,F,90,99,9,PLDTFEVTQ,0
3vr2,F,213,220,7,QRVIDTFF,0
3vr2,F,237,249,12,GKTVVQHQIAKWS,0
3vr2,F,262,273,11,RGNETDVVNEF,0
3vr2,F,274,276,2,PEL,0
3vr2,F,284,287,3,SLE,0
3vr2,F,299,320,21,PVAAREASIYTGITIAEYFRD,0
3vr2,F,330,345,15,STSRWAEALRESGRL,0
3vr2,F,350,354,4,GDEGY,0
3vr2,F,357,367,10,YLGSRLAEYYE,0
3vr2,F,392,396,4,PSGGD,0
3vr2,F,399,406,7,EPVTQNTL,0
3vr2,F,416,422,6,DSSLAQK,0
3vr2,F,437,450,13,YSTEVGRYDQILQ,0
3vr2,F,452,476,24,DWSDVTEGRILQEEEQLNEIVRL,0
3vr2,F,478,482,4,GIDSL,0
3vr2,F,483,500,17,SDNDRLTLEVAKSIREDY,0
3vr2,F,514,538,24,SREKQFNLKVILTFGKEARKALSL,0
3vr2,F,541,548,7,YFNEIEG,0
3vr2,F,549,558,9,TVAVRERISR,0
3vr2,F,559,562,3,SKYI,0
3vr2,F,563,566,3,PEEE,0
3vr2,F,567,572,5,LAKISS,0
3vr2,F,572,585,13,SINEEIKETIQLIV,0
3vr2,F,262,276,14,RGNETDVVNEFPEL,0
3vr2,F,299,319,20,PVAAREASIYTGITIAEYFRD,0
3vr2,F,330,346,16,STSRWAEALRESGRLE,0
3vr2,F,452,477,25,DWSDVTEGRILQEEEQLNEIVRLV,0
3vr2,F,541,549,8,YFNEIEGT,0
3vr2,F,549,559,10,TVAVRERISRS,0
3vr2,F,560,562,2,KYI,0
3vr2,F,572,584,12,SINEEIKETIQLI,0
3vr2,F,90,98,8,PLDTFEVT,0
3vr2,F,238,249,11,KTVVQHQIAKWS,0
3vr2,F,299,301,2,PVA,0
3vr2,F,302,320,18,AREASIYTGITIAEYFRD,0
3vr2,F,357,368,11,YLGSRLAEYYER,0
3vr2,F,416,421,5,DSSLAQ,0
3vr2,F,452,475,23,DWSDVTEGRILQEEEQLNEIVR,0
3vr2,F,514,537,23,SREKQFNLKVILTFGKEARKALS,0
3vr2,F,558,562,4,RSKYI,0
3vr2,F,573,581,8,INEEIKETI,0
3vr2,F,82,86,4,SEDI,0
3vr2,F,132,137,5,ISAIDH,0
3vr2,F,156,168,12,PHKELAAQIARQA,0
3vr2,F,187,202,15,TFEEAEFFEDFRQTG,0
3vr2,F,203,205,2,AID,0
3vr2,F,217,238,21,PAIERIATPRALTAAEYLAYE,0
3vr2,F,249,264,15,DTNYAEALREISAAR,0
3vr2,F,269,273,4,GRRGY,0
3vr2,F,274,275,1,PG,0
3vr2,F,276,286,10,YLYTNLATLFE,0
3vr2,F,307,310,3,PEDD,0
3vr2,F,313,323,10,HPIPDLTGYIT,0
3vr2,F,330,336,6,TRELYKS,0
3vr2,F,351,356,5,LKDKGT,0
3vr2,F,364,385,21,DHAATNQLFAAYAQGKQAKEL,0
3vr2,F,398,411,13,DKIYAKFAERFENE,0
3vr2,F,422,435,13,TITETLDLGWELLA,0
3vr2,F,445,449,4,IKDDL,0
3vr2,F,64,68,4,NLKNS,0
3vr2,F,187,201,14,TFEEAEFFEDFRQT,0
3vr2,F,202,205,3,GAID,0
3vr2,F,351,355,4,LKDKG,0
3vr2,F,364,389,25,DHAATNQLFAAYAQGKQAKELAVVL,0
3vr2,F,397,412,15,IDKIYAKFAERFENEY,0
3vr2,F,436,437,1,L,0
3vr2,F,438,442,4,PRTEL,0
3vr2,F,156,167,11,PHKELAAQIARQ,0
3vr2,F,173,175,2,SSD,0
3vr2,F,330,335,5,TRELYK,0
3vr2,F,352,356,4,KDKGT,0
3vr2,F,401,411,10,YAKFAERFENE,0
4k1f,E,32,35,3,SSYK,0
4k1f,E,50,62,12,FVCPTEVIAFSDS,0
4k1f,E,62,68,6,SVSRFNE,0
4k1f,E,80,89,9,SEYAHLQWTL,0
4k1f,E,91,95,4,DRKKG,0
4k1f,E,110,116,6,KNIARSY,0
4k1f,E,152,170,18,SVEEVLRLLEAFQFVEKHG,0
4k1f,E,187,195,8,EPNASVEGY,0
4k1f,E,196,199,3,FSKQ,0
4k1f,E,80,90,10,SEYAHLQWTLQ,0
2lf3,A,300,305,5,NRVAMR,0
2lf3,A,308,323,15,GNNEADAALQALAQNG,0
2lf3,A,325,338,13,NMEDLRAALEAYIV,0
2lf3,A,344,354,10,PLDIANALEGV,0
2lf3,A,370,385,15,NPLMNLSSALKRRLDA,0
5cdn,U,14,32,18,ITSEMRESFLDYAMSVIVA,0
5cdn,U,43,56,13,KPVHRRILYGLNEQ,0
5cdn,U,67,78,11,SARIVGDVMGKY,0
5cdn,U,82,95,13,GDSSIYEAMVRMAQ,0
5cdn,U,120,123,3,AMR,0
5cdn,U,132,137,5,TLELLR,0
5cdn,U,165,171,6,PNLLANG,0
5cdn,U,187,201,14,NLTELINGVLSLSKN,0
5cdn,U,205,210,5,SIAELM,0
5cdn,U,227,237,10,KSGIRRAYETG,0
5cdn,U,269,283,14,NKARMIEKIAELVRD,0
5cdn,U,313,325,12,NASVILNNLYKQT,0
5cdn,U,347,390,43,NLKEALVHYLEHQKTVVRRRTQYNLRKAKDRAHILEGLRIALDH,0
5cdn,U,390,400,10,HIDEIISTIRE,0
5cdn,U,403,415,12,TDKVAMESLQQRF,0
5cdn,U,418,427,9,SEKQAQAILD,0
5cdn,U,429,433,4,RLRRL,0
5cdn,U,434,461,27,TGLERDKIEAEYNELLNYISELETILAD,0
5cdn,U,461,481,20,DEEVLLQLVRDELTEIRDRFG,0
5cdn,U,436,447,11,GDSAGGSTKSGR,0
5cdn,U,468,475,7,RLDRILNN,0
5cdn,U,475,486,11,NNEIRQMITAFG,0
5cdn,U,489,493,4,IGGDF,0
5cdn,U,494,498,4,DLAKA,0
5cdn,U,510,528,18,DVDGAHIRTLLLTFFYRFM,0
5cdn,U,528,534,6,MRPLIEA,0
5cdn,U,587,596,9,NADQLWETTM,0
5cdn,U,610,623,13,DAIEADQTFEMLMG,0
5cdn,U,625,637,12,VVENRRQFIEDNA,0
5cdn,U,253,255,2,GGG,0
5cdn,U,582,586,4,GLGEM,0
5cdn,U,316,325,9,VILNNLYKQT,0
5cdn,U,626,636,10,VENRRQFIEDN,0
5xoc,B,280,288,8,NAAVELTRR,0
5xoc,B,317,324,7,SPNCNQRY,0
5xoc,B,345,359,14,NQEFAALLAQSVNQG,0
5xoc,B,359,365,6,GFEAVYQ,0
5xoc,B,366,369,3,LTRM,0
5xoc,B,388,392,4,TVTST,0
5xoc,B,401,412,11,NGPLQWLDKVLT,0
5xoc,B,222,227,5,SFDTDV,0
5xoc,B,243,260,17,CGPCKMIAPILDEIADEY,0
5xoc,B,276,281,5,GTAPKY,0
5xoc,B,306,318,12,SKGQLKEFLDANL,0
5xoc,B,326,331,5,DLDALF,0
5xoc,B,341,344,3,YDVW,0
1glh,A,36,38,2,ANN,0
1glh,A,97,99,2,PAH,0
1glh,A,140,142,2,ASK,0
1glh,A,190,193,3,DDWL,0
3ck1,B,12,16,4,RFKHC,0
3ck1,B,23,42,19,FYPRYFELNDFIEDWFAQA,0
3ck1,B,46,52,6,PFDAHG,0
3ck1,B,126,135,9,PDPVRQAAT,0
3ck1,B,136,137,1,YV,0
3ck1,B,138,142,4,DETLA,0
3zdj,B,28,41,13,QTLEQIKESESQLS,0
3zdj,B,71,86,15,TFKVLLCGAVLARVDA,0
3zdj,B,98,102,4,RQQDL,0
3zdj,B,108,113,5,VTEKHL,0
3zdj,B,119,129,10,VAELCAAAITM,0
3zdj,B,131,142,11,DNTAANLLLATI,0
3zdj,B,143,155,12,GGPAGLTAFLRNI,0
3zdj,B,167,171,4,TELNE,0
3zdj,B,182,196,14,TPAAMAATLRKLLTG,0
3zdj,B,200,213,13,SAASRQQLITWMVA,0
3zdj,B,220,225,5,LLRSVL,0
3zdj,B,271,289,18,SMDERNQQIAEIGAALIEH,0
3zdj,B,108,112,4,VTEKH,0
3zdj,B,131,141,10,DNTAANLLLAT,0
2gcx,A,19,27,8,SPAYRQKLL,0
1h3b,C,10,26,16,AYARTLDRAVEYLLSCQ,0
1h3b,C,40,53,13,VTMEAEYVLLCHIL,0
1h3b,C,57,72,15,DRDRMEKIRRYLLHEQ,0
1h3b,C,87,102,15,DLDTTIEAYVALKYIG,0
1h3b,C,107,119,12,EEPMQKALRFIQS,0
1h3b,C,120,126,6,QGGIESS,0
1h3b,C,127,137,10,RVFTRMWLALV,0
1h3b,C,141,145,4,PWEKV,0
1h3b,C,149,155,6,PPEIMFL,0
1h3b,C,162,166,4,NIYEF,0
1h3b,C,167,184,17,GSWARATVVALSIVMSRQ,0
1h3b,C,190,194,4,PERAR,0
1h3b,C,195,199,4,VPELY,0
1h3b,C,215,231,16,GWIFDALDRALHGYQKL,0
1h3b,C,236,252,16,FRRAAEIRALDWLLERQ,0
1h3b,C,261,275,14,IQPPWFYALIALKIL,0
1h3b,C,280,290,10,HPAFIKGWEGL,0
1h3b,C,309,324,15,SPVWDTGLAVLALRAA,0
1h3b,C,330,342,12,HDRLVKAGEWLLD,0
1h3b,C,349,355,6,GDWAVKR,0
1h3b,C,374,387,13,DVDDTAVVVWALNT,0
1h3b,C,392,411,19,DERRRRDAMTKGFRWIVGMQ,0
1h3b,C,427,432,5,DLPNHI,0
1h3b,C,445,459,14,SEDVTAHVLECFGSF,0
1h3b,C,465,479,14,WKVIRRAVEYLKREQ,0
1h3b,C,492,507,15,NYLYGTGAVVSALKAV,0
1h3b,C,513,526,13,EPYIQKALDWVEQH,0
1h3b,C,536,541,5,DCRSYE,0
1h3b,C,542,546,4,DPAYA,0
1h3b,C,552,566,14,TPSQTAWALMALIAG,0
1h3b,C,571,585,14,SEAARRGVQYLVETQ,0
1h3b,C,611,625,14,MYRHVFPTLALGRYK,0
1h3b,C,280,293,13,HPAFIKGWEGLELY,0
1h3b,C,309,325,16,SPVWDTGLAVLALRAAG,0
1h3b,C,374,386,12,DVDDTAVVVWALN,0
1h3b,C,626,628,2,QAI,0
1h3b,C,349,354,5,GDWAVK,0
4jfy,H,121,126,5,SDSQLK,0
4jfy,H,183,188,5,KADYEK,0
4jfy,H,28,32,4,TFRKF,0
4jfy,H,83,87,4,RAEDT,0
4jfy,H,156,158,2,SGA,0
4jfy,H,201,204,3,KPSN,0
4jfy,H,79,83,4,EPEDF,0
4jfy,H,121,127,6,SDSQLKS,0
4jfy,H,183,187,4,KADYE,0
4jfy,H,73,75,2,NSK,0
4jfy,H,127,131,4,SSKST,0
4jfy,H,187,189,2,SSL,0
6pad,A,24,43,19,SCWAFSAVVTIEGIIKIRTG,0
6pad,A,50,58,8,EQELLDCDR,0
6pad,A,67,78,11,YPWSALQLVAQY,0
6pad,A,117,128,11,NQGALLYSIANQ,0
6pad,A,137,143,6,AGKDFQL,0
5kcz,B,46,54,8,CRTDDHVVS,0
5kcz,B,100,105,5,CRVCKH,0
5kcz,B,165,170,5,PLEKVC,0
5kcz,B,171,173,2,LIG,0
5kcz,B,174,185,11,CGFSTGYGSAVK,0
5kcz,B,201,214,13,GGVGLSVIMGCKAA,0
5kcz,B,225,227,2,NKD,0
5kcz,B,228,235,7,KFAKAKEV,0
5kcz,B,242,246,4,NPQDY,0
5kcz,B,249,258,9,PIQEVLTEMS,0
5kcz,B,271,282,11,RLDTMVTALSCC,0
5kcz,B,305,310,5,PMLLLS,0
5kcz,B,318,322,4,IFGGF,0
5kcz,B,323,337,14,KSKDSVPKLVADFMA,0
5kcz,B,342,344,2,LDP,0
5kcz,B,354,364,10,KINEGFDLLRS,0
5kcz,B,228,236,8,KFAKAKEVG,0
5gix,B,5,15,10,SEVAHRFKDLG,0
5gix,B,15,31,16,GEENFKALVLIAFAQYL,0
5gix,B,35,56,21,PFEDHVKLVNEVTEFAKTCVAD,0
5gix,B,65,75,10,SLHTLFGDKLC,0
5gix,B,79,85,6,TLRETYG,0
5gix,B,86,93,7,EMADCCAK,0
5gix,B,96,105,9,PERNECFLQH,0
5gix,B,119,130,11,EVDVMCTAFHDN,0
5gix,B,130,146,16,NEETFLKKYLYEIARRH,0
5gix,B,150,169,19,YAPELLFFAKRYKAAFTECC,0
5gix,B,173,207,34,DKAACLLPKLDELRDEGKASSAKQRLKCASLQKFG,0
5gix,B,207,223,16,GERAFKAWAVARLSQRF,0
5gix,B,227,248,21,EFAEVSKLVTDLTKVHTECCHG,0
5gix,B,249,267,18,DLLECADDRADLAKYICEN,0
5gix,B,268,271,3,QDSI,0
5gix,B,275,281,6,LKECCEK,0
5gix,B,282,292,10,PLLEKSHCIAE,0
5gix,B,305,310,5,LAADFV,0
5gix,B,314,322,8,DVCKNYAEA,0
5gix,B,322,338,16,AKDVFLGMFLYEYARRH,0
5gix,B,342,361,19,SVVLLLRLAKTYETTLEKCC,0
5gix,B,366,398,32,PHECYAKVFDEFKPLVEEPQNLIKQNCELFEQL,0
5gix,B,399,415,16,GEYKFQNALLVRYTKKV,0
5gix,B,419,438,19,STPTLVEVSRNLGKVGSKCC,0
5gix,B,441,467,26,PEAKRMPCAEDYLSVVLNQLCVLHEKT,0
5gix,B,470,478,8,SDRVTKCCT,0
5gix,B,483,490,7,NRRPCFSA,0
5gix,B,504,508,4,AETFT,0
5gix,B,510,515,5,HADICT,0
5gix,B,517,536,19,SEKERQIKKQTALVELVKHK,0
5gix,B,540,559,19,TKEQLKAVMDDFAAFVEKCC,0
5gix,B,564,583,19,KETCFAEEGKKLVAASQAAL,0
5gix,B,173,206,33,DKAACLLPKLDELRDEGKASSAKQRLKCASLQKF,0
5gix,B,227,246,19,EFAEVSKLVTDLTKVHTECC,0
4hgl,A,82,94,12,QLHLEYRFYKQLG,0
4hgl,A,122,130,8,SLEDLFDLC,0
4hgl,A,135,156,21,SLKTVLMIAIQLISRMEYVHSK,0
4hgl,A,164,166,2,KPE,0
4hgl,A,217,222,5,SINTHL,0
4hgl,A,227,245,18,SRRDDLEALGHMFMYFLRG,0
4hgl,A,256,271,15,TLKERYQKIGDTKRAT,0
4hgl,A,272,277,5,PIEVLC,0
4hgl,A,280,292,12,FPEMATYLRYVRR,0
4hgl,A,300,315,15,DYDYLRKLFTDLFDRK,0
5t1d,L,53,60,7,EALWREAN,0
5t1d,L,64,73,9,DLASMLNRYK,0
5t1d,L,103,107,4,DASKV,0
5t1d,L,123,131,8,SAPLEKQLF,0
5t1d,L,143,148,5,PHSYVF,0
5t1d,L,231,239,8,TFVHYANFH,0
5t1d,L,245,256,11,NLKDMFSRAVTM,0
5t1d,L,257,274,17,TAASYARYVLQKLVLLEM,0
5t1d,L,284,307,23,DTETLTTMFEVSVAFFKVGHAVGE,0
5t1d,L,315,337,22,LRWLAKSFFELTVLKDIIGICYG,0
5t1d,L,345,356,11,SYGLERLAAMLM,0
5t1d,L,360,367,7,KMEELGHL,0
5t1d,L,368,383,15,TTEKQEYALRLATVGY,0
5t1d,L,391,407,16,GLIGGATSVLLSAYNRH,0
5t1d,L,414,434,20,HTVMRETLFIGSHVVLRELRL,0
5t1d,L,439,453,14,QGPNLALYQLLSTAL,0
5t1d,L,455,469,14,SALEIGEVLRGLALG,0
5t1d,L,470,474,4,TESGL,0
5t1d,L,487,494,7,TRDKLLSM,0
5t1d,L,502,517,15,DQAAVSNAVDGFLGRL,0
5t1d,L,529,535,6,LPAYKCV,0
5t1d,L,537,539,2,RLD,0
5t1d,L,636,646,10,SQEVQNSILSS,0
5t1d,L,82,96,14,GLNVVSFFISILKRS,0
5t1d,L,97,100,3,SSAL,0
5t1d,L,102,118,16,GHLRELLTTLETLYGSF,0
5t1d,L,66,71,5,TAEQEY,0
5t1d,L,127,134,7,GCFQACAE,0
5t1d,L,148,155,7,ILPVVTRN,0
5t1d,L,188,190,2,STW,0
5t1d,L,84,88,4,EAEDL,0
5t1d,L,126,132,6,SSEQLTS,0
5t1d,L,188,192,4,KDEYE,0
3w2c,G,129,131,2,ALE,0
3w2c,G,217,226,9,TVYRELQKLS,0
3w2c,G,229,247,18,DEQRTATYITELANALSYC,0
3w2c,G,258,260,2,KPE,0
3w2c,G,297,302,5,PPEMIE,0
3w2c,G,311,325,14,DLWSLGVLCYEFLVG,0
3w2c,G,339,343,4,KRISR,0
3w2c,G,353,364,11,TEGARDLISRLL,0
3w2c,G,382,387,5,WITANS,0
3w2c,G,182,188,6,VEIQSHL,0
3w2c,G,292,296,4,TLDYL,0
3w2c,G,182,187,5,VEIQSH,0
3w2c,G,183,188,5,EIQSHL,0
3w2c,G,312,325,13,LWSLGVLCYEFLVG,0
2xu4,A,8,11,3,REKG,0
2xu4,A,24,43,19,SCWAFSATGALEGQMFRKTG,0
2xu4,A,49,57,8,SEQNLVDCS,0
2xu4,A,63,67,4,EGCNG,0
2xu4,A,69,81,12,LMDYAFQYVQDNG,0
2xu4,A,101,103,2,NPK,0
2xu4,A,118,130,12,QEKALMKAVATVG,0
2xu4,A,140,145,5,HESFLF,0
2xu4,A,207,211,4,NHCGI,0
5wyl,D,27,31,4,ASHSK,0
5wyl,D,36,41,5,EPRVAV,0
5wyl,D,44,63,19,TFAEIYSQCYEGFKELCHLD,0
5wyl,D,64,72,8,SRFVPFDAT,0
5wyl,D,75,81,6,SAQSQEV,0
5wyl,D,82,86,4,DRTQM,0
5wyl,D,87,106,19,TAEENAALDKRVDSFLHLVG,0
5wyl,D,107,109,2,SRL,0
5wyl,D,111,126,15,LMPAIKAVEWLIRRFR,0
5wyl,D,126,131,5,RIHEFN,0
5wyl,D,131,140,9,NTGTLLATFL,0
5wyl,D,141,143,2,PYH,0
5wyl,D,145,153,8,IPAFVTLLS,0
5wyl,D,154,155,1,IL,0
5wyl,D,156,160,4,PVQRI,0
5wyl,D,161,166,5,PIEYRF,0
5wyl,D,167,174,7,LDPYIKSL,0
5wyl,D,178,189,11,PRAAIVQQATNR,0
5wyl,D,189,206,17,RPDLLSAISRYTLDSCRA,0
5wyl,D,210,232,22,YPGLISFWGGIMAEAVNGMIDKM,0
5wyl,D,251,259,8,IGPVLSEAM,0
5wyl,D,264,281,17,VPGIQIASYMVVAILAAK,0
5wyl,D,285,300,15,NDNILTAFMEQLVHGW,0
5wyl,D,301,303,2,TVD,0
5wyl,D,304,318,14,TLRPGLVCLTMLAQH,0
5wyl,D,325,333,8,SGRVAKAVI,0
5wyl,D,337,346,9,DLVSSLRDIS,0
5wyl,D,351,370,19,VDKLANGLVLAFVDRLAKKG,0
5wyl,D,373,383,10,RTLPVINSLLL,0
5wyl,D,388,405,17,QEKQAKVAYKALLLAAHK,0
5wyl,D,416,429,13,IRKQVGSALVRLSQ,0
5wyl,D,432,445,13,GDVGDAIRTAIQEV,0
5wyl,D,448,458,10,NIEELELKLGA,0
5wyl,D,922,930,8,APQRLAEIF,0
5wyl,D,934,938,4,PAFAM,0
5wyl,D,940,952,12,PIEDVFYQVASLF,0
5wyl,D,75,80,5,SAQSQE,0
5wyl,D,88,106,18,AEENAALDKRVDSFLHLVG,0
5wyl,D,210,233,23,YPGLISFWGGIMAEAVNGMIDKMR,0
5wyl,D,236,260,24,RRAIQLENDHLLLQQIGPVLSEAMV,0
5wyl,D,388,406,18,QEKQAKVAYKALLLAAHKI,0
5wyl,D,412,429,17,ADGNIRKQVGSALVRLSQ,0
5wyl,D,432,446,14,GDVGDAIRTAIQEVD,0
5wyl,D,922,931,9,APQRLAEIFN,0
5v8g,A,4,15,11,SRCELAAAMKRL,0
5v8g,A,19,23,4,NYRGY,0
5v8g,A,24,37,13,SLGNWVCAANYESS,0
5v8g,A,79,85,6,PCSVLLR,0
5v8g,A,88,100,12,ITEAVRCAKRIVS,0
5v8g,A,103,107,4,NGMNA,0
5v8g,A,108,115,7,WVAWRNRC,0
5v8g,A,119,125,6,DVSKWIR,0
3g1g,B,163,178,15,SFVDFANRLIKAVEGS,0
3g1g,B,181,183,2,PPS,0
3g1g,B,184,197,13,ARAPVIIDCFRQKS,0
3g1g,B,198,207,9,QPDIQQLIRT,0
3g1g,B,214,227,13,TPGEIIKYVLDRQK,0
3g1g,B,163,177,14,SFVDFANRLIKAVEG,0
3g1g,B,214,224,10,TPGEIIKYVLD,0
5jo7,D,37,61,24,DNQVAEKYAQEIETLKEQTSTMLSA,0
5jo7,D,66,80,14,TLTEKLNLIDIIERL,0
5jo7,D,82,85,3,IAYH,0
5jo7,D,86,101,15,FEKQIEDMLDHIYRAD,0
5jo7,D,106,110,4,AHEYN,0
5jo7,D,111,125,14,DLNTSSVQFRLLRQH,0
5jo7,D,130,138,8,SPNIFSRFQ,0
5jo7,D,145,150,5,KESLRS,0
5jo7,D,151,163,12,DIRGLLNLYEASH,0
5jo7,D,169,187,18,EDILEEALVFSVGHLESAA,0
5jo7,D,188,190,2,PHL,0
5jo7,D,193,204,11,PLSKQVTHALEQ,0
5jo7,D,205,209,4,SLHKS,0
5jo7,D,210,225,15,IPRVEIRYFISIYEEE,0
5jo7,D,229,262,33,NDLLLRFAKLDYNLLQMLHKHELSEVSRWWKDLD,0
5jo7,D,262,267,5,DFVTTL,0
5jo7,D,273,285,12,RAVECYFWTMGVY,0
5jo7,D,287,289,2,EPQ,0
5jo7,D,290,313,23,YSQARVMLAKTIAMISIVDDTFDA,0
5jo7,D,316,330,14,IVKELEVYTDAIQRW,0
5jo7,D,331,338,7,DISQIDRL,0
5jo7,D,339,362,23,PEYMKISYKALLDLYDDYEKELSK,0
5jo7,D,363,364,1,DG,0
5jo7,D,365,367,2,RSD,0
5jo7,D,368,393,25,VVHYAKERMKEIVRNYFIEAKWFIEG,0
5jo7,D,397,406,9,SVSEYLSNAL,0
5jo7,D,407,409,2,ATS,0
5jo7,D,410,418,8,TYYLLTTTS,0
5jo7,D,426,435,9,TKEHFEWLAT,0
5jo7,D,437,460,23,PKILEANATLCRVVDDIATYEVEK,0
5jo7,D,467,477,10,TGIECYMRDYG,0
5jo7,D,479,502,23,STEVAMEKFQEMADIAWKDVNEEI,0
5jo7,D,509,527,18,SSEILTRILNLARIIDVTY,0
5jo7,D,541,550,9,LKPHIIALVV,0
5jo7,D,39,60,21,QVAEKYAQEIETLKEQTSTMLS,0
5jo7,D,191,204,13,KSPLSKQVTHALEQ,0
5jo7,D,290,315,25,YSQARVMLAKTIAMISIVDDTFDAYG,0
5jo7,D,397,409,12,SVSEYLSNALATS,0
5jo7,D,410,419,9,TYYLLTTTSY,0
5jo7,D,426,434,8,TKEHFEWLA,0
5jo7,D,437,457,20,PKILEANATLCRVVDDIATYE,0
5jo7,D,40,62,22,VAEKYAQEIETLKEQTSTMLSAA,0
5jo7,D,107,110,3,HEYN,0
5jo7,D,290,312,22,YSQARVMLAKTIAMISIVDDTFD,0
5jo7,D,437,456,19,PKILEANATLCRVVDDIATY,0
5jo7,D,468,477,9,GIECYMRDYG,0
5jo7,D,478,502,24,VSTEVAMEKFQEMADIAWKDVNEEI,0
5jo7,D,47,60,13,EIETLKEQTSTMLS,0
5jo7,D,112,125,13,LNTSSVQFRLLRQH,0
2x70,D,49,53,4,APWIE,0
2x70,D,56,86,30,GPEYWDGETRKVKAHSQTHRVDLGTLRGYYN,0
2x70,D,137,150,13,DMAAQTTKHKWEAA,0
2x70,D,151,162,11,HVAEQLRAYLEG,0
2x70,D,162,175,13,GTCVEWLRRYLENG,0
2x70,D,175,180,5,GKETLQ,0
2x70,D,225,228,3,TQDT,0
2x70,D,253,255,2,QEQ,0
2x70,D,48,52,4,APWIE,0
2x70,D,55,84,29,GPEYWDGETRKVKAHSQTHRVDLGTLRGYY,0
2x70,D,136,149,13,DMAAQTTKHKWEAA,0
2x70,D,150,161,11,HVAEQLRAYLEG,0
2x70,D,161,174,13,GTCVEWLRRYLENG,0
2x70,D,174,179,5,GKETLQ,0
2x70,D,224,227,3,TQDT,0
2mbe,A,22,29,7,SVLKIKEH,0
5lts,B,0,15,15,HDEIISELRELCLNYI,0
5lts,B,18,20,2,DER,0
5lts,B,21,30,9,LSRQKLNFLG,0
5lts,B,33,57,24,EPRMVLIEGLKLLSRCIEIDSADKS,0
5lts,B,67,75,8,SVETILVES,0
5lts,B,107,124,17,TPASFEKKFIEATNKLAC,0
5lts,B,125,132,7,IREDLAVA,0
5lts,B,152,176,24,PEWANFKFRDLLFKLLEYSNQDEKV,0
5lts,B,178,186,8,EESEYFRLC,0
5lts,B,1,15,14,DEIISELRELCLNYI,0
5lts,B,21,31,10,LSRQKLNFLGQ,0
5lts,B,125,131,6,IREDLAV,0
5lts,B,152,179,27,PEWANFKFRDLLFKLLEYSNQDEKVFEE,0
5lts,B,180,188,8,SEYFRLCES,0
4wk0,B,80,84,4,LESSL,0
4wk0,B,184,189,5,GSYFWQ,0
4wk0,B,196,203,7,TQEQIAES,0
4wk0,B,223,227,4,SSIYD,0
4wk0,B,438,440,2,FGV,0
4wk0,B,14,21,7,SCGECIQA,0
4wk0,B,40,42,2,TSA,0
4wk0,B,47,52,5,LEALKK,0
4wk0,B,87,91,4,KPEDI,0
4wk0,B,132,134,2,SYS,0
4wk0,B,135,142,7,MKDDLENV,0
4wk0,B,144,154,10,SLGTDLMNEMR,0
4wk0,B,179,185,6,TPAKLRN,0
4wk0,B,208,217,9,KGEVFNELVG,0
4wk0,B,230,241,11,GGFDAIMQVAVC,0
4wk0,B,242,245,3,GSLI,0
4wk0,B,266,272,6,GDGKLGG,0
4wk0,B,298,309,11,SIAHLVQKLSEN,0
4wk0,B,321,332,11,FQPVYKELKNLI,0
4wk0,B,346,360,14,NVIQLIIDAYNSLSS,0
4wk0,B,382,384,2,KNG,0
4wk0,B,388,392,4,TGENG,0
3s0e,A,2,22,20,TIEELKTRLHTEQSVCKTETG,0
3s0e,A,24,33,9,DQQKANDVIE,0
3s0e,A,40,54,14,DKKVQLYCECILKNF,0
3s0e,A,64,73,9,KPQGIKAVME,0
3s0e,A,77,89,12,DENSVKQLVSDCS,0
3s0e,A,95,109,14,NPHLKASKLVQCVSK,0
3s0e,A,113,119,6,MKSVDFL,0
4cm1,D,13,26,13,KRIGRAIAVKLHQT,0
4cm1,D,37,52,15,SAEAAVSLADELNKER,0
4cm1,D,68,85,17,VLPASCEEIINSCFRAFG,0
4cm1,D,115,128,13,TVETQVAELIGTNA,0
4cm1,D,128,142,14,AIAPFLLTMSFAQRQ,0
4cm1,D,171,193,22,FSLYNMGKHALVGLTQSAALELA,0
4cm1,D,214,223,9,GEEEKDKWRR,0
4cm1,D,233,246,13,SAEQIADAVIFLVS,0
4cm1,D,247,250,3,GSAQ,0
4cm1,D,262,266,4,GLSLV,0
4cm1,D,128,141,13,AIAPFLLTMSFAQR,0
4cm1,D,214,224,10,GEEEKDKWRRK,0
4cm1,D,13,27,14,KRIGRAIAVKLHQTG,0
4cm1,D,194,196,2,PYG,0
4xr2,A,5,29,24,DLVDRLNTTFRQMEQELAIFAAHLE,0
4xr2,A,45,49,4,KKEDE,0
4xr2,A,63,75,12,GNDAQSLALRHFR,0
4xr2,A,78,82,4,FIQQQ,0
4xr2,A,103,130,27,DNLSQAALVSHIQHINKLKTTFEHIVTV,0
4xr2,A,135,137,2,PTA,0
4xr2,A,138,147,9,ARFEWVARHL,0
4xr2,A,151,157,6,ITLNAYR,0
4xr2,A,183,196,13,RDEVLAQLEKSLKS,0
4xr2,A,204,221,17,TREEWQRKLEREYQDIAA,0
4xr2,A,266,268,2,DNG,0
4xr2,A,283,285,2,DNV,0
3hhz,O,220,225,5,SLDELF,0
3hhz,O,228,235,7,RGEFISVG,0
3hhz,O,242,248,6,HKEAILL,0
3hhz,O,257,263,6,NQARVKY,0
3hhz,O,243,248,5,KEAILL,0
3hhz,O,196,202,6,DVWSLSK,0
3hhz,O,221,225,4,LDELF,0
3hhz,O,228,234,6,RGEFISV,0
3hhz,O,242,253,11,HKEAILLGLRYK,0
3hhz,O,255,263,8,LYNQARVKY,0
3hhz,O,241,250,9,SHKEAILLGL,0
3hhz,O,197,201,4,VWSLS,0
3hhz,O,227,235,8,SRGEFISVG,0
3hhz,O,255,261,6,LYNQARV,0
3hhz,O,9,11,2,IDN,0
3hhz,O,27,35,8,YPADYFRKS,0
3hhz,O,48,60,12,LSDLRGYVYQGLK,0
3hhz,O,65,78,13,SIIHVNSYLYGALK,0
3hhz,O,133,139,6,WLPLYLL,0
3hhz,O,139,144,5,LGLYRV,0
3hhz,O,151,160,9,EYRKKLMDGL,0
3hhz,O,160,165,5,LTNQCK,0
3hhz,O,182,186,4,FDVWG,0
3hhz,O,188,206,18,DSNYTKIVAAVDMFFHMFK,0
3hhz,O,210,215,5,CASFRY,0
3hhz,O,217,221,4,TIVSR,0
3hhz,O,225,239,14,CAALATFGHLCKITG,0
3hhz,O,243,248,5,EDVTTW,0
3hhz,O,251,263,12,NREVADEMVQMML,0
3hhz,O,274,278,4,YMPYL,0
3hhz,O,294,308,14,NPAFHFWGQLTALLL,0
3hhz,O,312,316,4,RARNA,0
3hhz,O,323,341,18,EYTSLTTAGLLYAYAVGSS,0
3hhz,O,374,384,10,DVVEWLGWFED,0
3hhz,O,390,402,12,TPDMMQYAKRAVM,0
3hhz,O,411,421,10,TIGKYAKSEFD,0
3hhz,O,27,33,6,YPADYFR,0
3hhz,O,50,60,10,DLRGYVYQGLK,0
3hhz,O,71,75,4,SYLYG,0
3hhz,O,133,140,7,WLPLYLLG,0
3hhz,O,141,146,5,LYRVGR,0
3hhz,O,155,157,2,KLM,0
3hhz,O,158,163,5,DGLTNQ,0
3hhz,O,189,205,16,SNYTKIVAAVDMFFHMF,0
3hhz,O,228,239,11,LATFGHLCKITG,0
3hhz,O,241,248,7,STEDVTTW,0
3hhz,O,251,262,11,NREVADEMVQMM,0
3hhz,O,290,293,3,SSVK,0
3hhz,O,374,383,9,DVVEWLGWFE,0
3hhz,O,384,386,2,DQN,0
3hhz,O,27,32,5,YPADYF,0
3hhz,O,50,58,8,DLRGYVYQG,0
3hhz,O,133,141,8,WLPLYLLGL,0
3hhz,O,151,163,12,EYRKKLMDGLTNQ,0
3hhz,O,183,188,5,DVWGND,0
3hhz,O,191,205,14,YTKIVAAVDMFFHMF,0
3hhz,O,208,215,7,HECASFRY,0
3hhz,O,374,385,11,DVVEWLGWFEDQ,0
3hhz,O,65,76,11,SIIHVNSYLYGA,0
3hhz,O,133,145,12,WLPLYLLGLYRVG,0
3hhz,O,152,157,5,YRKKLM,0
3hhz,O,210,212,2,CAS,0
3hhz,O,213,218,5,FRYGTI,0
3hhz,O,219,221,2,VSR,0
3hhz,O,50,59,9,DLRGYVYQGL,0
3hhz,O,65,77,12,SIIHVNSYLYGAL,0
3hhz,O,133,144,11,WLPLYLLGLYRV,0
3hhz,O,151,165,14,EYRKKLMDGLTNQCK,0
3hhz,O,188,205,17,DSNYTKIVAAVDMFFHMF,0
3hhz,O,208,216,8,HECASFRYG,0
3u0m,A,55,60,5,FDILAT,0
3u0m,A,78,83,5,DFFKQS,0
4tqn,A,1086,1104,18,KPEELRQALMPTLEALYRQ,0
4tqn,A,1108,1112,4,SLPFR,0
4tqn,A,1116,1121,5,DPQLLG,0
4tqn,A,1124,1129,5,DYFDIV,0
4tqn,A,1134,1144,10,DLSTIKRKLDT,0
4tqn,A,1149,1168,19,EPWQYVDDVWLMFNNAWLYN,0
4tqn,A,1172,1195,23,SRVYKFCSKLAEVFEQEIDPVMQS,0
5o96,H,23,31,8,SPEAGQHVG,0
5o96,H,91,104,13,GERMEMVMQKSAEL,0
5o96,H,122,145,23,DKEKMAKKMHQWLNIIIGACEQCG,0
5o96,H,158,165,7,LDQFVREA,0
5o96,H,180,184,4,TWRDY,0
5o96,H,202,212,10,SDEEIRLTSGH,0
5o96,H,225,242,17,RTETAAITALSVLQAAGG,0
5o96,H,23,32,9,SPEAGQHVGV,0
5o96,H,92,104,12,ERMEMVMQKSAEL,0
5o96,H,175,179,4,PAFSK,0
5o96,H,202,211,9,SDEEIRLTSG,0
5abk,A,13,26,13,VNEDKLIEMLVRTG,0
5abk,A,33,48,15,SDVDKRIALERYLEEK,0
5abk,A,49,51,2,IRS,0
3bp9,Y,16,27,11,SSSDLYNWKNNN,0
3bp9,Y,33,48,15,DPGKLTALIESVLTTH,0
3bp9,Y,51,63,12,TWDDCQQLLGTLL,0
3bp9,Y,64,78,14,TGEEKQRVLLEARKA,0
3bp9,Y,89,97,8,LPNEVDAAF,0
3bp9,Y,108,131,23,TTEGRNHLVLYRQLLLAGLQNAGR,0
3bp9,Y,16,26,10,SSSDLYNWKNN,0
3bp9,Y,108,130,22,TTEGRNHLVLYRQLLLAGLQNAG,0
3bp9,Y,64,77,13,TGEEKQRVLLEARK,0
3bp9,Y,108,132,24,TTEGRNHLVLYRQLLLAGLQNAGRS,0
3bp9,Y,34,48,14,PGKLTALIESVLTTH,0
3bp9,Y,33,49,16,DPGKLTALIESVLTTHQ,0
3bp9,Y,89,95,6,LPNEVDA,0
3bp9,Y,108,129,21,TTEGRNHLVLYRQLLLAGLQNA,0
3bp9,Y,16,25,9,SSSDLYNWKN,0
3bp9,Y,92,96,4,EVDAA,0
3bp9,Y,92,97,5,EVDAAF,0
3bp9,Y,110,131,21,EGRNHLVLYRQLLLAGLQNAGR,0
1wnt,D,17,29,12,KGIGRGTVQALHA,0
1wnt,D,40,51,11,TQADLDSLVREC,0
1wnt,D,63,72,9,DWEATERALG,0
1wnt,D,91,95,4,PFLEV,0
1wnt,D,96,107,11,TKEAFDRSFEVN,0
1wnt,D,108,126,18,LRAVIQVSQIVARGLIARG,0
1wnt,D,136,140,4,SQCSQ,0
1wnt,D,146,168,22,HSVYCSTKGALDMLTKVMALELG,0
1wnt,D,186,191,5,MGQATW,0
1wnt,D,193,202,9,DPHKAKTMLN,0
1wnt,D,211,224,13,EVEHVVNAILFLLS,0
1wnt,D,225,228,3,DRSG,0
1wnt,D,240,244,4,GFWAC,0
1wnt,D,17,30,13,KGIGRGTVQALHAT,0
1wnt,D,63,69,6,DWEATER,0
1wnt,D,96,108,12,TKEAFDRSFEVNL,0
1wnt,D,108,125,17,LRAVIQVSQIVARGLIAR,0
1wnt,D,63,71,8,DWEATERAL,0
3sr4,A,33,48,15,AAHEIIETIRWVCEEI,0
3sr4,A,48,57,9,IPDLKLAMEN,0
3sr4,A,67,89,22,SFESMQRLCDKYNRAIDSIHQLW,0
3sr4,A,103,119,16,STGLLRHILQQVYNHSV,0
3sr4,A,121,127,6,DPEKLNN,0
3sr4,A,140,151,11,SFDLVAQMIDEI,0
3sr4,A,167,177,10,GQVVLQVAAAT,0
3sr4,A,188,210,22,ADIPAKYAETMDREFRKWMKWYG,0
3sr4,A,225,234,9,SEEWRERIAN,0
3sr4,A,246,258,12,GPEVDHQLKERFA,0
3sr4,A,286,289,3,DIGT,0
3sr4,A,319,331,12,RTILENYFSSLKN,0
5f42,B,195,202,7,NTEGLKRR,0
5f42,B,205,221,16,TPEEMKKIKEVYKVLYR,0
5f42,B,225,240,15,MMKEAFEIIKEMAKED,0
5f42,B,243,252,9,LEPFVDVIGT,0
5f42,B,262,266,4,NSSSV,0
5f42,B,267,272,5,DKLAAA,0
3ca2,A,13,18,5,PEHWHK,0
3ca2,A,21,24,3,PIAK,0
3ca2,A,125,128,3,TKY,0
3ca2,A,131,134,3,FGKA,0
3ca2,A,155,167,12,PGLQKVVDVLDSI,0
3ca2,A,181,184,3,PRGL,0
3ca2,A,220,226,6,SEQVLKF,0
3jyp,A,18,30,12,RTPAMHEAEGLAQ,0
3jyp,A,50,61,11,DLKTLLDAALYL,0
3jyp,A,76,80,4,VLPLL,0
3jyp,A,84,91,7,SEQATQLG,0
3jyp,A,108,122,14,NTDVSGFGRGMEEGL,0
3jyp,A,136,149,13,GGVGNAVAYALVTH,0
3jyp,A,160,176,16,DTSRAQALADVINNAVG,0
3jyp,A,187,195,8,GIEDVIAAA,0
3jyp,A,215,219,4,DVSCL,0
3jyp,A,235,244,9,TELLKAARAL,0
3jyp,A,251,268,17,GTRMAIHQAVDAFRLFTG,0
3jyp,A,272,283,11,DVSRMRETFLSL,0
4clo,D,13,26,13,KRIGRAIAVKLHQT,0
4clo,D,37,52,15,SAEAAVSLADELNKER,0
4clo,D,68,85,17,VLPASCEEIINSCFRAFG,0
4clo,D,115,128,13,TVETQVAELIGTNA,0
4clo,D,128,141,13,AIAPFLLTMSFAQR,0
4clo,D,171,193,22,FSLYNMGKHALVGLTQSAALELA,0
4clo,D,214,223,9,GEEEKDKWRR,0
4clo,D,233,246,13,SAEQIADAVIFLVS,0
4clo,D,247,250,3,GSAQ,0
4clo,D,262,266,4,GLSLV,0
4clo,D,13,27,14,KRIGRAIAVKLHQTG,0
4clo,D,194,196,2,PYG,0
3pli,A,42,48,6,IETSYTK,0
3pli,A,50,54,4,DNSVI,0
3pli,A,56,71,15,ATDSIKNTIYITAKQN,0
3pli,A,75,91,16,PPELFGSILGTHFIEKY,0
3pli,A,193,200,7,GLQEVRSH,0
3pli,A,200,222,22,HVPKFDATWATAREVTLKTFAED,0
3pli,A,226,242,16,SVQATMYKMAEQILARQ,0
3pli,A,271,275,4,TGKNA,0
1s9v,E,45,51,6,LPVLRQF,0
1s9v,E,55,77,22,DPQFALTNIAVLKHNLNSLIKRS,0
1s9v,E,51,53,2,TLL,0
1s9v,E,54,64,10,GLPAAEYWNSQ,0
1s9v,E,64,72,8,QKDILERKR,0
1s9v,E,73,78,5,AAVDRV,0
1s9v,E,78,88,10,VCRHNYQLELR,0
1s9v,E,89,93,4,TTLQR,0
1s9v,E,56,77,21,PQFALTNIAVLKHNLNSLIKRS,0
1s9v,E,54,63,9,GLPAAEYWNS,0
1s9v,E,64,78,14,QKDILERKRAAVDRV,0
1s9v,E,78,89,11,VCRHNYQLELRT,0
1s9v,E,90,93,3,TLQR,0
5fj7,C,13,18,5,ARGLTQ,0
5fj7,C,18,22,4,QAFAI,0
5fj7,C,62,77,15,DPVMYARLFFQYAQAG,0
5fj7,C,81,98,17,SVDELVNQFTEYHQSTAC,0
5fj7,C,100,110,10,PEIWRKLTAYI,0
5fj7,C,129,138,9,TAILEQLRTL,0
5fj7,C,145,159,14,LFHHITTDFVCHVLS,0
5fj7,C,182,204,22,NFYALVDCVRASDLRRMLTALSS,0
5fj7,C,223,240,17,ALISQHLANAATTAFERS,0
5fj7,C,245,261,16,DANAVVSSVLTILGRLW,0
5fj7,C,280,286,6,GIDQLRS,0
5fj7,C,287,291,4,NLALF,0
5fj7,C,292,301,9,IAYQDMVKQR,0
5fj7,C,318,321,3,IPWF,0
5fj7,C,322,327,5,IEAMSE,0
5fj7,C,339,343,4,TTSYI,0
5fj7,C,390,407,17,EPGISDRMSATLAPIGNT,0
5fj7,C,409,421,12,AVSAFVKNRTAVY,0
5fj7,C,429,433,4,TVNSN,0
5fj7,C,441,450,9,FPSVVERDYA,0
5fj7,C,455,464,9,PMVAIAALRT,0
5fj7,C,475,494,19,ASNDLKRSMFNYYAAVMHYA,0
5fj7,C,544,551,7,EPLEAIAY,0
5fj7,C,568,573,5,LANHTT,0
5fj7,C,607,612,5,KEFELL,0
5fj7,C,628,653,25,VAHAIIQMWYSWFVEDDRTLAAARRT,0
5fj7,C,656,682,26,DDAEKLAIDGRRMQNAVTLLRKIEMIG,0
5fj7,C,687,706,19,GASAVHLAQSRIVDQMAGRG,0
5fj7,C,716,735,19,VGINRHRIRIWAGLAVLQMM,0
5fj7,C,740,752,12,RSEAEALTKVLGD,0
5fj7,C,11,18,7,DIKAQMLF,0
5fj7,C,21,29,8,NIKAQQASK,0
5fj7,C,47,65,18,DPRFLSFKNELSRYLTDHF,0
5fj7,C,83,87,4,NFFGM,0
5fj7,C,107,111,4,KKRAD,0
5fj7,C,120,135,15,SERDNLLFRAAVRLMF,0
5fj7,C,159,183,24,DMGTKIEIAERALEKAEEAGNLMLQ,0
5fj7,C,185,190,5,KFDDAY,0
5fj7,C,229,235,6,DFEYAVT,0
5fj7,C,249,255,6,ASRLKEQ,0
5fj7,C,279,298,19,LNAPIMAVAQPVRNKIYSKY,0
5fj7,C,307,316,9,RLNKEEKVKE,0
5fj7,C,333,347,14,PGWLRDLICDELLNM,0
5fj7,C,350,361,11,APWWVKLFETSL,0
5fj7,C,397,418,21,ATDLMGTLLMSITYLVMQLDHT,0
5fj7,C,420,426,6,PHLNSRI,0
5fj7,C,428,441,13,DMPSACRFLDSYWQ,0
5fj7,C,464,478,14,ALVGGHRLFEMLKEG,0
5fj7,C,518,527,9,INSMLNNQFS,0
5fj7,C,546,559,13,FPGLAWASMKDTYG,0
5fj7,C,563,577,14,IYSDVLEAIERCWWN,0
5fj7,C,582,602,20,SYRAYREDMLKRDTLELSRYV,0
5fj7,C,615,624,9,TPIDLEVLAD,0
5fj7,C,625,630,5,PNKLQY,0
5fj7,C,633,637,4,TEADV,0
5fj7,C,638,645,7,SANIHEVL,0
5fj7,C,650,662,12,SVEKTERFLRSVM,0
2om1,l,1,9,8,GIVEQCCTS,0
2om1,l,12,18,6,SLYQLEN,0
2om1,l,2,20,18,VNQHLCGSHLVEALYLVCG,0
2om1,l,21,23,2,ERG,0
2om1,l,1,7,6,GIVEQCC,0
2om1,l,1,20,19,FVNQHLCGSHLVEALYLVCG,0
2om1,l,12,17,5,SLYQLE,0
2om1,l,18,20,2,NYC,0
5lje,A,15,23,8,NFEEYLRAL,0
5lje,A,26,36,10,NVALRKIANLL,0
3dat,A,27,37,10,SELQYVKKTTM,0
3dat,A,45,50,5,RKNYEA,0
3dat,A,79,87,8,SVEEVFELC,0
3dat,A,98,106,8,GAQIYDLFL,0
5lf2,B,575,577,2,EGA,0
5lf2,B,661,664,3,LPRD,0
5lf2,B,727,729,2,VLM,0
5lf2,B,730,735,5,LEMFSG,0
5lf2,B,737,750,13,DAAALERRTTFERY,0
5lf2,B,751,757,6,RCHEEGL,0
5lf2,B,767,781,14,ACVPLLISASSLVYN,0
3rwg,A,49,55,6,APWVEQE,0
3rwg,A,56,85,29,GPEYWEEATRRAKEAAQTHRENLRTALRYY,0
3rwg,A,137,150,13,DMAAQNTQRKWEGN,0
3rwg,A,151,162,11,RYAERFRAYLEG,0
3rwg,A,162,175,13,GECLEWLRRYLENG,0
3rwg,A,175,180,5,GKETLQ,0
3rwg,A,253,255,2,EEQ,0
2bzw,B,2,19,17,SQSNRELVVDFLSYKLSQ,0
2bzw,B,23,27,4,SWSQF,0
2bzw,B,82,101,19,PMAAVKQALREAGDEFELRY,0
2bzw,B,102,106,4,RRAFS,0
2bzw,B,107,112,5,DLTSQL,0
2bzw,B,118,131,13,TAYQSFEQVVNELF,0
2bzw,B,136,157,21,NWGRIVAFFSFGGALCVESVDK,0
2bzw,B,161,178,17,VLVSRIASWMATYLNDHL,0
2bzw,B,178,185,7,LEPWIQEN,0
2bzw,B,187,195,8,GWDTFVDLY,0
2bzw,B,96,98,2,PPN,0
2bzw,B,99,119,20,LWAAQRYGRELRRMSDEFEGS,0
1tgs,I,164,176,12,SDSSCKSAYPGQI,0
1tgs,I,230,235,5,KVCNYV,0
1tgs,I,236,245,9,SWIKQTIASN,0
1tgs,I,34,42,8,ECVLCSENK,0
1t3t,A,12,25,13,SAFRINKLLARFQA,0
1t3t,A,48,59,11,NDSEQAQLTRLL,0
1t3t,A,85,98,13,SPWSSKATDIAHNC,0
1t3t,A,120,130,10,TAEQWRQVAAE,0
1t3t,A,142,151,9,SLTDAEKLFI,0
1t3t,A,162,167,5,DLLGEG,0
1t3t,A,168,178,10,RQALIDANLRL,0
1t3t,A,183,198,15,AEDEIDYLQEAFTKLG,0
1t3t,A,202,213,11,NDIELYMFAQAN,0
1t3t,A,214,219,5,SEHCRH,0
1t3t,A,219,224,5,HKIFNA,0
1t3t,A,236,248,12,SLFKMIKNTFETT,0
1t3t,A,296,303,7,HNHPTAIS,0
1t3t,A,303,321,18,SPWPGAATGSGGEIRDEGA,0
1t3t,A,361,381,20,TALDIMTEGPLGGAAFNNEFG,0
1t3t,A,421,425,4,RADHV,0
1t3t,A,474,490,16,NPEMERRCQEVIDRCWQ,0
1t3t,A,491,495,4,LGDAN,0
1t3t,A,507,519,12,GLSNAMPELVSDG,0
1t3t,A,528,530,2,RDI,0
1t3t,A,538,545,7,SPLEIWCN,0
1t3t,A,559,571,12,QLPLFDELCKRER,0
1t3t,A,602,606,4,LDVLL,0
1t3t,A,632,641,9,TIADAVKRVL,0
1t3t,A,649,654,5,KTFLVT,0
1t3t,A,701,706,5,APVALL,0
1t3t,A,707,724,17,DFAASARLAVGEALTNIA,0
1t3t,A,730,733,3,DIKR,0
1t3t,A,748,762,14,GEDAGLYDAVKAVGE,0
1t3t,A,763,769,6,ELCPQLG,0
1t3t,A,810,814,4,DVRHT,0
1t3t,A,841,847,6,TALAQVY,0
1t3t,A,859,876,17,DVAQLKGFYDAMQALVAA,0
1t3t,A,888,902,14,GGLLVTLAEMAFAGH,0
1t3t,A,910,913,3,AALG,0
1t3t,A,915,922,7,DHLAALFN,0
1t3t,A,935,946,11,DRDAVEALLAQY,0
1t3t,A,947,947,0,G,0
1t3t,A,948,950,2,LAD,0
1t3t,A,978,997,19,RTTLRVWWAETTWQMQRLRD,0
1t3t,A,998,1010,12,NPQCADQEHEAKA,0
1t3t,A,1030,1035,5,AAPYIA,0
1t3t,A,1052,1063,11,SHVEMAAAFHRA,0
1t3t,A,1072,1077,5,MSDLLG,0
1t3t,A,1081,1085,4,GLGNF,0
1t3t,A,1094,1099,5,FSYGDV,0
1t3t,A,1103,1113,10,GEGWAKSILFN,0
1t3t,A,1113,1126,13,NHRVRDEFETFFHR,0
1t3t,A,1135,1143,8,NGCQMMSN,0
1t3t,A,1144,1148,4,LRELI,0
1t3t,A,1179,1183,4,SLLLQ,0
1t3t,A,1205,1215,10,DDAHLAALESK,0
1t3t,A,1240,1242,2,SPN,0
1t3t,A,1260,1264,4,HPERV,0
1t3t,A,1266,1270,4,RTVAN,0
1t3t,A,1283,1295,12,WMRIFRNARKQLG,0
1epr,E,46,50,4,TASEV,0
1epr,E,57,61,4,TPSKS,0
1epr,E,108,113,5,SSSFTE,0
1epr,E,125,129,4,FSTLN,0
1epr,E,137,143,6,TFFDNAK,0
1epr,E,224,233,9,PATVVSAYWA,0
1epr,E,269,273,4,PGDYI,0
1epr,E,303,308,5,GDVALK,0
1qc5,B,48,60,12,WDSVTAFLNDLLE,0
1qc5,B,91,102,11,STEEVLVAAKKI,0
1qc5,B,111,122,11,MTALGTDTARKE,0
1qc5,B,125,129,4,TEARG,0
1qc5,B,148,150,2,DNH,0
1qc5,B,151,162,11,RLKKVIQDCEDE,0
1qc5,B,172,178,6,LGSYNRG,0
1qc5,B,182,193,11,TEKFVEEIKSIA,0
1qc5,B,196,200,4,PTEKH,0
1qc5,B,206,212,6,DEIALVT,0
1qc5,B,213,221,8,IVKTLGERI,0
1qc5,B,348,360,12,WDSVTAFLNDLLE,0
1qc5,B,391,402,11,STEEVLVAAKKI,0
1qc5,B,411,422,11,MTALGIDTARKE,0
1qc5,B,425,429,4,TEARG,0
1qc5,B,448,450,2,DNH,0
1qc5,B,451,462,11,RLKKVIQDCEDE,0
1qc5,B,472,478,6,LGSYNRG,0
1qc5,B,482,493,11,TEKFVEEIKSIA,0
1qc5,B,496,500,4,PTEKH,0
1qc5,B,506,512,6,DEIALVT,0
1qc5,B,513,521,8,IVKTLGERI,0
2fs6,B,14,22,8,NFEELLKVL,0
2fs6,B,25,36,11,NVMLRKIAVAAA,0
2n69,A,13,17,4,VSKCQ,0
2n69,A,23,30,7,QCNYDCKL,0
3rot,B,34,52,18,DPYWTSLFQGAKKAAEELK,0
3rot,B,65,79,14,DVPKQVQFIESALAT,0
3rot,B,94,105,11,FSKSLQRANKLN,0
3rot,B,130,146,16,DNLLAGKKLGEKALELT,0
3rot,B,161,178,17,HIGLEKRAYGIKTILQDK,0
3rot,B,190,205,15,DPNQVQSRVKSYFKIH,0
3rot,B,215,228,13,TSQALDPLGQLLH,0
3rot,B,228,233,5,HPDRYD,0
3rot,B,246,255,9,TPNTVSLIHK,0
3rot,B,265,284,19,QPFLGYLSITQLVLNRYQ,0
3rot,B,65,78,13,DVPKQVQFIESALA,0
3rot,B,94,104,10,FSKSLQRANKL,0
3fcs,D,152,157,5,SRIYVE,0
3fcs,D,188,191,3,GYYF,0
3fcs,D,200,206,6,VADIFSS,0
3fcs,D,228,230,2,PEY,0
3fcs,D,260,263,3,WSWT,0
3fcs,D,440,442,2,YGA,0
3fcs,D,516,518,2,RQG,0
3fcs,D,555,557,2,EAD,0
3fcs,D,911,914,3,LPSL,0
3fcs,D,13,19,6,CQQCLAV,0
3fcs,D,41,46,5,KENLLK,0
3fcs,D,51,53,2,PES,0
3fcs,D,122,130,8,YSMKDDLWS,0
3fcs,D,136,145,9,TKLATQMRKL,0
3fcs,D,200,207,7,VTRFNEEV,0
3fcs,D,222,231,9,GFDAIMQATV,0
3fcs,D,233,236,3,DEKI,0
3fcs,D,259,263,4,DGRLA,0
3fcs,D,282,285,3,SAST,0
3fcs,D,292,301,9,LGLMTEKLSQ,0
3fcs,D,312,324,12,ENVVNLYQNYSEL,0
3fcs,D,340,351,11,VLQLIVDAYGKI,0
3fcs,D,436,438,2,ACQ,0
3fcs,D,494,497,3,VCSQ,0
3fcs,D,536,538,2,CSG,0
3fcs,D,613,615,2,ECV,0
3fcs,D,122,129,7,YSMKDDLW,0
3fcs,D,136,142,6,TKLATQM,0
3fcs,D,170,174,4,PEALE,0
3fcs,D,201,209,8,TRFNEEVKK,0
3fcs,D,436,440,4,ACQAQ,0
3fcs,D,607,610,3,ACTF,0
3hbv,P,98,114,16,NAEQIEQAKLSLQSWSD,0
3hbv,P,170,175,5,QSNIRN,0
3hbv,P,179,194,15,EEYGRQTFTHEIGHAL,0
3hbv,P,247,259,12,MIDDIAAIQRLYG,0
3hbv,P,279,283,4,RDFYT,0
3hbv,P,392,396,4,SGQDS,0
3hbv,P,397,401,4,TVAAY,0
3hbv,P,417,423,6,SAFRNEG,0
3hbv,P,473,475,2,AQS,0
1jpm,D,58,69,11,SMDSIESAIHHV,0
1jpm,D,69,75,6,VLKPALL,0
1jpm,D,78,80,2,SLA,0
1jpm,D,81,92,11,GYEAILHDIQHL,0
1jpm,D,96,115,19,NMSAKAAVEMALYDGWAQMC,0
1jpm,D,118,123,5,PLYQML,0
1jpm,D,140,154,14,SPEEMAADAENYLKQ,0
1jpm,D,167,183,16,DIATDIARIQEIRKRVG,0
1jpm,D,197,211,14,RPKEAVTAIRKMEDA,0
1jpm,D,226,237,11,DLAGLKKVTDAT,0
1jpm,D,249,259,10,TPRQAFEVLQT,0
1jpm,D,268,273,5,KLMKAG,0
1jpm,D,274,288,14,GISGAEKINAMAEAC,0
1jpm,D,300,314,14,TKLGITAAAHFAASK,0
1jpm,D,323,328,5,DAPLML,0
1jpm,D,96,116,20,NMSAKAAVEMALYDGWAQMCG,0
1jpm,D,249,260,11,TPRQAFEVLQTR,0
1jpm,D,184,186,2,SAV,0
6dex,B,17,29,12,NAERALLQLVVED,0
6dex,B,39,49,10,GQDARRYFEEE,0
6dex,B,77,91,14,KLQYLYMYLTKLEVD,0
6dex,B,103,109,6,GLEQLLG,0
6dex,B,115,137,22,DADQVRLASLIYNTAFRVRVRHG,0
6dex,B,149,161,12,HAQLQQLEAHWRL,0
6dex,B,8,14,6,YSKLLRN,0
6dex,B,23,34,11,NEVVVSFLYQLF,0
6dex,B,37,47,10,DLFVRAFSLLE,0
6dex,B,62,73,11,EADELLESLYNG,0
6dex,B,95,98,3,LDHW,0
6dex,B,102,110,8,CTEFAATCR,0
6dex,B,111,113,2,PHL,0
6dex,B,118,123,5,PLSDAL,0
6dex,B,154,165,11,CEHLFAFAILLQ,0
6dex,B,167,176,9,DLRVLRHFST,0
6dex,B,189,197,8,SIDEWLKLH,0
3mkk,B,139,152,13,NAYDIVKQFRRVIG,0
3mkk,B,158,162,4,PKFAF,0
3mkk,B,173,186,13,TKEDFRAVAKGYRE,0
3mkk,B,197,201,4,DIDYM,0
3mkk,B,216,226,10,DFPEFVKEMKD,0
3mkk,B,245,254,9,YEVYEEGVKN,0
3mkk,B,282,292,10,NPEARKWFGDK,0
3mkk,B,293,298,5,YRFLID,0
3mkk,B,317,333,16,SEGLAEAKEFAGEFAKD,0
3mkk,B,339,350,11,HPWAMQAKMKDI,0
3mkk,B,355,359,4,EDYKR,0
3mkk,B,372,376,4,DKVHN,0
3mkk,B,377,394,17,LFGYNMTRAAGEAFERID,0
3mkk,B,409,413,4,GMHRY,0
3mkk,B,425,441,16,WSHILLNLKMLPSLNMC,0
3mkk,B,458,470,12,TRDLLLRFLALGV,0
3mkk,B,487,491,4,ECYQF,0
3mkk,B,494,521,27,IEDFRSVINARYRLVPYLYSEYMKAALN,0
3mkk,B,528,533,5,PLGFVY,0
3mkk,B,538,542,4,MAIRV,0
3mkk,B,621,625,4,CVKDI,0
3mkk,B,654,656,2,KKE,0
3mkk,B,139,151,12,NAYDIVKQFRRVI,0
3mkk,B,158,163,5,PKFAFG,0
3mkk,B,353,358,5,SPEDYK,0
3mkk,B,529,533,4,LGFVY,0
3rnl,A,17,27,10,GTSSLDRYLSQ,0
3rnl,A,40,47,7,HFFSIPDF,0
3rnl,A,56,62,6,DEGNLY,0
3rnl,A,66,73,7,DEDAYRL,0
3rnl,A,95,104,9,GTAQRYDAY,0
3rnl,A,115,130,15,NPVDRAFSAYHLVRD,0
3rnl,A,136,143,7,SFRESLAK,0
3rnl,A,143,150,7,KEEERIRQ,0
3rnl,A,153,157,4,EPLWY,0
3rnl,A,159,162,3,RAVG,0
3rnl,A,163,176,13,LYAAQVKRYLDVFG,0
3rnl,A,185,191,6,FEEFARD,0
3rnl,A,191,204,13,DPVQVVRDCCAFLG,0
3rnl,A,269,292,23,EPDLREELTAFFAPDVARLEALIH,0
3rnl,A,295,299,4,LSAWR,0
5jqn,A,14,32,18,DPQHNLDLIDDAAARASEQ,0
5jqn,A,42,46,4,LFGFG,0
5jqn,A,48,56,8,VPSQICAQV,0
5jqn,A,57,76,19,SAEQVDAARSRLRGIARDRG,0
5jqn,A,115,123,8,YGPEEKAAF,0
5jqn,A,144,149,5,VYDVE,0
5jqn,A,150,160,10,FPEMVRAAAAR,0
5jqn,A,176,181,5,TSVPGI,0
5jqn,A,181,191,10,ILLPARAVENG,0
5jqn,A,249,254,5,DYLQDR,0
5jqn,A,255,263,8,RAELHRNWL,0
3la3,B,76,81,5,GVLSLL,0
3la3,B,82,86,4,TGNKS,0
3la3,B,105,114,9,IEQVEQALKE,0
3la3,B,115,142,27,NPELSMLMLRGLSSRILQTEMMIETLAH,0
3la3,B,144,160,16,DMGSRLVSFLLILCRDF,0
3la3,B,175,183,8,SHQAIAEAI,0
3la3,B,186,200,14,TRVTVTRLLGDLREK,0
3la3,B,214,219,5,KPVTLS,0
3la3,B,77,83,6,VLSLLTG,0
3la3,B,84,86,2,NKS,0
3la3,B,105,115,10,IEQVEQALKEN,0
3la3,B,117,142,25,ELSMLMLRGLSSRILQTEMMIETLAH,0
3la3,B,175,184,9,SHQAIAEAIG,0
3la3,B,214,220,6,KPVTLSR,0
3riy,B,39,50,11,SMADFRKFFAKA,0
3riy,B,59,66,7,AGVSAESG,0
3riy,B,72,74,2,GAG,0
3riy,B,82,86,4,AQDLA,0
3riy,B,87,94,7,TPLAFAHN,0
3riy,B,94,110,16,NPSRVWEFYHYRREVMG,0
3riy,B,115,130,15,NAGHRAIAECETRLGK,0
3riy,B,144,150,6,ELHRKAG,0
3riy,B,181,185,4,CPALS,0
3riy,B,200,204,4,PVEKL,0
3riy,B,208,212,4,EEAGC,0
3riy,B,228,242,14,DPAILEEVDRELAHC,0
3riy,B,256,258,2,PAA,0
3riy,B,259,267,8,MFAPQVAAR,0
3riy,B,281,285,4,ATNRF,0
3riy,B,292,302,10,PCGTTLPEALA,0
3riy,B,94,111,17,NPSRVWEFYHYRREVMGS,0
5xau,F,2676,2701,25,VLDAGHSVSTLEKTLPQLLAKLSILE,0
5xau,F,2706,2732,26,HNASLALSASIGRVRELCAQARGAASK,0
5xau,F,2753,2757,4,LADLA,0
5xau,F,2888,2892,4,PPLLR,0
5xau,F,2937,2943,6,DPWLTDG,0
5xau,F,3056,3060,4,DLELA,0
5xau,F,3069,3073,4,PPDQL,0
5xau,F,3074,3081,7,PPSLRRLF,0
5xau,F,3102,3106,4,DLKRL,0
5xau,F,3116,3121,5,TADLLV,0
5xau,F,1717,1785,68,RKAEMLQNEAKTLLAQANSKLQLLKDLERKYEDNQRYLEDKAQELARLEGEVRSLLKDISQKVAVYSTC,0
5xau,F,1536,1553,17,NEIEGTLNKAKDEMKVSD,0
5xau,F,1553,1596,43,DLDRKVSDLENEAKKQEAAIMDYNRDIEEIMKCIRNLEDIRKTL,0
5xau,F,2674,2688,14,QAVLDAGHSVSTLEK,0
5xau,F,2689,2701,12,TLPQLLAKLSILE,0
5xau,F,2703,2732,29,RGVHNASLALSASIGRVRELCAQARGAASK,0
5xau,F,2752,2757,5,DLADLA,0
5xau,F,2870,2874,4,RPDDF,0
5xau,F,2957,2961,4,DSQIS,0
5xau,F,1716,1785,69,RRKAEMLQNEAKTLLAQANSKLQLLKDLERKYEDNQRYLEDKAQELARLEGEVRSLLKDISQKVAVYSTC,0
5xau,F,1554,1596,42,LDRKVSDLENEAKKQEAAIMDYNRDIEEIMKCIRNLEDIRKTL,0
5cg9,D,58,75,17,NKKSLLQNLLSKCKTTFQ,0
5cg9,D,117,134,17,PKELVEEFTEKFESIQTG,0
5cg9,D,156,159,3,ADLS,0
5cg9,D,160,169,9,QELGQYLSEI,0
5cg9,D,169,185,16,IVNPQINYYISKLLTCV,0
5cg9,D,186,194,8,SSRTINYLV,0
5cg9,D,197,205,8,NDSYYALNN,0
5cg9,D,223,227,4,HRIRK,0
5cg9,D,297,303,6,HKGSKTK,0
5cg9,D,309,321,12,TQKNSLKIHKETK,0
5cg9,D,169,186,17,IVNPQINYYISKLLTCVS,0
5cg9,D,310,320,10,QKNSLKIHKET,0
1yux,B,28,57,29,STLENLKAAIAGETGAHAKYTAFAKAAREQ,0
1yux,B,59,88,29,YEQIARLFEATAAAELIHIGLEYALVAEME,0
1yux,B,103,121,18,SCDLNLISGANGEIYETSD,0
1yux,B,121,134,13,DMYPAFIRKAQEEG,0
1yux,B,135,162,27,NSKAVHVFTRAKLAESVHAERYLAAYND,0
1yux,B,195,199,4,PKDTF,0
1yux,B,121,133,12,DMYPAFIRKAQEE,0
2gan,B,9,12,3,NPST,0
2gan,B,13,28,15,VKDELLELFRIYRST,0
2gan,B,46,64,18,DFNGFREVYEPFLKFRLSQ,0
2gan,B,88,92,4,RIKEK,0
2gan,B,98,102,4,PEEL,0
2gan,B,122,138,16,GIGSTLLEFAVKRLRSL,0
2gan,B,147,150,3,FPNL,0
2gan,B,151,159,8,EAYSYYYK,0
2gan,B,177,183,6,NHKKFQL,0
2gan,B,46,65,19,DFNGFREVYEPFLKFRLSQE,0
2gan,B,116,119,3,PEFQ,0
2gan,B,151,160,9,EAYSYYYKK,0
1kw5,A,2,12,10,NIFEMLRIDEG,0
1kw5,A,38,51,13,SLNAAKSELDKAIG,0
1kw5,A,59,80,21,TKDEAEKLFNQDVDAAVRGILR,0
1kw5,A,84,91,7,MKPVYDSM,0
1kw5,A,92,113,21,DAVRRAAMINMVFQMGETGVAG,0
1kw5,A,114,123,9,FTNSLRMLQQ,0
1kw5,A,125,135,10,RWDEAAVNLAK,0
1kw5,A,136,142,6,SRWYNQT,0
1kw5,A,142,156,14,TPNRAKRVITTFRTG,0
1kw5,A,158,162,4,WDAYK,0
3v8u,B,63,67,4,DESDW,0
3v8u,B,80,89,9,PKRQKSVIEK,0
3pe0,B,643,667,24,ESLHSFVAAATKELMWLNEKEEEEV,0
3pe0,B,678,711,33,MTAKKESYSALMRELELKEKKIKELQNAGDRLLR,0
3pe0,B,717,777,60,RPTVESFQAALQTQWSWMLQLCCCIEAHLKENAAYFQFFSDVREAEGQLQKLQEALRRKYS,0
3pe0,B,783,790,7,TVTRLEDL,0
3pe0,B,794,815,21,AQDEKEQLNEYKGHLSGLAKRA,0
3pe0,B,890,914,24,QEAQEAVTRLEAQHQALVTLWHQLH,0
4u7q,B,86,94,8,GRNLLTQIG,0
4u7q,B,86,91,5,GRNLLT,0
3paq,A,84,108,24,DEELQTELYEIKHQILQTMGVLSLQ,0
3paq,A,127,138,11,NFDTIKEMCTRA,0
3paq,A,147,162,15,TPEENEAIASIAKKYN,0
1t0m,D,49,55,6,ARWMEQE,0
1t0m,D,56,85,29,GPEYWERETQKAKGNEQSFRVDLRTLLGYY,0
1t0m,D,137,151,14,DMAALITKHKWEQAG,0
1t0m,D,151,162,11,GEAERLRAYLEG,0
1t0m,D,162,180,18,GTCVEWLRRYLKNGNATLL,0
1t0m,D,253,255,2,KEQ,0
2i78,D,44,50,6,TLTDYLK,0
2i78,D,200,207,7,DWVYEEEV,0
2i78,D,290,295,5,PASMLI,0
2i78,D,421,425,4,EYKGM,0
2i78,D,497,505,8,NSALDKMLQ,0
2i78,D,562,570,8,NWATYLAST,0
2i78,D,587,592,5,GDKIMH,0
2i78,D,593,595,2,AIN,0
2i78,D,600,615,15,TFEVEDQIEAARQFSK,0
2i78,D,630,641,11,SYGGYVTSMVLG,0
2i78,D,658,662,4,RWEYY,0
2i78,D,663,672,9,DSVYTERYMG,0
2i78,D,679,686,7,NLDHYRNS,0
2i78,D,688,698,10,VMSRAENFKQV,0
2i78,D,712,726,14,HFQQSAQISKALVDV,0
2i78,D,744,764,20,SSTAHQHIYTHMSHFIKQCFS,0
2i78,D,44,51,7,TLTDYLKN,0
2i78,D,95,99,4,FDEFG,0
2i78,D,562,572,10,NWATYLASTEN,0
2i78,D,630,640,10,SYGGYVTSMVL,0
2i78,D,713,725,12,FQQSAQISKALVD,0
2i78,D,91,96,5,ENSTFD,0
2i78,D,600,616,16,TFEVEDQIEAARQFSKM,0
2i78,D,713,726,13,FQQSAQISKALVDV,0
1k3i,A,-8,-4,4,SLQFL,0
1k3i,A,26,31,5,ECNKAI,0
1k3i,A,43,47,4,YGANG,0
1k3i,A,317,321,4,VNPML,0
1k3i,A,326,330,4,QGLYR,0
1k3i,A,341,343,2,KKG,0
1k3i,A,478,481,3,PEQD,0
1k3i,A,530,534,4,PNYLY,0
3g86,B,26,31,5,LSNSLL,0
3g86,B,33,35,2,HHN,0
3g86,B,41,43,2,TSR,0
3g86,B,44,53,9,SAGLRQKKVT,0
3g86,B,61,76,15,DDHYRDVLKEMKAKAS,0
3g86,B,84,91,7,SVEEACKL,0
3g86,B,104,110,6,GAKDVRN,0
3g86,B,112,129,17,SSKAVNHIHSVWKDLLED,0
3g86,B,164,188,24,DLGVRVCEKMALYDVVSTLPQVVMG,0
3g86,B,189,195,6,SSYGFQY,0
3g86,B,196,210,14,SPGQRVEFLVNTWKS,0
3g86,B,223,228,5,CFDSTV,0
3g86,B,229,241,12,TENDIRVEESIYQ,0
3g86,B,246,260,14,APEARQAIKSLTERL,0
3g86,B,286,306,20,TTSCGNTLTCYLKASAACRAA,0
3g86,B,328,346,18,GTQEDAASLRVFTEAMTRY,0
3g86,B,359,363,4,DLELI,0
3g86,B,388,401,13,PTTPLARAAWETAR,0
3g86,B,406,415,9,NSWLGNIIMY,0
3g86,B,418,424,6,TLWARMI,0
3g86,B,424,436,12,ILMTHFFSILLAQ,0
3g86,B,455,457,2,EPL,0
3g86,B,458,468,10,DLPQIIERLHG,0
3g86,B,469,473,4,LSAFS,0
3g86,B,478,493,15,SPGEINRVASCLRKLG,0
3g86,B,496,514,18,PLRVWRHRARSVRARLLSQ,0
3g86,B,515,526,11,GGRAATCGKYLF,0
3g86,B,527,530,3,NWAV,0
3g86,B,540,544,4,PAASR,0
3g86,B,229,243,14,TENDIRVEESIYQCC,0
3g86,B,539,543,4,IPAAS,0
5dbm,C,1086,1103,17,KPEELRQALMPTLEALYR,0
5dbm,C,1108,1112,4,SLPFR,0
5dbm,C,1116,1121,5,DPQLLG,0
5dbm,C,1124,1129,5,DYFDIV,0
5dbm,C,1134,1144,10,DLSTIKRKLDT,0
5dbm,C,1149,1168,19,EPWQYVDDVWLMFNNAWLYN,0
5dbm,C,1172,1196,24,SRVYKFCSKLAEVFEQEIDPVMQSL,0
5dbm,C,1086,1104,18,KPEELRQALMPTLEALYRQ,0
5dbm,C,1172,1197,25,SRVYKFCSKLAEVFEQEIDPVMQSLG,0
4a1r,D,68,74,6,DAEFMDA,0
4a1r,D,75,88,13,DFFSLQNDAKSVLG,0
4a1r,D,141,149,8,EPTETNFYK,0
4a1r,D,75,87,12,DFFSLQNDAKSVL,0
4a1r,D,146,150,4,NFYKV,0
5ys9,B,22,32,10,EPPKALAGERA,0
5ys9,B,37,47,10,PIKDMTEFLHG,0
5ys9,B,48,64,16,GEENVTMIERLMTELER,0
5ys9,B,72,76,4,GDYDM,0
5ys9,B,77,93,16,PKEQLRETAVARIAALS,0
5ys9,B,94,96,2,GHW,0
5ys9,B,100,112,12,TEKEALLRSQLHG,0
5ys9,B,115,127,12,DMGTRIRLGVHTG,0
5ys9,B,127,137,10,GLFMGAIRGSG,0
5ys9,B,138,148,10,TKEQYDYWVRK,0
5ys9,B,170,174,4,NVAGL,0
5ys9,B,193,197,4,NTGAT,0
5ys9,B,274,276,2,QNM,0
5ys9,B,299,331,32,YGALIGGRVTMIADSFFVSQRFITIALRYACVR,0
5ys9,B,344,347,3,KIID,0
5ys9,B,348,386,38,YPYHQRRLLPLLAFTYAMKMAADQSQIQYDQTTDLLQTI,0
5ys9,B,390,429,39,DKGALGKAIVDLKELFASSAGLKAFTTWTCANIIDQCRQA,0
5ys9,B,430,439,9,CGGHGYSGYN,0
5ys9,B,440,449,9,GFGQAYADWV,0
5ys9,B,450,453,3,VQCT,0
5ys9,B,457,478,21,DNNVLCLSMGRGLIQSCLGHRK,0
5ys9,B,483,495,12,GSSVGYLANKGLE,0
5ys9,B,506,535,29,DPKVLIEAWEKVANGAIQRATDKFVELTKG,0
5ys9,B,538,546,8,SPDQAFEEL,0
5ys9,B,546,574,28,LSQQRFQCAKIHTRKHLVTAFYERINASA,0
5ys9,B,578,597,19,VKPYLINLANLFTLWSIEED,0
5ys9,B,597,604,7,DSGLFLRE,0
5ys9,B,608,629,21,QPKDIDQVTELVNHYCKEVRDQ,0
5ys9,B,629,636,7,QVAGYTDA,0
5ys9,B,640,645,5,SDWFIN,0
5ys9,B,646,650,4,APIGN,0
5ys9,B,654,667,13,DVYKHYFAKVNQQN,0
5ys9,B,680,686,6,TLRPFLF,0
5ys9,B,22,33,11,EPPKALAGERAK,0
5ys9,B,48,65,17,GEENVTMIERLMTELERD,0
5ys9,B,66,69,3,PVLN,0
5ys9,B,293,298,5,PLAQLT,0
5ys9,B,348,385,37,YPYHQRRLLPLLAFTYAMKMAADQSQIQYDQTTDLLQT,0
5ys9,B,390,430,40,DKGALGKAIVDLKELFASSAGLKAFTTWTCANIIDQCRQAC,0
5ys9,B,431,439,8,GGHGYSGYN,0
5ys9,B,483,491,8,GSSVGYLAN,0
5ys9,B,492,496,4,KGLEQ,0
3wj5,B,207,226,19,ESADLRALAKHLYDSYIKSF,0
3wj5,B,229,239,10,TKAKARAILTG,0
3wj5,B,251,262,11,DMNSLMMGEDKI,0
3wj5,B,276,303,27,EVAIRIFQGCQFRSVEAVQEITEYAKSI,0
3wj5,B,305,309,4,GFVNL,0
3wj5,B,310,332,22,DLNDQVTLLKYGVHEIIYTMLAS,0
3wj5,B,350,355,5,REFLKS,0
3wj5,B,359,363,4,PFGDF,0
3wj5,B,364,376,12,MEPKFEFAVKFNA,0
3wj5,B,380,393,13,DDSDLAIFIAVIIL,0
3wj5,B,402,425,23,NVKPIEDIQDNLLQALELQLKLNH,0
3wj5,B,430,460,30,QLFAKLLQKMTDLRQIVTEHVQLLQVIKKTE,0
3wj5,B,466,474,8,HPLLQEIYK,0
3wj5,B,205,226,21,GSESADLRALAKHLYDSYIKSF,0
3wj5,B,229,238,9,TKAKARAILT,0
3wj5,B,276,302,26,EVAIRIFQGCQFRSVEAVQEITEYAKS,0
3wj5,B,310,333,23,DLNDQVTLLKYGVHEIIYTMLASL,0
3wj5,B,350,356,6,REFLKSL,0
3wj5,B,360,376,16,FGDFMEPKFEFAVKFNA,0
3wj5,B,467,473,6,PLLQEIY,0
3o2w,H,79,83,4,EAEDL,0
3o2w,H,121,126,5,SDEQLK,0
3o2w,H,183,187,4,KADYE,0
3o2w,H,28,32,4,MFTNY,0
3o2w,H,61,64,3,DDFK,0
3o2w,H,83,87,4,KNEDT,0
3o2w,H,163,165,2,SGA,0
3o2w,H,196,203,7,SSLGT,0
3o2w,H,213,216,3,KPSN,0
1ar2,A,81,85,4,QPEDI,0
3q2m,A,7,19,12,QAQQLIELLKVHY,0
3q2m,A,62,73,11,NLSIIRLLHDSG,0
3q2m,A,114,131,17,TGKQWKQLGKVLRQIHET,0
3q2m,A,134,139,5,PISIQQ,0
3q2m,A,148,158,10,PKWREIVRSFY,0
3q2m,A,159,161,2,NQI,0
3q2m,A,168,181,13,DKLTAAFKSFFNQN,0
3q2m,A,181,199,18,NSAAIHRLVDTSEKLSKKI,0
3q2m,A,214,216,2,HAG,0
3q2m,A,239,244,5,KERDLM,0
3q2m,A,249,253,4,GVGNV,0
3q2m,A,256,268,12,KPHEIQYFYEGYG,0
3q2m,A,273,296,23,DKTILSYYRHERIVEDIAVYGQDL,0
3q2m,A,299,303,4,RNQNN,0
3q2m,A,305,316,11,SRLESFKYFKEM,0
3q2m,A,321,328,7,NVVEIAFA,0
2k8h,A,48,61,13,ALKKLIDTYCKKQG,0
2k8h,A,80,87,7,KTPEELGM,0
3wyp,C,115,121,6,TEANAWK,0
3wyp,C,118,121,3,NAWK,0
3wyp,C,14,18,4,EAGIT,0
4dk9,A,448,453,5,VQETLF,0
4dk9,A,455,466,11,DPWKLLIATIFL,0
4dk9,A,470,485,15,SGKMAIPVLWKFLEKY,0
4dk9,A,487,492,5,SAEVAR,0
4dk9,A,495,504,9,DWRDVSELLK,0
4dk9,A,508,526,18,LYDLRAKTIVKFSDEYLTK,0
4dk9,A,530,534,4,YPIEL,0
4dk9,A,538,549,11,GKYGNDSYRIFC,0
4dk9,A,552,556,4,EWKQV,0
4dk9,A,560,574,14,DHKLNKYHDWLWENH,0
2ze8,D,13,26,13,GKTDMAIQIAQETG,0
2ze8,D,34,40,6,RVQCCPQ,0
2ze8,D,41,46,5,IATGSG,0
2ze8,D,50,54,4,ESELQ,0
2ze8,D,65,69,4,PLTEG,0
2ze8,D,72,86,14,DAESAHRRLIFEVDW,0
2ze8,D,99,109,10,SISLLNCMAKS,0
2ze8,D,127,144,17,DSDAFLTRAKQRVAEMFA,0
2ze8,D,151,159,8,SLLEELAEL,0
2ze8,D,160,161,1,WN,0
2ze8,D,162,163,1,YP,0
2ze8,D,164,170,6,AARPILE,0
2ze8,D,174,185,11,GYRCAIRFARKH,0
2ze8,D,188,195,7,AISQLPNI,0
2ze8,D,196,222,26,DAGRHVELIEAIANEYLEHALSQERDF,0
2ze8,D,34,42,8,RVQCCPQIA,0
2ze8,D,49,53,4,LESEL,0
2ze8,D,151,161,10,SLLEELAELWN,0
2ze8,D,188,192,4,AISQL,0
2ze8,D,174,186,12,GYRCAIRFARKHD,0
2ze8,D,197,222,25,AGRHVELIEAIANEYLEHALSQERDF,0
2ze8,D,151,162,11,SLLEELAELWNY,0
3tz3,C,1489,1494,5,VKEWLQ,0
3tz3,C,1494,1503,9,QPKRYKAHLM,0
3tz3,C,1507,1509,2,YVY,0
3tz3,C,1510,1527,17,DFPELFRQASSSQWKNFS,0
3tz3,C,1533,1535,2,TDD,0
3tz3,C,1591,1595,4,FKIGS,0
3tz3,C,1597,1615,18,GPQEDEFFNKVTEYARKRG,0
3tz3,C,1648,1651,3,NPDK,0
3tz3,C,1659,1669,10,TSEGMETLKKF,0
3tz3,C,1671,1673,2,KEN,0
3tz3,C,1701,1720,19,GVECLRGSGLIAGATSRAYH,0
3tz3,C,1734,1743,9,GIGAYLVRLG,0
3tz3,C,1758,1767,9,GASALNKVLG,0
3tz3,C,1773,1779,6,SNLQLGG,0
3tz3,C,1779,1784,5,GTQIMY,0
3tz3,C,1795,1808,13,DDLAGVEKIVEWMS,0
3tz3,C,1843,1849,6,VRWMIEG,0
3tz3,C,1925,1941,16,FPNSAFKTAQAINDFNN,0
3tz3,C,1959,1965,6,GQRDMFN,0
3tz3,C,1966,1980,14,EVLKYGSFIVDALVD,0
3tz3,C,1997,2002,5,GGSWVV,0
3tz3,C,2003,2009,6,VDPTINA,0
3tz3,C,2026,2035,9,EPEGTVEIKF,0
3tz3,C,2036,2048,12,RREKLLDTMNRLD,0
3tz3,C,2074,2096,22,QLADRERELLPIYGQISLQFADL,0
3tz3,C,2099,2106,7,RSSRMVAK,0
3tz3,C,2114,2116,2,EWT,0
3tz3,C,2117,2144,27,EARRFFFWRLRRRLNEEYLIKRLSHQVG,0
3tz3,C,2147,2157,10,SRLEKIARIRS,0
3tz3,C,2167,2189,22,DDRQVATWIEENYKTLDDKLKGL,0
3tz3,C,1842,1849,7,DVRWMIEG,0
3tz3,C,2167,2178,11,DDRQVATWIEEN,0
3tz3,C,2178,2188,10,NYKTLDDKLKG,0
3tz3,C,1495,1503,8,PKRYKAHLM,0
3tz3,C,2117,2143,26,EARRFFFWRLRRRLNEEYLIKRLSHQV,0
4hyz,B,47,64,17,DKETVRKQAEDIEIAQS,0
4hyz,B,66,72,6,DYESWKS,0
4hyz,B,75,80,5,TKDLQS,0
4hyz,B,83,96,13,TEESYDSYLKILEK,0
1djl,B,870,881,11,NLDNAIDMIREA,0
1djl,B,889,896,7,GYGLCAAK,0
1djl,B,897,911,14,AQYPIADLVKMLTEQ,0
1djl,B,928,937,9,GQLNVLLAEA,0
1djl,B,940,942,2,PYD,0
1djl,B,947,951,4,MDEIN,0
1djl,B,952,957,5,HDFPDT,0
1djl,B,966,970,4,NDTVN,0
1djl,B,971,976,5,SAAQED,0
1djl,B,988,992,4,EVWKS,0
1djl,B,1011,1016,5,NPIFYK,0
1djl,B,1025,1039,14,DAKKTCDALQAKVRE,0
2zn8,A,26,36,10,SFLWNVFQRVD,0
2zn8,A,45,51,6,DTELQQA,0
2zn8,A,61,73,12,NPVTVRSIISMFD,0
2zn8,A,81,103,22,NFSEFTGVWKYITDWQNVFRTYD,0
2zn8,A,111,123,12,DKNELKQALSGFG,0
2zn8,A,129,139,10,QFHDILIRKFD,0
2zn8,A,147,169,22,AFDDFIQGCIVLQRLTDIFRRYD,0
2zn8,A,179,189,10,SYEQYLSMVFS,0
3mzo,C,2,13,11,GIHQYFQSLSDL,0
3mzo,C,29,51,22,SVAEHSYKVTSIAQFFGAVEEDA,0
3mzo,C,56,67,11,NWRALYEKALNH,0
3mzo,C,68,73,5,DYSELF,0
3mzo,C,85,108,23,TTELRELSEVEESTKNFISREI,0
3mzo,C,109,111,2,PAT,0
3mzo,C,112,121,9,FQPIYRHLLK,0
3mzo,C,127,151,24,TLEGKILAISDKVDLLYESFGEIQK,0
3mzo,C,156,171,15,NIFVEIYSEALATIYE,0
3mzo,C,175,191,16,ASVKYFLKEILPDLA,0
3mzo,C,194,198,4,GIEKT,0
3mzo,C,199,209,10,ELPQLTTEITT,0
3mzo,C,156,172,16,NIFVEIYSEALATIYEY,0
3mzo,C,199,211,12,ELPQLTTEITTKA,0
3mzo,C,90,108,18,ELSEVEESTKNFISREI,0
3mzo,C,199,208,9,ELPQLTTEIT,0
1t6p,H,43,53,10,TQVDIVEKLA,0
1t6p,H,68,78,10,NLGDVVSAARK,0
1t6p,H,87,103,16,SDEIRSKIDKSVEFLRS,0
1t6p,H,125,139,14,EDAISLQKALLEHQL,0
1t6p,H,161,177,16,PLEVVRGATIRVNSLT,0
1t6p,H,184,198,14,RLVVLEALTNFLNHG,0
1t6p,H,214,226,12,DLSPLSYIAAAIS,0
1t6p,H,246,253,7,AREAALF,0
1t6p,H,263,270,7,KEGLGLVN,0
1t6p,H,272,304,32,TAVSASATLALHDAHLSLLSQSLTATVEA,0
1t6p,H,307,316,9,HAGSFHPFLH,0
1t6p,H,322,336,14,HPTQIEVAGNIRKLL,0
1t6p,H,362,367,5,RYPLRT,0
1t6p,H,367,392,25,TSPQWLGPLVSDLIHAHAVLTIEAGQ,0
1t6p,H,402,405,3,VENK,0
1t6p,H,415,444,29,AAAVANTEKTRLGLAQIGKLNFTQLTEL,0
1t6p,H,460,464,4,DPSLS,0
1t6p,H,467,485,18,CKGLDIAAAAYTSELGHLA,0
1t6p,H,488,492,4,VTTHV,0
1t6p,H,505,560,55,LALISARRTTESNDVLSLLLATHLYCVLQAIDLRAIEFEFKKQFGPAIVSLIDQHF,0
1t6p,H,569,586,17,LRDELVEKVNKTLAKRLE,0
1t6p,H,593,612,19,LVPRWHDAFSFAAGTVVEVL,0
1t6p,H,618,645,27,SLAAVNAWKVAAAESAISLTRQVRETFW,0
1t6p,H,648,652,4,ASTSS,0
1t6p,H,653,658,5,PALSYL,0
1t6p,H,661,671,10,RTQILYAFVRE,0
1t6p,H,680,685,5,GDVFLG,0
1t6p,H,690,704,14,TIGSNVSKIYEAIKS,0
1t6p,H,707,716,9,INNVLLKLA,0
1t6p,H,87,101,14,SDEIRSKIDKSVEFL,0
1t6p,H,121,139,18,DTRTEDAISLQKALLEHQL,0
1t6p,H,184,197,13,RLVVLEALTNFLNH,0
1t6p,H,245,251,6,YAREAA,0
1t6p,H,265,270,5,GLGLVN,0
1t6p,H,322,337,15,HPTQIEVAGNIRKLLE,0
1t6p,H,415,445,30,AAAVANTEKTRLGLAQIGKLNFTQLTELN,0
1t6p,H,569,587,18,LRDELVEKVNKTLAKRLEQ,0
1t6p,H,592,612,20,DLVPRWHDAFSFAAGTVVEVL,0
1t6p,H,618,647,29,SLAAVNAWKVAAAESAISLTRQVRETFWSA,0
1t6p,H,648,657,9,ASTSSPALSY,0
1t6p,H,659,671,12,SPRTQILYAFVRE,0
1t6p,H,690,705,15,TIGSNVSKIYEAIKSG,0
1t6p,H,705,714,9,GRINNVLLK,0
1t6p,H,88,103,15,DEIRSKIDKSVEFLRS,0
1t6p,H,126,139,13,DAISLQKALLEHQL,0
1t6p,H,161,176,15,PLEVVRGATIRVNSL,0
1t6p,H,214,225,11,DLSPLSYIAAAI,0
1t6p,H,246,252,6,AREAAL,0
1t6p,H,263,269,6,KEGLGLV,0
1t6p,H,272,305,33,TAVSASATLALHDAHLSLLSQSLTATVEAV,0
1t6p,H,368,392,24,SPQWLGPLVSDLIHAHAVLTIEAGQ,0
1t6p,H,494,499,5,PAEAN,0
1t6p,H,570,586,16,RDELVEKVNKTLAKRLE,0
1t6p,H,706,716,10,RINNVLLKLA,0
1t6p,H,68,79,11,NLGDVVSAARKG,0
1t6p,H,125,137,12,EDAISLQKALLEH,0
1t6p,H,312,316,4,HPFLH,0
1t6p,H,505,561,56,LALISARRTTESNDVLSLLLATHLYCVLQAIDLRAIEFEFKKQFGPAIVSLIDQHFG,0
1t6p,H,613,615,2,SST,0
1t6p,H,246,250,4,AREA,0
1t6p,H,251,254,3,ALFN,0
1t6p,H,367,393,26,TSPQWLGPLVSDLIHAHAVLTIEAGQS,0
1t6p,H,646,647,1,SA,0
1t6p,H,662,672,10,TQILYAFVREE,0
1t6p,H,307,311,4,HAGSF,0
1t6p,H,312,317,5,HPFLHD,0
1t6p,H,573,586,13,LVEKVNKTLAKRLE,0
1t6p,H,689,704,15,VTIGSNVSKIYEAIKS,0
1t6p,H,465,466,1,YH,0
1t6p,H,662,671,9,TQILYAFVRE,0
1t6p,H,89,103,14,EIRSKIDKSVEFLRS,0
1t6p,H,124,139,15,TEDAISLQKALLEHQL,0
1t6p,H,247,253,6,REAALF,0
1t6p,H,560,565,5,FGSAT,0
1t6p,H,707,714,7,INNVLLK,0
1wlm,A,16,26,10,GLEESFRKFAI,0
1wlm,A,39,49,10,GKNWAKLCKDC,0
1wlm,A,58,70,12,TGTDVDIVFSKVK,0
1wlm,A,79,89,10,YEEFKKALEEL,0
1wlm,A,89,94,5,LATKRF,0
1wlm,A,98,111,13,SKEEAFDAICQLIA,0
4dus,A,-1,3,4,FVEMV,0
4dus,A,53,57,4,QRQLS,0
4dus,A,123,127,4,YAEIA,0
4dus,A,135,144,9,PFFDSLVKQT,0
4dus,A,180,182,2,DHS,0
4dus,A,216,221,5,DCKEYN,0
4dus,A,238,252,14,KKVFEAAVKSIKAAS,0
4dus,A,276,280,4,PWNIF,0
4dus,A,301,305,4,LPQQY,0
4dus,A,334,339,5,GAVIME,0
4dus,A,347,349,2,RAR,0
4dus,A,379,383,4,MEDCG,0
4p15,A,7,24,17,SERAQKVLALSQEEAIRL,0
4p15,A,30,42,12,GTEHILLGLIREG,0
4p15,A,44,53,9,GIAAKALQQL,0
4p15,A,56,69,13,GSDKLQKEVEGLVG,0
4p15,A,81,98,17,TPRAKKVIELSMDEARKL,0
4p15,A,104,116,12,GTEHILLGLIREG,0
4p15,A,118,127,9,GVAARVLNNL,0
4p15,A,130,144,14,SLNKARQQVLQLLGN,0
5uos,A,4,17,13,KVAELKQKIEDTLC,0
5uos,A,28,33,5,VAWYNE,0
5uos,A,57,62,5,AMFDRA,0
5uos,A,62,69,7,ALKPFLQS,0
5uos,A,71,75,4,HLRML,0
5uos,A,77,94,17,DPVDQCVAYHLGRVRESL,0
5uos,A,116,124,8,LAQTAAHVA,0
5uos,A,131,135,4,QRQDV,0
5uos,A,185,199,14,TRADRIALLEGFNFH,0
5uos,A,200,208,8,WRDWTYRDA,0
5uos,A,216,225,9,SEEQKAYFST,0
5uos,A,226,228,2,PPA,0
5uos,A,229,234,5,QRLALL,0
1xve,F,24,30,6,NAQEVHR,0
1xve,F,31,36,5,WLQSFN,0
1xve,F,63,84,21,IAKEYARMEAVKDERQFGSLQD,0
1xve,F,84,89,5,DALTRL,0
1xve,F,96,128,32,HPKWNETMKVVSNFLEVGEYNAIAATGMLWDSA,0
1xve,F,130,162,32,AAEQKNGYLAQVLDEIRHTHQCAYVNYYFAKNG,0
1xve,F,170,175,5,DARRTR,0
1xve,F,178,189,11,GPLWKGMKRVFS,0
1xve,F,189,194,5,SDGFIS,0
1xve,F,196,205,9,DAVECSLNLQ,0
1xve,F,207,212,5,VGEACF,0
1xve,F,212,227,15,FTNPLIVAVTEWAAAN,0
1xve,F,230,241,11,EITPTVFLSIET,0
1xve,F,242,259,17,DELRHMANGYQTVVSIAN,0
1xve,F,260,293,33,DPASAKYLNTDLNNAFWTQQKYFTPVLGMLFEYG,0
1xve,F,300,309,9,PWVKTWDRWV,0
1xve,F,315,321,6,GIWIGRL,0
1xve,F,322,325,3,GKYG,0
1xve,F,331,353,22,SLKDAKQDAYWAHHDLYLLAYAL,0
1xve,F,354,357,3,WPTG,0
1xve,F,365,376,11,DQEEMEWFEANY,0
1xve,F,378,393,15,GWYDHYGKIYEEWRAR,0
1xve,F,397,401,4,DPSSG,0
1xve,F,403,411,8,IPLMWFIEN,0
1xve,F,450,460,10,DQWGERMWLAE,0
1xve,F,461,464,3,PERY,0
1xve,F,468,474,6,NIFEQYE,0
1xve,F,477,485,8,ELSEVIAEL,0
1xve,F,508,516,8,TLDDIKRLN,0
1xve,F,521,526,5,NPVKAF,0
1xve,F,262,293,31,ASAKYLNTDLNNAFWTQQKYFTPVLGMLFEYG,0
1xve,F,300,310,10,PWVKTWDRWVY,0
1xve,F,382,393,11,HYGKIYEEWRAR,0
1xve,F,404,411,7,PLMWFIEN,0
1xve,F,508,514,6,TLDDIKR,0
1xve,F,521,527,6,NPVKAFN,0
1xve,F,13,24,11,DPEMAAVILKAL,0
1xve,F,47,54,7,TEYEALTV,0
1xve,F,84,88,4,GNETT,0
1xve,F,105,130,25,WHAPYVKDKAEEWRYTDRFLQGYSAD,0
1xve,F,131,136,5,GQIRAM,0
1xve,F,137,143,6,NPTWRDE,0
1xve,F,147,162,15,RYWGAFLFNEYGLFNA,0
1xve,F,163,170,7,HSQGAREA,0
1xve,F,172,204,32,SDVTRVSLAFWGFDKIDIAQMIQLERGFLAKIV,0
1xve,F,211,221,10,TAVPKAEWTNG,0
1xve,F,224,237,13,YKSARLAVEGLWQE,0
1xve,F,240,251,11,DWNESAFSVHAV,0
1xve,F,251,263,12,VYDALFGQFVRRE,0
1xve,F,264,269,5,FFQRLA,0
1xve,F,270,273,3,PRFG,0
1xve,F,276,300,24,LTPFFINQAQTYFQIAKQGVQDLYY,0
1xve,F,309,336,27,FSDYNRTVMRNWTGKWLEPTIAALRDFM,0
1xve,F,337,342,5,GLFAKL,0
1xve,F,348,367,19,DKEEITASLYRVVDDWIEDY,0
1xve,F,368,372,4,ASRID,0
1xve,F,376,386,10,DRDQIVKAVLA,0
1xve,F,47,52,5,TEYEAL,0
1xve,F,132,136,4,QIRAM,0
1xve,F,137,145,8,NPTWRDEFI,0
1xve,F,151,162,11,AFLFNEYGLFNA,0
1xve,F,240,250,10,DWNESAFSVHA,0
1xve,F,255,262,7,LFGQFVRR,0
1xve,F,309,337,28,FSDYNRTVMRNWTGKWLEPTIAALRDFMG,0
1xve,F,338,342,4,LFAKL,0
1xve,F,348,366,18,DKEEITASLYRVVDDWIED,0
1xve,F,367,371,4,YASRI,0
1xve,F,9,21,12,NDTRDAWVNKIAQ,0
1xve,F,24,40,16,TLEKAAEMLKQFRMDHT,0
1xve,F,52,72,20,DYLWIEAKLEEKVAVLKARAF,0
1xve,F,73,80,7,NEVDFRHK,0
1xve,F,86,100,14,DAKSVLDGTVAKMNA,0
1xve,F,103,119,16,DKWEAEKIHIGFRQAYK,0
1xve,F,124,144,20,PVNYFLDGERQLGTRLMELRN,0
1xve,F,151,160,9,PLEELRKQRG,0
1xve,F,9,20,11,NDTRDAWVNKIA,0
1xve,F,52,70,18,DYLWIEAKLEEKVAVLKAR,0
1xve,F,75,80,5,VDFRHK,0
1xve,F,86,101,15,DAKSVLDGTVAKMNAA,0
2cob,A,15,28,13,NSEILEEAISVVMS,0
2cob,A,32,41,9,SVSKAQSIYG,0
2cob,A,43,55,12,PHSTLEYKVKERL,0
1hx1,B,52,58,6,GDAAKNQ,0
1hx1,B,59,64,5,VAMNPT,0
1hx1,B,69,73,4,DAKRL,0
1hx1,B,80,87,7,DAVVQSDM,0
1hx1,B,88,90,2,KHW,0
1hx1,B,115,136,21,YPEEVSSMVLTKMKEIAEAYLG,0
1hx1,B,151,165,14,NDSQRQATKDAGTIA,0
1hx1,B,175,184,9,EPTAAAIAYG,0
1hx1,B,229,250,21,GGEDFDNRMVNHFIAEFKRKHK,0
1hx1,B,256,274,18,NKRAVRRLRTACERAKRTL,0
1hx1,B,299,306,7,RARFEELN,0
1hx1,B,306,313,7,NADLFRGT,0
1hx1,B,313,324,11,TLDPVEKALRDA,0
1hx1,B,327,331,4,DKSQI,0
1hx1,B,338,342,4,GGSTR,0
1hx1,B,343,352,9,IPKIQKLLQD,0
1hx1,B,367,381,14,EAVAYGAAVQAAILS,0
1hx1,B,152,189,37,SPQEEVELKKLKHLEKSVEKIADQLEELNKELTGIQQG,0
1hx1,B,192,202,10,PKDLQAEALCK,0
1hx1,B,203,222,19,LDRRVKATIEQFMKILEEID,0
1hx1,B,230,256,26,FKDSRLKRKGLVKKVQAFLAECDTVEQ,0
1i1f,D,57,84,27,PEYWDGETRKVKAHSQTHRVDLGTLRGY,0
1i1f,D,138,149,11,MAAQTTKHKWEA,0
1i1f,D,152,161,9,VAEQLRAYLE,0
1i1f,D,163,174,11,TCVEWLRRYLEN,0
1i1f,D,176,179,3,KETL,0
1i1f,D,225,227,2,TQD,0
1i1f,D,254,256,2,EQR,0
1i1f,D,50,52,2,PWI,0
5b74,B,26,35,9,SVKEVLDIAG,0
5b74,B,51,55,4,DSTLI,0
5b74,B,56,71,15,QPEDWVDLAETLYKNV,0
5b74,B,85,97,12,TLAYTSSMISFML,0
5b74,B,119,132,13,DAPLNLQTAIKFAT,0
5b74,B,213,223,10,GDIFRAAVELG,0
5b74,B,243,252,9,DLLQTIEELS,0
5b74,B,273,282,9,YKVGRLALRA,0
5b74,B,291,304,13,TKEATVTKLMWILG,0
5b74,B,308,317,9,NVEEIKVLMR,0
5kr7,B,22,27,5,SMEEFR,0
5kr7,B,28,39,11,EFNKYLAYMESK,0
5kr7,B,40,44,4,GAHRA,0
5kr7,B,61,66,5,YDDIDN,0
5kr7,B,96,105,9,VKEFRQLANS,0
5kr7,B,115,127,12,DYEDLERKYWKNL,0
5kr7,B,157,167,10,TVLDVVEEECG,0
5kr7,B,192,196,4,EDMDL,0
5kr7,B,214,216,2,PPE,0
5kr7,B,217,229,12,HGKRLERLAQGFF,0
5kr7,B,229,236,7,FPSSSQGC,0
5kr7,B,238,243,5,AFLRHK,0
5kr7,B,248,255,7,SPSVLKKY,0
5kr7,B,295,297,2,TVR,0
5kr7,B,298,305,7,WIDYGKVA,0
5kr7,B,319,327,8,MDIFVRKFQ,0
5kr7,B,330,336,6,RYQLWKQ,0
5kr7,B,248,256,8,SPSVLKKYG,0
2v72,A,7,11,4,PQSEM,0
2v72,A,23,28,5,PASSAI,0
2v72,A,126,128,2,GGF,0
2pka,Y,55,59,4,AAHCK,0
2pka,Y,164,172,8,QNTFCADAH,0
2pka,Y,230,246,16,KLIFYLDWIDDTITENP,0
4xdc,B,18,26,8,TILKFARDN,0
4xdc,B,76,92,16,SDAVNEKIKSRISQLLD,0
4xdc,B,107,117,10,CEFLKLVIKYK,0
4xdc,B,128,131,3,DKTE,0
4xdc,B,145,147,2,TKC,0
4xdc,B,151,162,11,GRCVNACGKNTE,0
4xdc,B,179,183,4,AEDEK,0
4xdc,B,184,188,4,CFDDT,0
4xdc,B,194,199,5,GQCIIA,0
4xdc,B,210,220,10,HMDRVKNALNA,0
4xdc,B,231,242,11,PSVRASIGELFN,0
4xdc,B,249,260,11,VTGKIYTALRQL,0
4xdc,B,268,290,22,INFGADMTIMEEATELVQRIENN,0
4xdc,B,300,311,11,CPGWVRQAENYY,0
4xdc,B,312,318,6,PELLNNL,0
4xdc,B,323,333,10,SPQQIFGTASK,0
4xdc,B,334,339,5,TYYPSI,0
4xdc,B,343,345,2,DPK,0
4xdc,B,356,363,7,TSKKFEAD,0
4xdc,B,381,391,10,TRELAKMIKDA,0
4xdc,B,394,398,4,PFAKL,0
4xdc,B,404,408,4,DPAMG,0
4xdc,B,411,416,5,SGAGAI,0
4xdc,B,417,419,2,FGA,0
4xdc,B,421,437,16,GGVMEAALRSAKDFAEN,0
4xdc,B,445,449,4,YKQVR,0
4xdc,B,473,483,10,GASNLFKFMKS,0
4xdc,B,484,488,4,GMINE,0
4xdc,B,502,506,4,GCVNG,0
4xdc,B,513,520,7,NPKDLEKV,0
4xdc,B,521,536,15,DIKKVRASVLYNQDEH,0
4xdc,B,541,544,3,KSHE,0
4xdc,B,545,555,10,NTALVKMYQNY,0
4xdc,B,561,568,7,EGRAHEIL,0
4xdc,B,62,64,2,CDT,0
4xdc,B,194,200,6,GQCIIAC,0
4xdc,B,268,289,21,INFGADMTIMEEATELVQRIEN,0
4xdc,B,421,436,15,GGVMEAALRSAKDFAE,0
4xdc,B,521,537,16,DIKKVRASVLYNQDEHL,0
1kpb,B,18,23,5,IFGKII,0
1kpb,B,63,65,2,ISV,0
1kpb,B,68,88,20,DDDESLLGHLMIVGKKCAADL,0
1kpb,B,68,87,19,DDDESLLGHLMIVGKKCAAD,0
1kpb,B,101,104,3,GSDG,0
3hsf,A,4,14,10,AFVNKLWSMVN,0
3hsf,A,36,48,12,RERFVQEVLPKYF,0
3hsf,A,54,63,9,ASFVRQLNMY,0
1jen,C,32,34,2,LRT,0
1jen,C,37,45,8,RSEWDILLK,0
1jen,C,87,89,2,LLK,0
1jen,C,91,102,11,LVPLLKLARDYS,0
1jen,C,120,122,2,PSH,0
1jen,C,130,138,8,FQEEIEFLN,0
1jen,C,186,189,3,PAVM,0
1jen,C,200,206,6,AKDVTRE,0
1jen,C,209,211,2,IRD,0
1jen,C,265,275,10,DDLIRKVVEVF,0
5meq,A,49,55,6,APWIEQE,0
5meq,A,56,85,29,GPEYWDGETRKVKAHSQTHRVDLGTLRGYY,0
5meq,A,137,150,13,DMAAQTTKHKWEAA,0
5meq,A,151,162,11,HVAEQLRAYLEG,0
5meq,A,162,175,13,GTCVEWLRRYLENG,0
5meq,A,175,180,5,GKETLQ,0
5meq,A,253,255,2,QEQ,0
1sy6,A,78,82,4,EAEDA,0
1sy6,A,120,126,6,SSEQLTS,0
1sy6,A,182,187,5,KDEYER,0
1sy6,A,28,32,4,TFTRY,0
1sy6,A,62,65,3,QKFK,0
1sy6,A,74,76,2,KSS,0
1sy6,A,87,91,4,TSEDS,0
1sy6,A,101,104,3,DDHY,0
1sy6,A,162,164,2,SGS,0
1sy6,A,206,209,3,PASS,0
1sy6,A,56,58,2,AKD,0
1sy6,A,173,178,5,SELEQS,0
1sy6,A,189,193,4,KPEDA,0
4dku,B,64,74,10,EVHNVWATHAC,0
4dku,B,98,116,18,NNMVEQMQEDVISLWDQSL,0
4dku,B,334,353,19,NGTKWNKVLKQVTEKLKEHF,0
4dku,B,368,373,5,DLEITM,0
4dku,B,475,484,9,IKDNWRSELY,0
4dku,B,64,73,9,EVHNVWATHA,0
4dku,B,335,353,18,GTKWNKVLKQVTEKLKEHF,0
2fmf,B,14,28,14,FSTMRRIVRNLLKEL,0
2fmf,B,38,47,9,DGVDALNKLQ,0
2fmf,B,64,75,11,DGLELLKTIRAD,0
2fmf,B,91,102,11,KKENIIAAAQAG,0
2fmf,B,112,128,16,TAATLEEKLNKIFEKLG,0
2fmf,B,202,213,11,QDQVDDLLDSLG,0
1zgf,A,15,19,4,HWHKD,0
1zgf,A,20,25,5,FPIAKG,0
1zgf,A,127,129,2,KYG,0
1zgf,A,130,135,5,DFGKAV,0
1zgf,A,154,156,2,KPG,0
1zgf,A,157,164,7,LQKVVDVL,0
1zgf,A,165,168,3,DSIK,0
1zgf,A,180,185,5,DPRGLL,0
1zgf,A,219,227,8,SSEQVLKFR,0
1xhj,A,7,27,20,TMFDQVAEVIERLRPFLLRDG,0
1xhj,A,52,70,18,PSSTITLKAGIERALHEEV,0
3haz,B,15,27,12,DDAEIAARLLPAS,0
3haz,B,30,49,19,SPPQEARIHRTATRLIEAIR,0
3haz,B,57,65,8,GVEDMLREF,0
3haz,B,68,84,16,STKEGLALMVLAEALLR,0
3haz,B,87,98,11,DARTADQFIEDK,0
3haz,B,103,114,11,DFIHHETKSTAF,0
3haz,B,115,116,1,LV,0
3haz,B,117,121,4,NASAW,0
3haz,B,137,148,11,DGTIGRLVKRLG,0
3haz,B,148,167,19,GAPAVRTATRQAMRLMGNHF,0
3haz,B,172,181,9,TIEQALERGK,0
3haz,B,201,222,21,TAADARRYFDAYASAIETIGKA,0
3haz,B,237,242,5,KLSALH,0
3haz,B,246,248,2,EAI,0
3haz,B,249,271,22,SRARVMVELVPQLLDLAQRAKAH,0
3haz,B,281,283,2,EAD,0
3haz,B,284,297,13,RLELSLDVIAATLA,0
3haz,B,298,302,4,DPSLK,0
3haz,B,317,332,15,RASAVIDYVDALARAH,0
3haz,B,345,356,11,YWDTEIKRAQER,0
3haz,B,366,383,17,RKAMTDLNYVACASKLLA,0
3haz,B,396,408,12,NALTVATVLEMAE,0
3haz,B,422,433,11,GEALYEQLAKDH,0
3haz,B,449,462,13,DLLAYLVRRLLENG,0
3haz,B,466,472,6,SFVAQAA,0
3haz,B,477,482,5,PVPALL,0
3haz,B,484,490,6,RPADAIV,0
3haz,B,491,495,4,RPQAA,0
3haz,B,502,506,4,LPCDL,0
3haz,B,521,535,14,ARTALDQLLTDVKAE,0
3haz,B,546,566,20,TPDQAHAAVAAARAGFAGWSR,0
3haz,B,568,586,18,PAGIRAAALEQAAHLLESR,0
3haz,B,586,597,11,RSAHFIALLQRE,0
3haz,B,601,628,27,TLDDALSELREAADFCRYYAAQGRKLFG,0
3haz,B,661,674,13,LAIFLGQVTAALMA,0
3haz,B,686,701,15,TPRIAREAVALLHEAG,0
3haz,B,713,723,10,DGRIGAALTAH,0
3haz,B,734,748,14,STEVARSINRALAAK,0
3haz,B,772,786,14,LPEQVADDVVTSAFR,0
3haz,B,787,790,3,SAGQ,0
3haz,B,802,818,16,EDVADRMIEMVAGAARE,0
3haz,B,836,854,18,DVEAKQRLDAHIARMKTEA,0
3haz,B,877,881,4,EAGQL,0
3haz,B,896,898,2,RPE,0
3haz,B,899,910,11,NLERVLRAIERT,0
3haz,B,922,933,11,IDDSIEAIIDRV,0
3haz,B,957,961,4,NGLSG,0
3haz,B,971,974,3,YLAR,0
3haz,B,986,989,3,AAAG,0
3haz,B,172,180,8,TIEQALERG,0
3haz,B,201,221,20,TAADARRYFDAYASAIETIGK,0
3haz,B,249,270,21,SRARVMVELVPQLLDLAQRAKA,0
3haz,B,284,298,14,RLELSLDVIAATLAD,0
3haz,B,299,302,3,PSLK,0
3haz,B,546,567,21,TPDQAHAAVAAARAGFAGWSRT,0
3haz,B,703,705,2,PKS,0
5cb4,F,10,29,19,GQAGVQIGNACWELYCLEHG,0
5cb4,F,47,51,4,DSFNT,0
5cb4,F,72,80,8,PTVIDEVRT,0
5cb4,F,88,90,2,HPE,0
5cb4,F,102,108,6,NYARGHY,0
5cb4,F,110,113,3,IGKE,0
5cb4,F,114,128,14,IIDLVLDRIRKLADQ,0
5cb4,F,143,161,18,GGTGSGFTSLLMERLSVDY,0
5cb4,F,174,178,4,APQVS,0
5cb4,F,182,195,13,VEPYNSILTTHTTL,0
5cb4,F,196,198,2,EHS,0
5cb4,F,206,217,11,NEAIYDICRRNL,0
5cb4,F,223,244,21,TYTNLNRLISQIVSSITASLRF,0
5cb4,F,251,260,9,DLTEFQTNLV,0
5cb4,F,287,295,8,SVAEITNAC,0
5cb4,F,296,301,5,FEPANQ,0
5cb4,F,306,310,4,DPRHG,0
5cb4,F,324,337,13,VPKDVNAAIATIKT,0
5cb4,F,384,400,16,IAEAWARLDHKFDLMYA,0
5cb4,F,404,410,6,FVHWYVG,0
5cb4,F,414,437,23,EEGEFSEAREDMAALEKDYEEVGV,0
5cb4,F,10,28,18,GQCGNQIGAKFWEVISDEH,0
5cb4,F,40,44,4,SDLQL,0
5cb4,F,46,49,3,RINV,0
5cb4,F,70,78,8,PGTMDSVRS,0
5cb4,F,81,85,4,FGQIF,0
5cb4,F,86,88,2,RPD,0
5cb4,F,100,106,6,NWAKGHY,0
5cb4,F,112,127,15,LVDSVLDVVRKESESC,0
5cb4,F,142,159,17,GTGSGMGTLLISKIREEY,0
5cb4,F,172,176,4,SPKVS,0
5cb4,F,180,196,16,VEPYNATLSVHQLVENT,0
5cb4,F,204,214,10,NEALYDICFRT,0
5cb4,F,221,237,16,TYGDLNHLVSATMSGVT,0
5cb4,F,237,242,5,TTCLRF,0
5cb4,F,249,258,9,DLRKLAVNMV,0
5cb4,F,285,294,9,TVPELTQQMF,0
5cb4,F,295,299,4,DSKNM,0
5cb4,F,304,308,4,DPRHG,0
5cb4,F,322,337,15,SMKEVDEQMLNVQNKN,0
5cb4,F,338,341,3,SSYF,0
5cb4,F,374,390,16,IQELFKRISEQFTAMFR,0
5cb4,F,395,400,5,LHWYTG,0
5cb4,F,404,425,21,DEMEFTEAESNMNDLVSEYQQY,0
5cb4,F,426,428,2,QDA,0
5cb4,F,114,127,13,IIDLVLDRIRKLAD,0
5cb4,F,143,162,19,GGTGSGFTSLLMERLSVDYG,0
5cb4,F,277,282,5,SAEKAY,0
5cb4,F,287,294,7,SVAEITNA,0
5cb4,F,295,301,6,CFEPANQ,0
5cb4,F,414,435,21,EEGEFSEAREDMAALEKDYEEV,0
5cb4,F,70,79,9,PGTMDSVRSG,0
5cb4,F,107,126,19,TEGAELVDSVLDVVRKESES,0
5cb4,F,404,428,24,DEMEFTEAESNMNDLVSEYQQYQDA,0
5cb4,F,46,139,93,SLEEIQKKLEAAEERRKYQEAELLKHLAEKREHEREVIQKAIEENNNFIKMAKEKLAQKMESNKENREAHLAAMLERLQEKDKHAEEVRKNKEL,0
5cb4,F,11,24,13,SSVYAEVSRLLLAT,0
5cb4,F,48,52,4,PFGRL,0
5cb4,F,68,73,5,ADKLCR,0
5cb4,F,73,84,11,RKASLVKLIKTS,0
5cb4,F,127,140,13,EREVFLAAYNRRRE,0
5cb4,F,165,177,12,EASELLDFIDEQG,0
5cb4,F,242,247,5,NHCIQK,0
5cb4,F,264,276,12,FEEFNQYLMDALN,0
5cb4,F,278,283,5,TLENSI,0
5cb4,F,283,303,20,ILLQIKHIIRSCLMCIEPAIS,0
5cb4,F,342,355,13,LYAELCQGIVDVAI,0
2f6l,B,39,52,13,LAELVDAAAERLEV,0
2f6l,B,52,64,12,VADPVAAFKWRAQ,0
2f6l,B,69,87,18,DSGRVEQQLAKLGEDARSQ,0
2f6l,B,90,119,29,DPDYVTRVFDDQIRATEAIEYSRFSDWKLN,0
2f6l,B,120,123,3,PASA,0
2f6l,B,130,151,21,LSASRSAIDSLNNRMLSQIWSH,0
2f6l,B,151,156,5,HWSLLS,0
2f6l,B,159,175,16,SCAAQLDRAKRDIVRSR,0
2f6l,B,178,189,11,DSLYQRALTTAT,0
2f6l,B,129,151,22,DLSASRSAIDSLNNRMLSQIWSH,0
2f6l,B,190,195,5,QSYCQA,0
1ka0,A,3,31,28,LERELLVATQAVRKASLLTKRIQSEVISH,0
1ka0,A,47,64,17,TGDYAAQTIIINAIKSNF,0
1ka0,A,79,101,22,SDAFVSGILNEIKANDEVYNKNY,0
1ka0,A,117,127,10,SLEDVRQIIDF,0
1ka0,A,146,152,6,GTKGFLR,0
1ka0,A,179,184,5,VLSSYG,0
1ka0,A,227,230,3,DTKD,0
1ka0,A,243,255,12,SHDEQTAIKNKLN,0
1ka0,A,265,274,9,QAKYCLLALG,0
1ka0,A,291,294,3,KIWD,0
1ka0,A,295,305,10,HAAGNVIVHEA,0
1ka0,A,337,354,17,PRELHDLVVSTSCDVIQS,0
1qsj,D,1012,1031,19,EQNMIGMTPTVIAVHYLDQT,0
1qsj,D,1033,1038,5,QWEKFG,0
1qsj,D,1041,1057,16,KRQEALELIKKGYTQQL,0
1qsj,D,1075,1090,15,STWLTAYVSRVFSLAA,0
1qsj,D,1096,1111,15,DSQVLCGAVKWLILEK,0
1qsj,D,1126,1130,4,HQEMI,0
1qsj,D,1130,1135,5,IGGFRN,0
1qsj,D,1138,1154,16,EADVSLTAFVLIALQEA,0
1qsj,D,1154,1159,5,ARDICE,0
1qsj,D,1164,1181,17,SLPGSINKAGEYLEASYL,0
1qsj,D,1185,1199,14,RPYTVAIAGYALALM,0
1qsj,D,1203,1212,9,EEPYLTKFLN,0
1qsj,D,1225,1244,19,QQLYNVEATSYALLALLLLK,0
1qsj,D,1248,1259,11,SVPPVVRWLNDE,0
1qsj,D,1268,1285,17,STQATFMVFQALAQYRAD,0
1qsj,D,1041,1058,17,KRQEALELIKKGYTQQLA,0
1ved,A,4,15,11,GRCELAAAMKRH,0
1ved,A,19,23,4,NYRGY,0
1ved,A,24,37,13,SLGNWVCAAKFESN,0
1ved,A,79,85,6,PCSALLS,0
1ved,A,88,100,12,ITASVNCAKKIVS,0
1ved,A,101,102,1,DG,0
1ved,A,103,107,4,NGMNA,0
1ved,A,108,115,7,WVAWRNRC,0
1ved,A,119,124,5,DVQAWI,0
3pq1,B,63,76,13,FSEQNERREQAQR,0
3pq1,B,89,96,7,NKFLKYLS,0
3pq1,B,97,99,2,QFG,0
3pq1,B,124,129,5,IGSLQN,0
3pq1,B,173,181,8,NKQLFELLC,0
3pq1,B,185,198,13,SIDDQLNTLLKEFQ,0
3pq1,B,200,219,19,TEENTKLRYLTCSLIEDAA,0
3pq1,B,231,234,3,GSSV,0
3pq1,B,276,295,19,SERIATQKILSVLGECLDHF,0
3pq1,B,332,345,13,IALTSSELLYIYGA,0
3pq1,B,347,364,17,DSRVRALVFSVRCWARAH,0
3pq1,B,376,390,14,TNFSLTVIFFLQR,0
3pq1,B,402,407,5,LKTLAD,0
3pq1,B,436,448,12,TLELLLKEFFEYF,0
3pq1,B,449,451,2,GNF,0
3pq1,B,491,511,20,SQSQLQKFVDLARESAWILQQ,0
3pq1,B,527,531,4,LVSLL,0
3pq1,B,186,198,12,IDDQLNTLLKEFQ,0
3pq1,B,278,295,17,RIATQKILSVLGECLDHF,0
3pq1,B,491,515,24,SQSQLQKFVDLARESAWILQQEDTD,0
3pq1,B,526,531,5,GLVSLL,0
1xgs,B,3,23,20,TEKLMKAGEIAKKVREKAIKL,0
1xgs,B,30,44,14,LLELAESIEKMIMEL,0
1xgs,B,106,121,15,ELMEAAKEALNAAISV,0
1xgs,B,128,142,14,IKELGKAIENEIRKR,0
1xgs,B,217,229,12,AQARFLLAKIKRE,0
1xgs,B,238,240,2,RWL,0
1xgs,B,246,259,13,EGQLKLALKTLEKA,0
1xgs,B,30,43,13,LLELAESIEKMIME,0
1xgs,B,237,240,3,YRWL,0
1xgs,B,246,258,12,EGQLKLALKTLEK,0
5n7e,B,491,522,31,DLEKGLEMRKWVLSGILASEETYLSHLEALLL,0
5n7e,B,523,532,9,PMKPLKAAAT,0
5n7e,B,539,547,8,TSQQIETIF,0
5n7e,B,549,570,21,KVPELYEIHKEFYDGLFPRVQQ,0
5n7e,B,577,587,10,VGDLFQKLASQ,0
5n7e,B,587,612,25,QLGVYRAFVDNYGVAMEMAEKCCQAN,0
5n7e,B,612,619,7,NAQFAEIS,0
5n7e,B,639,652,13,LETLLYKPVDRVTR,0
5n7e,B,652,662,10,RSTLVLHDLLK,0
5n7e,B,669,688,19,PDHPLLQDALRISQNFLSSI,0
2iuh,A,6,10,4,SLQNA,0
2iuh,A,18,26,8,SREEVNEKL,0
2iuh,A,79,88,9,SVVELINHYR,0
2iuh,A,91,95,4,SLAQY,0
2iuh,A,96,100,4,NPKLD,0
5gr4,A,6,15,9,SADQVNQIIY,0
5gr4,A,20,24,4,DPFEI,0
5gr4,A,56,59,3,PTER,0
5gr4,A,110,119,9,TDEDIYLFSE,0
5gr4,A,124,128,4,RIYEK,0
5gr4,A,160,162,2,FNN,0
5gr4,A,225,229,4,DIDNI,0
5gr4,A,234,243,9,DEEWLEKRRN,0
5gr4,A,245,249,4,DPLKQ,0
5gr4,A,293,309,16,SYYELAEKLIPYVKDMG,0
5gr4,A,323,327,4,FDGSW,0
5gr4,A,339,342,3,SRFG,0
5gr4,A,343,357,14,RPEDFMYFVDKCHEN,0
5gr4,A,390,394,4,DPRIG,0
5gr4,A,408,427,19,RHEVRNFLVANVLFWFDKYH,0
5gr4,A,436,441,5,VASMLY,0
5gr4,A,461,479,18,HIEAVSFIREVNTLLFEYF,0
5gr4,A,498,502,4,PVYDG,0
5gr4,A,511,524,13,DMGWMHDMLDYFNI,0
5gr4,A,525,532,7,DPYFRQYH,0
5gr4,A,533,538,5,QNNVTF,0
5gr4,A,538,543,5,FSMAYY,0
5gr4,A,544,546,2,YNE,0
5gr4,A,553,557,4,SHDEI,0
5gr4,A,564,568,4,MLGKM,0
5gr4,A,571,589,18,DEWQKYANVRALFTYMYTH,0
5gr4,A,598,602,4,SMEFG,0
5gr4,A,614,619,5,EWHLLQ,0
5gr4,A,620,640,20,YEPHQQLKQFFTDLNALYQQE,0
5gr4,A,641,644,3,PALY,0
5gr4,A,649,651,2,EYH,0
5gr4,A,674,677,3,DPND,0
5gr4,A,711,715,4,AKQYG,0
3ial,B,47,59,12,TFADWFDAIMDAA,0
3ial,B,75,96,21,RPYGFFMENAIMRLCEEEYAKV,0
3ial,B,109,113,4,ESFLK,0
3ial,B,115,123,8,ESDHIKGFE,0
3ial,B,147,159,12,SETAIYSMFSKWV,0
3ial,B,161,165,4,SYKDL,0
3ial,B,203,223,20,TAEDAVSQLSDYWKVIDTIFS,0
3ial,B,237,240,3,CWDR,0
3ial,B,270,276,6,QRFSSTF,0
3ial,B,299,310,11,TRVLACALSIHG,0
3ial,B,318,322,4,PPLIA,0
3ial,B,338,359,21,NQESDQQVLGKVNEIADTLKSK,0
3ial,B,373,384,11,SMGDKLYYYELK,0
3ial,B,394,399,5,QRDLAN,0
3ial,B,410,414,4,GKDQK,0
3ial,B,419,424,5,ITEVMK,0
3ial,B,439,463,24,NVIKDELDAYKARLKEKAFAFHNSM,0
3ial,B,469,480,11,SFDEIVACIENK,0
3ial,B,492,494,2,EAD,0
3ial,B,495,507,12,GEVWDKKLKDACS,0
2xc9,A,10,20,10,YFYAQVEEVLN,0
2xc9,A,21,24,3,PSLK,0
2xc9,A,47,52,5,NYEARK,0
2xc9,A,60,68,8,PIVEAKKIL,0
2xc9,A,77,94,17,RKEVYQQVSSRIMNLLRE,0
2xc9,A,112,115,3,SDKV,0
2xc9,A,116,137,21,RDYREAYNLGLEIKNKILEKEK,0
2xc9,A,147,159,12,NKVFAKIAADMAK,0
2xc9,A,167,178,11,DDEEVKRLIREL,0
2xc9,A,180,183,3,IADV,0
2xc9,A,187,197,10,GNITAEKLKKL,0
2xc9,A,202,208,6,LVDTLSI,0
2xc9,A,209,218,9,EFDKLKGMIG,0
2xc9,A,218,230,12,GEAKAKYLISLAR,0
2xc9,A,257,277,20,NLEEIKPYLFRAIEESYYKLD,0
2xc9,A,307,325,18,SKETAYSESVKLLQKILEE,0
1buo,A,16,30,14,HPTGLLCKANQMRLA,0
1buo,A,49,55,6,RTVLACT,0
1buo,A,57,63,6,KMFEILF,0
1buo,A,77,89,12,PKTFQQILEYAYT,0
1buo,A,96,109,13,AEDLDDLLYAAEIL,0
1buo,A,112,126,14,EYLEEQCLKMLETIQ,0
2z1t,A,24,30,6,LFLRHFD,0
2z1t,A,68,82,14,IGTLAVHGTVNDVSM,0
2z1t,A,101,120,19,DMDILERVVASMGKAAREAG,0
2z1t,A,173,183,10,GDHGLTILSQR,0
2z1t,A,199,210,11,LNRVVEKLVLEV,0
2z1t,A,222,236,14,GGLATTLNEIAGQSQ,0
2z1t,A,244,246,2,TAV,0
2z1t,A,249,259,10,RESVRNGCSFL,0
2z1t,A,280,290,10,RAEAALAVLRE,0
2z1t,A,293,297,4,HGEHA,0
5tqr,B,5,10,5,DSAEWE,0
5tqr,B,169,173,4,APEHE,0
5tqr,B,281,285,4,GPLDA,0
5tqr,B,357,377,20,LARFGEYARFMADLKEAQQSY,0
5tqr,B,393,398,5,AQAQQV,0
5tqr,B,491,503,12,SRETLQAWADMYD,0
5tqr,B,198,211,13,TVDKIASALSVLAE,0
5tqr,B,211,231,20,EEVPQNHSRLVNFLLEETEKR,0
5tqr,B,360,378,18,PRSQKIAKRAQAEYAATLA,0
5tqr,B,380,389,9,YLEPWLRKLN,0
5tqr,B,394,405,11,TKSNLIRFMASQ,0
5tqr,B,406,409,3,PESD,0
5tqr,B,415,424,9,QQKSNLLDTY,0
5tqr,B,430,449,19,SPQAVRNASMFTEAWDRVFN,0
5tqr,B,458,464,6,ALRDILM,0
5tqr,B,469,474,5,VEPIFD,0
5tqr,B,492,500,8,LMQKVIDAL,0
5tqr,B,500,507,7,LGSYTTLG,0
5tqr,B,531,536,5,SLEEIG,0
5tqr,B,537,551,14,GLMPSLRRKWAAQIE,0
5tqr,B,591,606,15,SENEVGTLEWMFATIG,0
5tqr,B,612,621,9,RPECFVGAIL,0
5tqr,B,626,636,10,WDVHRKLQELD,0
5tqr,B,666,671,5,DWADAT,0
5tqr,B,675,679,4,EHAVR,0
5tqr,B,697,702,5,CPCASA,0
5tqr,B,746,751,5,CICVQL,0
5tqr,B,764,769,5,GARERA,0
5tqr,B,770,774,4,DPENA,0
5tqr,B,778,782,4,VLHST,0
5tqr,B,787,792,5,VALQRG,0
5tqr,B,832,844,12,SHDEGVRREHRRG,0
5tqr,B,874,879,5,NLSRYI,0
5tqr,B,924,932,8,NLTKKLVER,0
5tqr,B,2582,2595,13,DSWLLLKHRDNLQD,0
5tqr,B,2600,2617,17,RPEEKEFLQEWDAFILRR,0
5tqr,B,2621,2623,2,SEQ,0
5tqr,B,2624,2636,12,YLPRYFLRFVREK,0
5tqr,B,2636,2643,7,KADWLVSK,0
5tqr,B,2643,2660,17,KRSRGEEFSKLVATLLAR,0
5tqr,B,2664,2683,19,PERVVIEATQVLNDARGRLR,0
3hsu,A,1,10,9,NSINACLAAA,0
3hsu,A,19,26,7,SEGWDMDG,0
3hsu,A,30,34,4,NLRVD,0
3hsu,A,45,60,15,STEDIAAAVQCGLDAG,0
3hsu,A,109,120,11,RLGYTALELLDQ,0
3hsu,A,134,142,8,GVGGHVLGG,0
3hsu,A,147,152,5,ATHTHG,0
3hsu,A,153,156,3,LTLD,0
3hsu,A,178,186,8,NADLFWALR,0
3hsu,A,219,237,18,NRKQHVAGLKALQDWAQNT,0
3hsu,A,262,277,15,NAKDLKKILQPIMKKA,0
3hsu,A,290,296,6,DWYGQIN,0
3hsu,A,327,341,14,SDEAIQAFVDYKFDN,0
3hsu,A,363,367,4,ALAAV,0
3hsu,A,404,416,12,FEFMQGFVATIED,0
3hsu,A,417,418,1,TL,0
3hsu,A,419,423,4,PEDRK,0
3hsu,A,426,430,4,YFNYA,0
3hsu,A,435,445,10,TKEEAQKLYWR,0
3hsu,A,447,459,12,NLEKLQAIKAKYD,0
1ikg,A,7,21,14,DDTGLQAVLHTALSQ,0
1ikg,A,62,78,16,SVTKSFSAVVLLQLVDE,0
1ikg,A,86,91,5,SVNTYL,0
1ikg,A,101,107,6,TVRQVMS,0
1ikg,A,115,120,5,YTNDMF,0
1ikg,A,122,131,9,QTVPGFESVR,0
1ikg,A,136,146,10,SYQDLITLSLK,0
1ikg,A,160,176,16,SNTNFVVAGMLIEKLTG,0
1ikg,A,178,187,9,SVATEYQNRI,0
1ikg,A,234,238,4,AQSAG,0
1ikg,A,243,256,13,STQDLDTFFSALMS,0
1ikg,A,261,269,8,SAAQLAQMQ,0
1ikg,A,328,344,16,NVNVLNTMARTLESAFC,0
5usn,A,7,11,4,LLSQI,0
5usn,A,72,80,8,WDEHDFYCR,0
5usn,A,127,129,2,EPE,0
5usn,A,130,143,13,LNEIKSRKRLYVQN,0
4nng,A,280,291,11,YFQHMRHFARTH,0
4nng,A,324,326,2,SEL,0
4nng,A,333,337,4,VPDQV,0
4nng,A,362,369,7,LKQANEDY,0
4nng,A,374,378,4,DPAKY,0
4nng,A,380,384,4,MADSY,0
4nng,A,407,434,27,FEKQRAEWEARYAEAERRHKMHTAQMEK,0
1shl,B,79,83,4,DKVTG,0
1shl,B,89,105,16,GTDKDAEALFKCFRSLG,0
1shl,B,115,129,14,SCAKMQDLLKKASEE,0
1shl,B,159,164,5,IKDLTA,0
1shl,B,165,167,2,HFR,0
1shl,B,239,253,14,SWFVQALCSILEEHG,0
1shl,B,257,273,16,EIMQILTRVNDRVARHF,0
1shl,B,115,128,13,SCAKMQDLLKKASE,0
1shl,B,159,165,6,IKDLTAH,0
1shl,B,171,175,4,CKTLL,0
1shl,B,257,272,15,EIMQILTRVNDRVARH,0
1e46,P,2,20,18,ERNKLARQIIDTCLEMTRL,0
1e46,P,46,50,4,PYEKL,0
1e46,P,51,55,4,TESHI,0
1e46,P,71,73,2,SSS,0
1e46,P,74,84,10,WRFHMAAYQSR,0
1e46,P,95,102,7,AVHCTAVS,0
1e46,P,112,119,7,HYMIAAAG,0
1e46,P,133,144,11,TRELSEHVALAL,0
1e46,P,163,186,23,NLEKALWLAHEVEVLAQLYLTTLA,0
1e46,P,195,205,10,SDEEIAVVLEK,0
3dbj,H,3,15,12,SVVTKSIVNADAE,0
3dbj,H,20,32,12,SPGELDRIKNFVS,0
3dbj,H,33,63,30,TGERRLRIAQTLTENRERIVKQAGDQLFQKR,0
3dbj,H,76,102,26,YGEEMTATCLRDLDYYLRLVTYGIVAG,0
3dbj,H,104,112,8,VTPIEEIGL,0
3dbj,H,114,123,9,GVREMYNSLG,0
3dbj,H,125,142,17,PIPAVAEGIRAMKNVACS,0
3dbj,H,145,171,26,SAEDAAEAGSYFDFVIG,0
3dbj,H,3,14,11,DAITAVINASDV,0
3dbj,H,20,47,27,DTAAMEKLKAYFATGELRVRAASVISAN,0
3dbj,H,49,60,11,ANIVKEAVAKSL,0
3dbj,H,77,102,25,TTRRYAACIRDLDYYLRYATYAMLAG,0
3dbj,H,104,111,7,PSILDERV,0
3dbj,H,114,123,9,GLKETYNSLG,0
3dbj,H,125,145,20,PIAATVQAIQAMKEVTASLVG,0
3dbj,H,145,172,27,GADAGKEMGIYFDYICSG,0
3dbj,H,63,67,4,SDITR,0
3dbj,H,33,47,14,TGERRLRIAQTLTEN,0
3dbj,H,47,63,16,NRERIVKQAGDQLFQKR,0
2wjh,B,15,24,9,GKSTIFNALT,0
2wjh,B,67,81,14,SIDEIIARDYIINEK,0
2wjh,B,94,96,2,LER,0
2wjh,B,97,107,10,NLYLTLQLMEM,0
2wjh,B,117,124,7,KMDLAKSL,0
2wjh,B,129,138,9,DVDKLEKILG,0
2wjh,B,146,149,3,AAKK,0
2wjh,B,151,163,12,GIEELKKAISIAV,0
2wjh,B,67,80,13,SIDEIIARDYIINE,0
2wjh,B,93,107,14,ALERNLYLTLQLMEM,0
2wjh,B,151,164,13,GIEELKKAISIAVK,0
3lf0,C,9,11,2,KPF,0
3lf0,C,12,23,11,TLDDVKTSLEDA,0
3lf0,C,67,82,15,DSIVDKVVDSIVRAAR,0
3lf0,C,107,112,5,RGHDAL,0
3lf0,C,12,22,10,TLDDVKTSLED,0
3lf0,C,69,82,13,IVDKVVDSIVRAAR,0
3lf0,C,12,24,12,TLDDVKTSLEDAG,0
1tda,A,1,16,15,MLEQPYLDLAKKVLDE,0
1tda,A,54,67,13,FGLIKSELLWFLHG,0
1tda,A,71,78,7,IRFLLQHR,0
1tda,A,83,91,8,DEWAFEKWV,0
1tda,A,113,131,18,EFAAVYHEEMAKFDDRVLH,0
1tda,A,133,140,7,DAFAAKYG,0
1tda,A,145,152,7,VYGSQWRA,0
1tda,A,162,174,12,DQLGDVIEQIKTH,0
1tda,A,186,191,5,NPEDVP,0
1tda,A,225,245,20,GVPFNIASYALLTHLVAHECG,0
1tda,A,264,272,8,HLDQIKEQL,0
4owv,B,26,36,10,SWPQILGRLTD,0
4owv,B,43,54,11,GQAAWAMDQIMT,0
4owv,B,58,73,15,RPAQIAAFAVAMTMKA,0
4owv,B,75,89,14,TADEVGELAGVMLSH,0
4owv,B,117,129,12,NLSTMAAIVVAAA,0
4owv,B,146,154,8,GGADTLEAL,0
4owv,B,161,172,11,GPDLVARSLAEV,0
4owv,B,179,183,4,APRFH,0
4owv,B,186,197,11,YRHAAAVRREIG,0
4owv,B,200,209,9,TVFNLLGPLT,0
4owv,B,223,237,14,FADLAEVMAGVFAAR,0
4owv,B,275,280,5,DPAGFG,0
4owv,B,285,290,5,QLDQLA,0
4owv,B,293,306,13,DAQANAAAVRAVLG,0
4owv,B,310,329,19,GPVRDAVVLNAAGAIVAHAG,0
4owv,B,335,353,18,EWLPAWEEGLRRASAAIDT,0
4owv,B,354,370,16,GAAEQLLARWVRFGRQI,0
4owv,B,75,90,15,TADEVGELAGVMLSHA,0
4owv,B,115,129,14,TVNLSTMAAIVVAAA,0
4owv,B,161,173,12,GPDLVARSLAEVG,0
4owv,B,223,236,13,FADLAEVMAGVFAA,0
4owv,B,285,289,4,QLDQL,0
4owv,B,310,332,22,GPVRDAVVLNAAGAIVAHAGLSS,0
4owv,B,354,369,15,GAAEQLLARWVRFGRQ,0
4x7r,B,16,32,16,GGMTSSMFNRSKEFYDA,0
4x7r,B,46,57,11,NYDEIIKALKKQ,0
4x7r,B,69,79,10,VFEYFKQISNN,0
4x7r,B,85,96,11,NKLLYKHISERL,0
4x7r,B,202,215,13,NNLALCVYYLEKLI,0
4x7r,B,227,229,2,GPG,0
4x7r,B,230,236,6,SFPKMFN,0
4x7r,B,263,272,9,KKSEKYIIEN,0
4x7r,B,273,276,3,ANKI,0
4x7r,B,283,294,11,TEAQRLDILNQF,0
4x7r,B,328,331,3,VPTK,0
4x7r,B,332,347,15,RIDLLIEVAELVVKKD,0
4x7r,B,360,371,11,VKDKIAKMIEDK,0
4x7r,B,385,392,7,TPQKCLED,0
4x7r,B,406,415,9,GLSMIEAMIS,0
4x7r,B,427,432,5,GPSDFI,0
4x7r,B,445,458,13,NINDMADKILQLVN,0
4x7r,B,459,478,19,NDVLAAEFGSKARENIIEKY,0
4x7r,B,479,493,14,STESILEKWLNLFNS,0
2ban,B,29,42,13,EKIKALVEICTEME,0
2ban,B,77,82,5,FRELNK,0
2ban,B,96,100,4,HPAGL,0
2ban,B,113,118,5,DAYFSV,0
2ban,B,121,129,8,DEDFRKYTA,0
2ban,B,156,175,19,SPAIFQSSMTKILEPFKKQN,0
2ban,B,194,211,17,EIGQHRTKIEELRQHLLR,0
2ban,B,254,269,15,VNDIQKLVGKLNWASQ,0
2ban,B,296,312,16,TEEAELELAENREILKE,0
2ban,B,363,384,21,NDVKQLTEAVQKITTESIVIWG,0
2ban,B,394,405,11,QKETWETWWTEY,0
2ban,B,473,489,16,TNQKTELQAIYLALQDS,0
2ban,B,499,508,9,SQYALGIIQA,0
2ban,B,515,528,13,SELVNQIIEQLIKK,0
2ban,B,544,549,5,GNEQVD,0
2ban,B,27,42,15,TEEKIKALVEICTEME,0
2ban,B,77,83,6,FRELNKR,0
2ban,B,84,88,4,TQDFW,0
2ban,B,112,118,6,GDAYFSV,0
2ban,B,121,126,5,DEDFRK,0
2ban,B,134,138,4,SINNE,0
2ban,B,155,168,13,GSPAIFQSSMTKIL,0
2ban,B,168,173,5,LEPFKK,0
2ban,B,194,214,20,EIGQHRTKIEELRQHLLRWGL,0
2ban,B,235,239,4,HPDKW,0
2ban,B,254,268,14,VNDIQKLVGKLNWAS,0
2ban,B,280,284,4,SKLLR,0
2ban,B,296,310,14,TEEAELELAENREIL,0
2ban,B,363,383,20,NDVKQLTEAVQKITTESIVIW,0
2ban,B,394,406,12,QKETWETWWTEYW,0
2ban,B,421,425,4,PLVKL,0
5m7n,B,11,25,14,EVDIRDLVAGILSDE,0
5m7n,B,34,45,11,DADSALAAINDR,0
5m7n,B,62,74,12,DGLALLDEIKKQH,0
5m7n,B,88,97,9,IETAVSAIRR,0
5m7n,B,108,133,25,KADRLILVAERALETSKLKREVSDLR,0
5m7n,B,146,160,14,SLAMNQLRQTIERVA,0
5m7n,B,175,187,12,GKELVARAIHAQS,0
5m7n,B,203,205,2,TPE,0
5m7n,B,206,213,7,RMEIELFG,0
5m7n,B,224,229,5,GALEEA,0
5m7n,B,239,242,3,VADM,0
5m7n,B,243,257,14,PRETQNKILRVLVDQ,0
5m7n,B,281,288,7,NLEGMIAE,0
5m7n,B,292,300,8,REDLFHRLS,0
5m7n,B,308,314,6,ALAARRE,0
5m7n,B,315,332,17,DIPSLVEFFMKQIAEQAG,0
5m7n,B,339,349,10,GPDAMAVLQAH,0
5m7n,B,353,369,16,GNLRQLRNNVERLMILT,0
5m7n,B,379,383,4,TADLL,0
5m7n,B,384,389,5,PAEIGD,0
5m7n,B,399,404,5,DQHIMA,0
5m7n,B,406,426,20,PLREARERFEKEYLIAQINRF,0
5m7n,B,429,438,9,NISRTAEFVG,0
5m7n,B,440,452,12,ERSALHRKLKSLG,0
5m7n,B,11,24,13,EVDIRDLVAGILSD,0
5m7n,B,64,74,10,LALLDEIKKQH,0
5m7n,B,87,97,10,NIETAVSAIRR,0
5m7n,B,108,136,28,KADRLILVAERALETSKLKREVSDLRKRT,0
5m7n,B,175,186,11,GKELVARAIHAQ,0
5m7n,B,200,202,2,ATI,0
5m7n,B,353,370,17,GNLRQLRNNVERLMILTR,0
5m7n,B,401,405,4,HIMAL,0
5kfd,A,16,26,10,CFFVQVEQRQN,0
5kfd,A,27,30,3,PHLR,0
5kfd,A,51,56,5,SYEARA,0
5kfd,A,64,72,8,WADDAKKLC,0
5kfd,A,89,104,15,LTKYREASVEVMEIMS,0
5kfd,A,121,133,12,LTSAVQERLQKLQ,0
5kfd,A,138,142,4,SADLL,0
5kfd,A,162,178,16,QKEGMRKQGLFQWLDSL,0
5kfd,A,185,209,24,SPDLQLTVGAVIVEEMRAAIERETG,0
5kfd,A,219,228,9,NKVLAKLACG,0
5kfd,A,229,231,2,LNK,0
5kfd,A,242,249,7,SVPQLFSQ,0
5kfd,A,250,255,5,MPIRKI,0
5kfd,A,260,271,11,GKLGASVIEILG,0
5kfd,A,274,281,7,YMGELTQF,0
5kfd,A,282,291,9,TESQLQSHFG,0
5kfd,A,291,302,11,GEKNGSWLYAMC,0
5kfd,A,326,330,4,PGKTA,0
5kfd,A,334,360,26,REQVQWWLLQLAQELEERLTKDRNDND,0
5kfd,A,391,404,13,DAHKMSHDAFTVIK,0
5kfd,A,405,407,2,NCN,0
4dq1,B,3,20,17,NSFDAAYHSLCEEVLEIG,0
4dq1,B,44,46,2,SKG,0
4dq1,B,56,70,14,SFKLVATELLWFIKG,0
4dq1,B,73,79,6,NIQYLLK,0
4dq1,B,85,94,9,WNEWAFENYI,0
4dq1,B,108,114,6,GHRALSD,0
4dq1,B,116,135,19,EFNEQYKEQMKQFKQRILED,0
4dq1,B,135,143,8,DDTFAKQFG,0
4dq1,B,148,155,7,VYGKQWRD,0
4dq1,B,165,177,12,DQLKTVIEQIKHN,0
4dq1,B,189,193,4,NPTEI,0
4dq1,B,227,247,20,LGVPFNIASYALLTHLIAKEC,0
4dq1,B,267,277,10,HIDAIQTQLAR,0
4dq1,B,292,296,4,SIFDI,0
4dq1,B,297,299,2,NYE,0
4dq1,B,4,20,16,SFDAAYHSLCEEVLEIG,0
4dq1,B,56,69,13,SFKLVATELLWFIK,0
4dq1,B,74,80,6,IQYLLKY,0
4dq1,B,118,135,17,NEQYKEQMKQFKQRILED,0
4dq1,B,228,247,19,GVPFNIASYALLTHLIAKEC,0
4dq1,B,267,276,9,HIDAIQTQLA,0
5kdn,A,505,513,8,DSISEAKKR,0
5kdn,A,579,584,5,NYESNG,0
5kdn,A,601,605,4,KSDSQ,0
5kdn,A,628,646,18,DENEVMKELEAYVEKIKAE,0
5kdn,A,666,678,12,QATYALDWYKKNN,0
5kdn,A,680,699,19,TPKYTAEQWDQYIADAMGFW,0
5kdn,A,705,709,4,KDVNS,0
5kdn,A,741,748,7,NQDAILAA,0
5kdn,A,751,763,12,GWGVAHELGHNFD,0
5kdn,A,772,774,2,VTN,0
5kdn,A,775,786,11,NMMPLFFESKYK,0
5kdn,A,789,794,5,TRITDQ,0
5kdn,A,795,800,5,NIWENN,0
5kdn,A,800,806,6,NTYPKVG,0
5kdn,A,823,826,3,HLAQ,0
5kdn,A,827,837,10,LAPLWQLYLYD,0
5kdn,A,839,851,12,TFYGKFERQFRER,0
5kdn,A,857,874,17,NREDIYKSWVVAASDAME,0
5kdn,A,877,885,8,LTEFFARHG,0
5kdn,A,889,897,8,DDKVKEDLA,0
5kdn,A,905,909,4,KIYYL,0
5kdn,A,910,914,4,NDLAM,0
5kdn,A,946,949,3,DENK,0
3osw,B,205,226,21,NPESADLRALAKHLYDSYIKSF,0
3osw,B,229,239,10,TKAKARAILTG,0
3osw,B,251,260,9,DMNSLMMGED,0
3osw,B,276,302,26,EVAIRIFQGCQFRSVEAVQEITEYAKS,0
3osw,B,305,309,4,GFVNL,0
3osw,B,310,333,23,DLNDQVTLLKYGVHEIIYTMLASL,0
3osw,B,342,344,2,SEG,0
3osw,B,350,355,5,REFLKS,0
3osw,B,359,363,4,PFGDF,0
3osw,B,364,376,12,MEPKFEFAVKFNA,0
3osw,B,380,393,13,DDSDLAIFIAVIIL,0
3osw,B,402,425,23,NVKPIEDIQDNLLQALELQLKLNH,0
3osw,B,430,438,8,QLFAKLLQK,0
3osw,B,438,460,22,KMTDLRQIVTEHVQLLQVIKKTE,0
3osw,B,466,474,8,HPLLQEIYK,0
3osw,B,208,226,18,SADLRALAKHLYDSYIKSF,0
3osw,B,251,259,8,DMNSLMMGE,0
3osw,B,276,301,25,EVAIRIFQGCQFRSVEAVQEITEYAK,0
3osw,B,430,458,28,QLFAKLLQKMTDLRQIVTEHVQLLQVIKK,0
4ndo,A,4,15,11,STAELEELLMQR,0
4ndo,A,19,28,9,DPQLQAAAAA,0
4ndo,A,48,51,3,VIDR,0
4ndo,A,52,67,15,GRAAVYPLVDEIVAAR,0
4ndo,A,79,92,13,GTRARHLYSIAAGL,0
4ndo,A,95,119,24,PAGVLAQLGSSVADQNAAMLGQLLA,0
4ndo,A,120,122,2,KHG,0
4ndo,A,128,132,4,GAGLS,0
4ndo,A,134,138,4,VPLSL,0
4ndo,A,152,156,4,YKLWM,0
4ndo,A,168,181,13,RTDAGCFLLAEQFG,0
4ndo,A,213,219,6,VDEMKAK,0
4ndo,A,227,237,10,EFPVLDLLQSA,0
4ndo,A,252,259,7,GNLTRALA,0
4ndo,A,47,52,5,GGRVMD,0
4ndo,A,54,69,15,GADAILPLVEELRKLL,0
4ndo,A,81,94,13,GVRARHVFSVGLDL,0
4ndo,A,97,121,24,PVGSLAPLAASEAGQNGHILAAMLA,0
4ndo,A,122,124,2,SEG,0
4ndo,A,129,144,15,EHPTVADQLAIHLSAT,0
4ndo,A,155,159,4,YHHHE,0
4ndo,A,169,182,13,RADTGAFLLADAFG,0
4ndo,A,204,208,4,DRGQA,0
4ndo,A,216,222,6,ATDLAKS,0
4ndo,A,229,238,9,DRALLDVMAT,0
4ndo,A,254,261,7,GRLTAALR,0
4jzx,B,3,27,24,HMERFQKVYEEVQEFLLGDAEKRFE,0
4jzx,B,29,45,16,DVHRKGYLKSMMDTTCL,0
4jzx,B,49,66,17,YNRGLCVVDVAEAMAKDT,0
4jzx,B,69,102,33,DAAAMERVLHDACVCGWMIEMLQAHFLVEDDIMD,0
4jzx,B,113,116,3,WYLH,0
4jzx,B,120,143,23,TAQVAINDGLILLAWATQMALHYF,0
4jzx,B,148,172,24,FLAEVLRVFHDVDLTTTIGQLYDVT,0
4jzx,B,176,180,4,DSAKL,0
4jzx,B,196,208,12,TPFNHRRIVVYKT,0
4jzx,B,208,213,5,TAYYTY,0
4jzx,B,213,224,11,YWLPLVMGLLVS,0
4jzx,B,226,230,4,TLEKV,0
4jzx,B,231,257,26,DKKATHKVAMVMGEYFQVQDDVMDCFT,0
4jzx,B,258,263,5,PPEKLG,0
4jzx,B,275,285,10,SWLAVTFLTTA,0
4jzx,B,286,295,9,PAEKVAEFKA,0
4jzx,B,301,315,14,DPAAVAVIKQLYTEQ,0
4jzx,B,316,343,27,NLLARFEEYEKAVVAEVEQLIAALEAQN,0
4jzx,B,343,358,15,NAAFAASVKVLWSKTY,0
4jzx,B,49,65,16,YNRGLCVVDVAEAMAKD,0
4jzx,B,286,297,11,PAEKVAEFKANY,0
4jzx,B,343,356,13,NAAFAASVKVLWSK,0
5gjg,A,32,34,2,DYK,0
5gjg,A,67,77,10,SESERKAFIVE,0
5gjg,A,77,84,7,ELRQLSRV,0
5gjg,A,111,118,7,SLYNVLHG,0
5gjg,A,126,146,20,TAAHAMSWCLQCSQGVAYLHS,0
5gjg,A,158,160,2,KPP,0
5gjg,A,192,196,4,SAAWM,0
5gjg,A,197,202,5,APEVFE,0
5gjg,A,208,225,17,EKCDVFSWGIILWEVITR,0
5gjg,A,235,245,10,PAFRIMWAVHN,0
5gjg,A,256,267,11,PKPIESLMTRCW,0
5gjg,A,270,274,4,DPSQR,0
5gjg,A,276,288,12,SMEEIVKIMTHLM,0
5gjg,A,289,291,2,RYF,0
5gjg,A,484,495,11,FAEFYRLWSVDH,0
4fgj,B,16,33,17,SFNGSLKNVAVDELSRQG,0
4fgj,B,51,55,4,TDKDI,0
4fgj,B,66,77,11,NYGVETHEAYKQ,0
4fgj,B,81,94,13,ASDITDEQKKVREA,0
4fgj,B,109,120,11,PAILKGWMDRVL,0
4fgj,B,131,135,4,FYDSG,0
4fgj,B,163,173,10,DSRYFLWPLQH,0
4fgj,B,196,213,17,SEEERKGMVAAWSQRLQT,0
4fgj,B,214,217,3,IWKE,0
4fgj,B,223,229,6,TAHWHFG,0
4fgj,B,66,78,12,NYGVETHEAYKQR,0
5w3v,D,5,14,9,TAKTFSLQFN,0
5w3v,D,54,66,12,HAEIRFINEIKSM,0
5w3v,D,85,99,14,CPSCAGELVDFIKAH,0
5w3v,D,116,128,12,HPNYQEGLLLLCG,0
5w3v,D,137,149,12,GLPEFTDCWENFV,0
5w3v,D,158,185,27,NPSEKLKELDKNSQAIKRRLERIKSRSV,0
5w3v,D,5,13,8,TAKTFSLQF,0
5w3v,D,158,181,23,NPSEKLKELDKNSQAIKRRLERIK,0
5w3v,D,158,183,25,NPSEKLKELDKNSQAIKRRLERIKSR,0
5w3v,D,158,184,26,NPSEKLKELDKNSQAIKRRLERIKSRS,0
3ha4,H,59,69,10,ELEAQRQRHND,0
3ha4,H,74,84,10,PWPLLHQRVVL,0
3ha4,H,85,88,3,LREG,0
3ha4,H,91,93,2,APE,0
3ha4,H,94,106,12,DIALMWEQTKHYY,0
3ha4,H,110,123,13,WLIPLELTQVLKYS,0
3ha4,H,124,132,8,SGKYLQTYV,0
3ha4,H,134,151,17,DPDEMRKEVLMQLLNVKY,0
3ha4,H,163,179,16,NKDVEEIISMAVDDLEN,0
3ha4,H,74,85,11,PWPLLHQRVVLL,0
3ha4,H,86,88,2,REG,0
3ha4,H,74,88,14,PWPLLHQRVVLLREG,0
3ha4,H,93,106,13,EDIALMWEQTKHYY,0
3ha4,H,110,122,12,WLIPLELTQVLKY,0
3ha4,H,74,87,13,PWPLLHQRVVLLRE,0
3ha4,H,56,69,13,LPEELEAQRQRHND,0
3ha4,H,74,86,12,PWPLLHQRVVLLR,0
4fml,C,68,80,12,SKADEALRYYSAQ,0
4fml,C,81,90,9,GYTLLNNYLR,0
4fml,C,95,106,11,KQREAIDTLLSR,0
4fml,C,115,137,22,SAGEFDKAMKAYVADVEAGLAKL,0
4fml,C,154,156,2,KPE,0
4fml,C,157,165,8,LAALKEQFT,0
4fml,C,236,242,6,DFDTLLN,0
4fml,C,205,208,3,GDAA,0
4fml,C,236,243,7,DFDTLLNT,0
4fml,C,69,81,12,KADEALRYYSAQG,0
4fml,C,97,106,9,REAIDTLLSR,0
4fml,C,126,136,10,YVADVEAGLAK,0
3e7y,D,1,7,6,GIVEQCC,0
3e7y,D,12,17,5,SLYQLE,0
3e7y,D,18,20,2,NYC,0
3e7y,D,8,20,12,GSHLVEALYLVCG,0
3e7y,D,21,23,2,ERG,0
3e7y,D,1,9,8,GIVEQCCTS,0
3bbx,3,13,23,10,GKGASRRLRAA,0
3bbx,3,43,48,5,DHDKVM,0
3bbx,3,53,57,4,KAEFY,0
3bbx,3,130,134,4,PMRNI,0
3bbx,3,197,201,4,AEHML,0
3bbx,3,61,67,6,TKPEAGH,0
3bbx,3,24,36,12,NEALVHQVVVAYA,0
3bbx,3,97,103,6,NKKMYRG,0
3bbx,3,107,112,5,SILSEL,0
3bbx,3,133,139,6,LLAQKLK,0
3bbx,3,156,161,5,NLFLAA,0
3bbx,3,176,181,5,DPVSLI,0
3bbx,3,3,9,6,LHDYYKD,0
3bbx,3,50,61,11,DNAAADLAAISG,0
3bbx,3,93,101,8,ERMWEFFER,0
3bbx,3,57,81,24,YADGWAQAGTARALLNSMVIGVTEG,0
3bbx,3,136,150,14,DKQVIGQVAADLRAY,0
3bbx,3,40,53,13,TKKNIEFFEARRAE,0
3bbx,3,55,60,5,EAKLAE,0
3bbx,3,62,67,5,LAAANA,0
3bbx,3,67,72,5,ARAEKI,0
3bbx,3,96,101,5,TRDIAD,0
3bbx,3,102,104,2,AVT,0
3bbx,3,111,115,4,AKSEV,0
3bbx,3,24,28,4,TLGRL,0
3bbx,3,29,34,5,ATELAR,0
3bbx,3,66,71,5,GNKRTD,0
3bbx,3,89,94,5,FEEMIA,0
3bbx,3,100,109,9,VIEIAVKGML,0
3bbx,3,114,119,5,LGRAMF,0
3bbx,3,114,118,4,KIISL,0
3bbx,3,128,133,5,TKGARA,0
3bbx,3,43,52,9,ARQIEAARRA,0
3bbx,3,109,118,9,PEELAREAFK,0
3bbx,3,16,31,15,HRQAMFRNMAGSLVRH,0
3bbx,3,37,53,16,TLPKAKELRRVVEPLIT,0
3bbx,3,61,65,4,ANRRL,0
3bbx,3,73,82,9,NEIVAKLFNE,0
3bbx,3,82,87,5,ELGPRF,0
3bbx,3,8,12,4,IRRAT,0
3bbx,3,14,18,4,ARRKL,0
3bbx,3,68,83,15,KDAAAAVGKAVAERAL,0
3bbx,3,101,112,11,GRVQALADAARE,0
3bbx,3,5,18,13,RGVIARARHKKILK,0
3bbx,3,25,30,5,GARSRV,0
3bbx,3,33,68,35,VAFQAVIKAGQYAYRDRRQRKRQFRQLWIARINAAA,0
3bbx,3,69,72,3,RQNG,0
3bbx,3,74,84,10,SYSKFINGLKK,0
3bbx,3,93,95,2,ILA,0
3bbx,3,96,101,5,DIAVFD,0
3bbx,3,101,114,13,DKVAFTALVEKAKA,0
3bbx,3,13,24,11,SAQKVRLVADLI,0
3bbx,3,41,57,16,KKAAVLVKKVLESAIAN,0
3bbx,3,6,10,4,RLLKV,0
3bbx,3,40,50,10,KAEIKAAVQKL,0
3bbx,3,18,21,3,LLNL,0
3bbx,3,22,27,5,LREQFN,0
3bbx,3,42,48,6,LLKQVRR,0
3bbx,3,49,60,11,DVARVKTLLNEK,0
3bbx,3,17,22,5,PKHKAT,0
3bbx,3,40,42,2,TPA,0
3bbx,3,43,50,7,IRGMINAV,0
3bbx,3,53,58,5,TGGRVD,0
3bbx,3,14,20,6,MRRSHDA,0
3bbx,3,8,13,5,SVLKRN,0
3bbx,3,19,23,4,RARMA,0
3bbx,3,24,35,11,TKNGRQVLARRR,0
3bbx,3,5,13,8,TVRGAAKRF,0
3bbx,3,51,56,5,KGDLGL,0
3hlu,B,14,26,12,KRKIIADRLQEL,0
3hlu,B,52,65,13,RKATLVKVRNLLKE,0
3hlu,B,14,27,13,KRKIIADRLQELD,0
3hlu,B,54,67,13,ATLVKVRNLLKEVD,0
1sjj,B,30,50,20,WEKQQRKTFTAWCNSHLRKAG,0
1sjj,B,63,73,10,GLKLMLLLEVI,0
1sjj,B,86,104,18,MRVHKISNVNKALDFIASK,0
1sjj,B,113,118,5,AEEIVD,0
1sjj,B,120,133,13,NVKMTLGMIWTIIL,0
1sjj,B,151,160,9,LLLWYQRKTA,0
1sjj,B,171,175,4,HISWK,0
1sjj,B,177,186,9,GLGFCALIHR,0
1sjj,B,194,199,5,YGKLRK,0
1sjj,B,202,206,4,PLTNL,0
1sjj,B,207,218,11,NTAFDVAEKYLD,0
1sjj,B,224,229,5,DAEDIV,0
1sjj,B,235,246,11,DEKAIMTYVSSF,0
1sjj,B,269,295,26,VNQENEQLMEDYEKLASDLLEWIRRTI,0
1sjj,B,296,298,2,PWL,0
1sjj,B,306,323,17,TMQAMQQKLEDFRDYRRL,0
1sjj,B,325,338,13,KPPKVQEKCQLEIN,0
1sjj,B,340,346,6,NTLQTKL,0
1sjj,B,361,363,2,MVS,0
1sjj,B,364,377,13,DINNAWGGLEQAEK,0
1sjj,B,379,387,8,YEEWLLNEI,0
1sjj,B,390,420,30,LERLDHLAEKFRQKASIHESWTDGKEAMLQQ,0
1sjj,B,427,446,19,TLSEIKALLKKHEAFESDLA,0
1sjj,B,447,465,18,AHQDRVEQIAAIAQELNEL,0
1sjj,B,469,519,50,DSPSVNARCQKICDQWDNLGALTQKRREALERTEKLLETIDQLYLEYAKRA,0
1sjj,B,522,535,13,FNNWMEGAMEDLQD,0
1sjj,B,542,544,2,IEE,0
1sjj,B,545,557,12,IQGLTTAHEQFKA,0
1sjj,B,558,582,24,TLPDADKERQAILGIHNEVSKIVQT,0
1sjj,B,597,620,23,TPQEINGKWEHVRQLVPRRDQALM,0
1sjj,B,622,654,32,EHARQQQNERLRKQFGAQANVIGPWIQTKMEEI,0
1sjj,B,665,681,16,LEDQLNHLRQYEKSIVN,0
1sjj,B,682,684,2,YKP,0
1sjj,B,685,698,13,KIDQLEGDHQQIQE,0
1sjj,B,711,739,28,MEHIRVGWEQLLTTIARTINEVENQILTR,0
1sjj,B,745,757,12,SQEQMNEFRASFN,0
1sjj,B,771,780,9,DFRACLISMG,0
1sjj,B,785,796,11,EAEFARIMSIVD,0
1sjj,B,806,811,5,QAFIDF,0
1sjj,B,811,816,5,FMSRET,0
1sjj,B,822,831,9,ADQVMASFKI,0
1sjj,B,832,834,2,LAG,0
1sjj,B,841,848,7,VDELRREL,0
1sjj,B,849,860,11,PPDQAEYCIARM,0
1sjj,B,875,883,8,YMSFSTALY,0
1sjj,B,35,50,15,RKTFTAWCNSHLRKAG,0
1sjj,B,63,72,9,GLKLMLLLEV,0
1sjj,B,86,103,17,MRVHKISNVNKALDFIAS,0
1sjj,B,120,134,14,NVKMTLGMIWTIILR,0
1sjj,B,137,142,5,IQDISV,0
1sjj,B,147,160,13,AKEGLLLWYQRKTA,0
1sjj,B,177,188,11,GLGFCALIHRHR,0
1sjj,B,189,192,3,PELI,0
1sjj,B,193,198,5,DYGKLR,0
1sjj,B,207,216,9,NTAFDVAEKY,0
1sjj,B,235,244,9,DEKAIMTYVS,0
1sjj,B,245,248,3,SFYH,0
1sjj,B,271,300,29,QENEQLMEDYEKLASDLLEWIRRTIPWLEN,0
1sjj,B,306,324,18,TMQAMQQKLEDFRDYRRLH,0
1sjj,B,324,346,22,HKPPKVQEKCQLEINFNTLQTKL,0
1sjj,B,364,376,12,DINNAWGGLEQAE,0
1sjj,B,378,410,32,GYEEWLLNEIRRLERLDHLAEKFRQKASIHESW,0
1sjj,B,413,419,6,GKEAMLQ,0
1sjj,B,447,464,17,AHQDRVEQIAAIAQELNE,0
1sjj,B,523,533,10,NNWMEGAMEDL,0
1sjj,B,541,558,17,TIEEIQGLTTAHEQFKAT,0
1sjj,B,597,624,27,TPQEINGKWEHVRQLVPRRDQALMEEHA,0
1sjj,B,625,654,29,RQQQNERLRKQFGAQANVIGPWIQTKMEEI,0
1sjj,B,665,683,18,LEDQLNHLRQYEKSIVNYK,0
1sjj,B,683,698,15,KPKIDQLEGDHQQIQE,0
1sjj,B,710,729,19,TMEHIRVGWEQLLTTIARTI,0
1sjj,B,731,736,5,EVENQI,0
1sjj,B,746,760,14,QEQMNEFRASFNHFD,0
1sjj,B,769,780,11,CEDFRACLISMG,0
1sjj,B,787,792,5,EFARIM,0
1sjj,B,793,795,2,SIV,0
1sjj,B,804,817,13,TFQAFIDFMSRETA,0
1sjj,B,822,834,12,ADQVMASFKILAG,0
1sjj,B,852,858,6,QAEYCIA,0
1sjj,B,875,880,5,YMSFST,0
1six,A,64,72,8,RSGLATRVG,0
1six,A,129,134,5,SFDEAG,0
5l9a,B,12,27,15,GQIGTDLSLALRDKFG,0
5l9a,B,58,70,12,DSNGFEKLVKEFK,0
5l9a,B,81,88,7,MSVRGEAE,0
5l9a,B,88,97,9,EPDLAMDINV,0
5l9a,B,97,110,13,VNTTRYALELARKY,0
5l9a,B,121,123,2,AAF,0
5l9a,B,142,163,21,TVYGVTKVYTELLGTWYRQKYG,0
5l9a,B,186,199,13,TDYAIHMYHSALLQ,0
5l9a,B,217,230,13,MPDTLNSLVKIMEA,0
5l9a,B,231,235,4,PLEKL,0
5l9a,B,248,261,13,SPSELRFSIERCTD,0
5l9a,B,271,279,8,GPAQKIANS,0
5l9a,B,286,294,8,DSNARNDWG,0
5l9a,B,300,317,17,DIDMMSEDMLRQIPILHG,0
1bjf,B,10,19,9,PEVMQDLLES,0
1bjf,B,24,37,13,EHEIQEWYKGFLRD,0
1bjf,B,45,54,9,MEEFKKIYGN,0
1bjf,B,62,72,10,SKFAEHVFRTF,0
1bjf,B,82,92,10,FREFIIALSVT,0
1bjf,B,97,108,11,LEQKLKWAFSMY,0
1bjf,B,118,129,11,KAEMLEIVQAIY,0
1bjf,B,140,142,2,EDE,0
1bjf,B,145,155,10,PEKRTEKIFRQ,0
1bjf,B,166,175,9,LEEFIRGAKS,0
1bjf,B,178,181,3,SIVR,0
1bjf,B,118,131,13,KAEMLEIVQAIYKM,0
1bjf,B,177,181,4,PSIVR,0
3fzq,B,23,36,13,PESAKHAIRLCQKN,0
3fzq,B,52,57,5,QDDVLS,0
3fzq,B,84,99,15,NQRLIKEVVCLLKKRE,0
3fzq,B,113,126,13,NQKAKEIFETNQL,0
3fzq,B,133,138,5,INKQHI,0
3fzq,B,147,151,4,NIEEY,0
3fzq,B,164,176,12,NEKVFDEVKDILQ,0
3fzq,B,186,188,2,ISS,0
3fzq,B,199,212,13,HKGKAIKRLQERLG,0
3fzq,B,224,226,2,GQN,0
3fzq,B,227,233,6,DIVFQA,0
3fzq,B,244,251,7,HQQLKDIA,0
3fzq,B,257,260,3,DIFD,0
3fzq,B,261,270,9,NGIYKELKRR,0
3fzq,B,224,228,4,GQNDI,0
3fzq,B,229,234,5,VFQAS,0
5jhz,B,67,72,5,RSHDWW,0
5jhz,B,78,82,4,LDVLR,0
5jhz,B,85,89,4,QPSQN,0
5jhz,B,96,103,7,DYAEAFQS,0
5jhz,B,105,118,13,DYEAVKKDIAALMT,0
5jhz,B,126,130,4,ADFGN,0
5jhz,B,131,144,13,YGGLFVRMAWHSAG,0
5jhz,B,158,162,4,GQQRF,0
5jhz,B,164,172,8,PLNSWPDNQ,0
5jhz,B,173,189,16,NLDKARRLIWPIKQKYG,0
5jhz,B,190,192,2,NKI,0
5jhz,B,193,209,16,SWADLMLLTGNVALENM,0
5jhz,B,256,260,4,RADKL,0
5jhz,B,278,282,4,GPNGT,0
5jhz,B,284,299,15,DPAASAKDIREAFGRM,0
5jhz,B,302,314,12,NDTETVALIAGGH,0
5jhz,B,324,328,4,KGSNI,0
5jhz,B,331,335,4,APEAA,0
5jhz,B,336,340,4,DLGMQ,0
5jhz,B,352,356,4,NGPNQ,0
5jhz,B,374,383,9,NGYLESLINN,0
5jhz,B,421,426,5,LTSDLA,0
5jhz,B,427,429,2,LIN,0
5jhz,B,430,443,13,DPEYLKISQRWLEH,0
5jhz,B,443,461,18,HPEELADAFAKAWFKLLHR,0
5jhz,B,465,469,4,PTTRY,0
5jhz,B,479,483,4,FIWQD,0
5jhz,B,494,507,13,DDADVDKLKAAILS,0
5jhz,B,512,525,13,DVSKLASTAMACAT,0
5jhz,B,539,543,4,ARIAL,0
5jhz,B,545,552,7,PQRNWVSN,0
5jhz,B,553,572,19,NPTQLSAVLDALKKVQSDFN,0
5jhz,B,581,601,20,SLADLIVLGGTAAVEKAAKDA,0
5jhz,B,617,621,4,TQEQT,0
5jhz,B,622,628,6,DVTQFSY,0
5jhz,B,647,659,12,RTEEIMVDKASQL,0
5jhz,B,662,677,15,TPPELTVLVGGMRALG,0
5jhz,B,697,705,8,PDFFVNLVD,0
5jhz,B,736,740,4,RADLV,0
5jhz,B,741,743,2,FGS,0
5jhz,B,744,756,12,HAELRAIAEVYAE,0
5jhz,B,759,776,17,NQEKFVKDFVAAWTKVMN,0
5jhz,B,494,506,12,DDADVDKLKAAIL,0
5jhz,B,662,676,14,TPPELTVLVGGMRAL,0
5jhz,B,697,704,7,PDFFVNLV,0
5jhz,B,779,784,5,RFDLKV,0
2pbq,C,14,19,5,SDRASK,0
2pbq,C,24,38,14,DISGKAIIDYLKDVI,0
2pbq,C,52,66,14,ERDLIEKTLIELADE,0
2pbq,C,85,94,9,VTPEATEAVC,0
2pbq,C,98,111,13,LPGFGELMRQVSLK,0
2pbq,C,113,119,6,VPTAILS,0
2pbq,C,137,149,12,KPQSIKVCLDAVM,0
2pbq,C,151,159,8,AIPYCIDLI,0
2pbq,C,98,110,12,LPGFGELMRQVSL,0
2pbq,C,111,112,1,KQ,0
2pbq,C,112,119,7,QVPTAILS,0
4efn,A,15,25,10,GKSALTIQLIQ,0
4efn,A,67,75,8,MRDQYMRTG,0
4efn,A,86,92,6,NTKSFED,0
4efn,A,92,105,13,DIHQYREQIKRVKD,0
4efn,A,126,138,12,ESRQAQDLARSYG,0
4efn,A,151,165,14,GVEDAFYTLVREIRQ,0
4kk0,J,1,15,14,PLQSLVKALWNVLH,0
4kk0,J,25,39,14,LTELIAEVESYQQRY,0
4kk0,J,43,61,18,NPTNSQKIRHILDEIYEKT,0
4kk0,J,65,80,15,NTRRRILWLAVLKTVI,0
4kk0,J,81,83,2,PLL,0
4kk0,J,86,97,11,DRQAVGEWWDQI,0
4kk0,J,97,104,7,IFFPFLNS,0
4kk0,J,108,124,16,LKPVFSDLKSILFYILI,0
4kk0,J,134,155,21,DLRRECAEETITRLVDLYVSKA,0
4kk0,J,164,186,22,SQEQRNQTIECLVNVLVHYGIQR,0
4kk0,J,186,199,13,RPKELSSCFCHHFL,0
4kk0,J,200,202,2,NPP,0
4kk0,J,203,217,14,TRIPILSVVEVIRR,0
4kk0,J,221,228,7,RLYEIPQT,0
4kk0,J,229,241,12,GFYDLVLKCAEFD,0
4kk0,J,243,259,16,SPILLSYALSFILILS,0
4kk0,J,268,281,13,SLYRLFCIYLRFS,0
4kk0,J,331,335,4,PDYLE,0
4kk0,J,338,350,12,DYSQLFSILYALY,0
4kk0,J,350,358,8,YPINFLEFL,0
4kk0,J,360,367,7,DPKLYASK,0
4kk0,J,377,390,13,NQELLSTKSDGLLG,0
4kk0,J,395,400,5,HSNFLK,0
4kk0,J,402,408,6,TAETELT,0
4kk0,J,411,428,17,SRWTRLDSIAVVALCNSL,0
4kk0,J,2,14,12,PLQSLVKALWNVL,0
4kk0,J,134,157,23,DLRRECAEETITRLVDLYVSKAIE,0
4kk0,J,165,186,21,QEQRNQTIECLVNVLVHYGIQR,0
4kk0,J,263,281,18,NSLDDSLYRLFCIYLRFS,0
4kk0,J,338,348,10,DYSQLFSILYA,0
4kk0,J,360,366,6,DPKLYAS,0
4kk0,J,409,413,4,DKSRW,0
4kk0,J,414,428,14,TRLDSIAVVALCNSL,0
4kk0,J,186,196,10,RPKELSSCFCH,0
4kk0,J,197,202,5,HFLNPP,0
4kk0,J,402,409,7,TAETELTD,0
4kk0,J,410,413,3,KSRW,0
4kk0,J,2,15,13,PLQSLVKALWNVLH,0
4kk0,J,66,80,14,TRRRILWLAVLKTVI,0
4kk0,J,128,132,4,EDEWG,0
4kk0,J,262,280,18,CNSLDDSLYRLFCIYLRFS,0
4kk0,J,294,298,4,SGNWE,0
4kk0,J,350,360,10,YPINFLEFLRD,0
4kk0,J,396,401,5,SNFLKY,0
4kk0,J,410,428,18,KSRWTRLDSIAVVALCNSL,0
4kk0,J,243,258,15,SPILLSYALSFILIL,0
4kk0,J,259,261,2,SHI,0
4kk0,J,3,14,11,LQSLVKALWNVL,0
4kk0,J,262,281,19,CNSLDDSLYRLFCIYLRFS,0
4kk0,J,127,132,5,DEDEWG,0
4kk0,J,409,412,3,DKSR,0
4kk0,J,413,428,15,WTRLDSIAVVALCNSL,0
4kk0,J,262,267,5,CNSLDD,0
4kk0,J,404,409,5,ETELTD,0
4kk0,J,410,412,2,KSR,0
4lqq,E,294,297,3,YQSS,0
4lqq,E,298,317,19,VKYAIERNERRVELETELTS,0
4lqq,E,318,321,3,HNWS,0
4lqq,E,437,444,7,LMTMLIRW,0
4lqq,E,449,456,7,EDVTRFYM,0
4lqq,E,457,469,12,AECILAIETIHKL,0
4lqq,E,477,480,3,KPDN,0
4lqq,E,556,561,5,QIQTWR,0
4lqq,E,562,564,2,KSR,0
4lqq,E,589,607,18,GQECDWWSLGAIMYECLIG,0
4lqq,E,620,625,5,YRKIMN,0
4lqq,E,626,630,4,FEQTL,0
4lqq,E,639,651,12,SYEAEDLIRRLLT,0
4lqq,E,678,682,4,NTIRQ,0
4lqq,E,111,115,4,KTIVQ,0
4lqq,E,121,145,24,DLGEWIALNVFEFFTNLNQFYGVVA,0
4lqq,E,183,194,11,DLALTWINNKVN,0
4lqq,E,210,221,11,QFSRDVQRIMVQ,0
4lqq,E,222,233,11,MFRIFAHIYHHH,0
4lqq,E,233,241,8,HFDKIVHLS,0
4lqq,E,242,260,18,LEAHWNSFFSHFISFAKEF,0
4lqq,E,271,276,5,LLPLIE,0
4lqq,E,296,299,3,SSVK,0
4lqq,E,300,317,17,YAIERNERRVELETELTS,0
4lqq,E,436,444,8,DLMTMLIRW,0
4lqq,E,590,607,17,QECDWWSLGAIMYECLIG,0
4lqq,E,615,619,4,TPQET,0
4lqq,E,621,626,5,RKIMNF,0
4lqq,E,627,630,3,EQTL,0
4lqq,E,639,650,11,SYEAEDLIRRLL,0
4lqq,E,665,669,4,EIKSH,0
4lqq,E,121,144,23,DLGEWIALNVFEFFTNLNQFYGVV,0
4lqq,E,186,194,8,LTWINNKVN,0
4lqq,E,210,232,22,QFSRDVQRIMVQMFRIFAHIYHH,0
4lqq,E,233,240,7,HFDKIVHL,0
1qwv,A,1,6,5,SPEIMK,0
1qwv,A,7,13,6,NLSNNFG,0
1qwv,A,15,24,9,AMDQCKDELS,0
1qwv,A,26,34,8,PDSVVADLY,0
1qwv,A,45,53,8,DRLAGCAIN,0
1qwv,A,54,60,6,CLATKLD,0
1qwv,A,70,80,10,HGNAKDFAMKH,0
1qwv,A,83,100,17,DETMAQQLVDIIHGCEKS,0
1qwv,A,109,126,17,MKTIDVAMCFKKEIHKLN,0
3bl6,A,8,17,9,MEEEVTILKN,0
3bl6,A,50,66,16,GKVNAAISTTLLINKFK,0
3bl6,A,101,105,4,ATAFG,0
3bl6,A,121,135,14,SKPLIEKVSQVVQQQ,0
3bl6,A,153,164,11,SVEQRQKIKKAF,0
3bl6,A,173,185,12,EATAIAQTCYQFN,0
3bl6,A,201,226,25,EAEMSFEAFLEKAAVSSSQTVEALVS,0
4kgs,B,22,37,15,DAATAEKVFKQYANDN,0
4kgs,B,47,49,2,DAT,0
3lxm,C,12,16,4,SINDL,0
3lxm,C,17,34,17,SRDELELVLRTAASLKKT,0
3lxm,C,53,67,14,STRTRLSFETSIHRL,0
3lxm,C,88,100,12,TLADTMSVISTYV,0
3lxm,C,111,117,6,GASRLAA,0
3lxm,C,135,151,16,HPTQTLLDLFTIQETQG,0
3lxm,C,167,178,11,GRTVHSLTQALA,0
3lxm,C,190,194,4,PDALA,0
3lxm,C,196,206,10,PAYILQMLEEK,0
3lxm,C,215,223,8,SLEEVVPEL,0
3lxm,C,241,249,8,YANVKAQFI,0
3lxm,C,251,256,5,RSSDLT,0
3lxm,C,275,281,6,TTDVDKT,0
3lxm,C,285,306,21,YYFQQAGNGIFARQALLALVLN,0
3lxm,C,88,97,9,TLADTMSVIS,0
3lxm,C,111,120,9,GASRLAAQFS,0
3lxm,C,216,223,7,LEEVVPEL,0
3lxm,C,137,151,14,TQTLLDLFTIQETQG,0
3lxm,C,219,223,4,VVPEL,0
3lxm,C,276,281,5,TDVDKT,0
3lxm,C,285,292,7,YYFQQAGN,0
3lxm,C,292,306,14,NGIFARQALLALVLN,0
4ase,A,816,820,4,HCERL,0
4ase,A,823,828,5,DASKWE,0
4ase,A,830,832,2,PRD,0
4ase,A,875,893,18,THSEHRALMSELKILIHIG,0
4ase,A,924,931,7,LSTYLRSK,0
4ase,A,932,934,2,RNE,0
4ase,A,1001,1022,21,TLEHLICYSFQVAKGMEFLASR,0
4ase,A,1030,1032,2,AAR,0
4ase,A,1038,1040,2,EKN,0
4ase,A,1047,1051,4,FGLAR,0
4ase,A,1068,1072,4,PLKWM,0
4ase,A,1073,1080,7,APETIFDR,0
4ase,A,1083,1099,16,TIQSDVWSFGVLLWEIF,0
4ase,A,1112,1122,10,DEEFCRRLKEG,0
4ase,A,1132,1143,11,TPEMYQTMLDCW,0
4ase,A,1146,1150,4,EPSQR,0
4ase,A,1152,1167,15,TFSELVEHLGNLLQAN,0
1mql,H,65,72,7,TLIDALLG,0
1mql,H,73,80,7,DPHCDVFQ,0
1mql,H,104,116,12,DYASLRSLVASSG,0
1mql,H,187,196,9,TNQEQTNLYV,0
1mql,H,37,57,20,DLKSTQAAIDQINRKLNRVIE,0
1mql,H,75,127,52,GRIQDLEKYVEDTKIDLWSYNAELLVALENQHTIDLADSEMNKLFEKTRRQLR,0
1mql,H,145,154,9,DNACIESIRN,0
1mql,H,158,171,13,DHDIYRDEALNNRF,0
1mql,H,159,171,12,HDIYRDEALNNRF,0
1mql,H,73,77,4,DPHCD,0
4ovk,A,65,75,10,PWTSIVYAVDG,0
4ovk,A,84,93,9,HPSAKKSYEA,0
4ovk,A,95,100,5,IFKTLA,0
4ovk,A,101,106,5,PDLENV,0
4ovk,A,118,126,8,NFEEVAKLK,0
4ovk,A,136,146,10,QPEVAKKLKEL,0
4ovk,A,157,173,16,TLEDIQNGIRLLGKILD,0
4ovk,A,174,196,22,KPEQAEALISYHKDSEAYFKQKN,0
4ovk,A,197,200,3,ASAL,0
4ovk,A,221,230,9,SVNQLITT,0
4ovk,A,247,255,8,SEEITWD,0
4ovk,A,268,274,6,RPDDIYQ,0
4ovk,A,285,290,5,IKAVKT,0
4ovk,A,309,322,13,ETPLKWGQLIQ,0
4ovk,A,330,344,14,ILRDDLKQFYNTFYH,0
4ovk,A,348,357,9,TDSEINTILN,0
4ovk,A,357,362,5,NISINN,0
1rsr,B,33,46,13,YDIFEKLIEKQLSF,0
1rsr,B,49,53,4,RPEEV,0
1rsr,B,55,65,10,VSRDRIDYQAL,0
1rsr,B,66,95,29,PEHEKHIFISNLKYQTLLDSIQGRSPNVAL,0
1rsr,B,96,99,3,LPLI,0
1rsr,B,101,130,29,IPELETWVETWAFSETIHSRSFTHIIRNIV,0
1rsr,B,133,143,10,PSVVFDDIVTN,0
1rsr,B,143,150,7,NEQIQKRA,0
1rsr,B,152,171,19,GISSYYDELIEMTSYWHLLG,0
1rsr,B,185,206,21,SLRELKKKLYLCLMSVNALEAI,0
1rsr,B,206,221,15,IRAYVSFACSFAFAER,0
1rsr,B,224,255,31,MEGNAKIIRLIARDEALHLTGTQHMLNLLRSG,0
1rsr,B,258,268,10,DPEMAEIAEEC,0
1rsr,B,268,291,23,CKQECYDLFVQAAQQEKDWADYLF,0
1rsr,B,300,319,19,NKDILCQYVEYITNIRMQAV,0
1rsr,B,334,340,6,WINTWLV,0
1rsr,B,34,46,12,DIFEKLIEKQLSF,0
1rsr,B,57,65,8,RDRIDYQAL,0
1rsr,B,66,96,30,PEHEKHIFISNLKYQTLLDSIQGRSPNVALL,0
1rsr,B,97,99,2,PLI,0
1rsr,B,132,138,6,DPSVVFD,0
1rsr,B,332,338,6,IPWINTW,0
2cdv,A,78,84,6,SCVGCHL,0
2cdv,A,65,70,5,YYHAMH,0
2cdv,A,93,98,5,KKKELT,0
2wyz,F,56,61,5,GCTSAG,0
2wyz,F,131,136,5,NEESTK,0
2wyz,F,107,110,3,SGDH,0
2wyz,F,132,136,4,EESTK,0
3omt,B,9,18,9,RLKSVLAEKG,0
3omt,B,20,28,8,TNLWLTETL,0
3omt,B,31,40,9,NKTTVSKWCT,0
3omt,B,46,58,12,SLETLFDIAEALN,0
3omt,B,60,65,5,DVRELI,0
3omt,B,9,17,8,RLKSVLAEK,0
3omt,B,20,29,9,TNLWLTETLD,0
5cjs,K,79,83,4,QSEDE,0
5cjs,K,121,127,6,SSEELQA,0
5cjs,K,182,189,7,TPEQWKSH,0
5cjs,K,83,87,4,TSEDT,0
5cjs,K,196,198,2,SSL,0
5cjs,K,37,59,22,DQKSTQNAINGITNKVNSVIEKM,0
5cjs,K,85,127,42,EIESKQIWCYNAELLVLLENERTLDFHDSNVKNLYEKVKSQLK,0
5cjs,K,145,154,9,NDECMESVKN,0
5cjs,K,158,171,13,DYPKYSEESKLNRE,0
5cjs,K,163,165,2,SGA,0
5cjs,K,196,199,3,SSLG,0
5cjs,K,37,58,21,DQKSTQNAINGITNKVNSVIEK,0
5cjs,K,84,127,43,EEIESKQIWCYNAELLVLLENERTLDFHDSNVKNLYEKVKSQLK,0
5cjs,K,158,170,12,DYPKYSEESKLNR,0
5cjs,K,171,173,2,EKI,0
5fct,B,23,38,15,GELQYLRQVEHILRCG,0
5fct,B,74,87,13,FWKGVLEELLWFIK,0
5fct,B,91,97,6,NAKELSS,0
5fct,B,104,107,3,DANG,0
5fct,B,108,115,7,SRDFLDSL,0
5fct,B,128,136,8,VYGFQWRHF,0
5fct,B,153,165,12,DQLQKVIDTIKTN,0
5fct,B,180,184,4,DLPLM,0
5fct,B,215,236,21,LGVPFNIASYALLTYMIAHITG,0
5fct,B,255,264,9,HIEPLKIQLQ,0
5fct,B,281,285,4,TIDDF,0
5fct,B,286,288,2,KVE,0
5fct,B,103,108,5,WDANGS,0
6ejd,A,261,271,10,GKEAISALSRA,0
6ejd,A,273,289,16,SKHCRQEIGETYCRHKL,0
6ejd,A,338,350,12,ASRQLQRMFKAIY,0
6ejd,A,364,376,12,SNYLHRQVLQVSR,0
6ejd,A,395,411,16,ASLLSTYLQSMRDLLEM,0
6ejd,A,431,442,11,TNDQLVAFLSRY,0
6ejd,A,454,463,9,DNARFIRKQG,0
6ejd,A,500,509,9,RRFVEYVTFS,0
6ejd,A,511,521,10,DDLVTKMKQFY,0
6ejd,A,522,524,2,SYT,0
6ejd,A,526,529,3,LPAE,0
6ejd,A,530,539,9,SFFHTVLENS,0
6ejd,A,541,543,2,HCD,0
6ejd,A,556,561,5,NRKLGC,0
6ejd,A,580,589,9,KPQDFHRFQQ,0
6ejd,A,606,618,12,QEIIGQLDYYLYG,0
6ejd,A,638,644,6,PDGIHSL,0
6ejd,A,645,667,22,SDVTLTLYHSFARLGLRRAETSL,0
6ejd,A,851,859,8,KPEEALKLH,0
6ejd,A,872,876,4,FQSLN,0
6ejd,A,884,896,12,NPAQVEQARRNAA,0
6ejd,A,898,913,15,TGTALEGWLDSLVGGM,0
6ejd,A,932,936,4,TCSQT,0
6ejd,A,944,948,4,DPKSE,0
4aym,F,337,342,5,HENMRR,0
4aym,F,343,345,2,PYF,0
4aym,F,422,426,4,LPKAQ,0
4aym,F,101,105,4,LEDSI,0
4aym,F,129,133,4,NTGKL,0
4aym,F,206,209,3,FNQL,0
4aym,F,81,87,6,LADALTA,0
1imu,A,13,29,16,TPAIREHLEERLAKLGK,0
1imu,A,69,91,22,DMYKAINEVEEKLERQLNKLQHK,0
4k8n,F,9,15,6,NLKVVLV,0
4k8n,F,16,20,4,SFKQC,0
4k8n,F,28,46,18,LLDPYIASWKGLVRFLNSL,0
4k8n,F,48,52,4,TIFSF,0
4k8n,F,53,70,17,ISKDVVSKLRIMERLRGG,0
4k8n,F,72,77,5,QSEHYR,0
4k8n,F,78,89,11,SLQAMVAHELSN,0
4k8n,F,103,127,24,SGCRTVLRLHRALHWLQLFLEGLRT,0
4k8n,F,133,144,11,RTSALCADSYNA,0
4k8n,F,145,150,5,SLAAYH,0
4k8n,F,151,162,11,PWVVRRAVTVAF,0
4k8n,F,167,175,8,TREVFLEAM,0
4k8n,F,179,191,12,PPEQAVQMLGEAL,0
4k8n,F,191,208,17,LPFIQRVYNVSQKLYAEH,0
4k8n,F,10,16,6,LKVVLVS,0
4k8n,F,28,45,17,LLDPYIASWKGLVRFLNS,0
4k8n,F,49,69,20,IFSFISKDVVSKLRIMERLRG,0
4k8n,F,72,76,4,QSEHY,0
4k8n,F,133,145,12,RTSALCADSYNAS,0
4k8n,F,146,150,4,LAAYH,0
4k8n,F,151,164,13,PWVVRRAVTVAFCT,0
4k8n,F,167,174,7,TREVFLEA,0
4k8n,F,179,189,10,PPEQAVQMLGE,0
4k8n,F,10,15,5,LKVVLV,0
4k8n,F,48,51,3,TIFS,0
4k8n,F,52,69,17,FISKDVVSKLRIMERLRG,0
4k8n,F,78,87,9,SLQAMVAHEL,0
4k8n,F,134,136,2,TSA,0
4k8n,F,137,143,6,LCADSYN,0
4k8n,F,151,160,9,PWVVRRAVTV,0
4k8n,F,161,163,2,AFC,0
4k8n,F,182,187,5,QAVQML,0
4k8n,F,190,193,3,ALPF,0
4k8n,F,194,208,14,IQRVYNVSQKLYAEH,0
4k8n,F,17,21,4,FKQCL,0
4k8n,F,49,52,3,IFSF,0
4k8n,F,53,69,16,ISKDVVSKLRIMERLRG,0
4k8n,F,146,149,3,LAAY,0
4k8n,F,163,165,2,CTL,0
4k8n,F,179,208,29,PPEQAVQMLGEALPFIQRVYNVSQKLYAEH,0
4k8n,F,11,19,8,KVVLVSFKQ,0
4k8n,F,29,46,17,LDPYIASWKGLVRFLNSL,0
4k8n,F,50,70,20,FSFISKDVVSKLRIMERLRGG,0
4k8n,F,11,15,4,KVVLV,0
4k8n,F,16,18,2,SFK,0
4k8n,F,167,172,5,TREVFL,0
4n7j,B,56,60,4,FWHLT,0
4n7j,B,66,81,15,GTCADRDNLTRRFSDL,0
4n7j,B,92,106,14,KAEELLLKIHEVSTV,0
4n7j,B,136,142,6,IQTLTGL,0
4n7j,B,143,152,9,FKGDKCHSLV,0
4n7j,B,227,240,13,WYIQDLCEMLGKYG,0
4n7j,B,244,258,14,EFTELLTLVNRKVSQ,0
4n7j,B,266,270,4,DPSAI,0
4n7j,B,148,152,4,CHSLV,0
4xi8,F,11,17,6,HHMISFY,0
4xi8,F,35,56,21,GKALQERCAYDLLQAMLNLRKE,0
4xi8,F,63,76,13,DSSYLKYLHQRLYE,0
4xi8,F,105,120,15,KIKEGLKRIDQILAEK,0
4xi8,F,121,124,3,NNFQ,0
4xi8,F,127,145,18,SRKEFIHEVSTVFILLNKI,0
4xi8,F,151,167,16,GNKYVQRIFFEQIAEAA,0
4xi8,F,172,176,4,DFSVV,0
4xi8,F,177,188,11,TEKRMQFAIHAA,0
4xi8,F,200,211,11,ITPMLHLFEDIS,0
4xi8,F,212,222,10,NPEKVGILKEF,0
4xi8,F,12,17,5,HMISFY,0
4xi8,F,212,221,9,NPEKVGILKE,0
4xi8,F,35,54,19,GKALQERCAYDLLQAMLNLR,0
4xi8,F,109,120,11,GLKRIDQILAEK,0
4xi8,F,129,145,16,KEFIHEVSTVFILLNKI,0
4xi8,F,153,166,13,KYVQRIFFEQIAEA,0
4xi8,F,179,189,10,KRMQFAIHAAL,0
4xi8,F,212,220,8,NPEKVGILK,0
5oim,A,20,32,12,SIAFHIARVAQEQ,0
5oim,A,43,52,9,RLRLIQRITD,0
5oim,A,67,83,16,NEEHLASLAGRVTEAIG,0
5oim,A,99,103,4,PQTGM,0
5oim,A,107,111,4,PFFDA,0
5oim,A,112,124,12,PYADVSKGIHISA,0
5oim,A,124,135,11,AYSYASMAKALL,0
5oim,A,159,181,22,NWMTVAKSALESVNRFVAREAGK,0
5oim,A,196,204,8,TLAMSAIVG,0
5oim,A,208,226,18,GEEAGAQIQLLEEGWDQRA,0
5oim,A,235,247,12,ATPVAKTVCALLS,0
5oim,A,263,267,4,GAHTQ,0
5dtw,F,17,21,4,RPERR,0
5dtw,F,25,38,13,NSQLVEELTQAIRK,0
5dtw,F,70,85,15,DYPDRLIELHKAMDAS,0
5dtw,F,99,108,9,GAGLQLAMQC,0
5dtw,F,121,126,5,FPTSKY,0
5dtw,F,131,154,23,DNWSIRRLSSLVGHGRARAMLLSA,0
5dtw,F,159,166,7,AEIALHTG,0
5dtw,F,173,185,12,TLADAQAWAAEIA,0
5dtw,F,188,201,13,APLAIQHAKRVLND,0
5dtw,F,209,221,12,WPAHKELFDKAWG,0
5dtw,F,222,234,12,SQDVIEAQVARME,0
5dtw,F,122,127,5,PTSKYG,0
5dtw,F,131,143,12,DNWSIRRLSSLVG,0
5dtw,F,143,154,11,GHGRARAMLLSA,0
5dtw,F,173,186,13,TLADAQAWAAEIAR,0
5dtw,F,223,234,11,QDVIEAQVARME,0
5dtw,F,71,85,14,YPDRLIELHKAMDAS,0
5dtw,F,209,222,13,WPAHKELFDKAWGS,0
5dtw,F,64,68,4,GDAFA,0
5dtw,F,99,107,8,GAGLQLAMQ,0
5dtw,F,222,233,11,SQDVIEAQVARM,0
5dtw,F,122,126,4,PTSKY,0
5dtw,F,159,165,6,AEIALHT,0
2w29,D,6,19,13,DDIDRILVRELAAD,0
2w29,D,23,32,9,TLSELATRAG,0
2w29,D,34,48,14,SVSAVQSRVRRLESR,0
2w29,D,60,64,4,PEAVG,0
2w29,D,83,89,6,DAPARLE,0
2w29,D,114,130,16,SARALEDLLQRIRTTAN,0
2w29,D,36,48,12,SAVQSRVRRLESR,0
2w29,D,114,129,15,SARALEDLLQRIRTTA,0
3hva,B,278,295,17,RSHFLDLMDAAVQQAVTA,0
3hva,B,308,337,29,GYPSLQADHGLSGIDLLLGQLAGLMREQFG,0
3hva,B,338,340,2,EEA,0
3hva,B,358,375,17,TPEQAQAALQRLLKKVEN,0
3hva,B,402,419,17,KAQDVMNRAHRCADDAAR,0
3hva,B,358,376,18,TPEQAQAALQRLLKKVENH,0
3hva,B,402,421,19,KAQDVMNRAHRCADDAARKG,0
1t8q,D,47,57,10,TLPAKAAYAQ,0
1t8q,D,87,92,5,DVADRF,0
1t8q,D,103,107,4,YAIDF,0
1t8q,D,108,114,6,TLDEIKS,0
1t8q,D,147,163,16,TFEEEIEFVQGLNHSTG,0
1t8q,D,174,181,7,APWFHHQE,0
1t8q,D,184,196,12,DIAAKTLEVLKKY,0
1t8q,D,211,221,10,DADELKRIKNE,0
1t8q,D,223,227,4,EPKG,0
1t8q,D,238,242,4,YTDWN,0
1t8q,D,258,263,5,YDWFK,0
1t8q,D,266,272,6,AKQVAE,0
1t8q,D,281,284,3,YHL,0
1t8q,D,298,306,8,GVQDAQQN,0
1t8q,D,326,336,10,DVNQLYDALYN,0
1t8q,D,347,356,9,FPDKAVKFLN,0
1t8q,D,47,58,11,TLPAKAAYAQG,0
1t8q,D,221,226,5,ELEPK,0
1t8q,D,265,271,6,GAKQVA,0
1t8q,D,108,113,5,TLDEIK,0
1t8q,D,222,227,5,LEPKG,0
1t8q,D,298,305,7,GVQDAQQ,0
1t8q,D,211,222,11,DADELKRIKNEL,0
1t8q,D,266,271,5,AKQVA,0
1t8q,D,281,285,4,YHLI,0
2ytf,A,24,34,10,TKSNLIVHQRT,0
1uis,B,55,60,5,FDILAT,0
1uis,B,80,84,4,FKQSF,0
1uis,B,183,187,4,TVENF,0
1uis,B,54,62,8,AFDILATSF,0
1ok8,A,82,87,5,LNEEQD,0
1ok8,A,210,215,5,RQWFLD,0
1ok8,A,256,264,8,QEGAMHTAL,0
6fae,B,398,416,18,NDVVQRRHYRIGLNLFNKK,0
6fae,B,416,427,11,KPEKGIQYLIER,0
6fae,B,433,444,11,TPVGVAHFILER,0
6fae,B,448,457,9,SRQMIGEFLG,0
6fae,B,461,474,13,KQFNRDVLDCVVDE,0
6fae,B,481,493,12,DLDDALRKFQSHI,0
6fae,B,498,517,19,EAQKVERLIEAFSQRYCVCN,0
6fae,B,517,523,6,NPALVRQ,0
6fae,B,527,546,19,PDTIFILAFAIILLNTDMYS,0
6fae,B,550,554,4,KAERK,0
6fae,B,556,564,8,KLDDFIKNL,0
6fae,B,574,588,14,PRDLLVGIYQRIQGR,0
6fae,B,596,606,10,HVSQVQAVERM,0
6fae,B,714,742,28,SLQDRLRFTSDLRESIAEVQEMEKYRVES,0
6fae,B,29,36,7,GKTTILYK,0
6fae,B,74,77,3,IRPL,0
6fae,B,78,83,5,WRHYFQ,0
6fae,B,96,98,2,DRE,0
6fae,B,99,112,13,RVNEAREELMRMLA,0
6fae,B,113,117,4,EDELR,0
6fae,B,135,143,8,NAAEITDKL,0
6fae,B,144,148,4,GLHSL,0
6fae,B,159,163,4,CATSG,0
6fae,B,165,177,12,GLYEGLDWLSNQL,0
5n5j,A,126,143,17,NREDVDYAIRKAFQVWSN,0
5n5j,A,212,224,12,LFLTAVHEIGHSL,0
5n5j,A,251,262,11,SADDIRGIQSLY,0
2f3b,A,12,24,12,TLTRFVMEEGRKA,0
2f3b,A,28,50,22,GEMTQLLNSLCTAVKAISTAVRK,0
2f3b,A,72,88,16,KLDVLSNDLVINVLKSS,0
2f3b,A,106,108,2,EPE,0
2f3b,A,122,126,4,GSSNI,0
2f3b,A,148,153,5,SEKDAL,0
2f3b,A,155,159,4,PGRNL,0
2f3b,A,212,219,7,NEGYAKEF,0
2f3b,A,220,232,12,DPAITEYIQRKKF,0
2f3b,A,247,259,12,SMVADVHRTLVYG,0
2f3b,A,280,291,11,ECNPMAYVMEKA,0
2f3b,A,301,305,4,AVLDI,0
2f3b,A,320,335,15,SPEDVTELLEIYQKHA,0
5f1v,D,23,37,14,DEQSYARLIKRQIEN,0
5f1v,D,55,71,16,THEEHRTCIEIAVETCK,0
5f1v,D,85,99,14,ATHEAVGLAKFAKEH,0
5f1v,D,115,130,15,TQQGLYEHYKAIAQSV,0
5f1v,D,139,144,5,VPGRTG,0
5f1v,D,148,159,11,STDTIIKLFRDC,0
5f1v,D,171,182,11,NIDKCVDLLAHE,0
5f1v,D,191,193,2,EDA,0
5f1v,D,194,201,7,INYPILSN,0
5f1v,D,209,213,4,VTSNL,0
5f1v,D,214,227,13,LPDMISALTHFALD,0
5f1v,D,229,240,11,NYKEAKKINDEL,0
5f1v,D,240,247,7,LYNINKIL,0
5f1v,D,253,263,10,PIPIKTAMYLA,0
5f1v,D,279,291,12,SKENFAKIEEVMK,0
5f1v,D,50,54,4,ESATL,0
5f1v,D,229,247,18,NYKEAKKINDELYNINKIL,0
5f1v,D,115,128,13,TQQGLYEHYKAIAQ,0
2p0q,A,7,17,10,DETREHRIETE,0
2p0q,A,24,40,16,DKEERAMGWYYYLDDTL,0
2p0q,A,70,75,5,PDDECL,0
2p0q,A,106,122,16,DDDTQEAIADWLYWLAR,0
2oxt,D,3,19,16,GSTGASLGMMWKDKLNA,0
2oxt,D,21,31,10,TKEEFTRYKRA,0
2oxt,D,38,48,10,RKEARDYLKRG,0
2oxt,D,58,70,12,RGTAKLAWMEERG,0
2oxt,D,86,94,8,GGWSYYAAS,0
2oxt,D,121,123,2,GWN,0
2oxt,D,154,176,22,KWSVESERTIKILELLEKWKVKN,0
2oxt,D,190,205,15,SVEVMERLSVMQRKWG,0
2oxt,D,230,245,15,NIIGAVTACTERLLGR,0
2oxt,D,2,19,17,PGSTGASLGMMWKDKLNA,0
2oxt,D,38,47,9,RKEARDYLKR,0
2oxt,D,58,69,11,RGTAKLAWMEER,0
2oxt,D,132,136,4,DIHTL,0
2oxt,D,246,248,2,MAR,0
2oxt,D,38,45,7,RKEARDYL,0
2oxt,D,58,68,10,RGTAKLAWMEE,0
2oxt,D,86,95,9,GGWSYYAASR,0
2oxt,D,4,19,15,STGASLGMMWKDKLNA,0
2oxt,D,40,48,8,EARDYLKRG,0
2oxt,D,86,93,7,GGWSYYAA,0
1l2g,C,18,22,4,RGKDL,0
1l2g,C,77,83,6,APQIVRG,0
1l2g,C,85,90,5,SEDVRK,0
1l2g,C,157,161,4,AFETA,0
1l2g,C,198,202,4,PPSAC,0
1l2g,C,204,211,7,SPQAYQQG,0
1l2g,C,224,232,8,IPENQRTVA,0
1l2g,C,233,239,6,VYSLKIA,0
5vhs,f,73,82,9,APPALWDLAA,0
5vhs,f,84,89,5,KQTLQS,0
5vhs,f,130,134,4,APTDI,0
5vhs,f,159,166,7,PTVTMMQV,0
5vhs,f,173,177,4,TYSDV,0
5vhs,f,181,189,8,KEQIEKLRE,0
5vhs,f,192,197,5,ETPLLH,0
5vhs,f,198,204,6,PERFVNL,0
5vhs,f,223,231,8,TLCARAVAN,0
5vhs,f,243,245,2,SEL,0
5vhs,f,251,267,16,GEGARMVRELFEMARTK,0
5vhs,f,293,307,14,NEVQRTMLELINQLD,0
5vhs,f,328,333,5,DPALMR,0
5vhs,f,350,359,9,GRTHIFKIHA,0
5vhs,f,369,376,7,RFELLARL,0
5vhs,f,381,399,18,TGAEIRSVCTEAGMFAIRA,0
5vhs,f,409,419,10,FLEAVNKVIKS,0
5vhs,f,98,102,4,KVDDL,0
5vhs,f,190,202,12,LDNQIQEIKESVE,0
5vhs,f,207,211,4,HPEYY,0
5vhs,f,231,239,8,GKTLLAKAV,0
5vhs,f,240,243,3,ANQT,0
5vhs,f,253,258,5,SELIQK,0
5vhs,f,264,276,12,PKLVRELFRVAEE,0
5vhs,f,302,318,16,EREIQRTMLELLNQLDG,0
5vhs,f,333,337,4,RIETL,0
5vhs,f,338,342,4,DPALI,0
5vhs,f,358,369,11,EKTKKRIFQIHT,0
5vhs,f,380,385,5,LDDLIM,0
5vhs,f,392,409,17,GADIKAICTEAGLMALRE,0
5vhs,f,415,433,18,TNEDFKKSKENVLYKKQEG,0
5vhs,f,16,68,52,AGSGLRQYYLSKIEELQLIVNDKSQNLRRLQAQRNELNAKVRLLREELQLLQE,0
5vhs,f,155,162,7,DKQIKEIK,0
5vhs,f,197,207,10,TLLARAVAHHT,0
5vhs,f,232,241,9,RELFVMAREH,0
5vhs,f,261,283,22,GGSGGDSEVQRTMLELLNQLDGF,0
5vhs,f,298,307,9,IDILDSALLR,0
5vhs,f,322,336,14,EEARLDILKIHSRKM,0
5vhs,f,343,350,7,NLRKIAEL,0
5vhs,f,356,365,9,GAEVKGVCTE,0
5vhs,f,366,373,7,AGMYALRE,0
5vhs,f,379,392,13,TQEDFEMAVAKVMQ,0
5vhs,f,41,56,15,YSRYKKLQQELEFLEV,0
5vhs,f,56,81,25,VQEEYIKDEQKNLKKEFLHAQEEVKR,0
5vhs,f,120,124,4,DRELL,0
5vhs,f,173,187,14,QKQEVREAVELPLTH,0
5vhs,f,213,223,10,TMLAKAVAHHT,0
5vhs,f,241,257,16,GEGPRMVRDVFRLAKEN,0
5vhs,f,279,298,19,TGADREVQRILLELLNQMDG,0
5vhs,f,337,352,15,DRRQKRLIFSTITSKM,0
5vhs,f,361,370,9,EDYVARPDKI,0
5vhs,f,374,387,13,DINSICQESGMLAV,0
5vhs,f,395,406,11,LAKDFEKAYKTV,0
5vhs,f,12,28,16,YRKKLLEHKEIDGRLKE,0
5vhs,f,30,35,5,REQLKE,0
5vhs,f,35,50,15,ELTKQYEKSENDLKAL,0
5vhs,f,179,191,12,GKTLLARAVASQL,0
5vhs,f,199,203,4,VSSSI,0
5vhs,f,210,225,15,ESARLIREMFNYARDH,0
5vhs,f,250,263,13,DREIQRTLMELLNQ,0
5vhs,f,286,291,5,DPALLR,0
5vhs,f,305,316,11,NEQARLDILKIH,0
5vhs,f,327,335,8,DYEAIVKLS,0
5vhs,f,339,355,16,NGADLRNVCTEAGMFAI,0
5vhs,f,363,381,18,VQEDFMKAVRKVADSKKLE,0
5vhs,f,54,57,3,IMKS,0
5vhs,f,58,77,19,EVLRVTHELQAMKDKIKENS,0
5vhs,f,78,84,6,EKIKVNK,0
5vhs,f,195,208,13,IQELVEAIVLPMNH,0
5vhs,f,208,216,8,HKEKFENLG,0
5vhs,f,232,244,12,GKTLLARACAAQT,0
5vhs,f,252,257,5,AGPQLV,0
5vhs,f,262,275,13,GDGAKLVRDAFALA,0
5vhs,f,301,304,3,AGDR,0
5vhs,f,305,319,14,EVQRTMLELLNQLDG,0
5vhs,f,358,370,12,NEEARARIMQIHS,0
5vhs,f,381,388,7,YEELARCT,0
5vhs,f,392,407,15,NGAQCKAVCVEAGMIA,0
5vhs,f,417,428,11,HEDYMEGILEVQ,0
5vhs,f,96,115,19,YVETIIAKCIDHYTKQCVEN,0
5vhs,f,127,142,15,DQRLEGIVNKMFQRCL,0
5vhs,f,143,148,5,DDHKYK,0
5vhs,f,149,157,8,QAIGIALET,0
5vhs,f,172,185,13,DVPGMLAYSLKLCM,0
5vhs,f,193,202,9,FRNKVLRVLV,0
5vhs,f,212,221,9,DFINVCQCLI,0
5vhs,f,225,228,3,DPQA,0
5vhs,f,229,240,11,VSDILEKLVKED,0
5vhs,f,242,253,11,LLMAYQICFDLY,0
5vhs,f,258,271,13,QQFLSSVIQNLRTV,0
5vhs,f,318,329,11,PKDQTLKMIKIL,0
5vhs,f,331,342,11,GEMAIELHLQFL,0
5vhs,f,349,359,10,DLMILKNTKDA,0
5vhs,f,365,377,12,CHTATVIANSFMH,0
5vhs,f,398,412,14,NWAKFTATASLGVIH,0
5vhs,f,417,425,8,KEALQLMAT,0
5vhs,f,436,450,14,AYQEGGGLYALGLIH,0
5vhs,f,457,466,9,IIDYLLNQLK,0
5vhs,f,474,485,11,RHGGSLGLGLAA,0
5vhs,f,490,502,12,RQDVYDLLKTNLY,0
5vhs,f,506,520,14,AVTGEAAGLALGLVM,0
5vhs,f,525,537,12,NAQAIEDMVGYAQ,0
5vhs,f,542,555,13,EKILRGLAVGIALV,0
5vhs,f,562,571,9,EADALIESLC,0
5vhs,f,575,590,15,DPILRRSGMYTVAMAY,0
5vhs,f,597,608,11,KAIRRLLHVAVS,0
5vhs,f,611,617,6,NDDVRRA,0
5vhs,f,618,626,8,AVESLGFIL,0
5vhs,f,631,642,11,EQCPSVVSLLSE,0
5vhs,f,645,660,15,NPHVRYGAAMALGICC,0
5vhs,f,665,670,5,NKEAIN,0
5vhs,f,671,676,5,LLEPMT,0
5vhs,f,680,693,13,VNYVRQGALIASAL,0
5vhs,f,705,714,9,KVNQFRQLYS,0
5vhs,f,718,722,4,NDKHD,0
5vhs,f,723,738,15,DVMAKFGAILAQGILD,0
5vhs,f,739,742,3,AGGH,0
5vhs,f,756,768,12,HMPSVVGVLVFTQ,0
5vhs,f,772,781,9,WFPLSHFLSL,0
5vhs,f,885,890,5,MPAQLK,0
5vhs,f,245,258,13,DGQATLLNLLLRNY,0
5vhs,f,267,272,5,AEKLVS,0
5vhs,f,283,296,13,NEWARYLYYTGRIK,0
5vhs,f,303,315,12,SEARRTMTNALRK,0
5vhs,f,324,337,13,FKQTVHKLLIVVEL,0
5vhs,f,338,340,2,LLG,0
5vhs,f,352,370,18,SLKRSLMPYFLLTQAVRTG,0
5vhs,f,372,383,11,LAKFNQVLDQFG,0
5vhs,f,392,399,7,YTLIIRLR,0
5vhs,f,401,413,12,NVIKTGVRMISLS,0
5vhs,f,420,426,6,ADIAQKL,0
5vhs,f,430,443,13,SPEDAEFIVAKAIR,0
5vhs,f,471,503,32,EPQLAFHQRISFCLDIHNMSVKAMRFPPKSYNK,0
5vhs,f,69,79,10,AVVKMCYEAKE,0
5vhs,f,81,87,6,DLLNENI,0
5vhs,f,96,111,15,QLKQAVAKMVQQCCTY,0
5vhs,f,116,135,19,TDLPIKLRLIDTLRMVTEGK,0
5vhs,f,140,157,17,IERARLTKTLATIKEQNG,0
5vhs,f,161,174,13,EAASILQELQVETY,0
5vhs,f,179,187,8,KKERVEFIL,0
5vhs,f,192,197,5,LCLAVK,0
5vhs,f,198,205,7,DYIRTQII,0
5vhs,f,207,210,3,KKIN,0
5vhs,f,222,238,16,LKLKYYNLMIQLDQHEG,0
5vhs,f,240,244,4,YLSIC,0
5vhs,f,249,251,2,AIY,0
5vhs,f,252,257,5,DTPCIQ,0
5vhs,f,260,264,4,SEKWQ,0
5vhs,f,265,270,5,QALKSV,0
5vhs,f,271,276,5,VLYVIL,0
5vhs,f,281,291,10,NEQSDLVHRIS,0
5vhs,f,293,298,5,DKKLEE,0
5vhs,f,301,308,7,KYKDLLKL,0
5vhs,f,317,330,13,WSTLVEDYGMELRK,0
5vhs,f,336,341,5,PATDVF,0
5vhs,f,345,367,22,EEGEKRWKDLKNRVVEHNIRIMA,0
5vhs,f,374,382,8,TMKRMAQLL,0
5vhs,f,385,397,12,SVDESEAFLSNLV,0
5vhs,f,424,452,28,LLNDWSQKLNSLMSLVNKTTHLIAKEEMI,0
5vhs,f,453,456,3,HNLQ,0
5vhs,f,144,158,14,QEALHLGSQLLRELK,0
5vhs,f,162,164,2,DKA,0
5vhs,f,165,180,15,LLVEVQLLESKTYHAL,0
5vhs,f,182,197,15,NLPKARAALTSARTTA,0
5vhs,f,203,222,19,PPKLQATLDMQSGIIHAAEE,0
5vhs,f,224,239,15,DWKTAYSYFYEAFEGY,0
5vhs,f,243,260,17,DSPKAITSLKYMLLCKIM,0
5vhs,f,263,273,10,TPEDVQALVSG,0
5vhs,f,273,278,5,GKLALR,0
5vhs,f,281,297,16,GRQTEALKCVAQASKNR,0
5vhs,f,299,309,10,LADFEKALTDY,0
5vhs,f,319,339,20,ISTHLAKLYDNLLEQNLIRVI,0
5vhs,f,346,352,6,QIEHISS,0
5vhs,f,357,371,14,SKADVERKLSQMILD,0
5vhs,f,392,422,30,PVDKTYEAALETIQNMSKVVDSLYNKAKKLT,0
5vhs,f,15,20,5,PDLRIA,0
5vhs,f,22,28,6,LRFLLSL,0
5vhs,f,34,43,9,DAAVRDELMA,0
5vhs,f,44,46,2,AVR,0
5vhs,f,49,56,7,NMAPYYEA,0
5vhs,f,57,60,3,LCKS,0
5vhs,f,65,92,27,IDVDLLNKMKKANEDELKRLDEELEDAE,0
5vhs,f,97,115,18,ESEIRDAMMAKAEYLCRIG,0
5vhs,f,118,130,12,EGALTAFRKTYDK,0
5vhs,f,133,152,19,ALGHRLDIVFYLLRIGLFYM,0
5vhs,f,155,166,11,DLITRNTEKAKS,0
5vhs,f,175,191,16,DRRNRLKVYQGLYCVAI,0
5vhs,f,199,207,8,ELFLDTVST,0
5vhs,f,215,230,15,DYKTFVTYTVYVSMIA,0
5vhs,f,232,240,8,ERPDLREKV,0
5vhs,f,244,250,6,AEILEVL,0
5vhs,f,253,266,13,LPAVRQYLFSLYEC,0
5vhs,f,267,283,16,RYSVFFQSLAVVEQEMK,0
5vhs,f,291,310,19,HYRYYVREMRIHAYSQLLES,0
5vhs,f,316,324,8,LGYMAEAFG,0
5vhs,f,326,340,14,GVEFIDQELSRFIAA,0
5vhs,f,366,368,2,YQE,0
5vhs,f,369,387,18,TIKKGDLLLNRVQKLSRVI,0
5vhs,f,12,25,13,HPLVLLSVVDHFNR,0
5vhs,f,72,86,14,HDYLENMYGMFKKVN,0
5vhs,f,104,115,11,NDIAINELMKRY,0
5vhs,f,167,177,10,AEEVGVEHLLR,0
5vhs,f,186,217,31,TLSQRITNQVHGLKGLNSKLLDIRSYLEKVAT,0
5vhs,f,224,235,11,HQIIYQLQDVFN,0
5vhs,f,245,288,43,FVKAFYLKTNDQMVVVYLASLIRSVVALHNLINNKIANRDAEKK,0
5vhs,f,4,13,9,VPGFLQQSQN,0
5vhs,f,18,31,13,QPAVWHRLEELYTK,0
5vhs,f,33,47,14,LWHQLTLQVLDFVQD,0
5vhs,f,54,68,14,DGLIKLYENFISEFE,0
5vhs,f,73,88,15,PLSLVEIILHVVRQMT,0
5vhs,f,89,104,15,DPNVALTFLEKTREKV,0
5vhs,f,110,123,13,AVILCKTAIGALKL,0
5vhs,f,128,142,14,LQVTKETIEDVEEML,0
5vhs,f,149,164,15,TSVHSRFYDLSSKYYQ,0
5vhs,f,169,182,13,HASYYKDALRFLGC,0
5vhs,f,189,207,18,PVSEQQERAFTLGLAGLLG,0
5vhs,f,213,219,6,FGELLMH,0
5vhs,f,219,226,7,HPVLESLR,0
5vhs,f,231,243,12,QWLIDTLYAFNSG,0
5vhs,f,247,253,6,RFQTLKT,0
5vhs,f,264,273,9,NEAQLLRKIQ,0
5vhs,f,274,283,9,LLCLMEMTFT,0
5vhs,f,292,300,8,TFEEIAKSA,0
5vhs,f,306,318,12,EVELLVMKALSVG,0
5vhs,f,343,375,32,LQQIKGMKDRLEFWCTDVKSMEMLVEHQAHDIL,0
5vhs,f,13,17,4,SEYMR,0
5vhs,f,25,44,19,RLQAQQDAVNIVCHSKTRSN,0
5vhs,f,70,75,5,RILSKL,0
5vhs,f,86,92,6,FCTGIRV,0
5vhs,f,95,100,5,LALKHR,0
5vhs,f,120,135,15,NEKDLVKLAKRLKKEK,0
5vhs,f,152,161,9,KLTAFVNTLN,0
5vhs,f,180,185,5,ADALIS,0
5vhs,f,34,47,13,SSLALLKMLKHGRA,0
5vhs,f,88,101,13,DPVFQAKMLDMLKQ,0
5vhs,f,123,134,11,SGVDINTQQSFE,0
5vhs,f,164,169,5,NANMMV,0
5vhs,f,180,185,5,NLGHLN,0
5vhs,f,210,225,15,NELEQKMLLNLHKKSW,0
5vhs,f,232,241,9,QDYSEHCKHN,0
5vhs,f,244,264,20,VVKEMLELAKNYNKAVEEEDK,0
5vhs,f,265,270,5,MTPEQL,0
5vhs,f,284,310,26,LEEHVDVLMTSNIVQCLAAMLDTVVFK,0
5vhs,f,94,109,15,YMHQLLGLNLLFLLSQ,0
5vhs,f,111,119,8,RVAEFHTEL,0
5vhs,f,130,146,16,NVYIKHPVSLEQYLMEG,0
5vhs,f,148,154,6,YNKVFLA,0
5vhs,f,155,158,3,KGNI,0
5vhs,f,163,183,20,YTFFIDILLDTIRDEIAGCIE,0
5vhs,f,191,198,7,FTEATRIL,0
5vhs,f,204,213,9,KKMTDYAKKR,0
5vhs,f,236,254,18,TIPSTELAKQVIEYARQLE,0
5vhs,f,41,52,11,DNWDDDNVEDDF,0
5vhs,f,59,70,11,ELEKHGYKMETS,0
5vhs,f,71,87,16,YRPALEELRRQIRSSTT,0
5vhs,f,93,98,5,PKPLKF,0
5vhs,f,119,126,7,KRFAADII,0
5vhs,f,126,144,18,ISVLAMTMSGERECLKYRL,0
5vhs,f,164,181,17,GEVAKEWQELDDAEKVQR,0
5vhs,f,182,190,8,EPLLTLVKE,0
5vhs,f,208,217,9,LMEIEQVDML,0
5vhs,f,221,239,18,IDENAYAKVCLYLTSCVNY,0
5vhs,f,241,259,18,PEPENSALLRCALGVFRKF,0
5vhs,f,261,273,12,RFPEALRLALMLN,0
5vhs,f,274,288,14,DMELVEDIFTSCKDV,0
5vhs,f,298,309,11,LGRHGVFLELSE,0
5vhs,f,310,324,14,DVEEYEDLTEIMSNV,0
5vhs,f,328,334,6,SNFLALA,0
5vhs,f,343,351,8,KVPDDIYKT,0
5vhs,f,355,362,7,NNRFGGSG,0
5vhs,f,369,380,11,RMNLASSFVNGF,0
5vhs,f,390,394,4,LLTDD,0
5vhs,f,397,402,5,KWLYKN,0
5vhs,f,403,417,14,KDHGMLSAAASLGMI,0
5vhs,f,421,430,9,DVDGGLTQID,0
5vhs,f,437,452,15,EDYIKSGALLACGIVN,0
5vhs,f,458,464,6,ECDPALA,0
5vhs,f,472,474,2,HNS,0
5vhs,f,475,489,14,NTMRLGSIFGLGLAY,0
5vhs,f,494,501,7,REDVLTLL,0
5vhs,f,501,508,7,LLPVMGDS,0
5vhs,f,511,526,15,SMEVAGVTALACGMIA,0
5vhs,f,535,544,9,TSTILQTIME,0
5vhs,f,553,566,13,TYARWLPLGLGLNH,0
5vhs,f,573,582,9,IEAILAALEV,0
5vhs,f,585,599,14,EPFRSFANTLVDVCA,0
5vhs,f,606,616,10,VLKVQQLLHIC,0
5vhs,f,622,630,8,SKEKEEDKD,0
5vhs,f,630,635,5,DKKEKK,0
5vhs,f,644,649,5,ADMGAH,0
5vhs,f,651,662,11,GVAVLGIALIAM,0
5vhs,f,668,679,11,AEMALRTFGHLL,0
5vhs,f,683,697,14,EPTLRRAVPLALALI,0
5vhs,f,717,728,11,ADPEVSYNSIFA,0
5vhs,f,740,754,14,RLAAMLRQLAQYHAK,0
5vhs,f,774,785,11,GTLTLCPYHSDR,0
5vhs,f,793,798,5,VAGLLT,0
4gur,C,93,101,8,NECFDHYYR,0
4gur,C,106,120,14,GYDKYTTWKKIWTSN,0
4gur,C,126,135,9,SPKAFMADQQ,0
4gur,C,160,167,7,TPQIAKTY,0
4gur,C,183,187,4,DHCSL,0
4gur,C,193,197,4,VLEVS,0
4gur,C,198,204,6,NHWWYSM,0
4gur,C,216,221,5,AAPLLS,0
4gur,C,224,229,5,YPDCVG,0
4gur,C,290,297,7,ELDELYEF,0
4gur,C,298,301,3,PEYS,0
4gur,C,304,321,17,PTMYLALRNLILALWYTN,0
4gur,C,327,332,5,TPQKCI,0
4gur,C,333,335,2,PHI,0
4gur,C,340,359,19,LVRIRCVQEVERILYFMTRK,0
4gur,C,377,381,4,PKDYH,0
4gur,C,391,405,14,GPAGLAAARQLHNFG,0
4gur,C,445,455,10,NPVALMCEQLG,0
4gur,C,476,498,22,DPTIDKRMDFHFNALLDVVSEWR,0
4gur,C,502,506,4,TQLQD,0
4gur,C,508,524,16,PLGEKIEEIYKAFIKES,0
4gur,C,529,548,19,SELEGQVLQFHLSNLEYACG,0
4gur,C,560,565,5,DHNEFF,0
4gur,C,579,588,9,YSVIIEKLAE,0
4gur,C,628,634,6,PLALLQK,0
4gur,C,644,653,9,SEKKMKAINS,0
4gur,C,671,676,5,WDSKVQ,0
4gur,C,687,691,4,SASKR,0
4gur,C,715,720,5,GEAVAS,0
4gur,C,725,741,16,DDKQVLQQCMATLRELF,0
4gur,C,756,760,4,RWSTD,0
4gur,C,776,784,8,GEAYDIIAE,0
4gur,C,794,798,4,GEATN,0
4gur,C,804,822,18,TVTGAYLSGVREASKIAAF,0
4gur,C,219,223,4,HFLLS,0
4gur,C,1,5,4,ARTMQ,0
1l0c,A,41,43,2,TPE,0
1l0c,A,44,56,12,DAAGVFEIEREAF,0
1l0c,A,56,61,5,FISVSG,0
1l0c,A,66,77,11,NLDEVQHFLTLC,0
1l0c,A,106,111,5,QESLAL,0
1l0c,A,128,131,3,RSFR,0
1l0c,A,134,150,16,GKGSVLLWRYLHHVGAQ,0
1l0c,A,161,163,2,EDA,0
1l0c,A,164,170,6,LVPFFQR,0
5w10,D,6,17,11,SKPELIKLYSSL,0
5w10,D,20,24,4,IITSS,0
5w10,D,26,43,17,EQQEVLSAVEEVRLFFS,0
5w10,D,68,73,5,QFNHIR,0
5w10,D,81,91,10,EGIAGSVVQTK,0
5w10,D,98,102,4,NVKND,0
5w10,D,107,114,7,KKVDEKTG,0
5w10,D,147,174,27,SPEDLVILQTIADFTAISLAHSDQYEKT,0
5w10,D,6,22,16,SKPELIKLYSSLGKIIT,0
5w10,D,147,173,26,SPEDLVILQTIADFTAISLAHSDQYEK,0
4klv,A,9,11,2,ETG,0
4klv,A,12,18,6,DLETVAG,0
4klv,A,22,30,8,DRDELFYCY,0
4klv,A,38,49,11,SVAQLAAAIAER,0
4klv,A,85,88,3,PAAR,0
4klv,A,91,109,18,GVARYLIGVMENLAREQYK,0
4klv,A,121,131,10,NAAGLLLYTQL,0
5m85,A,441,457,16,LQNIFRATSDEVRHLLS,0
5m85,A,485,491,6,PLKDLQN,0
5m85,A,499,504,5,TYLQEN,0
5m85,A,506,512,6,GGRYRNH,0
5m85,A,519,523,4,DVETA,0
5m85,A,526,536,10,TDCHLDNLRRF,0
5m85,A,568,598,30,QAREIHLLHQIANQLGVAVYQAQLLARFQEL,0
4zjh,A,180,184,4,KVVEG,0
4zjh,A,206,216,10,SLPAFISQWEY,0
4zjh,A,225,230,5,SDKLLQ,0
4zjh,A,259,264,5,IKPLQQ,0
3ojb,D,120,124,4,ELSSI,0
2lmj,A,57,59,2,PSS,0
2mmj,A,2,7,5,LFGVLA,0
2mmj,A,8,10,2,KVA,0
2mmj,A,12,21,9,HVVGAIAEHF,0
3luk,C,463,482,19,TEVHLKSFTEQLRKISRDAG,0
3luk,C,497,499,2,GAD,0
3luk,C,500,512,12,SVEPFRHLKNTY,0
3luk,C,527,538,11,PVYAEVKRVGDT,0
3luk,C,549,554,5,KNVQR,0
3luk,C,556,573,17,TPQTLSNLCLKINVKLGG,0
3luk,C,463,481,18,TEVHLKSFTEQLRKISRDA,0
3luk,C,526,539,13,TPVYAEVKRVGDTV,0
3luk,C,556,572,16,TPQTLSNLCLKINVKLG,0
2dt2,A,10,13,3,WSQY,0
2dt2,A,15,19,4,EGDGS,0
2dt2,A,21,25,4,FPDAI,0
2dt2,A,51,61,10,NDVTLYDTLNT,0
2dt2,A,62,65,3,LKNR,0
2dt2,A,81,91,10,GPERFSKIASK,0
2dt2,A,91,109,18,KTQSRRTFIKSVPPFLRTH,0
2dt2,A,125,145,20,DKRHLTALVKEMKAEFAREAQ,0
2dt2,A,160,168,8,GKIAIDRGY,0
2dt2,A,169,177,8,DIAQISRHL,0
2dt2,A,215,227,12,NADYAVSYMLRLG,0
2dt2,A,229,231,2,PAN,0
2dt2,A,275,282,7,YYEICDFL,0
2dt2,A,309,323,14,DQESVKNKARYLKNR,0
2dt2,A,332,336,4,ALDLD,0
2dt2,A,349,361,12,FPLTSAVKDVLAR,0
4s0u,C,119,130,11,NWYESQASCMSQ,0
4s0u,C,143,149,6,QDLLKLV,0
4s0u,C,119,129,10,NWYESQASCMS,0
4s0u,C,41,44,3,PKFR,0
4s0u,C,46,48,2,GPR,0
4s0u,C,76,82,6,PLGKKLN,0
4s0u,C,85,107,22,MAWKAQNPVLREVVDILTEQLLD,0
4s0u,C,165,175,10,ARKMKEKWEND,0
4s0u,C,175,188,13,DKDVAMSFHYISMG,0
4s0u,C,188,203,15,GDCIGWLEDFLMGMDS,0
5hsw,A,36,43,7,SFSKFLKH,0
5hsw,A,43,51,8,HAKVRDWCA,0
5hsw,A,60,78,18,PALRMAYNYFLFSKVGEFI,0
5hsw,A,81,90,9,EDVCNFFVDR,0
5hsw,A,99,109,10,DVASVYAACSQ,0
5hsw,A,111,126,15,NAHQRHHICCLVERAT,0
5hsw,A,133,140,7,PVWDALRD,0
5hsw,A,147,154,7,KFHWAVKQ,0
5hsw,A,183,195,12,CEEVVKTLLATLL,0
5hsw,A,249,252,3,FKYT,0
5hsw,A,259,270,11,DPIYAAYQRLYE,0
5hsw,A,273,282,9,GKLALKDFFY,0
5hsw,A,308,312,4,DQEWE,0
5hsw,A,325,336,11,HNLIRECILHNS,0
5hsw,A,371,389,18,HSYFYQVLLQSSIVEEYIG,0
5hsw,A,445,468,23,PRGAKHRLLHQAANFWSRSAKDTF,0
5hsw,A,477,481,4,YLSAN,0
2om9,D,207,226,19,ESADLRALAKHLYDSYIKSF,0
2om9,D,229,238,9,TKAKARAILT,0
2om9,D,251,262,11,DMNSLMMGEDKI,0
2om9,D,270,275,5,LQEQSK,0
2om9,D,276,285,9,EVAIRIFQGC,0
2om9,D,285,301,16,CQFRSVEAVQEITEYAK,0
2om9,D,305,309,4,GFVNL,0
2om9,D,310,333,23,DLNDQVTLLKYGVHEIIYTMLASL,0
2om9,D,350,356,6,REFLKSL,0
2om9,D,359,363,4,PFGDF,0
2om9,D,364,376,12,MEPKFEFAVKFNA,0
2om9,D,380,393,13,DDSDLAIFIAVIIL,0
2om9,D,402,425,23,NVKPIEDIQDNLLQALELQLKLNH,0
2om9,D,430,460,30,QLFAKLLQKMTDLRQIVTEHVQLLQVIKKTE,0
2om9,D,466,474,8,HPLLQEIYK,0
2om9,D,285,303,18,CQFRSVEAVQEITEYAKSI,0
2om9,D,310,334,24,DLNDQVTLLKYGVHEIIYTMLASLM,0
2om9,D,350,355,5,REFLKS,0
2om9,D,403,425,22,VKPIEDIQDNLLQALELQLKLNH,0
2om9,D,285,302,17,CQFRSVEAVQEITEYAKS,0
2om9,D,364,377,13,MEPKFEFAVKFNAL,0
5bu2,D,298,301,3,DYLL,0
5bu2,D,302,316,14,SANGSKAIDFVWSNF,0
5bu2,D,322,326,4,NPKLK,0
5bu2,D,329,338,9,DANVKAAWEK,0
5bu2,D,344,349,5,HWSNMG,0
5bu2,D,367,389,22,GIAHTLRVAQLVPVIAEFLKAYS,0
5bu2,D,391,396,5,DPKFQK,0
5bu2,D,398,410,12,TQKEIQKAQYMML,0
5bu2,D,421,436,15,SWTDANHYQQAFKEAY,0
5bu2,D,443,461,18,HIYATFKENAQKGFLNHVV,0
5bu2,D,463,468,5,NKSSLI,0
5bu2,D,474,485,11,DESELQYWAEAL,0
5bu2,D,494,508,14,SASGILMALAHDLDL,0
5bu2,D,509,511,2,MRC,0
5bu2,D,513,521,8,DKGKFNSLK,0
5bu2,D,521,529,8,KMKDLVARL,0
5bu2,D,532,550,18,NEDAAKKLADYAHDLIVAT,0
5bu2,D,564,574,10,NYSLFGKCSLD,0
5bu2,D,574,584,10,DPNECLKQLQS,0
5bu2,D,393,397,4,KFQKL,0
5bu2,D,364,366,2,PNH,0
5bu2,D,391,397,6,DPKFQKL,0
5bu2,D,443,462,19,HIYATFKENAQKGFLNHVVT,0
5bu2,D,564,573,9,NYSLFGKCSL,0
5bu2,D,329,337,8,DANVKAAWE,0
2ox9,D,627,638,11,IFEDAKLFCEDK,0
2ox9,D,647,657,10,SREEQQWIKKH,0
2ox9,D,713,715,2,YAG,0
2ox9,D,647,659,12,SREEQQWIKKHTV,0
2ox9,D,647,658,11,SREEQQWIKKHT,0
2ox9,D,627,637,10,IFEDAKLFCED,0
2ox9,D,699,703,4,GSGHG,0
2wi4,A,23,36,13,QAEIAQLMSLIINT,0
2wi4,A,40,42,2,NKE,0
2wi4,A,43,65,22,IFLRELISNSSDALDKIRYESLT,0
2wi4,A,66,71,5,DPSKLD,0
2wi4,A,99,105,6,TKADLIN,0
2wi4,A,105,122,17,NNLGTIAKSGTKAFMEAL,0
2wi4,A,127,135,8,DISMIGQFG,0
2wi4,A,136,143,7,VGFYSAYL,0
2wi4,A,192,198,6,EDQTEYL,0
2wi4,A,199,211,12,EERRIKEIVKKHS,0
5wjp,A,14,23,9,SKLDQILSSG,0
5wjp,A,48,62,14,GFDIDVMQELAKDMG,0
5wjp,A,71,73,2,EWK,0
5wjp,A,74,81,7,TIVSGITA,0
5wjp,A,93,99,6,TPKRAEV,0
5wjp,A,118,120,2,KNL,0
5wjp,A,126,130,4,WKSLN,0
5wjp,A,142,152,10,TSQEEKAKEFF,0
5wjp,A,165,172,7,RDFQEVLA,0
5wjp,A,182,192,10,STEANKLVVKY,0
5wjp,A,216,233,17,DQVWNDYVNEWIKSKKSS,0
5wjp,A,234,243,9,GFFNKLLAKY,0
3i3d,D,14,18,4,RDWEN,0
3i3d,D,38,44,6,NSEEART,0
3i3d,D,65,70,5,APEAVP,0
3i3d,D,71,76,5,ESWLEC,0
3i3d,D,89,94,5,NWQMHG,0
3i3d,D,130,136,6,DESWLQE,0
3i3d,D,192,198,6,SDGSYLE,0
3i3d,D,368,382,14,DEQTMVQDILLMKQN,0
3i3d,D,395,406,11,HPLWYTLCDRYG,0
3i3d,D,429,431,2,DPR,0
3i3d,D,432,448,16,WLPAMSERVTRMVQRDR,0
3i3d,D,465,479,14,GANHDALYRWIKSVD,0
3i3d,D,519,525,6,SIKKWLS,0
3i3d,D,548,559,11,GFAKYWQAFRQY,0
3i3d,D,598,603,5,DRQFCM,0
3i3d,D,615,624,9,PALTEAKHQQ,0
3i3d,D,789,794,5,LDNDIG,0
3i3d,D,805,813,8,AWVERWKAA,0
3i3d,D,923,926,3,SDMY,0
3i3d,D,963,970,7,SQQQLMET,0
3i3d,D,972,976,4,HRHLL,0
3i3d,D,1004,1008,4,SAEFQ,0
3i3d,D,38,45,7,NSEEARTD,0
3i3d,D,396,406,10,PLWYTLCDRYG,0
3i3d,D,805,814,9,AWVERWKAAG,0
3i3d,D,130,134,4,DESWL,0
3i3d,D,65,69,4,APEAV,0
3i3d,D,70,75,5,PESWLE,0
3i3d,D,131,136,5,ESWLQE,0
4ptn,D,32,46,14,DKPGTAALIDDLIKA,0
4ptn,D,59,63,4,EFSQL,0
4ptn,D,64,80,16,GAEERKAIARFAIDHVD,0
4ptn,D,93,108,15,NARETIELSQHAQQAG,0
4ptn,D,123,137,14,SEANLIRYFEQVADS,0
4ptn,D,147,152,5,FPALTG,0
4ptn,D,156,167,11,TPALVKTLADSR,0
4ptn,D,179,194,15,SVAHLRSMIHTVKGAH,0
4ptn,D,203,205,2,YDD,0
4ptn,D,206,213,7,HLFNTLLL,0
4ptn,D,220,224,4,SASGN,0
4ptn,D,226,240,14,APQVSVNLLKAWRDG,0
4ptn,D,241,255,14,DVAKAAGYHQTLLQI,0
4ptn,D,256,262,6,PQMYQLD,0
4ptn,D,265,276,11,FVNVIKEAIVLC,0
4ptn,D,292,306,14,DEPRKAQLKTLLQQL,0
4ptn,D,220,225,5,SASGNF,0
4ptn,D,226,239,13,APQVSVNLLKAWRD,0
1fip,B,26,40,14,PLRDSVKQALKNYFA,0
1fip,B,49,70,21,DLYELVLAEVEQALLDMVMQYT,0
1fip,B,73,82,9,NQTRAALMMG,0
1fip,B,84,95,11,NRGTLRKKLKKY,0
1fip,B,26,42,16,PLRDSVKQALKNYFAQL,0
1ft4,B,77,80,3,RKEM,0
1ft4,B,77,81,4,RKEMG,0
1ft4,B,98,102,4,CRKNQ,0
1ft4,B,141,143,2,AGF,0
2o7i,A,4,6,2,PRE,0
2o7i,A,32,37,5,GTDQFM,0
2o7i,A,84,99,15,TADDFVYALELTKELG,0
2o7i,A,105,109,4,GWDTY,0
2o7i,A,131,141,10,NYFQFLSYSLG,0
2o7i,A,146,157,11,PKHVYERIRAQM,0
2o7i,A,158,162,4,NIKDW,0
2o7i,A,196,201,5,GKDIFG,0
2o7i,A,215,225,10,DNPSASLAFER,0
2o7i,A,239,244,5,WELWEK,0
2o7i,A,278,289,11,DPAVRKAIAYAI,0
2o7i,A,290,298,8,PYNEMLKKA,0
2o7i,A,315,322,7,FEPYKQYI,0
2o7i,A,323,332,9,DYELAKKTFG,0
2o7i,A,341,352,11,DLDMANKILDEA,0
2o7i,A,381,398,17,WTDWMMMCEMIAKNLRSI,0
2o7i,A,408,418,10,DFSVWADRMTK,0
2o7i,A,436,445,9,PFNIYRFVLD,0
2o7i,A,446,449,3,KRLS,0
2o7i,A,466,477,11,NDEVVELLDKAV,0
2o7i,A,481,500,19,DPEVRKQAYFRIQQIIYRDM,0
2o7i,A,542,547,5,PTLFII,0
2o7i,A,572,582,10,TAKIFEDLQKA,0
2q5c,D,11,26,15,NENLLNLFPKLALEKN,0
2q5c,D,35,47,12,SLTRASKIAFGLQ,0
2q5c,D,57,65,8,GATSDYIKK,0
2q5c,D,77,89,12,TRFDTMRAVYNAK,0
2q5c,D,90,92,2,RFG,0
2q5c,D,106,115,9,DKHEIEAMLG,0
2q5c,D,125,127,2,SED,0
2q5c,D,128,139,11,EITTLISKVKTE,0
2q5c,D,147,157,10,GKTVTDEAIKQ,0
2q5c,D,167,186,19,GEESLRRAIEEALNLIEVRN,0
4l4v,H,47,52,5,APWMAE,0
4l4v,H,55,85,30,APDHWERYTQLLRGWQQMFKVELKRLQRHYN,0
4l4v,H,133,145,12,DNVAHTIKQAWEA,0
4l4v,H,146,159,13,NQHELLYQKNWLEE,0
4l4v,H,159,172,13,EECIAWLKRFLEYG,0
4l4v,H,172,177,5,GKDTLQ,0
4l4v,H,79,83,4,QMKDS,0
4l4v,H,162,165,3,RSMD,0
4l4v,H,181,186,5,ACANAF,0
4l4v,H,82,86,4,APSQT,0
4l4v,H,117,121,4,DLKNV,0
4l4v,H,132,140,8,SEAEISHTQ,0
4l4v,H,199,203,4,ATFWQ,0
4l4v,H,181,185,4,ACANA,0
4l4v,H,199,204,5,ATFWQN,0
2y1g,B,22,34,12,GSIGTQALQVIAD,0
2y1g,B,51,61,10,LDTLLRQRAQT,0
2y1g,B,70,77,7,DEHAAQRV,0
2y1g,B,86,94,8,DAATRLVEQ,0
2y1g,B,108,118,10,LGLRPTLAALK,0
2y1g,B,128,133,5,KESLVA,0
2y1g,B,135,141,6,GSLVLRA,0
2y1g,B,151,163,12,DSEHSALAQCLRG,0
2y1g,B,185,190,5,SAADLE,0
2y1g,B,193,197,4,TPEQA,0
2y1g,B,206,214,8,GPMNTLNSA,0
2y1g,B,216,230,14,LVNKGLEVIETHLLF,0
2y1g,B,267,275,8,MKLPISLAL,0
2y1g,B,307,318,11,PAVELARQAGVA,0
2y1g,B,321,338,17,CMTAVYNAANEEAAAAFL,0
2y1g,B,343,357,14,GFPAIVGIIADVLHA,0
2y1g,B,368,387,19,VDDVLDAQRWARERAQRAVS,0
1exp,A,4,10,6,LKEAADG,0
1exp,A,21,25,4,PNRLS,0
1exp,A,27,36,9,AQYKAIADSE,0
1exp,A,48,51,3,WDAT,0
1exp,A,61,73,12,GAGDRVASYAADT,0
1exp,A,90,93,3,DWAK,0
1exp,A,97,115,18,GSAFESAMVNHVTKVADHF,0
1exp,A,140,145,5,AFQQKL,0
1exp,A,147,160,13,NGYIETAFRAARAA,0
1exp,A,178,193,15,AKSNSLYDLVKDFKAR,0
1exp,A,215,225,10,FRQNLQRFADL,0
1exp,A,244,262,18,ATKLATQAADYKKVVQACM,0
1exp,A,277,279,2,DKY,0
1exp,A,282,285,3,VPDV,0
1exp,A,303,310,7,PAYAAVME,0
4o8h,A,29,42,13,VPKTAENFRALCTG,0
4o8h,A,119,123,4,TDWLD,0
4o8h,A,135,145,10,GMDVVKKIESF,0
1p4f,A,8,11,3,NVDD,0
1p4f,A,57,71,14,SREDIEREVSILKEI,0
1p4f,A,112,133,21,TEEEATEFLKQILNGVYYLHSL,0
1p4f,A,141,143,2,KPE,0
1p4f,A,180,184,4,TPEFV,0
1p4f,A,185,190,5,APEIVN,0
1p4f,A,196,213,17,LEADMWSIGVITYILLSG,0
1p4f,A,221,232,11,TKQETLANVSAV,0
1p4f,A,237,242,5,EDEYFS,0
1p4f,A,245,254,9,SALAKDFIRR,0
1p4f,A,259,263,4,DPKKR,0
1p4f,A,265,272,7,TIQDSLQH,0
6bks,B,65,72,7,TLIDALLG,0
6bks,B,73,80,7,DPQCDGFQ,0
6bks,B,104,116,12,DYASLRSLVASSG,0
6bks,B,187,196,9,TDSEQISLYA,0
6bks,B,37,56,19,DLKSTQAAINQINGKLNRLI,0
6bks,B,75,127,52,GRIQDLEKYVEDTKIDLWSYNAELLVALENQHTIDLTDSEMNKLFERTKKQLR,0
6bks,B,145,154,9,DNACIESIRN,0
6bks,B,158,171,13,DHDVYRDEALNNRF,0
4pxw,B,1292,1295,3,PALD,0
4biz,F,221,246,25,AGASFNQMVTALERMMTSQQRLLSDI,0
4biz,F,250,269,19,LRTPLTRLQLGTALLRRRSG,0
4biz,F,271,302,31,SKELERIETEAQRLDSMINDLLVMSRNQQKNA,0
4biz,F,310,328,18,ANQLWSEVLDNAAFEAEQM,0
4biz,F,346,365,19,NPNALESALENIVRNALRYS,0
4biz,F,406,413,7,TDEARDRE,0
4biz,F,419,431,12,LGLAIVETAIQQH,0
4biz,F,224,268,44,SFNQMVTALERMMTSQQRLLSDISEELRTPLTRLQLGTALLRRRS,0
4biz,F,271,304,33,SKELERIETEAQRLDSMINDLLVMSRNQQKNALV,0
4biz,F,346,364,18,NPNALESALENIVRNALRY,0
4biz,F,218,268,50,FLAAGASFNQMVTALERMMTSQQRLLSDISEELRTPLTRLQLGTALLRRRS,0
4biz,F,271,303,32,SKELERIETEAQRLDSMINDLLVMSRNQQKNAL,0
4biz,F,420,431,11,GLAIVETAIQQH,0
4biz,F,223,250,27,ASFNQMVTALERMMTSQQRLLSDISEEL,0
4biz,F,250,268,18,LRTPLTRLQLGTALLRRRS,0
4biz,F,271,301,30,SKELERIETEAQRLDSMINDLLVMSRNQQKN,0
4biz,F,406,411,5,TDEARD,0
1pzn,G,44,53,9,GPATAEKLRE,0
1pzn,G,58,64,6,TLEAIAV,0
1pzn,G,66,75,9,SPIELKEVAG,0
1pzn,G,77,92,15,SEGTALKIIQAARKAA,0
1pzn,G,100,109,9,ADEYLKKRAT,0
1pzn,G,117,125,8,SKSLDKLLG,0
1pzn,G,143,155,12,GKTQLAHTLAVV,0
1pzn,G,156,157,1,QL,0
1pzn,G,158,162,4,PPEEG,0
1pzn,G,178,188,10,RPERIREIAQN,0
1pzn,G,192,197,5,DPDEVL,0
1pzn,G,207,225,18,NSNHQLLVQQAEDKIKEL,0
1pzn,G,243,248,5,HFRSEY,0
1pzn,G,253,275,22,ALAERQQKLAKHLADLHRLANLY,0
1pzn,G,99,107,8,RADEYLKKR,0
1pzn,G,117,124,7,SKSLDKLL,0
1pzn,G,207,227,20,NSNHQLLVQQAEDKIKELLN,0
1pzn,G,252,275,23,GALAERQQKLAKHLADLHRLANLY,0
1pzn,G,178,189,11,RPERIREIAQNR,0
1pzn,G,207,228,21,NSNHQLLVQQAEDKIKELLNT,0
1pzn,G,178,184,6,RPERIRE,0
1pzn,G,185,189,4,IAQNR,0
1pzn,G,207,217,10,NSNHQLLVQQ,0
1pzn,G,217,223,6,QAEDKIK,0
1pzn,G,224,228,4,ELLNT,0
1pzn,G,207,226,19,NSNHQLLVQQAEDKIKELL,0
1pzn,G,100,107,7,ADEYLKKR,0
1pzn,G,178,187,9,RPERIREIAQ,0
1pzn,G,195,198,3,EVLK,0
1pzn,G,207,224,17,NSNHQLLVQQAEDKIKE,0
4wcj,A,70,84,14,SRREFAQQLDYLRQV,0
4wcj,A,90,99,9,TPQEAEDYLA,0
4wcj,A,117,123,6,DLSVYRH,0
4wcj,A,123,131,8,HAFPVLKKR,0
4wcj,A,141,144,3,AGQV,0
4wcj,A,155,165,10,SWEQIKEMVAS,0
4wcj,A,189,191,2,FLL,0
4wcj,A,194,214,20,RERLFAEDTARGTACLKEHLG,0
4wcj,A,223,226,3,PYGF,0
4wcj,A,228,238,10,TPTTDEILRTQ,0
4wcj,A,268,278,10,SWPQVAAWAQA,0
1tpw,B,18,30,12,KKSLGELIHTLNG,0
1tpw,B,48,54,6,LDFARQK,0
1tpw,B,80,86,6,PAMIKDI,0
1tpw,B,96,100,4,PERRH,0
1tpw,B,106,118,12,DELIGQKVAHALA,0
1tpw,B,131,135,4,LDERE,0
1tpw,B,139,151,12,TEKVVFEQTKAIA,0
1tpw,B,175,192,17,TATPQQAQEVHEKLRGWL,0
1tpw,B,198,203,5,DAVAQS,0
1tpw,B,217,221,4,CKELA,0
1tpw,B,240,244,4,FVDII,0
4uf0,B,880,884,4,KDKLN,0
4uf0,B,894,900,6,NKRDAFF,0
4uf0,B,900,909,9,FPPLHQFCTN,0
4uf0,B,919,925,6,GLAGALK,0
4uf0,B,927,931,4,DLGLF,0
4uf0,B,932,941,9,STKTLVEANN,0
4uf0,B,979,998,19,IAKYAQYQASSFQESLREEN,0
4uf0,B,1043,1050,7,WKLQLHEL,0
4uf0,B,1051,1053,2,TKL,0
4uf0,B,1054,1058,4,PAFAR,0
4uf0,B,1064,1069,5,NLLTHV,0
4uf0,B,1095,1099,4,ENNNF,0
4uf0,B,1117,1119,2,PED,0
4uf0,B,1120,1131,11,YWGVLNDFCEKN,0
4uf0,B,1143,1150,7,NLEDLYEA,0
4uf0,B,1192,1209,17,TACQYKLAVERYEWNKLK,0
4uf0,B,1216,1228,12,PMVHLSWNMARNI,0
4uf0,B,1232,1260,28,DPKLFEMIKYCLLKILKQYQTLREALVAA,0
4uf0,B,1293,1298,5,NESNTQ,0
4uf0,B,1305,1313,8,CHDCARKTS,0
4uf0,B,1326,1336,10,KMEDLIQVYDQ,0
4uf0,B,896,900,4,RDAFF,0
4uf0,B,901,909,8,PPLHQFCTN,0
4uf0,B,932,940,8,STKTLVEAN,0
4uf0,B,1120,1130,10,YWGVLNDFCEK,0
4uf0,B,1326,1337,11,KMEDLIEVYDQF,0
3wtd,B,53,65,12,TPDSLAALKARFG,0
3wtd,B,72,83,11,ITPRFRAACEQQ,0
3wtd,B,113,141,28,PGPEAAPRLRALTLGLAKRVWSLERRLAA,0
3wtd,B,53,64,11,TPDSLAALKARF,0
3wtd,B,113,144,31,PGPEAAPRLRALTLGLAKRVWSLERRLAAAEE,0
3ngu,B,11,17,6,KPDGVQR,0
3ngu,B,19,31,12,LVGEIIARFERKG,0
3ngu,B,43,51,8,TTEQAQGHY,0
3ngu,B,52,55,3,KDLC,0
3ngu,B,59,68,9,FFPALVKYFS,0
3ngu,B,81,91,10,NVVKSGRVLLG,0
3ngu,B,94,98,4,NPADS,0
3ngu,B,102,108,6,TIRGDFA,0
3ngu,B,121,133,12,SVESAEREIAFWF,0
3ngu,B,145,150,5,SVSQIY,0
3ngu,B,19,30,11,LVGEIIARFERK,0
3ngu,B,110,114,4,DVGRN,0
3ngu,B,134,138,4,KADEI,0
1ccw,D,17,30,13,AVGNKILDHAFTNA,0
1ccw,D,42,54,12,PQELFIKAAIETK,0
1ccw,D,66,72,6,QGEIDCK,0
1ccw,D,73,81,8,GLRQKCDEA,0
1ccw,D,100,111,11,HWPDVEKRFKDM,0
1ccw,D,122,135,13,PPEVGIADLKKDLN,0
1ccw,D,9,21,12,TDEEFHKQREEVL,0
1ccw,D,22,30,8,QQWPTGKEV,0
1ccw,D,31,41,10,DLQEAVDYLKK,0
1ccw,D,42,46,4,IPAEK,0
1ccw,D,47,59,12,NFAEKLVLAKKKG,0
1ccw,D,71,85,14,LLDEHIELLRYLQDE,0
1ccw,D,98,102,4,YTRQN,0
1ccw,D,103,118,15,RYDECENGIKESEKAG,0
1ccw,D,126,142,16,PGVNFGVKGCRKVLEAV,0
1ccw,D,155,165,10,SRLLAEIIHAG,0
1ccw,D,186,207,21,TIEKSLLDWQYCDRLVGFYEEQ,0
1ccw,D,225,243,18,PPSMSNAVGITEALLAAEQ,0
1ccw,D,257,279,22,NMIQDIAALRCLEEQTNEYLKAY,0
1ccw,D,300,319,19,DESKAFGVIVTATTIAALAG,0
1ccw,D,336,354,18,TKEANAAGIKATKMALNML,0
1ccw,D,362,387,25,SKELETEMAVIKAETKCILDKMFELG,0
1ccw,D,390,401,11,DLAIGTVKAFET,0
1ccw,D,439,458,19,TEEIKNYNRERLQERAKFEG,0
1ccw,D,462,473,11,SFQMVIDDIFAV,0
1ccw,D,122,134,12,PPEVGIADLKKDL,0
1ccw,D,96,101,5,DAYTRQ,0
4no5,A,49,53,4,APWIE,0
4no5,A,56,85,29,GPEYWDGETRKVKAHSQTHRVDLGTLRGYY,0
4no5,A,137,150,13,DMAAQTTKHKWEAA,0
4no5,A,151,162,11,HVAEQLRAYLEG,0
4no5,A,162,175,13,GTCVEWLRRYLENG,0
4no5,A,175,180,5,GKETLQ,0
4no5,A,253,255,2,QEQ,0
5ife,A,27,46,19,TKWEWLVNQHRDSYCSYMGH,0
5ife,A,46,57,11,HFDLLNYFAIAE,0
5ife,A,60,71,11,SKARVRFNLMEK,0
5ife,A,468,470,2,KPD,0
5ife,A,471,476,5,DIQYFD,0
5ife,A,477,479,2,KLL,0
5ife,A,491,499,8,EQKERKIMK,0
5ife,A,499,506,7,KLLLKIKN,0
5ife,A,508,522,14,TPPMRKAALRQITDK,0
5ife,A,522,527,5,KAREFG,0
5ife,A,527,541,14,GAGPLFNQILPLLMS,0
5ife,A,545,563,18,EDQERHLLVKVIDRILYKL,0
5ife,A,567,569,2,VRP,0
5ife,A,570,579,9,YVHKILVVIE,0
5ife,A,580,584,4,PLLID,0
5ife,A,586,604,18,DYYARVEGREIISNLAKAA,0
5ife,A,605,614,9,GLATMISTMR,0
5ife,A,621,640,19,DEYVRNTTARAFAVVASALG,0
5ife,A,640,652,12,GIPSLLPFLKAVC,0
5ife,A,657,676,19,SWQARHTGIKIVQQIAILMG,0
5ife,A,677,681,4,CAILP,0
5ife,A,682,691,9,HLRSLVEIIE,0
5ife,A,692,696,4,HGLVD,0
5ife,A,698,717,19,QQKVRTISALAIAALAEAAT,0
5ife,A,721,723,2,IES,0
5ife,A,724,738,14,FDSVLKPLWKGIRQH,0
5ife,A,740,754,14,GKGLAAFLKAIGYLI,0
5ife,A,755,757,2,PLM,0
5ife,A,758,776,18,DAEYANYYTREVMLILIRE,0
5ife,A,777,779,2,FQS,0
5ife,A,781,796,15,DEEMKKIVLKVVKQCC,0
5ife,A,802,810,8,EANYIKTEI,0
5ife,A,810,818,8,ILPPFFKHF,0
5ife,A,820,824,4,QHRMA,0
5ife,A,826,845,19,DRRNYRQLVDTTVELANKVG,0
5ife,A,845,855,10,GAAEIISRIVD,0
5ife,A,856,859,3,DLKD,0
5ife,A,861,880,19,AEQYRKMVMETIEKIMGNLG,0
5ife,A,885,902,17,DHKLEEQLIDGILYAFQE,0
5ife,A,907,922,15,DSVMLNGFGTVVNALG,0
5ife,A,923,927,4,KRVKP,0
5ife,A,928,941,13,YLPQICGTVLWRLN,0
5ife,A,947,964,17,VRQQAADLISRTAVVMKT,0
5ife,A,967,980,13,EEKLMGHLGVVLYE,0
5ife,A,986,1002,16,YPEVLGSILGALKAIVN,0
5ife,A,1012,1021,9,PIKDLLPRLT,0
5ife,A,1022,1026,4,PILKN,0
5ife,A,1028,1046,18,HEKVQENCIDLVGRIADRG,0
5ife,A,1047,1050,3,AEYV,0
5ife,A,1051,1063,12,SAREWMRICFELL,0
5ife,A,1064,1068,4,ELLKA,0
5ife,A,1070,1089,19,KKAIRRATVNTFGYIAKAIG,0
5ife,A,1108,1123,15,NRVCTTVAIAIVAETC,0
5ife,A,1128,1135,7,VLPALMNE,0
5ife,A,1140,1159,19,ELNVQNGVLKSLSFLFEYIG,0
5ife,A,1160,1164,4,EMGKD,0
5ife,A,1165,1178,13,YIYAVTPLLEDALM,0
5ife,A,1181,1200,19,DLVHRQTASAVVQHMSLGVY,0
5ife,A,1204,1216,12,CEDSLNHLLNYVW,0
5ife,A,1217,1220,3,PNVF,0
5ife,A,1223,1242,19,SPHVIQAVMGALEGLRVAIG,0
5ife,A,1242,1251,9,GPCRMLQYCL,0
5ife,A,1252,1255,3,QGLF,0
5ife,A,1258,1275,17,ARKVRDVYWKIYNSIYIG,0
5ife,A,1279,1283,4,ALIAH,0
5ife,A,1298,1302,4,YELDY,0
5ife,A,51,55,4,YGSYQ,0
5ife,A,73,78,5,KECTIQ,0
5ife,A,79,83,4,EKDRD,0
5ife,A,429,432,3,RGPR,0
5ife,A,620,624,4,DPSDC,0
5ife,A,808,825,17,TEATKAQRKQQMAEEMVE,0
5ife,A,838,843,5,MAAAFL,0
5ife,A,930,935,5,LVNNGE,0
5ife,A,1134,1152,18,SHEDHDFFQHVEMHLRSEH,0
5ife,A,1159,1165,6,DHLSFRS,0
5ife,A,1176,1180,4,GDLCE,0
5ife,A,1181,1185,4,QFNSM,0
5ife,A,1186,1197,11,EPNKQKNVSEEL,0
5ife,A,1200,1216,16,TPPEVSKKLEDIRTRYA,0
2g3o,F,48,53,5,SPYLLS,0
2g3o,F,60,64,4,FYHFG,0
2g3o,F,72,78,6,NPFLHAI,0
2g3o,F,125,129,4,SVIFT,0
1hqb,A,3,19,16,DEAIKNGVLDILADLTG,0
1hqb,A,39,50,11,SMGTVQLLLELQ,0
1hqb,A,69,79,10,TPNKIIAKVEQ,0
4pxy,B,45,63,18,EEAHVQFAEQATTFFKKLN,0
4pxy,B,75,79,4,DFSKY,0
4pxy,B,80,85,5,PYEKLK,0
4pxy,B,99,112,13,TKAERDAFEQYEN,0
4pxy,B,121,124,3,AAAY,0
4pxy,B,131,139,8,WPWFVKFLG,0
4pxy,B,185,189,4,SPRQN,0
4pxy,B,200,203,3,PKNY,0
4pxy,B,241,258,17,DGTQNLLLVNAFRWVVSK,0
4pxy,B,263,267,4,NPFLK,0
5bir,B,13,28,15,SSDVSTAQAAGYKLHE,0
5bir,B,13,29,16,SSDVSTAQAAGYKLHED,0
3cck,B,105,116,11,SWTSAQNACSEH,0
3cck,B,125,137,12,SEKDMNFLKRYAG,0
3cck,B,105,115,10,SWTSAQNACSE,0
1apj,A,2080,2084,4,KQECC,0
1apj,A,2105,2110,5,EAFRQI,0
3c7x,A,317,321,4,NICDG,0
3c7x,A,357,361,4,IGQFW,0
3c7x,A,404,406,2,KEL,0
3c7x,A,454,456,2,KVW,0
3c7x,A,501,505,4,ALRDW,0
5xuf,A,2,24,22,SSVDQKAISTIRLLAVDAVAAAN,0
5xuf,A,28,45,17,PGAPLGLAPAAHAVFKKM,0
5xuf,A,64,66,2,NGH,0
5xuf,A,67,78,11,ACALLYSMLVLY,0
5xuf,A,83,89,6,TVEDLKK,0
5xuf,A,117,138,21,GQGICNGVGIALAQAQFAATYN,0
5xuf,A,154,160,6,GDGCLME,0
5xuf,A,160,173,13,EGVSSEASSLAGHL,0
5xuf,A,194,196,2,EVA,0
5xuf,A,200,208,8,DVIARYKSY,0
5xuf,A,221,235,14,DITAIAAAIDEAKKV,0
5xuf,A,257,261,4,THGVH,0
5xuf,A,266,277,11,KADDIKQLKTKW,0
5xuf,A,288,320,32,PAEVTASYNEHVAENQKIQQQWNELFAAYKQKY,0
5xuf,A,320,332,12,YPELGAELQRRLD,0
5xuf,A,338,343,5,NWDKAL,0
5xuf,A,355,367,12,TRKLSEIVLSKII,0
5xuf,A,368,370,2,PEV,0
5xuf,A,380,385,5,LTPSNL,0
5xuf,A,396,400,4,PAATG,0
5xuf,A,414,429,15,REHAMGAIMNGIAAFG,0
5xuf,A,440,444,4,LNFVS,0
5xuf,A,446,457,11,AAGAVRLSALSE,0
5xuf,A,468,472,4,SIGLG,0
5xuf,A,482,489,7,ETLAHFRA,0
5xuf,A,500,514,14,DGNETSAAYKSAIES,0
5xuf,A,535,540,5,SIEKAS,0
5xuf,A,561,576,15,SEVSLAVDALKVLEGQ,0
5xuf,A,587,593,6,DQLTFDK,0
5xuf,A,595,603,8,SEEYKLSVL,0
5xuf,A,619,623,4,GWSKY,0
5xuf,A,638,646,8,KAPEIFKLF,0
5xuf,A,649,664,15,TPEGVAERAAKTVAFY,0
5c3e,K,23,31,8,SPEEVRAIS,0
5c3e,K,93,95,2,VGF,0
5c3e,K,96,106,10,IAKIKKVCECV,0
5c3e,K,119,127,8,NELMRQALA,0
5c3e,K,131,144,13,SKKRFAAIWTLCKT,0
5c3e,K,203,213,10,STEEILNIFKH,0
5c3e,K,215,222,7,SVKDFTSL,0
5c3e,K,230,233,3,RPEW,0
5c3e,K,260,282,22,DDLTFKLADILKANISLETLEHN,0
5c3e,K,289,303,14,IEEAESLLQFHVATY,0
5c3e,K,324,329,5,SIRARL,0
5c3e,K,368,372,4,KSIAK,0
5c3e,K,385,395,10,IDRLTQLVRNG,0
5c3e,K,474,479,5,VTSPYN,0
5c3e,K,494,503,9,SEETRAELSQ,0
5c3e,K,508,512,4,PLQIV,0
5c3e,K,524,535,11,VQDTLCGIRKLT,0
5c3e,K,543,553,10,LDQVLNMLYWV,0
5c3e,K,574,582,8,GKQILSVAI,0
5c3e,K,618,623,5,EKKTVG,0
5c3e,K,629,637,8,LIHVVTREK,0
5c3e,K,640,661,21,QVCAKLFGNIQKVVNFWLLHNG,0
5c3e,K,665,670,5,GIGDTI,0
5c3e,K,672,699,27,DGPTMREITETIAEAKKKVLDVTKEAQA,0
5c3e,K,709,737,28,TLRESFEDNVVRFLNEARDKAGRLAEVNL,0
5c3e,K,741,750,9,NNVKQMVMAG,0
5c3e,K,754,763,9,SFINIAQMSA,0
5c3e,K,809,845,36,TPQEFFFHAMGGREGLIDTAVKTAETGYIQRRLVKAL,0
5c3e,K,867,871,4,IYGED,0
5c3e,K,874,876,2,DAA,0
5c3e,K,889,898,9,SDAAFEKRYR,0
5c3e,K,922,947,25,DLKLQVLLDEEYKQLVKDRKFLREVF,0
5c3e,K,959,971,12,NIRRIIQNAQQTF,0
5c3e,K,982,997,15,TIKDIVLGVKDLQENL,0
5c3e,K,1004,1016,12,NEIIQNAQRDAVT,0
5c3e,K,1016,1026,10,TLFCCLLRSRL,0
5c3e,K,1027,1034,7,ATRRVLQE,0
5c3e,K,1038,1057,19,TKQAFDWVLSNIEAQFLRSV,0
5c3e,K,1064,1078,14,VGVLAAQSIGEPATQ,0
5c3e,K,1096,1107,11,SGVPRLKEILNV,0
5c3e,K,1127,1139,12,DQEQAKLIRSAIE,0
5c3e,K,1167,1173,6,EEIIQLH,0
5c3e,K,1198,1205,7,DRAAMNDK,0
5c3e,K,1208,1218,10,TMGQVGERIKQ,0
5c3e,K,1256,1270,14,EDHMLKKIENTMLEN,0
5c3e,K,1332,1339,7,FIDIMEVL,0
5c3e,K,1340,1359,19,GIEAGRAALYKEVYNVIASD,0
5c3e,K,1364,1377,13,NYRHMALLVDVMTT,0
5c3e,K,1395,1401,6,GALMRCS,0
5c3e,K,1405,1415,10,TVEILFEAGAS,0
5c3e,K,1423,1431,8,GVSENVILG,0
5c3e,K,1436,1439,3,IGTG,0
5c3e,K,1446,1454,8,DEESLVKYM,0
5c3e,K,29,41,12,DSWAVISAFFREK,0
5c3e,K,44,57,13,VSQQLDSFNQFVDY,0
5c3e,K,58,66,8,TLQDIICED,0
5c3e,K,113,121,8,YPQEARLRN,0
5c3e,K,179,183,4,CYLSE,0
5c3e,K,185,192,7,TESDLYKL,0
5c3e,K,282,288,6,IVIIFRA,0
5c3e,K,293,302,9,PDGEILEHIC,0
5c3e,K,307,321,14,DWQMLEMLKPCVEDG,0
5c3e,K,326,332,6,DRETALD,0
5c3e,K,348,359,11,RIQYAKDILQKE,0
5c3e,K,370,390,20,FESRKAFFLGYMINRLLLCAL,0
5c3e,K,400,402,2,HFG,0
5c3e,K,408,435,27,LAGPLLAQLFKTLFKKLTKDIFRYMQRT,0
5c3e,K,442,464,22,FNMKLAINAKTITSGLKYALATG,0
5c3e,K,487,496,9,TYSSTLSHLR,0
5c3e,K,515,519,4,HNTHW,0
5c3e,K,551,560,9,PMPIITFLSE,0
5c3e,K,567,569,2,EDY,0
5c3e,K,593,607,14,PARLMETLRTLRRKG,0
5c3e,K,654,668,14,RKGHIAKLMATEYQD,0
5c3e,K,680,686,6,TWSSLLN,0
5c3e,K,696,701,5,EEEESI,0
5c3e,K,744,749,5,HPSMIL,0
5c3e,K,751,755,4,VAASI,0
5c3e,K,758,762,4,FPDHN,0
5c3e,K,763,774,11,QSPRNTYQSAMG,0
5c3e,K,775,777,2,KQA,0
5c3e,K,808,813,5,AMEYLK,0
5c3e,K,843,848,5,QSSIDR,0
5c3e,K,889,893,4,TYDKL,0
5c3e,K,1013,1017,4,NPHAI,0
5c3e,K,1022,1039,17,TVAHLIECLLSKVAALSG,0
5c3e,K,1051,1063,12,TVEGISKLLREHG,0
5c3e,K,1121,1125,4,GRSRD,0
5c3e,K,1131,1142,11,GEMERDCMIAHG,0
5c3e,K,1143,1152,9,AASFLKERLM,0
5c3e,K,1197,1209,12,PYAAKLLFQELMA,0
5c3e,K,26,39,13,DLAMANSLRRVMIA,0
5c3e,K,59,69,10,ADEFIAHRLGL,0
5c3e,K,114,118,4,YSKDL,0
5c3e,K,167,171,4,HAKWG,0
5c3e,K,196,201,5,DSAKEW,0
5c3e,K,204,210,6,SKNCEYE,0
5c3e,K,239,266,27,PVDQVVVRGIDTLQKKVASILLALTQMD,0
5c3e,K,51,71,20,NLSEARLVIKEALVERRRAFK,0
5c3e,K,118,134,16,TREKELESIDVLLEQTT,0
5c3e,K,138,152,14,NKDLKNTMQYLTNFS,0
5c3e,K,156,168,12,DQETVGAVIQLLK,0
5c3e,K,173,181,8,HPFEVAQLG,0
5c3e,K,187,195,8,TADEAKTLI,0
5c3e,K,203,218,15,SDDELERILKELSNLE,0
5c3e,K,4,27,23,ENERNISRLWRAFRTVKEMVKDRG,0
5c3e,K,31,36,5,TQEEVE,0
5c3e,K,38,47,9,PLEDFKAKYC,0
5c3e,K,65,72,7,TEESISKF,0
5c3e,K,89,104,15,GVKTMKTFVIHIQEKN,0
5c3e,K,137,142,5,EAALVV,0
5c3e,K,157,168,11,SSDEKRELLKRY,0
5c3e,K,182,188,6,DPVALYL,0
5c3e,K,86,103,17,TKYERARILGTRALQISM,0
5c3e,K,116,127,11,DPLRIAMKELAE,0
5c3e,K,14,18,4,HPSFF,0
5c3e,K,19,21,2,GPR,0
5c3e,K,22,34,12,MKQYLKTKLLEEV,0
5c3e,K,61,65,4,DIGSD,0
5c3e,K,15,25,10,GDKWESYLNLL,0
5c3e,K,31,39,8,DEGTALSRL,0
5c3e,K,43,52,9,RYCCRRMILT,0
5c3e,K,56,62,6,LIEKFLR,0
5c3e,K,5,10,5,DRFELF,0
5c3e,K,39,52,13,DHTLGNLIRAELLN,0
5c3e,K,82,111,29,DPKDALKNACNSIINKLGALKTNFETEWNL,0
4nk7,A,475,477,2,DNL,0
4nk7,A,478,498,20,PSKHWKKYIYGARFVGLVKSK,0
4nk7,A,555,578,23,ESRSLIEHGNECFTHCVNISNALE,0
3r30,A,58,61,3,AIID,0
3r30,A,98,112,14,CPKARREVELHWRAS,0
3r30,A,146,151,5,LFSRIQ,0
3r30,A,159,180,21,TEREASEIMKSIGEAIQYLHSI,0
3r30,A,188,190,2,KPE,0
3r30,A,242,259,17,KSCDMWSLGVIMYILLCG,0
3r30,A,274,281,7,GMKTRIRM,0
3r30,A,295,306,11,SEEVKMLIRNLL,0
3r30,A,309,313,4,EPTQR,0
3r30,A,315,322,7,TITEFMNH,0
3r30,A,322,327,5,HPWIMQ,0
3r30,A,337,345,8,HTSRVLKED,0
2gmg,A,8,20,12,GSATRREKIIELL,0
2gmg,A,28,33,5,SELARI,0
2gmg,A,41,57,16,SKKVILEDLKVISKIAK,0
2qjg,T,9,17,8,NLGKLVRLE,0
2qjg,T,33,39,6,DHGVSNG,0
2qjg,T,46,58,12,DIRKTVNDVAEGG,0
2qjg,T,65,71,6,HKGIVRH,0
2qjg,T,104,111,7,TVEEAIRM,0
2qjg,T,126,145,19,EDWEAYRDLGMIAETCEYWG,0
2qjg,T,164,178,14,DPELVAHAARLGAEL,0
2qjg,T,190,201,11,DIDSFRDVVKGC,0
2qjg,T,215,230,15,TDEEFLQMIKDAMEAG,0
2qjg,T,237,242,5,GRNIFQ,0
2qjg,T,245,260,15,DVVGITRAVCKIVHEN,0
2qjg,T,262,268,6,DVEEALK,0
2qjg,T,1,5,4,MELFK,0
2qjg,T,65,72,7,HKGIVRHG,0
2qjg,T,65,70,5,HKGIVR,0
2qjg,T,262,267,5,DVEEAL,0
2qjg,T,268,270,2,KEI,0
2qjg,T,9,18,9,NLGKLVRLER,0
2qjg,T,164,179,15,DPELVAHAARLGAELG,0
2qjg,T,9,20,11,NLGKLVRLERIF,0
2qjg,T,262,269,7,DVEEALKE,0
2qjg,T,18,20,2,RIF,0
2qjg,T,127,145,18,DWEAYRDLGMIAETCEYWG,0
4row,A,198,207,9,DPPTFTFNFN,0
4row,A,236,239,3,NQRR,0
4row,A,257,266,9,HAELCFLDVI,0
4row,A,267,270,3,PFWK,0
4row,A,288,302,14,CFSCAQEMAKFISKN,0
4row,A,320,331,11,RCQEGLRTLAEA,0
4row,A,339,351,12,TYSEFKHCWDTFV,0
4row,A,363,380,17,GLDEHSQALSGRLRAILQ,0
4mhv,B,77,85,8,AVMSQALKA,0
4mhv,B,86,88,2,TFS,0
4mhv,B,89,97,8,GFKKEQRRL,0
4mhv,B,102,106,4,NPWLW,0
4mhv,B,107,122,15,SEQQVCQWLLWATNEF,0
4mhv,B,128,133,5,NLQRFG,0
4mhv,B,135,142,7,NGQMLCNL,0
4mhv,B,143,151,8,GKERFLELA,0
4mhv,B,154,170,16,FVGDILWEHLEQMIKEN,0
4mhv,B,77,86,9,AVMSQALKAT,0
4mhv,B,128,132,4,NLQRF,0
4mhv,B,142,151,9,LGKERFLELA,0
4mhv,B,154,169,15,FVGDILWEHLEQMIKE,0
1wyq,A,9,22,13,KDALLLWCQMKTAG,0
1wyq,A,38,49,11,GLAFNAIVHKHR,0
1wyq,A,63,77,14,AHYNLQNAFNLAEKE,0
1wyq,A,95,113,18,DEKSIITYVATYYHYFSKM,0
2hku,B,18,35,17,QTRDALFTAATELFLEHG,0
2hku,B,39,48,9,PITQICAAAG,0
2hku,B,50,59,9,HPNQVTYYYG,0
2hku,B,60,86,26,SKERLFVEVACAAVLRAGKRAEDDAAT,0
2hku,B,89,103,14,TVGDYTEKLVGSLLG,0
2hku,B,105,119,14,GAPSVELFTSALT,0
2hku,B,122,143,21,RSELRDLITDTLRTLHSSGEVA,0
2hku,B,143,151,8,ALIRTLRT,0
2hku,B,158,180,22,GIDVESKAFWSAIFGLVIQKTAT,0
2hku,B,187,200,13,SLEEAVAVIFANLQ,0
2hku,B,202,208,6,PETVRNT,0
2hku,B,19,35,16,TRDALFTAATELFLEHG,0
2hku,B,51,59,8,PNQVTYYYG,0
2hku,B,60,85,25,SKERLFVEVACAAVLRAGKRAEDDAA,0
2hku,B,122,149,27,RSELRDLITDTLRTLHSSGEVALIRTL,0
2hku,B,158,178,20,GIDVESKAFWSAIFGLVIQKT,0
2hku,B,187,199,12,SLEEAVAVIFANL,0
1q53,B,24,42,18,SPEKIEELIKGYANLVNLI,0
1q53,B,73,82,9,SKEAVAEYIA,0
1q53,B,83,95,12,HPAHVEFATIFLG,0
1q53,B,24,40,16,SPEKIEELIKGYANLVN,0
1q53,B,75,82,7,EAVAEYIA,0
3mlm,B,1,14,13,SLFELGKMILQETG,0
3mlm,B,16,22,6,NPAKSYG,0
3mlm,B,38,53,15,DATDRCCYVHKCCYKK,0
3mlm,B,79,99,20,NPCLKELCECDKAVAICLREN,0
3mlm,B,100,103,3,LGTY,0
3mlm,B,104,108,4,NKKYR,0
3mlm,B,79,98,19,NPCLKELCECDKAVAICLRE,0
3mlm,B,99,103,4,NLGTY,0
3mlm,B,111,115,4,LKPFC,0
2dx8,B,373,383,10,TETAYGLLTAE,0
2dx8,B,390,396,6,CDTCMAD,0
2dx8,B,367,371,4,RICTG,0
3khv,A,23,27,4,TIENQ,0
3khv,A,55,59,4,ATHCF,0
3khv,A,61,61,0,K,0
3khv,A,164,170,6,SHRECQH,0
3khv,A,234,241,7,FLPWIRSH,0
4aup,B,92,103,11,SPVSDTDRLLYS,0
4aup,B,105,115,10,AMPAFLTAKRN,0
4aup,B,134,138,4,RPAGF,0
4aup,B,140,157,17,FLDSCKRHDFGYRNYKKQ,0
4aup,B,161,181,20,TEANRKRIDDNFKKDLYNECA,0
4aup,B,189,209,20,WKGVACRKIANTYYDAVRTFG,0
4aup,B,105,116,11,AMPAFLTAKRNK,0
4aup,B,184,186,2,SGL,0
4aup,B,187,209,22,ESWKGVACRKIANTYYDAVRTFG,0
3sxa,A,101,112,11,NIDILNEQFRLQ,0
3sxa,A,123,128,5,IKKYVA,0
3sxa,A,129,141,12,FLKLFLETAEKHF,0
3sxa,A,155,159,4,QPAAV,0
3sxa,A,180,187,7,RWQDVSMR,0
3sxa,A,187,193,6,RRMEMIS,0
3sxa,A,196,204,8,CERRFLSEV,0
3sxa,A,221,225,4,GVEIL,0
3sxa,A,240,244,4,SREAF,0
3sxa,A,274,294,20,VQEVQRLTRACHQAMMVDQAN,0
3sxa,A,300,313,13,WHDESHLNKYLLRH,0
3sxa,A,321,324,3,PEYL,0
3sxa,A,326,331,5,DQQLLG,0
3sxa,A,347,352,5,NHQAVR,0
1pcn,A,19,22,3,NSAQ,0
5thb,F,65,72,7,HPIGMLIG,0
5thb,F,73,80,7,TPACDLHL,0
5thb,F,104,114,10,NVEALRQKIME,0
5thb,F,187,196,9,STQEKNTLYG,0
5thb,F,37,57,20,DYKSTQAAIDQITGKLNRLVE,0
5thb,F,74,127,53,EHQIGNVINWTKDSITDIWTYQAELLVAMENQHTIDMADSEMLNLYERVRKQLR,0
5thb,F,145,155,10,DDSCMESIRNN,0
5thb,F,158,171,13,DHSQYREEALLNRL,0
5thb,F,37,56,19,DYKSTQAAIDQITGKLNRLV,0
5thb,F,145,154,9,DDSCMESIRN,0
5thb,F,159,172,13,HSQYREEALLNRLN,0
5thb,F,104,113,9,NVEALRQKIM,0
5thb,F,158,161,3,DHSQ,0
5thb,F,162,172,10,YREEALLNRLN,0
3iyf,P,17,36,19,GRDAQRMNILAGRIIAETVR,0
3iyf,P,60,68,8,DGVTILREM,0
3iyf,P,72,77,5,HPAAKM,0
3iyf,P,78,89,11,LIEVAKTQEKEV,0
3iyf,P,92,112,20,GTTTAVVVAGELLRKAEELLD,0
3iyf,P,116,130,14,HPTIVVKGYQAAAQK,0
3iyf,P,130,138,8,KAQELLKTI,0
3iyf,P,146,151,5,DKEILT,0
3iyf,P,151,156,5,TKIAMT,0
3iyf,P,166,171,5,AKEKLA,0
3iyf,P,177,182,5,AVSAVV,0
3iyf,P,244,258,14,SEMLKDMVAEIKASG,0
3iyf,P,269,277,8,DDLAQHYLA,0
3iyf,P,278,280,2,KEG,0
3iyf,P,288,299,11,KKSDMEKLAKAT,0
3iyf,P,306,310,4,NIKDL,0
3iyf,P,351,359,8,TEHVIEEVA,0
3iyf,P,364,369,5,DAVGVV,0
3iyf,P,370,375,5,GCTIED,0
3iyf,P,385,401,16,TEVELSMKLREYAEGIS,0
3iyf,P,403,416,13,REQLAVRAFADALE,0
3iyf,P,416,426,10,EVIPRTLAENA,0
3iyf,P,429,438,9,DAIEILVKVR,0
3iyf,P,440,445,5,AHASNG,0
3iyf,P,460,465,5,DMCENG,0
3iyf,P,470,482,12,LRVKTQAIQSAAE,0
3iyf,P,483,490,7,STEMLLRI,0
3iyf,P,20,35,15,AQRMNILAGRIIAETV,0
3iyf,P,78,84,6,LIEVAKT,0
3iyf,P,84,89,5,TQEKEV,0
3iyf,P,93,114,21,TTTAVVVAGELLRKAEELLDQN,0
3iyf,P,116,127,11,HPTIVVKGYQAA,0
3iyf,P,129,136,7,QKAQELLK,0
3iyf,P,149,156,7,ILTKIAMT,0
3iyf,P,171,182,11,AEIIVEAVSAVV,0
3iyf,P,244,249,5,SEMLKD,0
3iyf,P,250,258,8,MVAEIKASG,0
3iyf,P,269,279,10,DDLAQHYLAKE,0
3iyf,P,288,293,5,KKSDME,0
3iyf,P,351,364,13,TEHVIEEVARAVDD,0
3iyf,P,364,370,6,DAVGVVG,0
3iyf,P,402,415,13,GREQLAVRAFADAL,0
3iyf,P,416,425,9,EVIPRTLAEN,0
3iyf,P,429,442,13,DAIEILVKVRAAHA,0
3iyf,P,470,490,20,LRVKTQAIQSAAESTEMLLRI,0
3iyf,P,17,35,18,GRDAQRMNILAGRIIAETV,0
3iyf,P,116,125,9,HPTIVVKGYQ,0
3iyf,P,125,136,11,QAAAQKAQELLK,0
3iyf,P,146,158,12,DKEILTKIAMTSI,0
3iyf,P,270,279,9,DLAQHYLAKE,0
3iyf,P,351,362,11,TEHVIEEVARAV,0
3iyf,P,363,375,12,DDAVGVVGCTIED,0
3iyf,P,383,395,12,GSTEVELSMKLRE,0
3iyf,P,396,401,5,YAEGIS,0
3iyf,P,404,413,9,EQLAVRAFAD,0
3iyf,P,417,426,9,VIPRTLAENA,0
3iyf,P,80,89,9,EVAKTQEKEV,0
3iyf,P,92,113,21,GTTTAVVVAGELLRKAEELLDQ,0
3iyf,P,130,139,9,KAQELLKTIA,0
3iyf,P,149,154,5,ILTKIA,0
3iyf,P,155,159,4,MTSIT,0
3iyf,P,166,182,16,AKEKLAEIIVEAVSAVV,0
3iyf,P,290,298,8,SDMEKLAKA,0
3iyf,P,351,358,7,TEHVIEEV,0
3iyf,P,362,375,13,VDDAVGVVGCTIED,0
3iyf,P,384,395,11,STEVELSMKLRE,0
3iyf,P,404,415,11,EQLAVRAFADAL,0
3iyf,P,430,445,15,AIEILVKVRAAHASNG,0
3iyf,P,471,482,11,RVKTQAIQSAAE,0
3iyf,P,17,37,20,GRDAQRMNILAGRIIAETVRS,0
3iyf,P,78,88,10,LIEVAKTQEKE,0
3iyf,P,93,112,19,TTTAVVVAGELLRKAEELLD,0
3iyf,P,125,139,14,QAAAQKAQELLKTIA,0
3iyf,P,245,252,7,EMLKDMVA,0
3iyf,P,253,258,5,EIKASG,0
3iyf,P,288,295,7,KKSDMEKL,0
3iyf,P,351,371,20,TEHVIEEVARAVDDAVGVVGC,0
3iyf,P,383,394,11,GSTEVELSMKLR,0
3iyf,P,395,397,2,EYA,0
3iyf,P,402,410,8,GREQLAVRA,0
3iyf,P,413,415,2,DAL,0
3iyf,P,416,423,7,EVIPRTLA,0
3iyf,P,429,445,16,DAIEILVKVRAAHASNG,0
3iyf,P,485,490,5,EMLLRI,0
3iyf,P,36,39,3,RSTL,0
3iyf,P,146,155,9,DKEILTKIAM,0
3iyf,P,172,182,10,EIIVEAVSAVV,0
3iyf,P,189,191,2,DKD,0
3iyf,P,245,258,13,EMLKDMVAEIKASG,0
3iyf,P,359,371,12,ARAVDDAVGVVGC,0
3iyf,P,403,414,11,REQLAVRAFADA,0
3iyf,P,429,444,15,DAIEILVKVRAAHASN,0
3iyf,P,470,480,10,LRVKTQAIQSA,0
3iyf,P,480,488,8,AAESTEMLL,0
3iyf,P,146,157,11,DKEILTKIAMTS,0
3iyf,P,351,375,24,TEHVIEEVARAVDDAVGVVGCTIED,0
3iyf,P,402,413,11,GREQLAVRAFAD,0
3iyf,P,469,488,19,PLRVKTQAIQSAAESTEMLL,0
3iyf,P,16,36,20,MGRDAQRMNILAGRIIAETVR,0
3iyf,P,74,77,3,AAKM,0
3iyf,P,78,87,9,LIEVAKTQEK,0
3iyf,P,92,106,14,GTTTAVVVAGELLRK,0
3iyf,P,107,113,6,AEELLDQ,0
3iyf,P,119,127,8,IVVKGYQAA,0
3iyf,P,171,179,8,AEIIVEAVS,0
3iyf,P,247,255,8,LKDMVAEIK,0
3iyf,P,289,299,10,KSDMEKLAKAT,0
3iyf,P,383,401,18,GSTEVELSMKLREYAEGIS,0
3iyf,P,403,415,12,REQLAVRAFADAL,0
3iyf,P,470,485,15,LRVKTQAIQSAAESTE,0
3iyf,P,486,489,3,MLLR,0
3iyf,P,37,39,2,STL,0
3iyf,P,75,89,14,AKMLIEVAKTQEKEV,0
3iyf,P,130,136,6,KAQELLK,0
3iyf,P,289,296,7,KSDMEKLA,0
3iyf,P,351,361,10,TEHVIEEVARA,0
3iyf,P,402,416,14,GREQLAVRAFADALE,0
3iyf,P,417,425,8,VIPRTLAEN,0
3iyf,P,470,475,5,LRVKTQ,0
3iyf,P,475,488,13,QAIQSAAESTEMLL,0
3iyf,P,16,37,21,MGRDAQRMNILAGRIIAETVRS,0
3iyf,P,244,246,2,SEM,0
3iyf,P,351,369,18,TEHVIEEVARAVDDAVGVV,0
3iyf,P,384,401,17,STEVELSMKLREYAEGIS,0
3iyf,P,125,130,5,QAAAQK,0
3iyf,P,146,156,10,DKEILTKIAMT,0
3iyf,P,166,179,13,AKEKLAEIIVEAVS,0
3iyf,P,269,280,11,DDLAQHYLAKEG,0
3iyf,P,289,300,11,KSDMEKLAKATG,0
3iyf,P,416,427,11,EVIPRTLAENAG,0
3iyf,P,470,488,18,LRVKTQAIQSAAESTEMLL,0
3iyf,P,61,68,7,GVTILREM,0
3iyf,P,72,89,17,HPAAKMLIEVAKTQEKEV,0
3iyf,P,92,98,6,GTTTAVV,0
3iyf,P,98,112,14,VVAGELLRKAEELLD,0
3iyf,P,116,136,20,HPTIVVKGYQAAAQKAQELLK,0
3iyf,P,163,165,2,AEK,0
3iyf,P,244,252,8,SEMLKDMVA,0
3iyf,P,271,279,8,LAQHYLAKE,0
3iyf,P,351,374,23,TEHVIEEVARAVDDAVGVVGCTIE,0
3iyf,P,38,43,5,TLGPKG,0
3iyf,P,92,110,18,GTTTAVVVAGELLRKAEEL,0
3iyf,P,146,154,8,DKEILTKIA,0
3iyf,P,288,298,10,KKSDMEKLAKA,0
3iyf,P,384,399,15,STEVELSMKLREYAEG,0
3iyf,P,483,488,5,STEMLL,0
3iyf,P,73,77,4,PAAKM,0
3iyf,P,125,138,13,QAAAQKAQELLKTI,0
3iyf,P,383,398,15,GSTEVELSMKLREYAE,0
3iyf,P,470,477,7,LRVKTQAI,0
3iyf,P,477,487,10,IQSAAESTEML,0
3iyf,P,94,112,18,TTAVVVAGELLRKAEELLD,0
3iyf,P,131,139,8,AQELLKTIA,0
3iyf,P,385,395,10,TEVELSMKLRE,0
3iyf,P,82,87,5,AKTQEK,0
3iyf,P,244,255,11,SEMLKDMVAEIK,0
3iyf,P,290,299,9,SDMEKLAKAT,0
3iyf,P,404,412,8,EQLAVRAFA,0
3iyf,P,469,479,10,PLRVKTQAIQS,0
4iis,D,15,26,11,PVSEVIALYKKS,0
4iis,D,37,44,7,NQAVLEAL,0
4iis,D,56,61,5,PNSDLQ,0
4iis,D,62,64,2,SLT,0
4iis,D,65,77,12,NPSNAKSWVQKNV,0
4iis,D,102,107,5,TAWLAQ,0
4iis,D,108,123,15,FVLPAMRNIHDAIRSA,0
4iis,D,136,138,2,DLT,0
4iis,D,145,149,4,PPSAG,0
4iis,D,155,169,14,VRSYLNPIIRFLSSI,0
4iis,D,178,186,8,YPYFTYAGN,0
4iis,D,191,197,6,SLPYALF,0
4iis,D,213,229,16,NLFDATLDALYSALERA,0
4iis,D,252,267,15,TFDNGRTYLSNLIQHV,0
4iis,D,294,299,5,PEVEKH,0
4iis,D,56,60,4,PNSDL,0
4iis,D,61,64,3,QSLT,0
4iis,D,56,58,2,PNS,0
4iis,D,59,64,5,DLQSLT,0
4iis,D,108,124,16,FVLPAMRNIHDAIRSAG,0
4iis,D,155,170,15,VRSYLNPIIRFLSSIR,0
4iis,D,191,196,5,SLPYAL,0
4iis,D,15,27,12,PVSEVIALYKKSN,0
4iis,D,102,104,2,TAW,0
4iis,D,105,123,18,LAQFVLPAMRNIHDAIRSA,0
3c6l,H,80,84,4,TPSQT,0
3c6l,H,127,133,6,SKAEIAN,0
3c6l,H,190,194,4,ATFWH,0
3c6l,H,46,50,4,LPEFG,0
3c6l,H,57,77,20,PQGGLQNIAVVKHNLGVLTKR,0
3c6l,H,77,79,2,TEL,0
3c6l,H,80,90,10,GRPDAEYWNSQ,0
3c6l,H,90,98,8,QPEILERTR,0
3c6l,H,99,104,5,AELDTV,0
3c6l,H,104,111,7,VCRHNYEG,0
3c6l,H,112,116,4,PETHT,0
3c6l,H,80,84,4,QPGDS,0
3c6l,H,46,51,5,LPEFGQ,0
3c6l,H,57,78,21,PQGGLQNIAVVKHNLGVLTKRS,0
3c6l,H,90,104,14,QPEILERTRAELDTV,0
4o8a,A,89,98,9,SVSRAAITAA,0
4o8a,A,102,115,13,PETEAVSMLLEQAR,0
4o8a,A,117,138,21,PQPVAEQAHKLAYQLADKLRNQ,0
4o8a,A,140,152,12,NASGRAGMVQGLL,0
4o8a,A,158,174,16,SSQEGVALMCLAEALLR,0
4o8a,A,177,184,7,DKATRDAL,0
4o8a,A,244,257,13,IRKGVDMAMRLMGE,0
4o8a,A,258,260,2,QFV,0
4o8a,A,264,271,7,TIAEALAN,0
4o8a,A,272,277,5,ARKLEE,0
4o8a,A,293,316,23,TAADAQAYMVSYQQAIHAIGKASN,0
4o8a,A,318,323,5,RGIYEG,0
4o8a,A,329,333,4,KLSAL,0
4o8a,A,336,340,4,RYSRA,0
4o8a,A,341,364,23,QYDRVMEELYPRLKSLTLLARQYD,0
4o8a,A,373,375,2,ESD,0
4o8a,A,376,388,12,RLEISLDLLEKLC,0
4o8a,A,389,394,5,FEPELA,0
4o8a,A,409,425,16,RCPLVIDYLIDLATRSR,0
4o8a,A,437,449,12,YWDSEIKRAQMDG,0
4o8a,A,458,475,17,RKVYTDVSYLACAKKLLA,0
4o8a,A,488,499,11,NAHTLAAIYQLA,0
4o8a,A,517,522,5,GEPLYE,0
4o8a,A,527,531,4,KVADG,0
4o8a,A,545,548,3,THET,0
4o8a,A,549,562,13,LLAYLVRRLLENGA,0
4o8a,A,565,570,5,SFVNRI,0
4o8a,A,576,581,5,PLDELV,0
4o8a,A,583,596,13,DPVTAVEKLAQQEG,0
2rud,A,35,52,17,TKEEALELINGYIQKIKS,0
2rud,A,56,64,8,DFESLASQF,0
2rud,A,67,73,6,DSSAKAR,0
2rud,A,82,84,2,GQM,0
2rud,A,85,95,10,QKPFEDASFAL,0
1kdb,A,54,68,14,YGPEASAFTKKMVEN,0
1kdb,A,99,106,7,VNEALVRQ,0
1kdb,A,121,135,14,HEQHLRKSEAQAKKE,0
1kdb,A,137,141,4,LNIWS,0
3vh9,A,6,14,8,QQATVTAWL,0
3vh9,A,15,17,2,PQV,0
3vh9,A,18,31,13,DASQITGTISSLES,0
3vh9,A,39,58,19,TTSGAQASDWIASEWQALSA,0
3vh9,A,118,135,17,DASGIAAVTEVIRVLSEN,0
3vh9,A,150,154,4,AEEVG,0
3vh9,A,155,168,13,LRGSQDLANQYKSE,0
3vh9,A,198,213,15,DSNFTQYLTQLMDEYL,0
3vh9,A,229,236,7,DHASWHNA,0
3vh9,A,247,251,4,KFNDY,0
3vh9,A,261,265,4,TLANS,0
3vh9,A,269,289,20,GSHAKKFTQLGLAYAIEMGSA,0
4y6i,F,20,34,14,DEATAQDLAAKVLAE,0
4y6i,F,70,84,14,VSHQQALLEALKSHH,0
4y6i,F,100,111,11,DTDYLSWLNASL,0
4y6i,F,72,84,12,HQQALLEALKSHH,0
4y6i,F,100,112,12,DTDYLSWLNASLR,0
5ch5,A,6,27,21,SLMEKLKWKIKCIENKFLNYRL,0
5ch5,A,68,72,4,VGELR,0
5ch5,A,152,156,4,YFIKK,0
5ch5,A,167,173,6,LGALGFL,0
5ch5,A,177,181,4,SEDLN,0
5ch5,A,185,202,17,NAGLKDQVMALRWIKNNC,0
5ch5,A,203,205,2,ANF,0
5ch5,A,218,230,12,SAGAASTHYMMLT,0
5ch5,A,231,234,3,EQTR,0
5ch5,A,249,253,4,CPWAN,0
5ch5,A,258,267,9,HRAFTLAKLA,0
5ch5,A,274,285,11,NDKDVLEFLMKA,0
5ch5,A,286,294,8,KPQDLIKLE,0
5ch5,A,295,297,2,EKV,0
5ch5,A,299,305,6,TLEERTN,0
5ch5,A,328,334,6,HPREMVK,0
5ch5,A,335,341,6,TAWGNSI,0
5ch5,A,350,354,4,YEGLF,0
5ch5,A,355,362,7,FTSILKQM,0
5ch5,A,363,370,7,PLLVKELE,0
5ch5,A,372,376,4,CVNFV,0
5ch5,A,387,402,15,APETLEMGAKIKKAHV,0
5ch5,A,408,421,13,TADNFMDLCSHFYF,0
5ch5,A,421,434,13,FWFPMHRLLQLRFN,0
5ch5,A,456,461,5,PYRIMR,0
5ch5,A,472,478,6,TDELTYF,0
5ch5,A,491,511,20,SREYKTIERMTGIWTQFATTG,0
5ch5,A,552,561,9,EMGKIKQWES,0
5ch5,A,562,564,2,MFE,0
5ch5,A,566,570,4,HRDLF,0
1mob,A,3,18,15,SEGEWQLVLHVWAKVE,0
1mob,A,20,35,15,DVAGHGQDILIRLFKS,0
1mob,A,36,42,6,HPETLEK,0
1mob,A,51,57,6,TEAEMKA,0
1mob,A,58,77,19,SEDLKKGGVTVLTALGAILK,0
1mob,A,86,95,9,LKPLAQSHAT,0
1mob,A,100,118,18,PIKYLEFISEAIIHVLHSR,0
1mob,A,124,149,25,GADAQGAMNKALELFRKDIAAKYKEL,0
2xfg,B,5,20,15,NYGEALQKAIFFYECQ,0
2xfg,B,43,47,4,GKDAG,0
2xfg,B,64,81,17,NLPMSYSAAMLGWAVYEY,0
2xfg,B,81,88,7,YEDAFKQS,0
2xfg,B,90,108,18,QYNHILNNIKWACDYFIKC,0
2xfg,B,121,127,6,DGHADHA,0
2xfg,B,131,135,4,PAEVM,0
2xfg,B,150,168,18,GSTVVAETSAALAIASIIF,0
2xfg,B,172,194,22,DGEYSKECLKHAKELFEFADTTK,0
2xfg,B,212,228,16,FYDELSWAAVWLYLATN,0
2xfg,B,229,239,10,DSSYLDKAESY,0
2xfg,B,263,276,13,VTYGTYLLLARIKN,0
2xfg,B,279,293,14,GKYKEAIERHLDWWT,0
2xfg,B,315,332,17,GSLRYATTTAFLACVYSD,0
2xfg,B,337,357,20,DKEKAKTYLEFARSQADYALG,0
2xfg,B,377,382,5,HRTAHG,0
2xfg,B,418,423,5,NYTCNE,0
2xfg,B,425,444,19,ACDYNAGFVGLLAKMYKLYG,0
2xfg,B,506,511,5,IEEIVN,0
2xfg,B,515,519,4,SASDL,0
2xfg,B,578,582,4,NPEND,0
2xfg,B,582,586,4,DYSYQ,0
3bbw,A,737,750,13,NVEFMDEALIMASM,0
3bbw,A,778,786,8,CLLEYVHEH,0
3bbw,A,791,813,22,GSQLLLNWCVQIAKGMMYLEERR,0
3bbw,A,838,843,5,GLARLL,0
3bbw,A,858,862,4,PIKWM,0
3bbw,A,863,870,7,ALECIHYR,0
3bbw,A,873,890,17,THQSDVWSYGVTIWELMT,0
3bbw,A,903,911,8,EIPDLLEKG,0
3bbw,A,921,932,11,TIDVYMVMVKCW,0
3bbw,A,941,953,12,KFKELAAEFSRMA,0
3bbw,A,954,959,5,RDPQRY,0
4jvj,F,8,20,12,DVYAQEKQDFVQH,0
4jvj,F,20,29,9,HFSQIVRVLT,0
4jvj,F,35,37,2,HPE,0
4jvj,F,38,53,15,IGDAIARLKEVLEYNA,0
4jvj,F,58,72,14,YNRGLTVVVAFRELV,0
4jvj,F,78,107,29,DADSLQRAWTVGWCVELLQAFFLVADDIMD,0
4jvj,F,118,121,3,WYQK,0
4jvj,F,124,126,2,VGL,0
4jvj,F,127,148,21,DAINDANLLEACIYRLLKLYCR,0
4jvj,F,152,177,25,YYLNLIELFLQSSYQTEIGQTLDLLT,0
4jvj,F,189,201,12,TEKRYKSIVKYKT,0
4jvj,F,201,206,5,TAFYSF,0
4jvj,F,206,217,11,FYLPIAAAMYMA,0
4jvj,F,221,250,29,GEKEHANAKKILLEMGEFFQIQDDYLDLFG,0
4jvj,F,251,256,5,DPSVTG,0
4jvj,F,268,277,9,SWLVVQCLQR,0
4jvj,F,279,290,11,TPEQYQILKENY,0
4jvj,F,294,308,14,EAEKVARVKALYEEL,0
4jvj,F,309,333,24,DLPAVFLQYEEDSYSHIMALIEQYA,0
4jvj,F,338,349,11,PAVFLGLARKIY,0
1dmq,A,5,23,18,TAQEVQGLMARYIELVDVG,0
1dmq,A,24,30,6,DIEAIVQ,0
1dmq,A,49,61,12,GREQIAAFYRQGL,0
1dmq,A,121,123,2,SEV,0
2j59,R,29,40,11,GKTTILYKLKLG,0
2j59,R,71,82,11,LDKIRPLWRHYF,0
2j59,R,99,112,13,RVNEAREELMRMLA,0
2j59,R,113,117,4,EDELR,0
2j59,R,135,144,9,NAAEITDKLG,0
2j59,R,145,148,3,LHSL,0
2j59,R,165,179,14,GLYEGLDWLSNQLRN,0
2j59,R,96,98,2,DRE,0
2j59,R,99,111,12,RVNEAREELMRML,0
2j59,R,112,117,5,AEDELR,0
2j59,R,135,143,8,NAAEITDKL,0
2j59,R,144,148,4,GLHSL,0
2j59,R,165,180,15,GLYEGLDWLSNQLRNQ,0
2j59,R,1023,1038,15,DRDDMLAWIKTIQESS,0
2j59,R,1041,1063,22,NEEDTGVTNRDLISRRIKEYNNL,0
2j59,R,1023,1037,14,DRDDMLAWIKTIQES,0
2j59,R,1041,1061,20,NEEDTGVTNRDLISRRIKEYN,0
2j59,R,974,978,4,DKREQ,0
2j59,R,1041,1062,21,NEEDTGVTNRDLISRRIKEYNN,0
3u5w,A,7,18,11,SDYDIREMIQHK,0
3u5w,A,51,61,10,DGQKTNAMRKN,0
3u5w,A,90,92,2,ARE,0
3u5w,A,93,103,10,DEEEAIVRIMA,0
4jtx,L,62,69,7,NIAGWILG,0
4jtx,L,103,112,9,DYEELREQLS,0
4jtx,L,124,129,5,PKTSSW,0
4jtx,L,190,198,8,TSADQQSLY,0
4jtx,L,37,58,21,DLKSTQNAIDEITNKVNSVIEK,0
4jtx,L,74,124,50,EKRIENLNKKVDDGFLDIWTYNAELLVLLENERTLDYHDSNVKNLYEKVRS,0
4jtx,L,145,154,9,DNTCMESVKN,0
4m2b,A,9,22,13,SAAAQACVKKMRDA,0
4m2b,A,25,41,16,NEACIRTFIAQHVMVSK,0
4m2b,A,48,52,4,PDSAI,0
4m2b,A,62,64,2,DSL,0
4m2b,A,69,75,6,DNAVLQS,0
4m2b,A,86,90,4,GTGMG,0
4m2b,A,94,97,3,AKTL,0
4m2b,A,106,121,15,FLDFTALQVQYLRQHC,0
4m2b,A,135,147,12,TSASTKSFLKARY,0
4m2b,A,147,152,5,YPWLYQ,0
4m2b,A,181,184,3,NPAY,0
4m2b,A,190,192,2,GHG,0
4m2b,A,193,201,8,DIYTALYGS,0
4m2b,A,202,210,8,GKLQELVEQ,0
4m2b,A,228,239,11,DKRVLAYMEKEK,0
4m2b,A,286,288,2,AQC,0
4m2b,A,289,291,2,PKA,0
4m2b,A,292,297,5,DMESFQ,0
4m2b,A,314,324,10,LPVLLETMQEH,0
4m2b,A,355,363,8,AMGAAIAMF,0
4m2b,A,372,376,4,PRSRF,0
4m2b,A,381,390,9,TCADLLALRS,0
4m2b,A,405,408,3,DRCH,0
4m2b,A,417,422,5,DSAHYK,0
4m2b,A,423,431,8,MMNGFEKLV,0
2jkh,L,55,61,6,AAHCLYA,0
2jkh,L,124,130,6,ERDWAES,0
2jkh,L,164,172,8,DRNSCKLSS,0
2jkh,L,234,242,8,FLKWIDRSM,0
2jkh,L,91,96,5,LDNGDC,0
1djr,H,4,10,6,TITELCS,0
1djr,H,60,78,18,SQKKAIERMKDTLRITYLT,0
1djr,H,4,11,7,TITELCSE,0
1djr,H,58,60,2,IDS,0
1djr,H,61,79,18,QKKAIERMKDTLRITYLTE,0
2q3c,A,6,11,5,DITQLI,0
2q3c,A,36,38,2,FFN,0
2q3c,A,43,58,15,VDRIGVAMLQAAEQA,0
2q3c,A,73,87,14,GNTGIALAMVCAARG,0
2q3c,A,99,109,10,SLERRMLLRAY,0
2q3c,A,117,119,2,PGA,0
2q3c,A,120,136,16,DGMSGAIAKAEELAKTD,0
2q3c,A,148,157,9,PANPAIHRVT,0
2q3c,A,157,166,9,TTAEEVWRDT,0
2q3c,A,180,194,14,GGTITGVAQVIKERK,0
2q3c,A,244,260,16,GNEDALNVARRLAREEG,0
2q3c,A,264,279,15,GISSGAATVAALQVAR,0
2q3c,A,280,284,4,RPENA,0
2q3c,A,295,300,5,FGERYL,0
5vdn,B,23,36,13,GSGGIASINRAAMY,0
5vdn,B,49,56,7,GGTCVNVG,0
5vdn,B,56,75,19,GCVPKKVMWHAAQIAEAIHL,0
5vdn,B,76,80,4,YGPDY,0
5vdn,B,90,116,26,DWKKLIANRTAYIDRIHQSYERGLGNN,0
5vdn,B,160,164,4,GAEYG,0
5vdn,B,166,173,7,DSDGFFEL,0
5vdn,B,186,200,14,GYIAVEIAGVLNGLG,0
5vdn,B,217,232,15,DPLIVETLLEVMNTEG,0
5vdn,B,281,286,5,NLSVTG,0
5vdn,B,312,316,4,GDNTG,0
5vdn,B,320,337,17,LTPVAVAAGRRLSERLFN,0
5vdn,B,365,374,9,TEPQAREKFG,0
5vdn,B,387,392,5,AMYSAV,0
5vdn,B,421,435,14,GMDEILQGFAVAMKM,0
5vdn,B,438,444,6,TKKDFDN,0
5vdn,B,452,458,6,AAEEFVT,0
2dja,A,41,47,6,CALCKLV,0
3zqh,A,5,25,20,DKSKVINSALELLNEVGIEGL,0
3zqh,A,26,35,9,TTRKLAQKLG,0
3zqh,A,37,43,6,EQPTLYW,0
3zqh,A,47,64,17,NKRALLDALAIEMLDRHH,0
3zqh,A,74,92,18,SWQDFLRNNAKSFRNALLS,0
3zqh,A,95,101,6,DGAKVHL,0
3zqh,A,106,108,2,TEK,0
3zqh,A,109,123,14,QYETLENQLAFLTQQ,0
3zqh,A,126,155,29,SLENALYALSAVGHFTLGSVLEDQEHQVAK,0
3zqh,A,167,181,14,PPLLRQAIELFDHQG,0
3zqh,A,181,203,22,GAEPAFLHGLESLIRGFEVQLTA,0
3te3,F,703,732,29,SGEEFYMLTRRVLQLETVLEGVVSQIDAVG,0
3te3,F,704,734,30,GEEFYMLTRRVLQLETVLEGVVSQIDAVGSK,0
3te3,F,703,733,30,SGEEFYMLTRRVLQLETVLEGVVSQIDAVGS,0
3te3,F,703,729,26,SGEEFYMLTRRVLQLETVLEGVVSQID,0
3te3,F,703,735,32,SGEEFYMLTRRVLQLETVLEGVVSQIDAVGSKL,0
1ln0,B,23,37,14,DFEKAWKRHFKDLEK,0
1ln0,B,42,53,11,SIKLQRSFNKHG,0
1ln0,B,67,83,16,EKDLIIERENFWIKELN,0
1ln0,B,23,38,15,DFEKAWKRHFKDLEKG,0
5ewg,A,16,26,10,CFFVQVEQRQN,0
5ewg,A,27,30,3,PHLR,0
5ewg,A,51,56,5,SYEARA,0
5ewg,A,64,72,8,WADDAKKLC,0
5ewg,A,89,104,15,LTKYREASVEVMEIMS,0
5ewg,A,121,132,11,LTSAVQERLQKL,0
5ewg,A,138,142,4,SADLL,0
5ewg,A,162,177,15,QKEGMRKQGLFQWLDS,0
5ewg,A,185,209,24,SPDLQLTVGAVIVEEMRAAIERETG,0
5ewg,A,219,228,9,NKVLAKLACG,0
5ewg,A,239,241,2,SHG,0
5ewg,A,242,249,7,SVPQLFSQ,0
5ewg,A,250,255,5,MPIRKI,0
5ewg,A,260,271,11,GKLGASVIEILG,0
5ewg,A,274,281,7,YMGELTQF,0
5ewg,A,282,291,9,TESQLQSHFG,0
5ewg,A,291,302,11,GEKNGSWLYAMC,0
5ewg,A,326,330,4,PGKTA,0
5ewg,A,334,360,26,REQVQWWLLQLAQELEERLTKDRNDND,0
5ewg,A,391,404,13,DAHKMSHDAFTVIK,0
5ewg,A,405,407,2,NCN,0
4i6b,A,116,119,3,SRVS,0
4i6b,A,120,135,15,KPHQREKIDKEIELHR,0
4i6b,A,166,175,9,SMAHILKARK,0
4i6b,A,178,199,21,TEPEVRYYLRQIVSGLKYLHEQ,0
4i6b,A,207,209,2,KLG,0
4i6b,A,232,236,4,PLEHR,0
4i6b,A,248,253,5,SPEVLN,0
4i6b,A,258,276,18,GAESDIWALGCVMYTMLLG,0
4i6b,A,285,287,2,LKE,0
4i6b,A,288,294,6,TYRSIRE,0
4i6b,A,304,315,11,LAPAKHLIASML,0
4i6b,A,318,322,4,NPEDR,0
4i6b,A,324,330,6,SLDDIIR,0
4i6b,A,331,336,5,HDFFTQ,0
4i6b,A,344,349,5,SSSCCH,0
1w54,B,16,20,4,RRNRR,0
1w54,B,21,29,8,DDFSRRLVR,0
1w54,B,34,36,2,TVD,0
1w54,B,65,79,14,IDQLLIEAEEWVALG,0
1w54,B,90,94,4,PVEKK,0
1w54,B,98,103,5,AAEAYN,0
1w54,B,106,119,13,GIAQRATRALRERF,0
1w54,B,130,133,3,LDPF,0
1w54,B,149,167,18,LNDVSIDVLVRQALSHAEA,0
1w54,B,180,192,12,GRIGAIREALESA,0
1w54,B,208,210,2,SAY,0
1w54,B,211,217,6,YGPFRDA,0
1w54,B,239,252,13,SDEALHEVAADLAE,0
1w54,B,262,264,2,GMP,0
1w54,B,265,277,12,YLDIVRRVKDEFR,0
1w54,B,285,298,13,VSGEYAMHMGAIQN,0
1w54,B,304,317,13,SVILESLTAFKRAG,0
1w54,B,325,335,10,FAKQAAEQLRR,0
1w54,B,65,78,13,IDQLLIEAEEWVAL,0
1w54,B,98,102,4,AAEAY,0
1w54,B,149,168,19,LNDVSIDVLVRQALSHAEAG,0
1w54,B,211,219,8,YGPFRDAVG,0
1w54,B,325,334,9,FAKQAAEQLR,0
3n0h,A,27,40,13,LRNEFRYFSRMTTT,0
3n0h,A,54,60,6,KKTWFSI,0
3n0h,A,61,65,4,PEKFR,0
3n0h,A,92,101,9,SLDDALKLTE,0
3n0h,A,102,107,5,QPELAN,0
3n0h,A,117,127,10,GSSVYKEAMNH,0
4gy4,C,109,113,4,EISSD,0
4gy4,C,165,172,7,GTGGIRNG,0
4gy4,C,290,296,6,VQSHSDM,0
8icd,A,37,58,21,IGVDVTPAMLKVVDAAVEKAYK,0
8icd,A,70,78,8,TGEKSTQVY,0
8icd,A,85,95,10,PAETLDLIREY,0
8icd,A,113,124,11,ELNVALRQELDL,0
8icd,A,168,183,15,DSADAEKVIKFLREEM,0
8icd,A,203,222,19,EEGTKRLVRAAIEYAIANDR,0
8icd,A,235,253,18,KFTEGAFKDWGYQLAREEF,0
8icd,A,281,291,10,IADAFLQQILL,0
8icd,A,303,317,14,NLNGDYISDALAAQV,0
8icd,A,353,367,14,PGSIILSAEMMLRHM,0
8icd,A,369,388,19,WTEAADLIVKGMEGAINAKT,0
8icd,A,390,397,7,TYDFERLM,0
8icd,A,404,415,11,KCSEFGDAIIEN,0
5hxq,C,87,96,9,GNRRWAKDKG,0
5hxq,C,98,104,6,DVSEGYK,0
5hxq,C,105,120,15,HLFPKLKEICDISSKL,0
5hxq,C,133,137,4,ENWKR,0
5hxq,C,138,150,12,AKGEVDFLMQMFE,0
5hxq,C,151,157,6,ELYDEFS,0
5hxq,C,168,172,4,CKTDL,0
5hxq,C,173,188,15,PMTLQKCIALTEETTK,0
5hxq,C,202,220,18,GGYYDILQATKSIVNKAMN,0
5hxq,C,224,228,4,DVEDI,0
5hxq,C,229,237,8,NKNLFDQEL,0
5hxq,C,275,279,4,LFPDF,0
5hxq,C,280,298,18,GEEDLKEAIINFQQRHRRF,0
5hxq,C,73,77,4,DEALM,0
5hxq,C,87,95,8,GNRRWAKDK,0
5hxq,C,105,121,16,HLFPKLKEICDISSKLG,0
5hxq,C,138,149,11,AKGEVDFLMQMF,0
5hxq,C,261,265,4,LWQLA,0
5hxq,C,280,294,14,GEEDLKEAIINFQQR,0
4bya,A,9,20,11,EEEIREAFRVFD,0
4bya,A,28,40,12,SAAELRHVMTNLG,0
4bya,A,44,56,12,TDEEVDEMIREAD,0
4bya,A,64,75,11,NYEEFVQHMTAK,0
4tmn,E,65,87,22,SYDAPAVDAHYYAGVTYDYYKNV,0
4tmn,E,133,135,2,LSG,0
4tmn,E,137,150,13,IDVVAHELTHAVTD,0
4tmn,E,160,180,20,ESGAINEAISDIFGTLVEFYA,0
4tmn,E,190,192,2,EDV,0
4tmn,E,208,211,3,PAKY,0
4tmn,E,217,219,2,YSK,0
4tmn,E,226,229,3,DNGG,0
4tmn,E,233,246,13,NSGIINKAAYLISQ,0
4tmn,E,260,274,14,RDKLGKIFYRALTQY,0
4tmn,E,281,296,15,FSQLRAAAVQSATDLY,0
4tmn,E,301,313,12,QEVASVKQAFDAV,0
5nk0,A,609,611,2,HPS,0
5nk0,A,653,668,15,TEKQRVDFLGEAGIMG,0
5nk0,A,700,706,6,LDKFLRE,0
5nk0,A,712,733,21,SVLQLVGMLRGIAAGMKYLANM,0
5nk0,A,741,743,2,AAR,0
5nk0,A,780,784,4,PIRWT,0
5nk0,A,785,792,7,APEAISYR,0
5nk0,A,795,812,17,TSASDVWSFGIVMWEVMT,0
5nk0,A,822,832,10,SNHEVMKAIND,0
5nk0,A,843,854,11,PSAIYQLMMQCW,0
5nk0,A,857,861,4,ERARR,0
5nk0,A,863,877,14,KFADIVSILDKLIRA,0
5nk0,A,878,883,5,PDSLKT,0
2guu,A,21,33,12,LKIKLQKRRDEVN,0
2guu,A,43,58,15,DEADIKSFMQSEKQNG,0
2guu,A,59,68,9,YQSVKKNLSN,0
2guu,A,91,97,6,GGQMLLA,0
2guu,A,105,126,21,QEKDEFFYFFNHFCFYIINETK,0
2guu,A,127,129,2,EYA,0
2guu,A,137,140,3,AFYL,0
2guu,A,143,161,18,GSLGVDVLKNVFDYLHHLN,0
2guu,A,173,186,13,IGNTVKHYRKFIFD,0
2guu,A,203,208,5,MLRDIC,0
2guu,A,230,235,5,SHIFQN,0
2guu,A,244,259,15,AYVVIAEEAQKMAKQL,0
2guu,A,261,265,4,LEENG,0
2guu,A,276,287,11,CYDEIKKIRELF,0
2guu,A,303,312,9,DLRKMLCNGY,0
2guu,A,315,317,2,NYE,0
2guu,A,324,329,5,GRAITK,0
2guu,A,332,352,20,SPQQAAREYHQQIKEVLAELQ,0
2cg9,B,11,22,11,EITQLMSLIINT,0
2cg9,B,28,49,21,EIFLRELISNASDALDKIRYKS,0
2cg9,B,70,72,2,PEQ,0
2cg9,B,85,91,6,TKAELIN,0
2cg9,B,92,94,2,NLG,0
2cg9,B,101,106,5,TKAFME,0
2cg9,B,124,129,5,FYSLFL,0
2cg9,B,180,185,5,DQLEYL,0
2cg9,B,186,198,12,EEKRIKEVIKRHS,0
2cg9,B,280,284,4,NPSDI,0
2cg9,B,288,297,9,EYNAFYKSIS,0
2cg9,B,359,363,4,PEWLS,0
2cg9,B,385,409,24,QNKIMKVIRKNIVKKLIEAFNEIAE,0
2cg9,B,411,432,21,SEQFEKFYSAFSKNIKLGVHED,0
2cg9,B,435,441,6,NRAALAK,0
2cg9,B,459,464,5,DYVTRM,0
2cg9,B,485,487,2,SPF,0
2cg9,B,488,493,5,LDALKA,0
2cg9,B,503,511,8,DPIDEYAFT,0
2cg9,B,512,514,2,QLK,0
2cg9,B,539,545,6,EREKEIK,0
2cg9,B,547,557,10,YEPLTKALKEI,0
2cg9,B,586,594,8,SANMERIMK,0
2cg9,B,619,631,12,SPIIKELKKRVDE,0
2cg9,B,642,654,12,LTKLLYETALLTS,0
2cg9,B,662,671,9,TSFASRINRL,0
2cg9,B,532,536,4,ETDEE,0
5xva,A,299,310,11,SSHEQFRAALQL,0
5xva,A,316,319,3,DPRS,0
5xva,A,355,357,2,RKQ,0
5xva,A,361,370,9,ELLFNEVVIM,0
5xva,A,402,410,8,ALTDIVTHT,0
5xva,A,413,434,21,NEEQIAAVCLAVLQALSVLHAQ,0
5xva,A,442,444,2,KSD,0
5xva,A,478,482,4,TPYWM,0
5xva,A,483,488,5,APELIS,0
5xva,A,494,511,17,PEVDIWSLGIMVIEMVDG,0
5xva,A,519,530,11,PPLKAMKMIRDN,0
5xva,A,537,541,4,NLHKV,0
5xva,A,542,553,11,SPSLKGFLDRLL,0
5xva,A,562,567,5,TAAELL,0
5xva,A,568,575,7,KHPFLAKA,0
5xva,A,577,582,5,PPASIV,0
5xva,A,583,586,3,PLMR,0
4p59,L,75,80,5,SFLQWI,0
4p59,L,110,113,3,VYDG,0
4p59,L,162,166,4,DWRDI,0
4p59,L,347,352,5,NIDGFV,0
4p59,L,364,369,5,LITGLN,0
4p59,L,380,388,8,DPEKLNVFR,0
4p59,L,409,414,5,FSVFSN,0
4p59,L,469,474,5,NWTKVL,0
4p59,L,489,497,8,PRRDCVAEG,0
4p59,L,28,32,4,TFSSY,0
4p59,L,87,91,4,RAEDT,0
4p59,L,160,162,2,SGA,0
4p59,L,189,194,5,PSSSLG,0
4p59,L,79,83,4,QPEDF,0
4p59,L,121,127,6,SDEQLKS,0
4p59,L,182,188,6,SKADYEK,0
2gsb,A,12,16,4,PHEGK,0
2gsb,A,24,34,10,SKQEAYNLLMT,0
2gsb,A,85,94,9,SIGDIIDHYR,0
5p5a,A,49,53,4,TASEV,0
5p5a,A,60,64,4,TPSKS,0
5p5a,A,113,119,6,SSSFTED,0
5p5a,A,130,134,4,FSTLN,0
5p5a,A,143,149,6,TFFDNAK,0
5p5a,A,150,152,2,ASL,0
5p5a,A,228,237,9,PATVVSAYWA,0
5p5a,A,274,277,3,PGDY,0
5p5a,A,306,311,5,GDVALK,0
1bke,A,6,14,8,EVAHRFKDL,0
1bke,A,16,30,14,EENFKALVLIAFAQY,0
1bke,A,36,55,19,FEDHVKLVNEVTEFAKTCVA,0
1bke,A,66,76,10,LHTLFGDKLCT,0
1bke,A,78,83,5,ATLRET,0
1bke,A,85,92,7,GEMADCCA,0
1bke,A,96,104,8,PERNECFLQ,0
1bke,A,120,129,9,VDVMCTAFHD,0
1bke,A,131,145,14,EETFLKKYLYEIARR,0
1bke,A,151,168,17,APELLFFAKRYKAAFTEC,0
1bke,A,174,205,31,KAACLLPKLDELRDEGKASSAKQRLKCASLQK,0
1bke,A,207,222,15,GERAFKAWAVARLSQR,0
1bke,A,228,247,19,FAEVSKLVTDLTKVHTECCH,0
1bke,A,250,266,16,LLECADDRADLAKYICE,0
1bke,A,268,270,2,QDS,0
1bke,A,276,280,4,KECCE,0
1bke,A,283,292,9,LLEKSHCIAE,0
1bke,A,306,309,3,AADF,0
1bke,A,315,321,6,VCKNYAE,0
1bke,A,323,336,13,KDVFLGMFLYEYAR,0
1bke,A,343,359,16,VVLLLRLAKTYETTLEK,0
1bke,A,366,368,2,PHE,0
1bke,A,373,397,24,VFDEFKPLVEEPQNLIKQNCELFEQ,0
1bke,A,400,414,14,EYKFQNALLVRYTKK,0
1bke,A,420,438,18,TPTLVEVSRNLGKVGSKCC,0
1bke,A,442,466,24,EAKRMPCAEDYLSVVLNQLCVLHEK,0
1bke,A,471,478,7,DRVTKCCT,0
1bke,A,486,490,4,PCFSA,0
1bke,A,504,507,3,AETF,0
1bke,A,513,515,2,ICT,0
1bke,A,518,535,17,EKERQIKKQTALVELVKH,0
1bke,A,541,559,18,KEQLKAVMDDFAAFVEKCC,0
1bke,A,567,582,15,CFAEEGKKLVAASQAA,0
3tpr,A,53,57,4,QRQLS,0
3tpr,A,123,127,4,YAEIA,0
3tpr,A,135,144,9,PFFDSLVKQT,0
3tpr,A,180,182,2,DHS,0
3tpr,A,218,222,4,KEYNY,0
3tpr,A,238,252,14,KKVFEAAVKSIKAAS,0
3tpr,A,276,280,4,PWNIF,0
3tpr,A,301,305,4,LPQQY,0
3tpr,A,334,339,5,GAVIME,0
3tpr,A,379,383,4,MEDCG,0
4lum,B,28,31,3,SDME,0
4lum,B,36,47,11,DERAWKELVEKE,0
4lum,B,160,167,7,YGTIAEKG,0
6cik,N,400,423,23,TRRAQKHRLRELKIQVKEFADKEE,0
6cik,N,426,442,16,DVKAVCLTLFLLALRAR,0
6cik,N,444,457,13,EHRQADELEAIMQG,0
6cik,N,463,474,11,QPAVCLAIRVNT,0
6cik,N,477,493,16,SCSQYHKMYRTVKAITG,0
6cik,N,499,511,12,PLHALRNAEKVLL,0
6cik,N,558,581,23,RYDSALVSALMDMEEDILEGMRSQ,0
6cik,N,648,652,4,SELCC,0
6cik,N,664,683,19,DHETLTAILSPLIAEREAMK,0
6cik,N,708,716,8,DEKLVREVE,0
6cik,N,733,740,7,TRLEASQN,0
6cik,N,749,763,14,SHAENLQRYEVWRSN,0
6cik,N,768,777,9,SVEELRDRVK,0
6cik,N,792,813,21,DALHCDIGNAAEFYKIFQLEIG,0
6cik,N,822,841,19,SKEERKRWQATLDKHLRKRM,0
6cik,N,850,858,8,NGNFARKLM,0
6cik,N,859,868,9,TQETVDAVCE,0
6cik,N,872,895,23,SEERHEALRELMDLYLKMKPVWRS,0
6cik,N,897,902,5,CPAKEC,0
6cik,N,902,924,22,CPESLCQYSFNSQRFAELLSTKF,0
6cik,N,933,942,9,TNYFHKTLAH,0
6cik,N,942,951,9,HVPEIIERDG,0
6cik,N,953,957,4,IGAWA,0
6cik,N,961,975,14,NQSGNKLFRRFRKMN,0
6cik,N,979,996,17,SKCYEMEDVLKHHWLYTS,0
6cik,N,996,1004,8,SKYLQKFMN,0
6cik,N,11,15,4,NIALI,0
6cik,N,168,172,4,TTEKW,0
6cik,N,308,314,6,TSDIKHS,0
6cik,N,400,408,8,TRRAQKHRL,0
6cik,N,408,424,16,LRELKIQVKEFADKEEG,0
6cik,N,558,570,12,RYDSALVSALMDM,0
6cik,N,570,581,11,MEEDILEGMRSQ,0
6cik,N,792,814,22,DALHCDIGNAAEFYKIFQLEIGE,0
6cik,N,815,818,3,VYKH,0
6cik,N,822,842,20,SKEERKRWQATLDKHLRKRMN,0
6cik,N,873,895,22,EERHEALRELMDLYLKMKPVWRS,0
6cik,N,902,923,21,CPESLCQYSFNSQRFAELLSTK,0
6cik,N,924,928,4,FKYRY,0
6cik,N,962,976,14,QSGNKLFRRFRKMNA,0
6cik,N,982,995,13,YEMEDVLKHHWLYT,0
6cik,N,20,31,11,VQTCREEHKKKH,0
6cik,N,37,48,11,NFSEFSKKCSER,0
6cik,N,100,117,17,SAFFLFCSEYRPKIKGEH,0
6cik,N,121,136,15,SIGDVAKKLGEMWNNT,0
6cik,N,141,158,17,KQPYEKKAAKLKEKYEKD,0
4bi8,B,42,51,9,PGSDFFRFYR,0
4bi8,B,54,73,19,DKQEKEKARIYLLGVLDATE,0
4bi8,B,80,82,2,YSQ,0
4bi8,B,85,98,13,TVTLQEFVFEFFNK,0
4bi8,B,101,105,4,AARLH,0
4bi8,B,108,119,11,AAPLIEEALATR,0
4bi8,B,8,11,3,LKSS,0
4bi8,B,25,32,7,AEAVYAEI,0
4bi8,B,36,42,6,LDTLLKQ,0
4bi8,B,44,47,3,PGYA,0
4bi8,B,49,61,12,TCAVRMSLALLKT,0
4bi8,B,85,94,9,AKLLADQLHR,0
4bi8,B,107,114,7,APDAEKGI,0
4o71,B,60,69,9,TNQLQYLLRV,0
4o71,B,69,76,7,VVLKTLWK,0
4o71,B,80,84,4,AWPFQ,0
4o71,B,88,93,5,DAVKLN,0
4o71,B,96,101,5,DYYKII,0
4o71,B,106,116,10,DMGTIKKRLEN,0
4o71,B,121,140,19,NAQECIQDFNTMFTNCYIYN,0
4o71,B,144,163,19,DDIVLMAEALEKLFLQKINE,0
4o71,B,144,162,18,DDIVLMAEALEKLFLQKIN,0
2wlw,A,29,42,13,VPKTAENFRALSTG,0
2wlw,A,119,123,4,TEWLD,0
2wlw,A,135,144,9,GMNIVEAMER,0
3te8,B,32,37,5,RVIERE,0
3te8,B,41,60,19,QRVALQLVAIVKLTRTALLY,0
3te8,B,62,64,2,DPD,0
3te8,B,65,78,13,LRRALLQDLESNEG,0
3te8,B,96,111,15,ESVNRLIEHDIRSRLG,0
3te8,B,36,60,24,REPRAQRVALQLVAIVKLTRTALLY,0
4nuv,D,214,218,4,MKNCN,0
4nuv,D,239,244,5,PDRRYQ,0
4nuv,D,247,252,5,MKELTN,0
4nuv,D,264,270,6,DITFRKL,0
4nuv,D,270,291,21,LYLKRKLIYDAAVEGDLLLKLN,0
4nuv,D,296,315,19,NKDFCKDIRWSLGDFGDIIM,0
4nuv,D,323,337,14,GYSKVVENNLRSIFG,0
4nuv,D,341,352,11,KAQQRRKQWWNE,0
4nuv,D,353,362,9,SKAQIWTAMM,0
4nuv,D,362,367,5,MYSVKK,0
4nuv,D,378,384,6,KLNVAVN,0
4nuv,D,387,416,29,PQIYRWIREWGRDYVSELPTEVQKLKEKCD,0
4nuv,D,424,429,5,KKVCKV,0
4nuv,D,429,463,34,VPPCQNACKSYDQWITRKKNQWDVLSNKFISVKNA,0
4nuv,D,473,482,9,TPYDILKQEL,0
4nuv,D,486,495,9,NEVAFENEIN,0
4nuv,D,498,506,8,DGAYIELCV,0
4nuv,D,247,253,6,MKELTNL,0
4nuv,D,264,291,27,DITFRKLYLKRKLIYDAAVEGDLLLKLN,0
4nuv,D,296,316,20,NKDFCKDIRWSLGDFGDIIMG,0
4nuv,D,341,362,21,KAQQRRKQWWNESKAQIWTAMM,0
4nuv,D,362,370,8,MYSVKKRLK,0
4nuv,D,371,376,5,GNFIWI,0
4nuv,D,378,383,5,KLNVAV,0
4nuv,D,424,428,4,KKVCK,0
4nuv,D,429,461,32,VPPCQNACKSYDQWITRKKNQWDVLSNKFISVK,0
4nuv,D,21,29,8,DFEDVWNSS,0
5fjm,B,64,76,12,GIQGIMTAINLAE,0
5fjm,B,92,96,4,EQSGR,0
5fjm,B,110,123,13,IFPLHHYGKILWRG,0
5fjm,B,123,129,6,GMNEKIG,0
5fjm,B,145,163,18,DEKALDRAQEWIKTAKETA,0
5fjm,B,176,183,7,GEELSNRL,0
5fjm,B,203,218,15,DPETGTPTLARYAKQI,0
5fjm,B,257,259,2,GGI,0
5fjm,B,260,267,7,WSRLFMGN,0
5fjm,B,323,330,7,VKDSFLLG,0
5fjm,B,331,334,3,PKFM,0
5fjm,B,349,358,9,GEDLFNSFKM,0
5fjm,B,368,372,4,SPFEQ,0
5fjm,B,381,396,15,NTEHLDAVFQRMKTEF,0
5fjm,B,397,402,5,PVFEKS,0
5fjm,B,439,457,18,WGMTEGPAAGEVTADIVTG,0
5fjm,B,464,468,4,PTPFS,0
5fjm,B,468,473,5,SLDRFK,0
5fjm,B,64,77,13,GIQGIMTAINLAER,0
5fjm,B,92,97,5,EQSGRA,0
5fjm,B,323,329,6,VKDSFLL,0
5fjm,B,330,337,7,GPKFMHLL,0
4ode,A,21,25,4,ASEQE,0
4ode,A,31,41,10,KPLLLKLLKSV,0
4ode,A,50,64,14,MKEVLFYLGQYIMTK,0
4ode,A,80,87,7,DLLGDLFG,0
4ode,A,95,105,10,EHRKIYTMIYR,0
3mwe,B,7,19,12,SEQTGKELLYKFI,0
3mwe,B,39,47,8,DWARLLQDH,0
3mwe,B,48,52,4,PWLLS,0
3mwe,B,77,86,9,TLDGVKSWLK,0
3mwe,B,114,116,2,SQA,0
3mwe,B,139,143,4,GVDVG,0
3mwe,B,144,149,5,DVDAKA,0
3mwe,B,161,168,7,NPEDIKKH,0
3mwe,B,174,176,2,PED,0
3mwe,B,177,195,18,KKEILASFISGLFNFYEDL,0
3mwe,B,225,234,9,ADYICKVKWG,0
3mwe,B,247,259,12,YPEEAYIADLDAK,0
3mwe,B,281,295,14,GGGASVVYSDTICDL,0
3mwe,B,297,301,4,GVNEL,0
3mwe,B,312,327,15,SEQQTYDYAKTILSLM,0
3mwe,B,349,364,15,NVAATFKGIVRAIRDY,0
3mwe,B,364,371,7,YQGPLKEH,0
3mwe,B,383,399,16,NYQEGLRVMGEVGKTTG,0
3mwe,B,412,419,7,TAIVGMAL,0
3mwe,B,505,519,14,QTRAVQGMLDFDYVC,0
3mwe,B,555,563,8,NMADAMRKH,0
3mwe,B,577,586,9,SAYDSTMETM,0
3mwe,B,602,617,15,PEALTRKLIKKADQKG,0
3mwe,B,642,649,7,MLDNILAS,0
3mwe,B,663,678,15,SGGMSNELNNIISRTT,0
3mwe,B,696,706,10,TFMDHVLRYQD,0
3mwe,B,722,733,11,TEEYKICRGIKE,0
3mwe,B,767,770,3,QASE,0
3mwe,B,771,782,11,TAVAKNQALKEA,0
3mwe,B,789,791,2,SFD,0
3mwe,B,792,807,15,ELGEIIQSVYEDLVAN,0
1ouc,A,5,14,9,RCELARTLKR,0
1ouc,A,25,36,11,LANWMCLAKWES,0
1ouc,A,81,85,4,CSALL,0
1ouc,A,90,100,10,ADAVACAKRVV,0
1ouc,A,105,108,3,GIRA,0
1ouc,A,110,115,5,AAWRNR,0
1ouc,A,122,124,2,RQY,0
4jpd,A,3,27,24,DTEYLARAEAVLAAVERTVDVANDG,0
4jpd,A,56,58,2,PPM,0
4jpd,A,87,101,14,EFFSALTDYATQQAG,0
5nqs,B,3,20,17,SLSRELVFLILQFLDEEK,0
5nqs,B,21,33,12,FKETVHKLEQESG,0
5nqs,B,37,47,10,NMKYFEDEVHN,0
5nqs,B,49,58,9,NWDEVEKYLS,0
5nqs,B,66,87,21,NRYSMKIFFEIRKQKYLEALDK,0
5nqs,B,89,100,11,DRPKAVDILVKD,0
5nqs,B,101,105,4,LKVFS,0
5nqs,B,108,118,10,NEELFKEITQL,0
5nqs,B,119,121,2,LTL,0
5nqs,B,123,127,4,NFREN,0
5nqs,B,128,133,5,EQLSKY,0
5nqs,B,135,153,18,DTKSARAIMLVELKKLIEA,0
5nqs,B,169,179,10,SRLRTLINQSL,0
5nqs,B,101,107,6,LKVFSTF,0
5nqs,B,123,131,8,NFRENEQLS,0
5nqs,B,135,154,19,DTKSARAIMLVELKKLIEAN,0
5nqs,B,155,158,3,PLFR,0
5ipm,F,34,50,16,GFGHTLGNALRRILLSS,0
5ipm,F,77,87,10,DILEILLNLKG,0
5ipm,F,113,115,2,ADI,0
5ipm,F,154,162,8,PASTRIHSE,0
5ipm,F,212,233,21,DPEEAIRRAATILAEQLEAFVD,0
5ipm,F,4,10,6,SYTEKKR,0
5ipm,F,28,40,12,LSIQLDSFQKFIE,0
5ipm,F,48,57,9,GLEAAFRSVF,0
5ipm,F,81,89,8,DVQECQIRG,0
5ipm,F,206,213,7,ATIILRAL,0
5ipm,F,216,225,9,TTEQILDLFF,0
5ipm,F,270,281,11,TARHIRQLEKDD,0
5ipm,F,288,293,5,PVEYIA,0
5ipm,F,318,329,11,SLDLLAKLSQSG,0
5ipm,F,345,354,9,PYISETLRVD,0
5ipm,F,358,371,13,DRLSALVEIYRMMR,0
5ipm,F,377,390,13,TREAAESLFENLFF,0
5ipm,F,397,409,12,LSAVGRMKFNRSL,0
5ipm,F,421,438,17,SKDDIIDVMKKLIDIRNG,0
5ipm,F,455,482,27,SVGEMAENQFRVGLVRVERAVKERLSLG,0
5ipm,F,488,493,5,MPQDMI,0
5ipm,F,495,509,14,AKPISAAVKEFFGSS,0
5ipm,F,519,528,9,NPLSEITHKR,0
5ipm,F,551,555,4,HPTHY,0
5ipm,F,608,612,4,AIEEG,0
5ipm,F,662,667,5,SVGASL,0
5ipm,F,670,674,4,FLEHD,0
5ipm,F,675,688,13,DANRALMGANMQRQ,0
5ipm,F,703,713,10,GMERAVAVDSG,0
5ipm,F,820,825,5,ERVVQE,0
5ipm,F,858,864,6,GEAALSK,0
5ipm,F,896,907,11,TPEEKLLRAIFG,0
5ipm,F,942,981,39,DKRALEIEEMQLKQAKKDLSEELQILEAGLFSRIRAVLVA,0
5ipm,F,985,991,6,EAEKLDK,0
5ipm,F,993,997,4,PRDRW,0
5ipm,F,1005,1038,33,EEKQNQLEQLAEQYDELKHEFEKKLEAKRRKITQ,0
5ipm,F,1099,1103,4,NPLGV,0
5ipm,F,1109,1135,26,IGQILETHLGMAAKGIGDKINAMLKQQ,0
5ipm,F,1137,1150,13,EVAKLREFIQRAYD,0
5ipm,F,1165,1177,12,SDEEVMRLAENLR,0
5ipm,F,1191,1202,11,KEAEIKELLKLG,0
5ipm,F,1238,1243,5,LVDDKM,0
5ipm,F,1271,1282,11,GEMEVWALEAYG,0
5ipm,F,1283,1292,9,AAYTLQEMLT,0
5ipm,F,1297,1310,13,DVNGRTKMYKNIVD,0
5ipm,F,1320,1333,13,PESFNVLLKEIRSL,0
5ipm,F,26,33,7,SPDMIRSW,0
5ipm,F,58,63,5,CARIFG,0
5ipm,F,94,100,6,QTKVRRE,0
5ipm,F,114,119,5,IWFLKS,0
5ipm,F,123,129,6,RIGLLLD,0
5ipm,F,131,140,9,PLRDIERVLY,0
5ipm,F,161,172,11,TEEQYLDALEEF,0
5ipm,F,181,192,11,GAEAIQALLKSM,0
5ipm,F,193,206,13,DLEQECEQLREELN,0
5ipm,F,210,231,21,SETKRKKLTKRIKLLEAFVQSG,0
5ipm,F,233,236,3,KPEW,0
5ipm,F,246,250,4,PPDLR,0
5ipm,F,263,285,22,SDLNDLYRRVINRNNRLKRLLDL,0
5ipm,F,288,308,20,PDIIVRNEKRMLQEAVDALLD,0
5ipm,F,309,312,3,NGRR,0
5ipm,F,326,332,6,SLADMIK,0
5ipm,F,336,342,6,GRFRQNL,0
5ipm,F,370,377,7,KKMALELF,0
5ipm,F,377,388,11,FKPFIYGKLELR,0
5ipm,F,393,403,10,TIKAAKKMVER,0
5ipm,F,405,417,12,EAVVWDILDEVIR,0
5ipm,F,430,432,2,HRL,0
5ipm,F,450,452,2,HPL,0
5ipm,F,453,458,5,VCAAYN,0
5ipm,F,473,483,10,TLEAQLEARAL,0
5ipm,F,504,515,11,QDVVLGLYYMTR,0
5ipm,F,529,540,11,GPKEAERLYRSG,0
5ipm,F,574,583,9,VGRAILWMIV,0
5ipm,F,589,594,5,YSIVNQ,0
5ipm,F,597,612,15,GKKAISKMLNTCYRIL,0
5ipm,F,613,636,23,GLKPTVIFADQIMYTGFAYAARSG,0
5ipm,F,649,670,21,KKHEIISEAEAEVAEIQEQFQS,0
5ipm,F,674,703,29,TAGERYNKVIDIWAAANDRVSKAMMDNLQT,0
5ipm,F,721,728,7,SIYMMADS,0
5ipm,F,733,741,8,SAAQIRQLA,0
5ipm,F,768,805,37,NVLQYFISTHGARKGLADTALKTANSGYLTRRLVDVAQ,0
5ipm,F,834,840,6,PLRDRVL,0
5ipm,F,865,876,11,HEQWCDLLEENS,0
5ipm,F,896,900,4,AHCYG,0
5ipm,F,914,934,20,AIGVIAAQSIGEPGTQLTMRT,0
5ipm,F,1068,1072,4,TAGGK,0
5ipm,F,1136,1146,10,GGLPRVADLFE,0
5ipm,F,1216,1244,28,APHDILRLRGVHAVTRYIVNEVQDVYRLQ,0
5ipm,F,1249,1261,12,NDKHIEVIVRQML,0
5ipm,F,1282,1296,14,YSRVKIANRELEANG,0
5ipm,F,1308,1316,8,GITKASLAT,0
5ipm,F,1318,1326,8,SFISAASFQ,0
5ipm,F,1327,1339,12,ETTRVLTEAAVAG,0
5ipm,F,1346,1353,7,GLKENVIV,0
5ipm,F,1361,1375,14,TGYAYHQDRMRRRAA,0
5ipm,F,6,14,8,VQDAVEKIG,0
5ipm,F,15,32,17,NRFDLVLVAARRARQMQV,0
5ipm,F,45,57,12,KTTVIALREIEEG,0
5ipm,F,60,80,20,NNQILDVRERQEQQEQEAAEL,0
5ipm,F,56,67,11,DATQLYLGEIGY,0
5ipm,F,72,86,14,TAEEEVYFARRALRG,0
5ipm,F,88,110,22,VASRRRMIESNLRLVVKIARRYG,0
5ipm,F,115,133,18,ALLDLIEEGNLGLIRAVEK,0
5ipm,F,141,161,20,RFSTYATWWIRQTIERAIMNQ,0
5ipm,F,168,190,22,PIHIVKELNVYLRTARELSHKLD,0
5ipm,F,194,203,9,SAEEIAEQLD,0
5ipm,F,205,217,12,PVDDVSRMLRLNE,0
5ipm,F,245,266,21,GPEDTTQDDDMKQSIVKWLFEL,0
5ipm,F,267,279,12,NAKQREVLARRFG,0
5ipm,F,287,295,8,TLEDVGREI,0
5ipm,F,298,325,27,TRERVRQIQVEGLRRLREILQTQGLNIE,0
5ipm,F,326,328,2,ALF,0
2zxa,B,11,16,5,DWESLR,0
2zxa,B,21,27,6,PKWFDKA,0
2zxa,B,36,40,4,GIYSV,0
2zxa,B,57,61,4,AWFFQ,0
2zxa,B,64,66,2,YAE,0
2zxa,B,67,74,7,WYENSLRI,0
2zxa,B,77,87,10,SPTWEYHVKTY,0
2zxa,B,92,94,2,EYE,0
2zxa,B,95,100,5,KFADLF,0
2zxa,B,106,117,11,DPQEWADLFKKA,0
2zxa,B,152,164,12,DLVGDLAKAVREA,0
2zxa,B,177,181,4,DWRFT,0
2zxa,B,187,193,6,YPEDLSY,0
2zxa,B,198,217,19,TYEYADYAYKQVMELVDLYL,0
2zxa,B,228,232,4,PEKGK,0
2zxa,B,233,246,13,EDLKYLFAYYYNKH,0
2zxa,B,297,301,4,GPEHM,0
2zxa,B,303,317,14,SVEQLVYTLVDVVSK,0
2zxa,B,334,352,18,PDLQKERLLGLGEWLRKYG,0
2zxa,B,353,355,2,DAI,0
2zxa,B,431,436,5,PKKLLE,0
2zxa,B,54,59,5,PMDAWF,0
2zxa,B,60,62,2,FQN,0
5k1i,H,89,97,8,EDVLAKELE,0
5k1i,H,105,113,8,HVFRIAELS,0
5k1i,H,116,129,13,RPLTVIMHTIFQER,0
5k1i,H,130,135,5,DLLKTF,0
5k1i,H,138,152,14,PVDTLITYLMTLEDH,0
5k1i,H,161,177,16,NNIHAADVVQSTHVLLS,0
5k1i,H,178,182,4,TPALE,0
5k1i,H,186,200,14,TDLEILAAIFASAIH,0
5k1i,H,208,215,7,SNQFLINT,0
5k1i,H,217,223,6,SELALMY,0
5k1i,H,227,241,14,SVLENHHLAVGFKLL,0
5k1i,H,253,271,18,TKKQRQSLRKMVIDIVLAT,0
5k1i,H,275,289,14,KHMNLLADLKTMVET,0
5k1i,H,302,319,17,NYSDRIQVLQNMVHCADL,0
5k1i,H,320,324,4,SNPTK,0
5k1i,H,325,351,26,PLQLYRQWTDRIMEEFFRQGDRERERG,0
5k1i,H,364,376,12,SVEKSQVGFIDYI,0
5k1i,H,376,388,12,IVHPLWETWADLV,0
5k1i,H,392,409,17,AQDILDTLEDNREWYQST,0
5k1i,H,87,97,10,EQEDVLAKELE,0
5k1i,H,130,136,6,DLLKTFK,0
5k1i,H,217,224,7,SELALMYN,0
5k1i,H,253,269,16,TKKQRQSLRKMVIDIVL,0
5k1i,H,270,274,4,ATDMS,0
5k1i,H,275,290,15,KHMNLLADLKTMVETK,0
5k1i,H,325,350,25,PLQLYRQWTDRIMEEFFRQGDRERER,0
5k1i,H,392,410,18,AQDILDTLEDNREWYQSTI,0
5k1i,H,88,96,8,QEDVLAKEL,0
5k1i,H,97,99,2,EDV,0
5k1i,H,116,130,14,RPLTVIMHTIFQERD,0
5k1i,H,227,240,13,SVLENHHLAVGFKL,0
5k1i,H,241,243,2,LQE,0
5k1i,H,253,270,17,TKKQRQSLRKMVIDIVLA,0
5k1i,H,271,274,3,TDMS,0
5k1i,H,138,153,15,PVDTLITYLMTLEDHY,0
5k1i,H,272,274,2,DMS,0
5k1i,H,88,97,9,QEDVLAKELE,0
5k1i,H,98,101,3,DVNK,0
5k1i,H,227,242,15,SVLENHHLAVGFKLLQ,0
5k1i,H,359,363,4,DKHNA,0
5k1i,H,138,151,13,PVDTLITYLMTLED,0
4nuj,B,79,83,4,EAEDV,0
4nuj,B,121,126,5,SDEQLK,0
4nuj,B,183,189,6,KADYEKH,0
4nuj,B,28,32,4,PFSKY,0
4nuj,B,83,87,4,KIEDT,0
4nuj,B,156,158,2,SGA,0
4nuj,B,187,189,2,SSL,0
4nuj,B,201,204,3,KPSN,0
4ypz,A,9,12,3,FPEM,0
4ypz,A,13,18,5,FKAITE,0
4ypz,A,19,28,9,FGVTGRAVKH,0
4ypz,A,37,42,5,NPRDFT,0
4ypz,A,63,79,16,MVQPLRDAIHTAKAAAG,0
4ypz,A,95,103,8,DQGGVTELA,0
4ypz,A,119,127,8,DERLIQTEI,0
4ypz,A,141,154,13,GELPAMTLIDAVAR,0
4ypz,A,193,198,5,PPVLMS,0
4ypz,A,200,220,20,HHEEIRKWRLKQSLQRTWLRR,0
4ypz,A,220,226,6,RPELLEG,0
4ypz,A,230,245,15,TDEQRKLLKEAQAEHN,0
3fvs,B,7,11,4,ARRLD,0
3fvs,B,16,27,11,NPWVEFVKLASE,0
3fvs,B,43,56,13,PDFAVEAFQHAVSG,0
3fvs,B,57,62,5,DFMLNQ,0
3fvs,B,69,85,16,YPPLTKILASFFGELLG,0
3fvs,B,89,93,4,DPLRN,0
3fvs,B,98,112,14,VGGYGALFTAFQALV,0
3fvs,B,127,135,8,CYEPMTMMA,0
3fvs,B,156,160,4,SSSNW,0
3fvs,B,163,169,6,DPMELAG,0
3fvs,B,192,207,15,SREELELVASLCQQHD,0
3fvs,B,228,232,4,SIASL,0
3fvs,B,235,237,2,MWE,0
3fvs,B,245,250,5,AGTFS,0
3fvs,B,251,255,4,ATGWK,0
3fvs,B,262,275,13,PDHIMKHLRTVHQN,0
3fvs,B,281,298,17,PTQSQAAVAESFEREQLL,0
3fvs,B,304,326,22,SYFVQFPQAMQRCRDHMIRSLQS,0
3fvs,B,344,351,7,ISDFKRKM,0
3fvs,B,361,375,14,PYDRRFVKWMIKNKG,0
3fvs,B,382,385,3,SIFY,0
3fvs,B,386,391,5,SVPHQK,0
3fvs,B,404,421,17,DEATLQAMDEKLRKWKVE,0
3fvs,B,163,171,8,DPMELAGKF,0
3fvs,B,245,249,4,AGTF,0
3fvs,B,404,420,16,DEATLQAMDEKLRKWKV,0
4l68,B,272,277,5,GLAQRL,0
4l68,B,296,304,8,KLGDLMAAT,0
4l68,B,308,310,2,NSE,0
4l68,B,343,356,13,GEREFRYEMNQLWE,0
4l68,B,386,394,8,TLHSLLDSN,0
4l68,B,395,398,3,RGEL,0
4l68,B,399,420,21,DWSTRFRIGLGAARGLAWLHHG,0
4l68,B,450,454,4,LARLM,0
4l68,B,478,483,5,EYSTTM,0
4l68,B,486,504,18,SLKGDVYGLGVVLLELATG,0
4l68,B,516,527,11,SLVDWVKQLESS,0
4l68,B,529,534,5,RIAETF,0
4l68,B,543,558,15,HDEEISKFVEIALNCV,0
4l68,B,567,581,14,SMFQAYQSLKAIAEK,0
4l68,B,586,591,5,FSEQDD,0
4l68,B,270,279,9,GSGLAQRLRS,0
4l68,B,386,393,7,TLHSLLDS,0
4l68,B,480,504,24,STTMLASLKGDVYGLGVVLLELATG,0
4l68,B,512,527,15,GFKGSLVDWVKQLESS,0
4l68,B,528,534,6,GRIAETF,0
4l68,B,543,560,17,HDEEISKFVEIALNCVSS,0
4l68,B,561,565,4,RPKER,0
2rpb,A,109,128,19,SDFLMAIVKLAQTNLRAIIG,0
2rpb,A,133,138,5,DETLSG,0
2rpb,A,138,155,17,GRDIINARLREELDKITD,0
3kln,D,16,30,14,CMQSRLLKEALESKL,0
3kln,D,38,45,7,PFSELWLE,0
3kln,D,48,54,6,KPESRSI,0
3kln,D,62,64,2,SRI,0
3kln,D,65,79,14,SDDVLTDYSSFKHIS,0
3kln,D,95,100,5,EHKLLF,0
3kln,D,114,126,12,DMDTLIKGMSKIL,0
3kln,D,133,146,13,TRKLAQEYILHYRA,0
3kln,D,153,158,5,SQMYAK,0
3kln,D,160,171,11,TKREQQIIKLLG,0
3kln,D,175,181,6,SNIEIAD,0
3kln,D,186,202,16,SENTVKTHLHNVFKKIN,0
3kln,D,205,217,12,NRLQALIWAKNNI,0
3kln,D,38,42,4,PFSEL,0
3kln,D,65,80,15,SDDVLTDYSSFKHISC,0
3kln,D,96,101,5,HKLLFK,0
3kln,D,153,159,6,SQMYAKL,0
3kln,D,175,183,8,SNIEIADKL,0
3kln,D,49,54,5,PESRSI,0
3kln,D,68,80,12,VLTDYSSFKHISC,0
3kln,D,95,102,7,EHKLLFKW,0
3kln,D,114,127,13,DMDTLIKGMSKILQ,0
3kln,D,155,159,4,MYAKL,0
3kln,D,160,172,12,TKREQQIIKLLGS,0
3kln,D,205,214,9,NRLQALIWAK,0
3kln,D,38,46,8,PFSELWLEE,0
3kln,D,65,68,3,SDDV,0
3kln,D,69,80,11,LTDYSSFKHISC,0
3kln,D,206,215,9,RLQALIWAKN,0
5jdv,B,12,19,7,GPEHWHKD,0
5jdv,B,20,25,5,FPIAKG,0
5jdv,B,126,128,2,KYG,0
5jdv,B,129,134,5,DWGKAV,0
5jdv,B,153,155,2,KPG,0
5jdv,B,156,163,7,LQKVVDVL,0
5jdv,B,164,167,3,DSIK,0
5jdv,B,179,184,5,DPRGLL,0
5jdv,B,218,226,8,SSEQVLKFR,0
5b1h,D,5,10,5,HVQELI,0
5b1h,D,22,26,4,VPNHS,0
5b1h,D,34,36,2,MFN,0
5b1h,D,41,56,15,IDRLGAYLIEDGLQR,0
5b1h,D,71,84,13,GNTGIGLALATQAH,0
5b1h,D,97,107,10,SMEKQVLMQAL,0
5b1h,D,115,117,2,PSE,0
5b1h,D,118,133,15,EGIKGAIRKAEALAAT,0
5b1h,D,146,154,8,PANPAAYYH,0
5b1h,D,155,164,9,TLAPEILADM,0
5b1h,D,178,192,14,GGTFAGVAAYLQAQD,0
5b1h,D,205,209,4,SILNG,0
5b1h,D,226,232,6,PPFFDQV,0
5b1h,D,241,257,16,ADNDAFAQVRHLARDHG,0
5b1h,D,261,276,15,GSSSGAALAASLQLAT,0
5b1h,D,292,299,7,SERYLSQK,0
5b1h,D,261,277,16,GSSSGAALAASLQLATN,0
5b1h,D,291,299,8,SSERYLSQK,0
2nw0,B,8,12,4,SKWNG,0
2nw0,B,15,21,6,DWDTAKG,0
2nw0,B,40,52,12,VYKDYVAAMKARN,0
2nw0,B,65,80,15,SVEDAKVEARDFWNRG,0
2nw0,B,98,114,16,DMRAGTQAFIDELYRLG,0
2nw0,B,131,135,4,GAAQI,0
2nw0,B,180,186,6,SLDWFTG,0
2nw0,B,40,51,11,VYKDYVAAMKAR,0
2nw0,B,180,185,5,SLDWFT,0
4e3n,B,5,24,19,PQQINDIVHRTITPLIEQQK,0
4e3n,B,65,80,15,VSKTFTGVLGGDAIAR,0
4e3n,B,88,92,4,PTTKY,0
4e3n,B,98,102,4,AKQWN,0
4e3n,B,105,111,6,TLLHLAT,0
4e3n,B,127,138,11,SSSDLLRFYQNW,0
4e3n,B,151,163,12,ANSSIGLFGALAV,0
4e3n,B,169,178,9,SFEQAMQTRV,0
4e3n,B,192,199,7,PPAEEKNY,0
4e3n,B,216,222,6,LDAEAYG,0
4e3n,B,226,239,13,TIEDMARWVQSNLK,0
4e3n,B,240,243,3,PLDI,0
4e3n,B,245,256,11,EKTLQQGIQLAQ,0
4e3n,B,279,288,9,NPDSIINGSD,0
4e3n,B,288,293,5,DNKIAL,0
4e3n,B,330,333,3,PEKE,0
4e3n,B,345,361,16,PNPARVDAAWQILNALQ,0
4e3n,B,279,287,8,NPDSIINGS,0
3pg4,A,94,109,15,TDDQTAQILNWIKQEI,0
3pg4,A,122,127,5,HQDKMG,0
3pg4,A,128,135,7,GMDALHAA,0
3pg4,A,143,152,9,ALSNQLAPQE,0
3pg4,A,170,174,4,EPATA,0
3pg4,A,228,240,12,HYAASARAFGAAF,0
3pg4,A,256,275,19,RAAITHTARMADKLRLEHHH,0
1ywu,A,91,106,15,DLDSISHLRRLVELNL,0
1ywu,A,108,114,6,DEELLER,0
1ywu,A,115,119,4,ELALL,0
1a5j,A,12,25,13,KEEDQKVIELVKKY,0
1a5j,A,30,36,6,WTLIAKH,0
1a5j,A,46,49,3,RERW,0
1a5j,A,64,72,8,EEEDRIIFE,0
1a5j,A,81,87,6,WAEIAKL,0
1a5j,A,93,102,9,DNAVKNHWNS,0
2vdb,B,6,15,9,EVAHRFKDLG,0
2vdb,B,16,31,15,EENFKALVLIAFAQYL,0
2vdb,B,35,45,10,PFEDHVKLVNE,0
2vdb,B,65,74,9,SLHTLFGDKL,0
2vdb,B,86,90,4,EMADC,0
2vdb,B,99,106,7,NECFLQHK,0
2vdb,B,119,130,11,EVDVMCTAFHDN,0
2vdb,B,130,146,16,NEETFLKKYLYEIARRH,0
2vdb,B,150,169,19,YAPELLFFAKRYKAAFTECC,0
2vdb,B,174,206,32,KAACLLPKLDELRDEGKASSAKQRLKCASLQKF,0
2vdb,B,206,223,17,FGERAFKAWAVARLSQRF,0
2vdb,B,227,246,19,EFAEVSKLVTDLTKVHTECC,0
2vdb,B,249,267,18,DLLECADDRADLAKYICEN,0
2vdb,B,267,272,5,NQDSIS,0
2vdb,B,275,280,5,LKECCE,0
2vdb,B,282,292,10,PLLEKSHCIAE,0
2vdb,B,305,310,5,LAADFV,0
2vdb,B,314,322,8,DVCKNYAEA,0
2vdb,B,322,338,16,AKDVFLGMFLYEYARRH,0
2vdb,B,342,361,19,SVVLLLRLAKTYETTLEKCC,0
2vdb,B,365,371,6,DPHECYA,0
2vdb,B,372,375,3,KVFD,0
2vdb,B,376,398,22,EFKPLVEEPQNLIKQNCELFEQL,0
2vdb,B,399,415,16,GEYKFQNALLVRYTKKV,0
2vdb,B,419,439,20,STPTLVEVSRNLGKVGSKCCK,0
2vdb,B,444,466,22,KRMPCAEDYLSVVLNQLCVLHEK,0
2vdb,B,470,478,8,SDRVTKCCT,0
2vdb,B,480,490,10,SLVNRRPCFSA,0
2vdb,B,503,508,5,NAETFT,0
2vdb,B,510,516,6,HADICTL,0
2vdb,B,517,536,19,SEKERQIKKQTALVELVKHK,0
2vdb,B,542,558,16,EQLKAVMDDFAAFVEKC,0
2vdb,B,563,581,18,DKETCFAEEGKKLVAASQA,0
2vdb,B,1,20,19,TIDQWLLKNAKEDAIAELKK,0
2vdb,B,25,35,10,SDFYFNAINKA,0
2vdb,B,37,53,16,TVEEVNALKNEILKAHA,0
5j57,B,17,33,16,TVQSYTNFIRAVRGRLT,0
5j57,B,52,55,3,PINQ,0
5j57,B,97,105,8,NQEDAEAIT,0
5j57,B,122,131,9,NYDRLEQLAG,0
5j57,B,133,137,4,LRENI,0
5j57,B,140,155,15,GNGPLEEAISALYYYS,0
5j57,B,160,181,21,QLPTLARSFIICIQMISEAARF,0
5j57,B,181,194,13,FQYIEGEMRTRIRY,0
5j57,B,201,220,19,DPSVITLENSWGRLSTAIQE,0
5j57,B,246,249,3,SILI,0
5j57,B,28,32,4,RLQYY,0
5j57,B,62,65,3,GSVQ,0
5j57,B,87,91,4,KPEDT,0
5j57,B,106,110,4,MPSCR,0
1ljy,A,10,14,4,WSQYR,0
1ljy,A,15,19,4,EGDGS,0
1ljy,A,21,25,4,FPDAI,0
1ljy,A,51,66,15,NDVTLYDTLNTLKNRN,0
1ljy,A,81,91,10,GPERFSAIASK,0
1ljy,A,91,110,19,KTQSRRTFIKSVPPFLRTHG,0
1ljy,A,125,144,19,DKRHLTALVKEMKAEFAREA,0
1ljy,A,145,147,2,QAG,0
1ljy,A,160,168,8,GKIAIDRGY,0
1ljy,A,169,175,6,DIAQISR,0
1ljy,A,215,227,12,NADYAVSYMLRLG,0
1ljy,A,229,231,2,PAN,0
1ljy,A,275,282,7,YYEICDFL,0
1ljy,A,309,323,14,DQESVKNKARYLKNR,0
1ljy,A,349,361,12,FPLTSAVKDVLAE,0
1vp9,A,13,15,2,FEE,0
1vp9,A,24,28,4,PESAN,0
1vp9,A,37,55,18,QGQLKLLLGELFFLSKLQR,0
1vp9,A,73,84,11,THIRYLRDHFYN,0
1vp9,A,101,103,2,PIL,0
1vp9,A,118,128,10,EEYLRSIKKQL,0
1vp9,A,150,167,17,TADLLSNYALQNVMISIL,0
1vp9,A,181,183,2,PDQ,0
1vp9,A,226,241,15,KSDAVNYEKKMYYLNK,0
1vp9,A,243,245,2,VRN,0
1vp9,A,258,269,11,YDYFHMYFMLRT,0
1vp9,A,279,294,15,TKAKVLFLQQSIFRFL,0
5m1f,A,260,266,6,FSGLDML,0
5m1f,A,324,339,15,TWSDQVARLKALSEDY,0
5m1f,A,353,363,10,DAIAEELDAQG,0
5m1f,A,373,390,17,SSSVKEQLISNLALLMEK,0
5m1f,A,398,407,9,DKTILDELRN,0
5m1f,A,428,439,11,DDIVMSLALAYS,0
3s9d,D,8,22,14,SLGSRRTLMLLAQMR,0
3s9d,D,26,33,7,LFSCLKDR,0
3s9d,D,39,43,4,PQEEF,0
3s9d,D,52,67,15,TIPVLAAMIAQIFNLF,0
3s9d,D,69,76,7,TKDSSAAW,0
3s9d,D,77,98,21,DETLLDKFYTELYQQLNDLEAC,0
3s9d,D,114,133,19,DSILAVRKYFQRITLYLKEK,0
3s9d,D,136,155,19,SPCAWEVVRAEIMRSFSLST,0
3s9d,D,56,59,3,KNCA,0
3s9d,D,100,105,5,WLAIDM,0
3s9d,D,54,67,13,PVLAAMIAQIFNLF,0
3s9d,D,77,97,20,DETLLDKFYTELYQQLNDLEA,0
3s9d,D,117,133,16,LAVRKYFQRITLYLKEK,0
2zqj,C,12,21,9,DNSLTLLKEG,0
2zqj,C,22,32,10,YLFIKNRTERY,0
2zqj,C,51,59,8,GAEAAKVFY,0
2zqj,C,71,76,5,PKRVQK,0
2zqj,C,83,87,4,AIQGM,0
2zqj,C,88,103,15,DGSAHIHRKMLFLSLM,0
2zqj,C,104,127,23,TPPHQKRLAELMTEEWKAAVTRWE,0
2zqj,C,134,151,17,LFEEAKEILCRVACYWAG,0
2zqj,C,155,157,2,KET,0
2zqj,C,158,171,13,EVKERADDFIDMVD,0
2zqj,C,177,203,26,GPRHWKGRRARPRAEEWIEVMIEDARA,0
2zqj,C,212,219,7,TALHEMAF,0
2zqj,C,229,261,32,DSRMAAIELINVLRPIVAISYFLVFSALALHEH,0
2zqj,C,263,271,8,KYKEWLRSG,0
2zqj,C,272,287,15,NSREREMFVQEVRRYY,0
2zqj,C,318,323,5,LYGTNH,0
2zqj,C,335,340,5,RPERFA,0
2zqj,C,365,383,18,GEGITIEVMKASLDFLVHQ,0
2zqj,C,23,32,9,LFIKNRTERY,0
2zqj,C,71,78,7,PKRVQKSL,0
2zqj,C,88,102,14,DGSAHIHRKMLFLSL,0
2zqj,C,104,129,25,TPPHQKRLAELMTEEWKAAVTRWEKA,0
2zqj,C,133,151,18,VLFEEAKEILCRVACYWAG,0
2zqj,C,177,202,25,GPRHWKGRRARPRAEEWIEVMIEDAR,0
2zqj,C,229,247,18,DSRMAAIELINVLRPIVAI,0
2zqj,C,247,261,14,ISYFLVFSALALHEH,0
2zqj,C,261,270,9,HPKYKEWLRS,0
2zqj,C,320,324,4,GTNHD,0
2zqj,C,365,382,17,GEGITIEVMKASLDFLVH,0
2zqj,C,22,24,2,YLF,0
2zqj,C,88,101,13,DGSAHIHRKMLFLS,0
2zqj,C,155,171,16,KETEVKERADDFIDMVD,0
2zqj,C,262,271,9,PKYKEWLRSG,0
2zqj,C,273,287,14,SREREMFVQEVRRYY,0
2zqj,C,318,322,4,LYGTN,0
4o6t,A,10,12,2,TYS,0
4o6t,A,15,28,13,TVADYLADWSAYFG,0
4o6t,A,102,105,3,ASSG,0
4o6t,A,124,130,6,PIAQGRD,0
4o6t,A,131,142,11,GTVHKVVYGLMS,0
4o6t,A,145,160,15,SSALQGQIDALLKAVD,0
4o6t,A,168,175,7,TFDQLAAA,0
1xxx,H,7,13,6,DVAARLG,0
1xxx,H,30,44,14,DTATAARLANHLVDQ,0
1xxx,H,62,78,16,TDGEKIELLRAVLEAVG,0
1xxx,H,91,106,15,DTAHSIRLAKACAAEG,0
1xxx,H,121,134,13,PQRGLQAHFTAVAD,0
1xxx,H,145,150,5,IPGRSA,0
1xxx,H,154,163,9,EPDTIRALAS,0
1xxx,H,176,188,12,DLHSGAQIMADTG,0
1xxx,H,195,197,2,DDA,0
1xxx,H,198,206,8,LNLPWLAMG,0
1xxx,H,214,231,17,IAHLAAGQLRELLSAFGS,0
1xxx,H,233,255,22,DIATARKINIAVAPLCNAMSRLG,0
1xxx,H,255,267,12,GGVTLSKAGLRLQ,0
1xxx,H,282,296,14,TPEQIDALAADMRAA,0
1xxx,H,121,136,15,PQRGLQAHFTAVADAT,0
1xxx,H,214,232,18,IAHLAAGQLRELLSAFGSG,0
1xxx,H,233,268,35,DIATARKINIAVAPLCNAMSRLGGVTLSKAGLRLQG,0
1xxx,H,30,45,15,DTATAARLANHLVDQG,0
1xxx,H,154,162,8,EPDTIRALA,0
1xxx,H,198,205,7,LNLPWLAM,0
1xxx,H,121,135,14,PQRGLQAHFTAVADA,0
1xxx,H,233,244,11,DIATARKINIAV,0
1xxx,H,244,255,11,VAPLCNAMSRLG,0
1xxx,H,255,268,13,GGVTLSKAGLRLQG,0
1xxx,H,57,61,4,ESPTT,0
4dc7,A,3,19,16,SDGEWQQVLNVWGKVEA,0
4dc7,A,20,36,16,DIAGHGQEVLIRLFTGH,0
4dc7,A,37,43,6,PETLEKF,0
4dc7,A,51,58,7,TEAEMKAS,0
4dc7,A,58,77,19,SEDLKKHGTVVLTALGGILK,0
4dc7,A,82,96,14,HEAELKPLAQSHATK,0
4dc7,A,100,119,19,PIKYLEFISDAIIHVLHSKH,0
4dc7,A,124,150,26,GADAQGAMTKALELFRNDIAAKYKELG,0
2a8h,B,232,239,7,DHRFYRYM,0
2a8h,B,243,264,21,EESTTTNYLIELIDRVDDIYRN,0
2a8h,B,313,325,12,DVKMLLEQFSFDI,0
2a8h,B,325,330,5,IAEEAS,0
2a8h,B,343,347,4,FDMGT,0
2a8h,B,395,411,16,LTKEADLVTTHELGHNF,0
2a8h,B,420,424,4,LAECA,0
2a8h,B,426,430,4,NEDQG,0
2a8h,B,444,449,5,HENNKM,0
2a8h,B,451,470,19,SQCSKQSIYKTIESKAQECF,0
5noj,H,55,61,6,GDEAQSK,0
5noj,H,78,92,14,NWDDMEKIWHHTFYN,0
5noj,H,97,101,4,APEEH,0
5noj,H,112,126,14,PKANREKMTQIMFET,0
5noj,H,137,146,9,QAVLSLYASG,0
5noj,H,171,175,4,LPHAI,0
5noj,H,181,194,13,AGRDLTDYLMKILT,0
5noj,H,195,197,2,ERG,0
5noj,H,202,216,14,TTAEREIVRDIKEKL,0
5noj,H,222,232,10,DFENEMATAAS,0
5noj,H,252,257,5,NERFRC,0
5noj,H,258,262,4,PETLF,0
5noj,H,263,267,4,QPSFI,0
5noj,H,273,285,12,GIHETTYNSIMKC,0
5noj,H,289,296,7,IRKDLYAN,0
5noj,H,301,305,4,GGTTM,0
5noj,H,308,321,13,GIADRMQKEITALA,0
5noj,H,334,349,15,ERKYSVWIGGSILASL,0
5noj,H,359,371,12,KQEYDEAGPSIVH,0
5noj,H,99,233,134,,0
5noj,H,99,104,5,,0
5noj,H,109,233,124,,0
1ur0,B,32,39,7,SIIALEES,0
1ur0,B,52,60,8,DIFKTLKEA,0
1ur0,B,87,101,14,DLEKAIQIGKRATAN,0
1ur0,B,124,128,4,PKAWA,0
1ur0,B,131,153,22,NFEDKKTALYQYTKQSLKAMKAA,0
1ur0,B,175,194,19,DWAKMSQLFNAGSQAVRETD,0
1ur0,B,210,222,12,GRYAWIAETLHRH,0
1ur0,B,240,256,16,TLKNLTSVLTSVADTYG,0
1ur0,B,292,309,17,TVQGQANAVRDVIQAVSD,0
1ur0,B,329,331,2,PAH,0
1ur0,B,332,344,12,RLEKNKALWETYG,0
1ur0,B,349,353,4,TSYAA,0
1ur0,B,359,364,5,DAGKWF,0
1ur0,B,369,373,4,VDNQA,0
1ur0,B,382,385,3,LPSL,0
1ur0,B,386,394,8,HVFQYVDTG,0
1ur0,B,359,363,4,DAGKW,0
5xem,B,5,10,5,SVIDLI,0
5xem,B,34,36,2,GSN,0
5xem,B,41,57,16,TKDRIALKMIEEAEKEG,0
5xem,B,71,85,14,GNTGIGLAMICAVKN,0
5xem,B,98,107,9,IERIQLMRAY,0
5xem,B,115,117,2,DGS,0
5xem,B,118,133,15,LGMKACLEKLEELKKN,0
5xem,B,146,155,9,VNNPKAHYET,0
5xem,B,155,164,9,TTAEEILKDL,0
5xem,B,178,192,14,GGSFSGTAKKLKEKL,0
5xem,B,206,211,5,PLLSKG,0
5xem,B,233,237,4,DGSLA,0
5xem,B,244,260,16,EDDDAFEMMRELSFKEG,0
5xem,B,264,281,17,GISTGATFKAALDYSKEN,0
5xem,B,296,300,4,GEKYL,0
5xem,B,41,56,15,TKDRIALKMIEEAEKE,0
5xem,B,97,107,10,SIERIQLMRAY,0
5xem,B,118,132,14,LGMKACLEKLEELKK,0
5xem,B,295,300,5,SGEKYL,0
5y4c,A,26,29,3,APLD,0
5y4c,A,30,61,31,LVQPISDYKIYVSENLQTLVRDTREFTNAVKA,0
5y4c,A,63,81,18,DVAKAKKLFASTRMSYERI,0
5y4c,A,82,87,5,EPIAEL,0
5y4c,A,88,96,8,FSDLDASID,0
5y4c,A,98,102,4,RADDH,0
5y4c,A,104,108,4,KAEKD,0
5y4c,A,113,123,10,GFHRIEYGLFA,0
5y4c,A,129,150,21,GLAPVADKLMADVLELQKRIRG,0
5y4c,A,154,172,18,PPEKVVGGAAVLMEEVAAT,0
5y4c,A,173,176,3,KISG,0
5y4c,A,184,230,46,TDLWDFQANFEGAKKIVDLFRPLVVKDNRAFADKVDANFDTVFKTLA,0
5y4c,A,231,233,2,KYR,0
5y4c,A,241,245,4,LYGKL,0
5y4c,A,246,272,26,SERDRKVLAGRVNTLAEDLSKMRGLLG,0
1wcj,A,7,16,9,TKEDVLNALK,0
1wcj,A,26,31,5,DVVSLG,0
1wcj,A,57,70,13,LAGMILSDAEEAIK,0
1wcj,A,89,93,4,TPERM,0
1wcj,A,94,102,8,SPELREKFG,0
4hzh,B,196,201,5,SAQAKA,0
4hzh,B,282,287,5,NPRTFG,0
4hzh,B,289,293,4,GEADC,0
4hzh,B,361,364,3,AAHC,0
4hzh,B,375,377,2,TEN,0
4hzh,B,442,453,11,DRETAASLLQAG,0
4hzh,B,462,468,6,GNLKETW,0
4hzh,B,489,497,8,ERPVCKDST,0
4hzh,B,565,578,13,RLKKWIQKVIDQFG,0
4hzh,B,172,176,4,PDRGQ,0
4hzh,B,308,314,6,TERELLE,0
4hzh,B,442,449,7,DRETAASL,0
4hzh,B,566,578,12,LKKWIQKVIDQFG,0
1fx0,B,79,83,4,DGLMI,0
1fx0,B,175,186,11,GKTAVATDTILN,0
1fx0,B,202,213,11,KASSVAQVVTNF,0
1fx0,B,217,220,3,GAME,0
1fx0,B,232,236,4,PATLQ,0
1fx0,B,237,253,16,YLAPYTGAALAEYFMYR,0
1fx0,B,263,278,15,DLSKQAQAYRQMSLLL,0
1fx0,B,283,287,4,GREAY,0
1fx0,B,298,302,4,LLERA,0
1fx0,B,329,337,8,AYIPTNVIS,0
1fx0,B,367,372,5,VGSAAQ,0
1fx0,B,373,394,21,IKAMKKVAGKLKLELAQFAELE,0
1fx0,B,396,400,4,FAQFA,0
1fx0,B,404,422,18,DKATQNQLARGQRLRELLK,0
1fx0,B,430,443,13,TVEEQVMTIYTGTN,0
1fx0,B,450,468,18,ELDQVRKYLVELRTYVKTN,0
1fx0,B,469,480,11,KPEFQEIISSTK,0
1fx0,B,483,499,16,TEEAEALLKEAIQEQME,0
1fx0,B,138,142,4,AFTQL,0
1fx0,B,155,160,5,VVNLLA,0
1fx0,B,177,189,12,GKTVLIMELINNI,0
1fx0,B,206,219,13,TREGNDLYMEMKES,0
1fx0,B,242,247,5,PPGARM,0
1fx0,B,248,256,8,RVGLTALTM,0
1fx0,B,256,261,5,MAEYFR,0
1fx0,B,275,290,15,IFRFVQAGSEVSALLG,0
1fx0,B,294,298,4,SAVGY,0
1fx0,B,301,309,8,TLSTEMGSL,0
1fx0,B,330,333,3,PADD,0
1fx0,B,336,343,7,DPAPATTF,0
1fx0,B,344,346,2,AHL,0
1fx0,B,381,409,28,GEEHYEIAQRVKETLQRYKELQDIIAILG,0
1fx0,B,417,431,14,DRLTVARARKIERFL,0
1fx0,B,450,460,10,GLAETIRGFQL,0
1fx0,B,470,474,4,PEQAF,0
1fx0,B,480,484,4,IDEAT,0
5t2x,C,14,28,14,SELKKINIIENLIKE,0
5t2x,C,30,41,11,NFARAKLLNNL,0
5t2x,C,42,53,11,DLTTLIKYTELS,0
5t2x,C,53,61,8,SKTITDFCE,0
5t2x,C,62,64,2,EAE,0
5t2x,C,65,77,12,QADIWRTHLQNFN,0
5t2x,C,90,112,22,TVSQLVKGIYFYGQAAECREEEG,0
5t2x,C,116,129,13,GDNELEFLKKSAYQ,0
5t2x,C,131,148,17,CFYAYNSLSTWAYEKYK,0
5t2x,C,152,168,16,DYSLLTLHYAQKACQYH,0
5t2x,C,168,186,18,HWTPGYLLFYKTCLNLAIL,0
5t2x,C,190,208,18,PSLSYQEALEALLIARKLS,0
5t2x,C,210,221,11,HQYSISAINNAY,0
5t2x,C,236,249,13,SWDKAISETIAKGK,0
5t2x,C,251,273,22,PSTLLNKIYDKASEKAKGILDEF,0
5t2x,C,15,28,13,ELKKINIIENLIKE,0
5t2x,C,168,187,19,HWTPGYLLFYKTCLNLAILS,0
5t2x,C,65,76,11,QADIWRTHLQNF,0
5t2x,C,224,229,5,KGLIHG,0
4no6,b,18,31,13,LGQIDYALTAVKQG,0
4no6,b,78,96,18,MGPDYRVLVDKSRKVAHTS,0
4no6,b,97,102,5,YKRIYG,0
4no6,b,106,121,15,PTKLLVSEVAKIMQEA,0
4no6,b,167,179,12,GSVAAKTFLEKRW,0
4no6,b,184,200,16,ELEDAIHIALLTLKESV,0
4no6,b,218,222,4,NPDLL,0
4no6,b,239,249,10,TSQEINDRLEA,0
4no6,b,1,6,5,GSRRYD,0
4no6,b,18,29,11,LYQVEYALESIS,0
4no6,b,79,102,23,LTADAEILINTARIHAQNYLKTYN,0
4no6,b,106,121,15,PVEILVRRLSDIKQGY,0
4no6,b,167,179,12,NTSAAQTLLQMDY,0
4no6,b,184,200,16,KVDDAIELALKTLSKTT,0
4no6,b,206,208,2,TYD,0
4no6,b,230,240,10,KPQEIKDILVK,0
4no6,b,15,28,13,IFQVEYALEAVKRG,0
4no6,b,76,99,23,LNADSRILIEKARVEAQSHRLTLE,0
4no6,b,103,118,15,TVEYLTRYVAGVQQRY,0
4no6,b,165,177,12,NSKTVREFLEKNY,0
4no6,b,185,198,13,TVEECVKLTVRSLL,0
4no6,b,223,239,16,SSEEINQYVTQIEQEKQ,0
4no6,b,13,25,12,LFQVEYSLEAIKL,0
4no6,b,52,56,4,ESDSI,0
4no6,b,76,96,20,DARSMIEHARTAAVTHNLYYD,0
4no6,b,100,113,13,NVESLTQSVCDLAL,0
4no6,b,167,179,12,GSEGAQAELLNEW,0
4no6,b,184,200,16,TLKEAELLVLKILKQVM,0
4no6,b,224,241,17,DNEKTAELIKELKEKEAA,0
4no6,b,18,31,13,LFQVEYALEAIKQG,0
4no6,b,76,99,23,LAPDARVLSNYLRQQCNYSSLVFN,0
4no6,b,103,118,15,AVERAGHLLCDKAQKN,0
4no6,b,163,179,16,RSQGAKTYLERTLDTFI,0
4no6,b,184,198,14,NPDELIKAGVEAISQ,0
4no6,b,226,231,5,GEAVAK,0
4no6,b,17,29,12,NFQVEYAVKAVEN,0
4no6,b,77,100,23,LIPDGRHLVNRGREEAASFKKLYK,0
4no6,b,104,119,15,PIPAFADRLGQYVQAH,0
4no6,b,164,179,15,GRQSAKAELEKLVDHH,0
4no6,b,184,199,15,SAREAVKQAAKIIYLA,0
4no6,b,200,204,4,HEDNK,0
4no6,b,228,243,15,KGDLLQEAIDFAQKEI,0
4no6,b,2,6,4,GYDRH,0
4no6,b,16,27,11,LYQVEYAFKATN,0
4no6,b,56,60,4,DPTTV,0
4no6,b,77,100,23,PIPDARNAALRAKAEAAEFRYKYG,0
4no6,b,104,122,18,PCDVLAKRMANLSQIYTQR,0
4no6,b,165,181,16,KQQEITTNLENHFKKSK,0
4no6,b,189,206,17,SWEKVVEFAITHMIDALG,0
4no6,b,228,241,13,SAENIEERLVAIAE,0
4no6,b,48,71,23,TAADTEAVTQLIGSNIELHSLYTS,0
4no6,b,75,90,15,RVVSALQMLKQHLFKY,0
4no6,b,130,142,12,GSLAAMAVLESHW,0
4no6,b,147,166,19,TKEEAIKLASDAIQAGIWND,0
4no6,b,2,6,4,DPSSI,0
4no6,b,55,78,23,LATDVTTLNEMFRYKTNLYKLKEE,0
4no6,b,82,96,14,EPETFTQLVSSSLYE,0
4no6,b,141,153,12,ASDQLFGMCESLY,0
4no6,b,158,175,17,EPEDLFETISQALLNAAD,0
4no6,b,51,72,21,GDTVQFAEYIQANIQLYSIRED,0
4no6,b,76,93,17,SPQAVSSFVRQELAKSIR,0
4no6,b,136,148,12,SGFYTFSLLDHHY,0
4no6,b,153,172,19,TTEEGLDLLKLCVQELEKRM,0
4no6,b,48,71,23,GAADCQFWETWLGSQCRLHELREK,0
4no6,b,75,90,15,SVAAASKILSNLVYQY,0
4no6,b,132,144,12,GQTFAYGVLDSNY,0
4no6,b,149,168,19,SVEDALYLGKRSILAAAHRD,0
4no6,b,193,205,12,VGELFWKVKEEEG,0
4no6,b,57,79,22,FAADGDALVKRFKNSVKWYHFDH,0
4no6,b,85,99,14,SINSAARNIQHLLYG,0
4no6,b,142,154,12,AASLIMPFLDNQV,0
4no6,b,176,195,19,SVEEVIKLVRDSFTSATERH,0
4no6,b,57,76,19,ISDMQHIERLLKDLVTENAY,0
4no6,b,88,106,18,EPSYIFEYLATVMYQRRSK,0
4no6,b,145,156,11,GFGAHMANPLLR,0
4no6,b,161,168,7,RESDIPKT,0
4no6,b,169,188,19,TVQVAEEAIVNAMRVLYYRD,0
4no6,b,219,225,6,WDFAKDI,0
4no6,b,48,71,23,SAADTQAIADIVQYHLELYTSQYG,0
4no6,b,74,89,15,STETAASVFKELCYEN,0
4no6,b,90,93,3,KDNL,0
4no6,b,128,133,5,GSGSTF,0
4no6,b,134,142,8,IYGYCDKNF,0
4no6,b,147,166,19,SKEETVDFIKHSLSQAIKWD,0
4no6,b,189,194,5,YPDEYE,0
4no6,b,76,92,16,SPQAVSSFVRQELAKSI,0
3igj,C,3,11,8,TEKDKLAG,0
3igj,C,18,42,24,DEELVADRVEAKRLTRLYNEAVETG,0
3igj,C,45,54,9,RRFTLLNQLL,0
3igj,C,118,123,5,HPVERN,0
3igj,C,3,10,7,TEKDKLA,0
3igj,C,18,41,23,DEELVADRVEAKRLTRLYNEAVET,0
3chi,B,25,39,14,SATLGRLVRAWPRRA,0
3chi,B,39,44,5,AAVVNK,0
3chi,B,46,52,6,DILDEWA,0
3chi,B,62,66,4,PLEIV,0
3chi,B,71,77,6,HPLFLAA,0
3chi,B,78,104,26,EPHQRQRVLTGMWIGYNERVIATEQLI,0
3chi,B,104,114,10,IAEPAFDLVMH,0
3chi,B,122,154,32,DPLIRKSVQQAIVDESFHTYMHMLAIDRTRELR,0
3chi,B,165,177,12,LVTYRRLRRVLAD,0
3chi,B,180,198,18,EQWERDIAVLVWGAVAETC,0
3chi,B,200,208,8,NALLALLAR,0
3chi,B,213,245,32,QPMHSLITTLHLRDETAHGSIVVEVVRELYARM,0
3chi,B,246,266,20,NEQQRRALVRCLPIALEAFAE,0
3chi,B,269,280,11,LSALLLELNAAG,0
3chi,B,283,291,8,GAEEIVGDL,0
3chi,B,304,314,10,FSGARKMVEQL,0
3chi,B,104,115,11,IAEPAFDLVMHG,0
3chi,B,269,279,10,LSALLLELNAA,0
2ktx,A,11,21,10,SPQCLKPCKDA,0
5c2a,B,442,451,9,TSEEWQGLMQ,0
5c2a,B,455,459,4,PVRLC,0
5c2a,B,469,474,5,IGPFEN,0
5c2a,B,475,489,14,MWPGIFVYMVHRSCG,0
5c2a,B,494,508,14,ELEKLCRFIMSVKKN,0
5c2a,B,516,533,17,NWKHAVTVAHCMYAILQN,0
5c2a,B,534,538,4,NHTLF,0
5c2a,B,539,553,14,TDLERKGLLIACLCH,0
5c2a,B,561,568,7,SNSYLQKF,0
5c2a,B,570,576,6,HPLAALY,0
5c2a,B,579,594,15,STMEQHHFSQTVSILQ,0
5c2a,B,605,623,18,SSSEYEQVLEIIRKAIIAT,0
5c2a,B,624,641,17,DLALYFGNRKQLEEMYQT,0
5c2a,B,648,665,17,NQSHRDRVIGLMMTACDL,0
5c2a,B,666,670,4,CSVTK,0
5c2a,B,671,695,24,LWPVTKLTANDIYAEFWAEGDEMKK,0
5c2a,B,701,710,9,IPMMDRDKKD,0
5c2a,B,711,723,12,EVPQGQLGFYNAV,0
5c2a,B,723,735,12,VAIPCYTTLTQIL,0
5c2a,B,738,758,20,TEPLLKACRDNLSQWEKVIRG,0
5c2a,B,460,464,4,KEIEL,0
5c2a,B,472,474,2,FEN,0
5c2a,B,475,488,13,MWPGIFVYMVHRSC,0
5k1d,A,9,24,15,LRPVVDASIQPLLKEH,0
5k1d,A,66,81,15,VSKTLTATLGAYAVVK,0
5k1d,A,89,98,9,KASRHAPWLK,0
5k1d,A,100,104,4,SAFDS,0
5k1d,A,106,112,6,TMGELAT,0
5k1d,A,128,139,11,SSEKMRAYYRQW,0
5k1d,A,152,167,15,SNPSIGLFGHLAASSL,0
5k1d,A,170,178,8,PFAPLMEQT,0
5k1d,A,178,183,5,TLLPGL,0
5k1d,A,193,200,7,PKQAMASY,0
5k1d,A,218,223,5,LADEAY,0
5k1d,A,228,242,14,SSADLLRFVKANIGG,0
5k1d,A,245,257,12,DKALQQAISLTHQ,0
5k1d,A,279,287,8,TEQTLLAGN,0
5k1d,A,288,294,6,SAKVILE,0
5k1d,A,327,330,3,PARG,0
5k1d,A,342,359,17,PIEARIKAAHAILAQLAG,0
5yjj,F,67,70,3,MYAA,0
5yjj,F,87,100,13,EATLTARLIDRPIR,0
5yjj,F,125,140,15,SPEMAAMIGSSMALSV,0
5yjj,F,166,172,6,SVADKEI,0
5yjj,F,197,227,30,TESEMLEAIFFGHEEIKRLVAFQQEIIDHIQ,0
5yjj,F,298,315,17,YAILNDLIKEEVRRLIAD,0
5yjj,F,387,392,5,PNFSVG,0
5yjj,F,401,417,16,GRREIGHGALGERALRY,0
5yjj,F,441,457,16,SSSQASICGSTLALMDA,0
5yjj,F,486,493,7,QGMEDALG,0
5yjj,F,519,545,26,TREVIEEALEQARQGRLAIMDHMLHTI,0
5yjj,F,298,317,19,YAILNDLIKEEVRRLIADEK,0
1yau,U,21,32,11,LFQVEYAREAVK,0
1yau,U,82,104,22,VADARVLVDFARISAQQEKVTYG,0
1yau,U,108,123,15,NIENLVKRVADQMQQY,0
1yau,U,168,180,12,GKDAVVSFLEREY,0
1yau,U,185,199,14,PEKEAVTLGIKALKS,0
1yau,U,225,231,6,DQEEVKK,0
1yau,U,185,200,15,PEKEAVTLGIKALKSS,0
1yau,U,21,33,12,LFQVEYAREAVKK,0
1yau,U,48,71,23,LVGDAQVLVRYMKAELELYRLQRR,0
1yau,U,75,90,15,PIEAVATLLSNMLNQV,0
1yau,U,130,142,12,GSPFVYGVLESQY,0
1yau,U,147,166,19,TVDEGVDLVIRAISAAKQRD,0
1yau,U,188,200,12,PTDQIESRIRKLG,0
1yau,U,75,89,14,PIEAVATLLSNMLNQ,0
1yau,U,4,16,12,KRAALIQNLRDSY,0
1yau,U,17,30,13,TETSSFAVIEEWAA,0
1yau,U,30,52,22,AGTLQEIEGIAKAAAEAHGVIRN,0
1yau,U,57,62,5,RAQAEK,0
1yau,U,64,94,30,PEQLLGVLQRYQDLCHNVYCQAETIRTVIAI,0
1yau,U,104,122,18,NLGVAVQHAVLKIIDELEI,0
1yau,U,143,161,18,YALREYLSARSTVEDKLLG,0
1yau,U,176,221,45,SPSLLLELRQIDADFMLKVELATTHLSTMVRAVINAYLLNWKKLIQ,0
1yau,U,56,61,5,GRAQAE,0
1yau,U,104,123,19,NLGVAVQHAVLKIIDELEIK,0
1yau,U,56,60,4,GRAQA,0
1yau,U,143,160,17,YALREYLSARSTVEDKLL,0
2cke,D,8,11,3,KVED,0
2cke,D,57,71,14,SREEIEREVSILRQV,0
2cke,D,100,106,6,ELFDFLA,0
2cke,D,112,133,21,SEEEATSFIKQILDGVNYLHTK,0
2cke,D,141,143,2,KPE,0
2cke,D,180,184,4,TPEFV,0
2cke,D,185,190,5,APEIVN,0
2cke,D,196,213,17,LEADMWSIGVITYILLSG,0
2cke,D,221,232,11,TKQETLANITSV,0
2cke,D,237,242,5,DEEFFS,0
2cke,D,245,256,11,SELAKDFIRKLL,0
2cke,D,265,271,6,TIQEALR,0
2cke,D,279,289,10,DNQQAMVRRES,0
2cke,D,292,299,7,NLENFRKQ,0
2cke,D,8,12,4,KVEDF,0
2cke,D,57,69,12,SREEIEREVSILR,0
2cke,D,221,231,10,TKQETLANITS,0
2cke,D,245,254,9,SELAKDFIRK,0
2cke,D,265,272,7,TIQEALRH,0
2cke,D,292,301,9,NLENFRKQYV,0
2cke,D,185,191,6,APEIVNY,0
2lu4,A,37,39,2,FNN,0
2lu4,A,98,103,5,KSDFEV,0
2xtj,P,224,236,12,DSHGTHLAGVVSG,0
2xtj,P,261,278,17,VSGTLIGLEFIRKSQLVQ,0
2xtj,P,294,307,13,SRVLNAACQRLARA,0
2xtj,P,384,403,19,GTSQAAAHVAGIAAMMLSAE,0
2xtj,P,407,419,12,TLAELRQRLILFS,0
2xtj,P,79,83,4,QPEDF,0
2xtj,P,120,127,7,SDEQLKSG,0
2xtj,P,182,186,4,KADYE,0
2xtj,P,62,65,3,QKFQ,0
2xtj,P,87,91,4,RSEDT,0
2xtj,P,174,176,2,SGA,0
2xtj,P,205,207,2,SSL,0
2xtj,P,219,222,3,KPSN,0
2xtj,P,69,71,2,KDP,0
2xtj,P,87,104,17,HLSQSERTARRLQAQAAR,0
2xtj,P,127,129,2,SGD,0
2xtj,P,130,135,5,LLELAL,0
1o4i,A,13,22,9,TRRESERLLL,0
1o4i,A,81,90,9,SLQQLVAYYS,0
2h4j,D,3,13,10,MKEFLDLLNES,0
2h4j,D,22,29,7,AGISTPSG,0
2h4j,D,49,56,7,DIDFFYSH,0
2h4j,D,56,68,12,HPEEFYRFAKEGI,0
2h4j,D,69,74,5,FPMLQA,0
2h4j,D,77,89,12,NLAHVLLAKLEEK,0
2h4j,D,102,107,5,RLHQRA,0
2h4j,D,133,140,7,VEDVIKKL,0
2h4j,D,167,181,14,PQDALREAIGLSSRA,0
2h4j,D,195,197,2,PAA,0
2h4j,D,198,207,9,ELPLITVRSG,0
2h4j,D,220,224,4,FDDIA,0
2h4j,D,231,243,12,DVVEFARRVMEEG,0
2h4j,D,4,9,5,QSTSRH,0
4rvn,D,7,12,5,EEEIEI,0
4rvn,D,14,34,20,SREKLQELQLQRLKKTINIAA,0
4rvn,D,36,46,10,SPYYKEVFSKN,0
4rvn,D,55,62,7,SLDDIRKI,0
4rvn,D,66,73,7,TKSDRAN,0
4rvn,D,82,86,4,DKRD,0
4rvn,D,107,124,17,QHDLDSWANLVARCLYV,0
4rvn,D,141,155,14,FTGGLGFQYGAERLG,0
4rvn,D,165,177,12,NSKRQIKFISDFK,0
4rvn,D,184,198,14,IPSYAIRLAEVFQEE,0
4rvn,D,218,230,12,TDEQRRKIERLN,0
4rvn,D,240,243,3,TEN,0
4rvn,D,341,350,9,FPQVEKILV,0
4rvn,D,385,405,20,NYIELEKIRRDIIRQLKDEIL,0
4rvn,D,330,332,2,DD,0
1pl5,S,1272,1343,71,SFVDIVLSKAASALDEKEKQLAVANEIIRSLSDEVMRNEIRITSLQGDLTFTKKCLENARSQISEKDAKINK,0
1pl5,S,1272,1344,72,SFVDIVLSKAASALDEKEKQLAVANEIIRSLSDEVMRNEIRITSLQGDLTFTKKCLENARSQISEKDAKINKL,0
2bkg,B,12,25,13,SDLGKKLLEAARAG,0
2bkg,B,26,37,11,QDDEVRILMANG,0
2bkg,B,49,58,9,TPLHLAARVG,0
2bkg,B,59,69,10,HLEIVEVLLKN,0
2bkg,B,82,90,8,TPLHLAAKR,0
2bkg,B,92,102,10,HLEIVEVLLKY,0
2bkg,B,115,123,8,TPLHLAADT,0
2bkg,B,125,135,10,HLEIVEVLLKY,0
2bkg,B,148,156,8,TAFDISIDN,0
2bkg,B,158,165,7,NEDLAEIL,0
2bkg,B,26,36,10,QDDEVRILMAN,0
2bkg,B,148,157,9,TAFDISIDNG,0
3edj,B,31,35,4,DIGRM,0
3edj,B,113,118,5,MPDRFA,0
3edj,B,121,125,4,DPSND,0
3edj,B,146,153,7,DIRGTIDH,0
3edj,B,153,160,7,HLDYIAGL,0
3edj,B,178,182,4,YSYHG,0
3edj,B,197,211,14,SNEDFVRLSTEARKR,0
3edj,B,228,233,5,HWWMKD,0
3edj,B,240,245,5,INYGGK,0
3edj,B,252,258,6,HRVAVQD,0
3edj,B,262,272,10,AQADSENFTKG,0
3edj,B,285,304,19,NPLVANYLIQNNIWWIEYAG,0
3edj,B,312,316,4,TYGYS,0
3edj,B,317,332,15,DGAFLTEYTRRLMAEY,0
3edj,B,345,351,6,RVPVVAR,0
3edj,B,371,384,13,DFPLVDAMRNALSK,0
3edj,B,391,400,9,LNEVYETLSL,0
3edj,B,401,404,3,DYLY,0
3edj,B,406,409,3,EPQN,0
3edj,B,421,426,5,RMFSAA,0
3edj,B,429,443,14,DFDRWRMNLVFLMTM,0
3edj,B,452,456,4,GDEIL,0
3edj,B,465,470,5,DDASYR,0
3edj,B,491,510,19,TSQQRAAQDLVRKLANWRKN,0
3edj,B,511,517,6,QPVIHNG,0
3edj,B,558,563,5,FQEMLK,0
5hvy,B,2,13,11,DYDFKVKLSSER,0
5hvy,B,15,19,4,RVEDL,0
5hvy,B,60,71,11,SMSACREIALLR,0
5hvy,B,104,113,9,LWHIIKFHRA,0
5hvy,B,124,145,21,PRGMVKSLLYQILDGIHYLHAN,0
5hvy,B,153,155,2,KPA,0
5hvy,B,201,206,5,APELLL,0
5hvy,B,212,230,18,TKAIDIWAIGCIFAELLTS,0
5hvy,B,248,260,12,HHDQLDRIFNVMG,0
5hvy,B,263,273,10,ADKDWEDIKKM,0
5hvy,B,275,283,8,EHSTLMKDF,0
5hvy,B,284,289,5,RRNTYT,0
5hvy,B,292,300,8,SLIKYMEKH,0
5hvy,B,306,316,10,SKAFHLLQKLL,0
5hvy,B,319,323,4,DPIKR,0
5hvy,B,325,331,6,TSEQAMQ,0
5hvy,B,332,337,5,DPYFLE,0
5hvy,B,4,7,3,NFWQ,0
5hvy,B,8,14,6,SSHYLQW,0
5hvy,B,17,30,13,DKQDLLKERQKDLK,0
5hvy,B,33,55,22,SEEEYWKLQIFFTNVIQALGEHL,0
5hvy,B,58,76,18,RQQVIATATVYFKRFYARY,0
5hvy,B,82,96,14,DPVLMAPTCVFLASK,0
5hvy,B,104,120,16,SNTRLIAAATSVLKTRF,0
5hvy,B,131,146,15,RMNHILECEFYLLELM,0
5hvy,B,155,167,12,PYRPLLQYVQDMG,0
5hvy,B,168,184,16,QEDMLLPLAWRIVNDTY,0
5hvy,B,187,192,5,DLCLLY,0
5hvy,B,193,209,16,PPFMIALACLHVACVVQ,0
5hvy,B,213,219,6,ARQWFAE,0
5hvy,B,223,244,21,DMEKILEIIRVILKLYEQWKNF,0
5hvy,B,245,257,12,DERKEMATILSKM,0
2oi9,C,49,53,4,VPWME,0
2oi9,C,56,86,30,GPEYWERITQVAKGQEQWFRVNLRTLLGYYN,0
2oi9,C,137,151,14,DMAAQITRRKWEQAG,0
2oi9,C,151,162,11,GAAEYYRAYLEG,0
2oi9,C,162,175,13,GECVEWLHRYLKNG,0
2oi9,C,81,85,4,HRSDS,0
2oi9,C,100,102,2,FAS,0
2oi9,C,83,87,4,TPSQT,0
4r6s,B,205,226,21,NPESADLRALAKHLYDSYIKSF,0
4r6s,B,229,238,9,TKAKARAILT,0
4r6s,B,251,262,11,DMNSLMMGEDKI,0
4r6s,B,277,302,25,VAIRIFQGCQFRSVEAVQEITEYAKS,0
4r6s,B,310,333,23,DLNDQVTLLKYGVHEIIYTMLASL,0
4r6s,B,342,344,2,SEG,0
4r6s,B,350,355,5,REFLKS,0
4r6s,B,359,363,4,PFGDF,0
4r6s,B,364,376,12,MEPKFEFAVKFNA,0
4r6s,B,380,393,13,DDSDLAIFIAVIIL,0
4r6s,B,402,425,23,NVKPIEDIQDNLLQALELQLKLNH,0
4r6s,B,430,460,30,QLFAKLLQKMTDLRQIVFEHVQLLQVIKKTE,0
4r6s,B,466,474,8,HPLLQEIYK,0
4r6s,B,208,226,18,SADLRALAKHLYDSYIKSF,0
4r6s,B,229,239,10,TKAKARAILTG,0
4r6s,B,276,302,26,EVAIRIFQGCQFRSVEAVQEITEYAKS,0
4r6s,B,310,332,22,DLNDQVTLLKYGVHEIIYTMLAS,0
4r6s,B,430,457,27,QLFAKLLQKMTDLRQIVFEHVQLLQVIK,0
4r6s,B,467,473,6,PLLQEIY,0
2pby,D,5,18,13,NQEELVRFVEEAKQ,0
2pby,D,19,23,4,YARYG,0
2pby,D,29,35,6,IPALGKA,0
2pby,D,65,88,23,SISKIIALALVLIDRGEDEVFHKV,0
2pby,D,115,124,9,INAGALVVTS,0
2pby,D,130,147,17,SVSERLERLLAFVRRLAG,0
2pby,D,154,165,11,SDEVARSEFETA,0
2pby,D,165,178,13,AFLNRSLCYFLKQH,0
2pby,D,184,197,13,DVEELMELYTKQCA,0
2pby,D,201,214,13,TCIDLARIGLVLAL,0
2pby,D,227,241,14,PLDVARICKTFMVTC,0
2pby,D,246,254,8,SSGEFAIKV,0
2pby,D,289,304,15,SLTGVKLLERLSKTYS,0
2pby,D,65,79,14,SISKIIALALVLIDR,0
2pby,D,79,87,8,RGEDEVFHK,0
2pby,D,115,125,10,INAGALVVTSM,0
2pby,D,243,245,2,MYN,0
2pby,D,66,80,14,ISKIIALALVLIDRG,0
2pby,D,80,88,8,GEDEVFHKV,0
2pby,D,31,35,4,ALGKA,0
2pby,D,289,303,14,SLTGVKLLERLSKTY,0
3ey6,A,97,101,4,QALDL,0
3ey6,A,102,106,4,SVPLM,0
3ey6,A,118,120,2,SKY,0
3ey6,A,123,125,2,GPQ,0
6eid,B,37,41,4,AGWIE,0
6eid,B,45,77,32,TNGAQTASNVLQWLAAGFSILLLMFYAYQTWKS,0
6eid,B,80,101,21,GWEEIYVCAIEMVKVILEFFFE,0
6eid,B,117,137,20,QWLRYAEWLLTCPVILIHLSN,0
6eid,B,146,169,23,SRRTMGLLVSDIGTIVWGATSAMA,0
6eid,B,172,203,31,YVKVIFFCLGLCYGANTFFHAAKAYIEGYHTV,0
6eid,B,206,233,27,GRCRQVVTGMAWLFFVSWGMFPILFILG,0
6eid,B,241,257,16,SVYGSTVGHTIIDLMS,0
6eid,B,257,279,22,NCWGLLGHYLRVLIHEHILIHG,0
2w7l,A,2,8,6,KYLPQQD,0
2w7l,A,8,25,17,DPQVFAAIEQERKRQHAK,0
2w7l,A,36,44,8,SRAVMEAQG,0
2w7l,A,45,50,5,SVLTNK,0
2w7l,A,64,83,19,CEYVDIVEELARERAKQLFG,0
2w7l,A,93,106,13,SGAQANMAVYFTVL,0
2w7l,A,122,126,4,HLTHG,0
2w7l,A,130,136,6,NFSGVQY,0
2w7l,A,151,163,12,DYDDVREKARLHR,0
2w7l,A,179,191,12,DFAKFREIADEVG,0
2w7l,A,201,207,6,IAGLVAA,0
2w7l,A,242,251,9,FAKQIDKAIF,0
2w7l,A,259,275,16,LMHVIAAKAVAFGEALQ,0
2w7l,A,275,299,24,QDDFKAYAKRVVDNAKRLASALQNE,0
2w7l,A,305,307,2,SGG,0
2w7l,A,323,335,12,TGKTAEKVLDEVG,0
2w7l,A,360,367,7,TAAVTTRG,0
2w7l,A,369,385,16,GLEEMDEIAAIIGLVLK,0
2w7l,A,389,404,15,SEQALEEARQRVAALT,0
2e2c,A,31,45,14,VSKRLQQELRTLLMS,0
2e2c,A,116,118,2,DIL,0
2e2c,A,128,138,10,VRTILLSLQSL,0
2e2c,A,150,157,7,AQAADMWS,0
2e2c,A,159,175,16,QTEYKKVLHEKYKTAQS,0
5l3r,D,103,117,14,IAEPMRDIRRALLEA,0
5l3r,D,120,139,19,SLPVVRRFVQSVSDQAVGMG,0
5l3r,D,146,162,16,PDQQLVKIVHDELVKLM,0
5l3r,D,188,202,14,GKTTVCAKLACYLKK,0
5l3r,D,218,231,13,AAIDQLVILGEQVG,0
5l3r,D,242,257,15,KPADIAKQGLKEAKKN,0
5l3r,D,273,288,15,DKGMMDELKDVKKFLN,0
5l3r,D,303,315,12,EAAALVTTFNVEI,0
5l3r,D,332,342,10,GAALSVKEVSG,0
5l3r,D,361,370,9,YPDRMAGRIL,0
5l3r,D,79,86,7,HVIDELLL,0
5l3r,D,87,88,1,FW,0
5l3r,D,89,91,2,NLA,0
5l3r,D,92,107,15,ETDRVLDELEEALLVS,0
5l3r,D,110,127,17,GPKITVRIVERLREDIMS,0
5l3r,D,132,149,17,SGSEIKDALKESVLEMLA,0
5l3r,D,176,191,15,GKTTSLGKLAHRLKNE,0
5l3r,D,206,219,13,AASDQLEIWAERTG,0
5l3r,D,231,246,15,KAATVLSKAVKRGKEE,0
5l3r,D,262,278,16,NYSLMEELIACKKAVGK,0
5l3r,D,298,311,13,NMLPQAREFNEVVG,0
5l3r,D,328,337,9,CVVSVVEELG,0
5l3r,D,356,365,9,DPEAFVNAIF,0
5l3r,D,99,117,18,TKDNIAEPMRDIRRALLEA,0
4h81,A,54,81,27,GSHLLKSGRYLQQELPVRIAHRIKGFRS,0
4h81,A,83,88,5,PFIIGC,0
4h81,A,89,109,20,NPTILHVHELYIRAFQKLTDF,0
4h81,A,114,132,18,DQADEAQYCQLVRQLLDDH,0
4h81,A,134,147,13,DVVTLLAEGLRESR,0
4h81,A,153,180,27,EKLVRYFLDKTLTSRLGIRMLATHHLAL,0
4h81,A,196,217,21,SPKKIIEKWVDFARRLCEHKYG,0
4h81,A,235,257,22,IPMPLDYILPELLKNAMRATMES,0
4h81,A,338,350,12,FGLPTSRAYAEYL,0
2fhj,D,29,42,13,SHKWAMIAVKEATG,0
2fhj,D,62,66,4,PPEET,0
2fhj,D,81,97,16,DEDELKEQLLDRIGQCV,0
2fhj,D,119,126,7,RVGYKLSF,0
2fhj,D,127,129,2,FGD,0
2fhj,D,175,192,17,SQPAGLQAAEAAVDAIKG,0
2fhj,D,200,202,2,FPG,0
2fhj,D,225,228,3,DAYC,0
2fhj,D,252,268,16,NEEAVKEAMRVGIEAAC,0
2fhj,D,293,295,2,HDL,0
2fhj,D,110,114,4,PEAEK,0
2fhj,D,293,296,3,HDLF,0
2v65,B,2,8,6,STKEKLI,0
2v65,B,30,43,13,GMVGMASAISILLK,0
2v65,B,55,68,13,MEDKLKGEVMDLQH,0
2v65,B,69,73,4,GSLFL,0
2v65,B,84,89,5,DYSVTA,0
2v65,B,108,131,23,SRLNLVQRNVNIFKFIIPNIVKYS,0
2v65,B,141,152,11,PVDILTYVAWKL,0
2v65,B,156,158,2,PRH,0
2v65,B,165,181,16,TNLDSARFRHLIGEKLH,0
2v65,B,183,185,2,HPS,0
2v65,B,203,206,3,WSGV,0
2v65,B,224,234,10,NWKAIHKEVVD,0
2v65,B,234,244,10,DGAYEVIKLKG,0
2v65,B,247,263,16,SWAIGMSVADLVESIIK,0
2v65,B,308,328,20,KAEEEKQLQKSAETLWGVQKE,0
2v65,B,141,154,13,PVDILTYVAWKLSG,0
2v65,B,308,327,19,KAEEEKQLQKSAETLWGVQK,0
2j0q,T,40,44,4,FDTMG,0
2j0q,T,46,57,11,REDLLRGIYAYG,0
2j0q,T,62,74,12,SAIQQRAIKQIIK,0
2j0q,T,87,100,13,GKTATFSISVLQCL,0
2j0q,T,115,130,15,TRELAVQIQKGLLALG,0
2j0q,T,131,133,2,DYM,0
2j0q,T,145,156,11,NVGEDIRKLDYG,0
2j0q,T,163,173,10,TPGRVFDMIRR,0
2j0q,T,188,193,5,EADEML,0
2j0q,T,197,208,11,FKEQIYDVYRYL,0
2j0q,T,222,229,7,PHEILEMT,0
2j0q,T,230,232,2,NKF,0
2j0q,T,242,246,4,KRDEL,0
2j0q,T,262,276,14,EWKFDTLCDLYDTLT,0
2j0q,T,286,300,14,TKRKVDWLTEKMREA,0
2j0q,T,312,325,13,PQKERESIMKEFRS,0
2j0q,T,335,338,3,DVWA,0
2j0q,T,357,366,9,NRELYIHRIG,0
2j0q,T,382,384,2,KND,0
2j0q,T,385,396,11,DIRILRDIEQYY,0
2j0q,T,22,26,4,DMTKV,0
2j0q,T,87,99,12,GKTATFSISVLQC,0
2j0q,T,39,43,4,NYKND,0
2j0q,T,53,68,15,HKSVMEELKRIIDDSE,0
2j0q,T,69,72,3,ITKE,0
2j0q,T,106,112,6,SLIDVNQ,0
2j0q,T,115,142,27,DPEGLRVFYYLVQDLKCLVFSLIGLHFK,0
2j0q,T,86,95,9,EEDIHDKFAE,0
2j0q,T,123,135,12,TYKEAQAAMEGLN,0
2j0q,T,106,113,7,SLIDVNQS,0
2j0q,T,115,141,26,DPEGLRVFYYLVQDLKCLVFSLIGLHF,0
2j0q,T,171,175,4,DDDED,0
2j0q,T,224,229,5,REDEQA,0
2j0q,T,232,241,9,SRQELIALYG,0
2j0q,T,224,228,4,REDEQ,0
6f71,D,15,28,13,SPFPHRVRLALEEA,0
6f71,D,43,50,7,QDWYQKKV,0
6f71,D,82,94,12,ESLVILEFLADLF,0
6f71,D,95,98,3,PAAH,0
6f71,D,103,120,17,DPVLRARARLFTTAVETE,0
6f71,D,120,130,10,ELLPAQKAFFL,0
6f71,D,134,148,14,PPDAMLAALDALQAR,0
6f71,D,162,181,19,SIADAAVMPILLRLRMSVTL,0
6f71,D,189,199,10,GAAPVVRAALE,0
6f71,D,200,202,2,SPR,0
6f71,D,203,215,12,FARLQRYIADNVA,0
6f71,D,216,221,5,RPSMAA,0
6f71,D,224,242,18,DEAAVKAEFVGRFEKLRSL,0
6f71,D,40,45,5,VDKQDW,0
6f71,D,134,149,15,PPDAMLAALDALQARL,0
6f71,D,203,216,13,FARLQRYIADNVAR,0
6f71,D,2,5,3,SAQK,0
6f71,D,162,182,20,SIADAAVMPILLRLRMSVTLE,0
6f71,D,189,200,11,GAAPVVRAALES,0
6f71,D,38,45,7,SLVDKQDW,0
6f71,D,45,50,5,WYQKKV,0
6f71,D,120,132,12,ELLPAQKAFFLMG,0
2m0m,B,17,29,12,VGTTVASTTSRLS,0
2m0m,B,30,45,15,TAEASSRISTAASTLV,0
2m0m,B,54,70,16,ALPSVIADLFAQVGASS,0
2m0m,B,74,95,21,SDSEVLIQVLLEIVSSLIHILS,0
2m0m,B,103,105,2,DFS,0
2m0m,B,106,122,16,SVGSSAAAVGQSMQVVM,0
2m0m,B,18,29,11,GTTVASTTSRLS,0
2eun,A,15,33,18,SYEDFQKVYNAIALKLRED,0
2eun,A,35,40,5,EYDNYI,0
2eun,A,42,55,13,YGPVLVRLAWHISG,0
2eun,A,69,72,3,GTYR,0
2eun,A,73,78,5,FKKEFN,0
2eun,A,79,84,5,DPSNAG,0
2eun,A,85,99,14,LQNGFKFLEPIHKEF,0
2eun,A,103,119,16,SSGDLFSLGGVTAVQEM,0
2eun,A,134,138,4,PEDTT,0
2eun,A,150,160,10,DAGYVRTFFQR,0
2eun,A,164,173,9,NDREVVALMG,0
2eun,A,174,177,3,AHAL,0
2eun,A,181,186,5,HLKNSG,0
2eun,A,200,209,9,NEFYLNLLNE,0
2eun,A,232,241,9,LPTDYSLIQD,0
2eun,A,241,254,13,DPKYLSIVKEYAND,0
2eun,A,254,272,18,DQDKFFKDFSKAFEKLLEN,0
2eun,A,289,293,4,LEEQG,0
5fka,C,79,83,4,QTTDS,0
5fka,C,184,189,5,ACANAF,0
5fka,C,84,88,4,EQGDS,0
5fka,C,115,119,4,DLKNV,0
5fka,C,130,138,8,SEAEISHTQ,0
5fka,C,197,202,5,ATFWQD,0
5fka,C,14,18,4,KKSEL,0
5fka,C,21,32,11,NALSNLRQIYYY,0
5fka,C,73,81,8,SKDATNKYK,0
5fka,C,152,168,16,VQELDLQARHYLHGKFG,0
5fka,C,205,210,5,YPDTLL,0
5fka,C,211,214,3,RIYR,0
4wqa,A,12,16,4,AAALL,0
4wqa,A,19,34,15,GALGESIVRGRRYLSD,0
4wqa,A,34,39,5,DTPAQL,0
4wqa,A,48,52,4,ACRHC,0
4wqa,A,72,76,4,VVGRF,0
4wqa,A,88,99,11,TLEQRIGDFER,0
4wqa,A,110,124,14,HPALIDMLAYMSWLS,0
4wqa,A,148,160,12,DGVHGEALYQARC,0
4wqa,A,160,165,5,CLACHG,0
4wqa,A,193,196,3,AGMN,0
4wqa,A,197,209,12,RQATAAGFIKHKM,0
4wqa,A,218,230,12,SDEEAWDVAGFVL,0
3cv8,A,27,36,9,PDGYAQLRDT,0
3cv8,A,56,65,9,KHEAARKLLG,0
3cv8,A,83,90,7,PFFEAVRE,0
3cv8,A,94,98,4,AFIGL,0
3cv8,A,101,108,7,PEHGTRRR,0
3cv8,A,109,114,5,MTISEF,0
3cv8,A,115,121,6,TVKRIKG,0
3cv8,A,122,141,19,MRPEVEEVVHGFLDEMLAAG,0
3cv8,A,146,150,4,LVSQF,0
3cv8,A,152,164,12,LPVPSMVICRLLG,0
3cv8,A,166,168,2,PYA,0
3cv8,A,169,182,13,DHEFFQDASKRLVQ,0
3cv8,A,185,210,25,DAQSALTARNDLAGYLDGLITQFQTE,0
3cv8,A,213,222,9,AGLVGALVAD,0
3cv8,A,230,263,33,DREELISTAMLLLIAGHETTASMTSLSVITLLDH,0
3cv8,A,263,273,10,HPEQYAALRAD,0
3cv8,A,276,289,13,LVPGAVEELLRYLA,0
3cv8,A,319,324,5,VNSIAN,0
3cv8,A,357,376,19,GQNLARLELEVILNALMDRV,0
3cv8,A,384,388,4,PVEQL,0
2wjv,E,130,132,2,DPA,0
2wjv,E,154,164,10,SHIVNHLVRAK,0
2wjv,E,225,229,4,DSSQW,0
2wjv,E,247,254,7,SEQEQLRA,0
2wjv,E,258,269,11,TAQQINKLEELW,0
2wjv,E,298,322,24,DAYQYQNIFGPLVKLEADYDKKLKE,0
2wjv,E,335,339,4,LGLNK,0
2wjv,E,417,433,16,STSFDRMQSALKTFAVD,0
2wjv,E,438,446,8,SGYIYHKLL,0
2wjv,E,472,484,12,NHSQVYAVKTVLQ,0
2wjv,E,497,511,14,GKTVTSATIVYHLAR,0
2wjv,E,523,536,13,SNIAVDQLTEKIHQ,0
2wjv,E,546,550,4,AKSRE,0
2wjv,E,556,559,3,VSFL,0
2wjv,E,560,567,7,ALHNQIRN,0
2wjv,E,571,583,12,MPELQKLQQLKDE,0
2wjv,E,588,609,21,SSADEKRYRALKRTAERELLMN,0
2wjv,E,618,622,4,VGAGD,0
2wjv,E,622,626,4,DPRLA,0
2wjv,E,637,641,4,ESTQA,0
2wjv,E,642,651,9,TEPECMVPVV,0
2wjv,E,672,678,6,CKKAAKA,0
2wjv,E,683,692,9,SLFERLVVLG,0
2wjv,E,705,717,12,HPALSAFPSNIFY,0
2wjv,E,727,731,4,AADRV,0
2wjv,E,766,784,18,NRTEAANVEKITTKLLKAG,0
2wjv,E,786,788,2,KPD,0
2wjv,E,796,811,15,YEGQRSYLVQYMQFSG,0
2wjv,E,814,820,6,HTKLYQE,0
2wjv,E,826,830,4,VDAFQ,0
2wjv,E,850,854,4,IGFLN,0
2wjv,E,855,863,8,DPRRLNVAL,0
2wjv,E,875,880,5,NPKALS,0
2wjv,E,882,895,13,QPLWNHLLNYYKEQ,0
2wjv,E,902,906,4,PLNNL,0
2wjv,E,211,215,4,QPCAS,0
2wjv,E,276,280,4,TLEDL,0
2wjv,E,523,537,14,SNIAVDQLTEKIHQT,0
2wjv,E,571,585,14,MPELQKLQQLKDETG,0
2wjv,E,825,830,5,SVDAFQ,0
2wjv,E,1107,1127,20,CVEDEDFIQALDKMMLENLQQ,0
2wjv,E,1192,1198,6,SQLAANH,0
2wjv,E,1107,1129,22,CVEDEDFIQALDKMMLENLQQRS,0
2xic,B,463,467,4,LFKYT,0
2xic,B,474,489,15,DPDTFLKHIKKVIEKG,0
2xic,B,503,520,17,TETQLRAATQLAIYYFTD,0
2xic,B,526,530,4,KDKLK,0
2xic,B,534,538,4,GFGD,0
2xic,B,539,555,16,NDSTLAVAKILVEYAQD,0
4bmw,A,19,23,4,RGGEL,0
4bmw,A,30,48,18,TLEAATKAARAAVEAAEKD,0
4bmw,A,75,91,16,QSYDSADRKAFTAVSWN,0
4bmw,A,93,98,5,PTSELA,0
4bmw,A,99,103,4,KRLAQ,0
4bmw,A,104,110,6,APTLKDI,0
4bmw,A,139,153,14,SGDLDEQYARAGAAV,0
3vps,B,17,30,13,GFIGGHLARALVAS,0
3vps,B,58,62,4,PVLEL,0
3vps,B,63,68,5,EERDLS,0
3vps,B,81,86,5,SVPRSF,0
3vps,B,92,110,18,YLDNVDSGRHLLALCTSVG,0
3vps,B,121,124,3,EVYG,0
3vps,B,141,160,19,SPYAASKVGLEMVAGAHQRA,0
3vps,B,183,196,13,ALVPRLCANLLTRN,0
3vps,B,213,223,10,ITDVVDKLVAL,0
3vps,B,224,226,2,ANR,0
3vps,B,242,251,9,VNDVIRILQA,0
3vps,B,275,283,8,TALQTRQIG,0
3vps,B,290,304,14,GIEEGIRLTLEWWQS,0
3vps,B,63,67,4,EERDL,0
3vps,B,87,91,4,KQPLD,0
3vps,B,213,224,11,ITDVVDKLVALA,0
4avy,B,20,33,13,SGIGAAIAMQFAEL,0
4avy,B,64,75,11,DSQRLQRLFEAL,0
4avy,B,89,94,5,RDREEY,0
4avy,B,95,107,12,DLATFERVLRLNL,0
4avy,B,107,123,16,LSAAMLASQLARPLLAQ,0
4avy,B,133,137,4,SMYST,0
4avy,B,143,165,22,RPAYSASKGAIVQLTRSLACEYA,0
4avy,B,181,183,2,TPL,0
4avy,B,184,190,6,GAGLKAD,0
4avy,B,190,200,10,DVEATRRIMQR,0
4avy,B,208,220,12,EAPEVASAAAFLC,0
4avy,B,221,225,4,GPGAS,0
4avy,B,237,241,4,GYLCA,0
2qzc,B,4,14,10,VGNVENLINGV,0
2qzc,B,16,23,7,ELWNKYVK,0
2qzc,B,24,32,8,HEFILKRD,0
2qzc,B,36,63,27,PLDIFRYYLIQDGKYVEDLRALLIASS,0
2qzc,B,66,78,12,PIDKVTKILNLVF,0
2qzc,B,83,95,12,KGLETHGKLYSKL,0
2qzc,B,98,105,7,SRDVIVKT,0
2qzc,B,108,125,17,NLINYAYTRHLYYYANLD,0
2qzc,B,125,148,23,DWNKFLVAWTPCFGYSIVGDYVI,0
2qzc,B,152,164,12,NEVYKTWASFYAS,0
2qzc,B,164,179,15,STEYKKRIEAILYALD,0
2qzc,B,184,208,24,TEDLLNIFINSVRFEIGFWDASLRK,0
2qzc,B,5,14,9,GNVENLINGV,0
2qzc,B,24,33,9,HEFILKRDG,0
2qzc,B,86,95,9,ETHGKLYSKL,0
2qzc,B,108,123,15,NLINYAYTRHLYYYAN,0
2qzc,B,184,207,23,TEDLLNIFINSVRFEIGFWDASLR,0
2hmy,B,23,31,8,GFRLALESC,0
2hmy,B,43,52,9,KYAQEVYEMN,0
2hmy,B,61,63,2,ITQ,0
2hmy,B,66,68,2,EKT,0
2hmy,B,93,96,3,FEDS,0
2hmy,B,101,111,10,FFDIARIVREK,0
2hmy,B,122,124,2,KNF,0
2hmy,B,127,143,16,HDNGNTLEVVKNTMNEL,0
2hmy,B,154,156,2,ALD,0
2hmy,B,173,175,2,NDL,0
2hmy,B,192,194,2,VKD,0
2hmy,B,199,205,6,DSEVEHL,0
2hmy,B,276,283,7,PRECARVM,0
2hmy,B,295,304,9,TSQAYKQFGN,0
2hmy,B,308,323,15,INVLQYIAYNIGSSLN,0
5l7p,B,2,9,7,DEFEMIKR,0
5l7p,B,16,24,8,SEEELREVL,0
5l7p,B,42,58,16,HLGHYLQIKKMIDLQNA,0
5l7p,B,67,74,7,ADLAAYLN,0
5l7p,B,78,97,19,ELDEIRKIGDYNKKVFEAMG,0
5l7p,B,106,108,2,SEF,0
5l7p,B,111,125,14,DKDYTLNVYRLALKT,0
5l7p,B,126,134,8,TLKRARRSM,0
5l7p,B,146,163,17,VAEVIYPIMQVNAAHYMG,0
5l7p,B,173,184,11,QRKIHMLQRELL,0
5l7p,B,218,228,10,SPEEIRAKIKK,0
5l7p,B,239,248,9,NPIMEIAKYF,0
5l7p,B,258,262,4,PEKFG,0
5l7p,B,269,279,10,SYEELESLFKN,0
5l7p,B,283,306,23,HPMRLKNAVAEELIKILEPIRKRL,0
5l7p,B,16,25,9,SEEELREVLK,0
5l7p,B,78,96,18,ELDEIRKIGDYNKKVFEAM,0
5l7p,B,111,123,12,DKDYTLNVYRLAL,0
3tnx,C,14,29,15,STERLIQLFESWMLKH,0
3tnx,C,35,57,22,NIDEKIYRFEIFKDNLKYIDETN,0
3tnx,C,74,83,9,SNDEFKEKYT,0
3tnx,C,115,118,3,RQKG,0
3tnx,C,131,150,19,SAWAFSAVSTIESIIKIRTG,0
3tnx,C,156,164,8,SEQELLDCD,0
3tnx,C,168,172,4,YGCNG,0
3tnx,C,174,185,11,YPWSALQLVAQY,0
3tnx,C,203,208,5,RSREKG,0
3tnx,C,224,233,9,NEGALLYSIA,0
3tnx,C,245,250,5,GKDFQL,0
3tnx,C,305,309,4,GVCGL,0
3tnx,C,15,29,14,TERLIQLFESWMLKH,0
3tnx,C,189,193,4,YRNTY,0
3tnx,C,202,208,6,CRSREKG,0
3geb,D,282,287,5,FHSLLT,0
3geb,D,288,295,7,GTFASRYG,0
3geb,D,297,320,23,DTTTSVRIGLMMEEMIFNLADTHL,0
3geb,D,321,326,5,FFNDLE,0
3geb,D,336,340,4,VSSDD,0
3geb,D,375,395,20,DWMRKLAFRYRRVKEMYNTYK,0
3geb,D,397,403,6,NVGGLIG,0
3geb,D,405,421,16,PKRETWLQLRAELEALT,0
3geb,D,423,438,15,LWLTHSLKALNLINSR,0
3geb,D,450,461,11,QLIPALAKVLLY,0
3geb,D,468,470,2,PIE,0
3geb,D,479,492,13,GKESCFERIMQRFG,0
3geb,D,503,513,10,GVEEEQGAKKH,0
3geb,D,522,535,13,CHADLEALRHALEL,0
3geb,D,282,288,6,FHSLLTG,0
3geb,D,288,294,6,GTFASRY,0
3geb,D,398,403,5,VGGLIG,0
3geb,D,403,421,18,GTPKRETWLQLRAELEALT,0
3geb,D,297,321,24,DTTTSVRIGLMMEEMIFNLADTHLF,0
3geb,D,374,394,20,VDWMRKLAFRYRRVKEMYNTY,0
3geb,D,480,492,12,KESCFERIMQRFG,0
3geb,D,344,348,4,DLSTY,0
3geb,D,349,353,4,NFSAD,0
3geb,D,373,395,22,GVDWMRKLAFRYRRVKEMYNTYK,0
3zg5,B,27,40,13,DKEINNTIDAIEDK,0
3zg5,B,41,49,8,NFKQVYKDS,0
3zg5,B,50,58,8,SYISKSDNG,0
3zg5,B,58,74,16,GEVEMTERPIKIYNSLG,0
3zg5,B,128,132,4,DHSVI,0
3zg5,B,174,178,4,VPKNV,0
3zg5,B,179,181,2,SKK,0
3zg5,B,182,191,9,DYKAIAKELS,0
3zg5,B,193,202,9,SEDYIKQQMD,0
3zg5,B,224,232,8,LSDFAKKFH,0
3zg5,B,245,248,3,LGKA,0
3zg5,B,249,254,5,TSHLLG,0
3zg5,B,266,270,4,QKEYK,0
3zg5,B,282,287,5,GLEKLY,0
3zg5,B,287,292,5,YDKKLQ,0
3zg5,B,329,341,12,DAKVQKSIYNNMK,0
3zg5,B,368,374,6,VYPFMYG,0
3zg5,B,376,385,9,SNEEYNKLTE,0
3zg5,B,401,403,2,PGS,0
3zg5,B,404,417,13,TQKILTAMIGLNNK,0
3zg5,B,455,461,6,LKQAIES,0
3zg5,B,463,473,10,DNIFFARVALE,0
3zg5,B,475,485,10,GSKKFEKGMKK,0
3zg5,B,505,509,4,NKNLD,0
3zg5,B,510,519,9,NEILLADSGY,0
3zg5,B,527,536,9,NPVQILSIYS,0
3zg5,B,537,540,3,ALEN,0
3zg5,B,564,581,17,SKENINLLTDGMQQVVNK,0
3zg5,B,642,658,16,ASYNAKISGKVYDELYE,0
3zg5,B,27,39,12,DKEINNTIDAIED,0
3zg5,B,42,48,6,FKQVYKD,0
3zg5,B,58,64,6,GEVEMTE,0
3zg5,B,64,73,9,ERPIKIYNSL,0
3zg5,B,182,190,8,DYKAIAKEL,0
3zg5,B,224,231,7,LSDFAKKF,0
3zg5,B,281,287,6,KGLEKLY,0
3zg5,B,404,416,12,TQKILTAMIGLNN,0
3zg5,B,435,439,4,DKSWG,0
3zg5,B,463,475,12,DNIFFARVALELG,0
3zg5,B,475,486,11,GSKKFEKGMKKL,0
3zg5,B,527,537,10,NPVQILSIYSA,0
3zg5,B,538,540,2,LEN,0
3zg5,B,564,582,18,SKENINLLTDGMQQVVNKT,0
3zg5,B,583,588,5,HKEDIY,0
3zg5,B,642,657,15,ASYNAKISGKVYDELY,0
3zg5,B,658,661,3,ENGN,0
1tgy,B,12,17,5,TKNDLQ,0
1tgy,B,29,36,7,DRVEKIAA,0
1tgy,B,70,84,14,GGPSTSIAVEELAQL,0
1tgy,B,118,123,5,GASLHF,0
1tgy,B,133,147,14,DFECTTALVEAAKSI,0
1tgy,B,163,167,4,YPGQE,0
1tgy,B,177,181,4,VRHFK,0
1tgy,B,182,190,8,GSMEEWQAM,0
1tgy,B,198,208,10,ESATLLTMCAS,0
1tgy,B,230,253,23,NAETMKQTESHAVKIVVEAARRLL,0
1tgy,B,230,251,21,NAETMKQTESHAVKIVVEAARR,0
1j6u,A,10,23,13,GIGSAVALHEFSN,0
1j6u,A,35,44,9,TERTAYLRKL,0
1j6u,A,73,82,9,NPEIVRARE,0
1j6u,A,89,101,12,RLHYFRDTLKREK,0
1j6u,A,112,127,15,GKTTTTAVAHVLKHL,0
1j6u,A,162,168,6,EEFFSEF,0
1j6u,A,182,187,5,HLENYG,0
1j6u,A,189,203,14,SLTRYRSAFEKISRN,0
1j6u,A,216,220,4,TSHLG,0
1j6u,A,263,280,17,GFHNVLNALAVIALFDSL,0
1j6u,A,283,294,11,DLAPVLEALEEF,0
1j6u,A,321,336,15,TPDEIRNLLQTAKEVF,0
1j6u,A,358,365,7,GNFAKALQ,0
1j6u,A,387,398,11,SGKIWDSLKSL,0
1j6u,A,407,409,2,KLP,0
1j6u,A,410,415,5,ELEKVI,0
1j6u,A,430,446,16,DIIYSSRRFVERYQSSK,0
1n8s,C,30,35,5,SPKDVN,0
1n8s,C,55,60,5,DSSSIS,0
1n8s,C,81,83,2,GEE,0
1n8s,C,84,97,13,NWLANVCKNLFKVE,0
1n8s,C,106,111,5,WKGGSR,0
1n8s,C,113,140,27,GYTQASQNIRIVGAEVAYFVEFLQSAFG,0
1n8s,C,142,144,2,SPS,0
1n8s,C,152,165,13,SLGAHAAGEAGRRT,0
1n8s,C,192,196,4,DPSDA,0
1n8s,C,247,253,6,DIDGIWE,0
1n8s,C,260,275,15,ACNHLRSYKYYTDSIV,0
1n8s,C,287,293,6,SYNVFTA,0
1n8s,C,310,314,4,YADRY,0
1n8s,C,519,523,4,NSAQC,0
1yp3,D,16,20,4,DASRS,0
1yp3,D,42,45,3,AKPA,0
1yp3,D,55,65,10,IDIPVSNCLNS,0
1yp3,D,78,89,11,SASLNRHLSRAY,0
1yp3,D,119,133,14,GTADAVRQYLWLFEE,0
1yp3,D,151,162,11,DYEKFIQAHRET,0
1yp3,D,174,179,5,DEKRAT,0
1yp3,D,200,206,6,QGEQLQA,0
1yp3,D,210,215,5,DTTILG,0
1yp3,D,218,223,5,DKRAKE,0
1yp3,D,237,246,9,KDVMLNLLRD,0
1yp3,D,257,264,7,EVIPGATS,0
1yp3,D,283,293,10,TIEAFYNANLG,0
1yp3,D,294,296,2,ITK,0
1yp3,D,374,384,10,TDADRKLLAAK,0
1yp3,D,31,35,4,GTRLY,0
1yp3,D,119,127,8,GTADAVRQY,0
1yp3,D,127,132,5,YLWLFE,0
1yp3,D,151,161,10,DYEKFIQAHRE,0
1yp3,D,204,208,4,LQAMK,0
1yp3,D,217,224,7,DDKRAKEM,0
1yp3,D,257,265,8,EVIPGATSL,0
1yp3,D,374,385,11,TDADRKLLAAKG,0
1yp3,D,425,428,3,RETD,0
1yp3,D,78,90,12,SASLNRHLSRAYA,0
1yp3,D,119,132,13,GTADAVRQYLWLFE,0
1yp3,D,426,428,2,ETD,0
1yp3,D,55,64,9,IDIPVSNCLN,0
1yp3,D,120,127,7,TADAVRQY,0
1yp3,D,127,134,7,YLWLFEEH,0
1yp3,D,217,222,5,DDKRAK,0
1yp3,D,283,294,11,TIEAFYNANLGI,0
1yp3,D,374,383,9,TDADRKLLAA,0
2zx5,B,11,16,5,DWESLR,0
2zx5,B,21,28,7,PKWFDKAK,0
2zx5,B,36,40,4,GIYSV,0
2zx5,B,64,66,2,YAE,0
2zx5,B,67,73,6,WYENSLR,0
2zx5,B,77,87,10,SPTWEYHVKTY,0
2zx5,B,92,94,2,EYE,0
2zx5,B,95,100,5,KFADLF,0
2zx5,B,106,117,11,DPQEWADLFKKA,0
2zx5,B,152,164,12,DLVGDLAKAVREA,0
2zx5,B,177,181,4,DWRFT,0
2zx5,B,187,193,6,YPEDLSY,0
2zx5,B,198,217,19,TYEYADYAYKQVMELVDLYL,0
2zx5,B,228,232,4,PEKGK,0
2zx5,B,233,246,13,EDLKYLFAYYYNKH,0
2zx5,B,297,301,4,GPEHM,0
2zx5,B,303,316,13,SVEQLVYTLVDVVS,0
2zx5,B,334,352,18,PDLQKERLLGLGEWLRKYG,0
2zx5,B,353,355,2,DAI,0
2zx5,B,431,436,5,PKKLLE,0
2zx5,B,57,61,4,AWFFQ,0
2zx5,B,303,317,14,SVEQLVYTLVDVVSK,0
2zx5,B,431,438,7,PKKLLETD,0
1wdd,W,20,25,5,YKLTYY,0
1wdd,W,49,61,12,PPEEAGAAVAAES,0
1wdd,W,69,75,6,VWTDGLT,0
1wdd,W,76,81,5,SLDRYK,0
1wdd,W,104,108,4,PLDLF,0
1wdd,W,112,122,10,SVTNMFTSIVG,0
1wdd,W,123,127,4,NVFGF,0
1wdd,W,141,146,5,PPTYSK,0
1wdd,W,154,163,9,GIQVERDKLN,0
1wdd,W,181,195,14,SAKNYGRACYECLRG,0
1wdd,W,213,233,20,RWRDRFVFCAEAIYKSQAETG,0
1wdd,W,246,261,15,TCEEMIKRAVFARELG,0
1wdd,W,269,273,4,YLTGG,0
1wdd,W,273,288,15,GFTANTSLAHYCRDNG,0
1wdd,W,297,303,6,MHAVIDR,0
1wdd,W,310,322,12,HFRVLAKALRMSG,0
1wdd,W,338,351,13,EREMTLGFVDLLRD,0
1wdd,W,357,361,4,DRARG,0
1wdd,W,383,385,2,HVW,0
1wdd,W,386,395,9,HMPALTEIFG,0
1wdd,W,403,408,5,GGGTLG,0
1wdd,W,412,433,21,GNAPGAAANRVALEACVQARNE,0
1wdd,W,436,450,14,DLAREGNEIIRSACK,0
1wdd,W,452,463,11,SPELAAACEIWK,0
1wdd,W,22,36,14,TVEDLLKQIEYLLRS,0
1wdd,W,78,93,15,DATQVLKELEEAKKAY,0
1wdd,W,273,287,14,GFTANTSLAHYCRDN,0
1wdd,W,412,434,22,GNAPGAAANRVALEACVQARNEG,0
1o5t,A,102,107,5,KLIVRF,0
1o5t,A,113,125,12,DKELINRIERATG,0
1o5t,A,129,134,5,HHFLRR,0
1o5t,A,142,152,10,DMNQVLDAYEN,0
1o5t,A,170,188,18,HVGHLIPFIFTKWLQDVFN,0
1o5t,A,196,204,8,TDDEKYLWK,0
1o5t,A,207,225,18,TLDQAYSYAVENAKDIIAC,0
1o5t,A,228,230,2,DIN,0
1o5t,A,237,241,4,DLDYM,0
1o5t,A,242,244,2,GMS,0
1o5t,A,246,257,11,GFYKNVVKIQKH,0
1o5t,A,259,268,9,TFNQVKGIFG,0
1o5t,A,274,280,6,CIGKISF,0
1o5t,A,280,286,6,FPAIQAA,0
1o5t,A,287,292,5,PSFSNS,0
1o5t,A,293,298,5,FPQIFR,0
1o5t,A,313,327,14,QDPYFRMTRDVAPRI,0
1o5t,A,364,376,12,TAKQIKTKVNKHA,0
1o5t,A,383,390,7,TIEEHRQF,0
1o5t,A,393,396,3,NCDV,0
1o5t,A,397,407,10,DVSFMYLTFFL,0
1o5t,A,409,423,14,DDDKLEQIRKDYTSG,0
1o5t,A,426,450,24,LTGELKKALIEVLQPLIAEHQARRK,0
1o5t,A,453,461,8,TDEIVKEFM,0
3gb1,A,22,37,15,DAATAEKVFKQYANDN,0
4nle,B,7,13,6,NVLANRY,0
4nle,B,15,23,8,SDEMVAIWS,0
4nle,B,23,45,22,SPEAKIIAERRLWLAVLRAQAEL,0
4nle,B,52,61,9,GVVEDYERVL,0
4nle,B,65,75,10,DLESIAARERV,0
4nle,B,78,84,6,HDVKARI,0
4nle,B,85,88,3,EEFN,0
4nle,B,101,139,38,TSRDLTENVEQLQIRQSLELVFSHGVAVVARLAERAVVY,0
4nle,B,158,183,25,LGKRFASAAEETLVALTRLRELIDRY,0
4nle,B,195,202,7,AQDMLDLF,0
4nle,B,205,221,16,DVGKLADLERRVAEFLG,0
4nle,B,235,265,30,RSLDHDVLSALVQFGAGPSSMAHTIRLMAGH,0
4nle,B,288,312,24,TRSCERVNGLQVVLRGYASMAAELA,0
4nle,B,321,352,31,VFCSVVRRVALPDAFFAIDGQTETFLTVLDEF,0
4nle,B,355,371,16,YPAVIQRELDRYLPFLA,0
4nle,B,371,382,11,ATTRILMAAVRA,0
4nle,B,385,407,22,GREAAHEVIKEHAVAVALAMREQ,0
4nle,B,412,420,8,DLIDRLAGD,0
4nle,B,426,436,10,DKVALEAALED,0
4nle,B,437,441,4,KQAFT,0
4nle,B,443,462,19,AAGDQVDGVVAAVGELVSRY,0
4nle,B,464,468,4,EAAKY,0
4nle,B,65,76,11,DLESIAARERVT,0
4nle,B,78,83,5,HDVKAR,0
4nle,B,84,89,5,IEEFNA,0
4nle,B,323,352,29,CSVVRRVALPDAFFAIDGQTETFLTVLDEF,0
4nle,B,371,383,12,ATTRILMAAVRAG,0
4nle,B,426,434,8,DKVALEAAL,0
4nle,B,436,441,5,DKQAFT,0
4nle,B,462,467,5,YPEAAK,0
4etz,B,158,174,16,QSLRSSLLGLRQLLREL,0
4etz,B,179,184,5,APLDAL,0
4etz,B,184,197,13,LAETVLALLAQYGS,0
4etz,B,230,240,10,DLLVRTCLERG,0
4etz,B,284,288,4,PFFVF,0
4etz,B,289,309,20,NERTFSLLAILAGHIADLLQS,0
4etz,B,318,339,21,DIDAQRFSQYLKRSLLDARDHG,0
4etz,B,354,365,11,YGEEVQRLLEGS,0
4etz,B,392,411,19,SAEGSQGYLQRLRILFAERF,0
4etz,B,416,420,4,ELESL,0
4etz,B,436,443,7,QALGHFLF,0
4etz,B,159,173,14,SLRSSLLGLRQLLRE,0
4etz,B,179,197,18,APLDALAETVLALLAQYGS,0
4etz,B,289,308,19,NERTFSLLAILAGHIADLLQ,0
3zqy,A,4,25,21,KPEDAVKYRQSAATLMASHFGR,0
3zqy,A,26,31,5,MTPVVK,0
3zqy,A,37,53,16,DAAQIKANVEVLKTLSA,0
3zqy,A,54,59,5,LPWAAF,0
3zqy,A,70,75,5,PEIWSD,0
3zqy,A,75,100,25,DAASFKQKQQAFQDNIVKLSAAADAG,0
3zqy,A,101,124,23,DLDKLRAAFGDVGASCKACHDAYR,0
2gbi,B,42,48,6,TLADYLK,0
2gbi,B,89,94,5,ENSTFE,0
2gbi,B,198,205,7,DWVYEEEI,0
2gbi,B,216,218,2,PNG,0
2gbi,B,273,277,4,SLSST,0
2gbi,B,338,342,4,PTTQE,0
2gbi,B,422,426,4,EYKEM,0
2gbi,B,498,506,8,NSALDKMLQ,0
2gbi,B,563,571,8,NWATYLAST,0
2gbi,B,588,593,5,GDKIMH,0
2gbi,B,594,596,2,AIN,0
2gbi,B,601,617,16,TLEVEDQIEAARQFLKM,0
2gbi,B,631,642,11,SYGGYVTSMVLG,0
2gbi,B,659,663,4,RWEYY,0
2gbi,B,664,673,9,DSVYTERYMG,0
2gbi,B,680,686,6,NLDHYRN,0
2gbi,B,687,688,1,ST,0
2gbi,B,689,699,10,VMSRAENFKQV,0
2gbi,B,714,728,14,FQQSAQISKALVDAG,0
2gbi,B,745,764,19,SSTAHQHIYSHMSHFLQQCF,0
5jq4,B,7,22,15,NQKLEDCFYIRKKVF,0
5jq4,B,29,34,5,PEESEI,0
5jq4,B,75,78,3,KSHR,0
5jq4,B,79,97,18,GQGGRLQAVESLAKDE,0
5jq4,B,110,117,7,AIPFYESL,0
5jq4,B,29,33,4,PEESE,0
1tv8,B,45,49,4,PKNEL,0
1tv8,B,51,65,14,TFDEMARIAKVYAEL,0
1tv8,B,76,80,4,EPLMR,0
1tv8,B,82,91,9,DLDVLIAKLN,0
1tv8,B,107,119,12,LLKKHGQKLYDAG,0
1tv8,B,131,140,9,DDTLFQSINN,0
1tv8,B,144,158,14,KATTILEQIDYATSI,0
1tv8,B,173,175,2,NDD,0
1tv8,B,176,187,11,QIIPMLEYFKDK,0
1tv8,B,212,224,12,TKDEMLTMIEQHF,0
1tv8,B,260,264,4,FCSTC,0
1tv8,B,287,294,7,NVKAFIRS,0
1tv8,B,297,311,14,TDEELKEQFKALWQI,0
1tv8,B,315,328,13,RYSDERTAQTVANR,0
1tv8,B,51,64,13,TFDEMARIAKVYAE,0
1tv8,B,107,118,11,LLKKHGQKLYDA,0
1tv8,B,212,222,10,TKDEMLTMIEQ,0
1tv8,B,288,294,6,VKAFIRS,0
2r9w,B,5,24,19,PQQINDIVHRTITPLIEQQK,0
2r9w,B,65,80,15,VSKTFTGVLGGDAIAR,0
2r9w,B,88,93,5,PTTKYW,0
2r9w,B,98,102,4,AKQWN,0
2r9w,B,105,111,6,TLLHLAT,0
2r9w,B,127,138,11,SSSDLLRFYQNW,0
2r9w,B,151,163,12,ANSSIGLFGALAV,0
2r9w,B,169,178,9,SFEQAMQTRV,0
2r9w,B,192,199,7,PPAEEKNY,0
2r9w,B,216,222,6,LDAEAYG,0
2r9w,B,226,239,13,TIEDMARWVQSNLK,0
2r9w,B,240,243,3,PLDI,0
2r9w,B,245,256,11,EKTLQQGIQLAQ,0
2r9w,B,279,288,9,NPDSIINGSD,0
2r9w,B,288,293,5,DNKIAL,0
2r9w,B,330,333,3,PEKE,0
2r9w,B,345,361,16,PNPARVDAAWQILNALQ,0
4uvw,B,962,975,13,DKEFQSVEEEMQST,0
4uvw,B,1002,1019,17,NKKLWERYTHRRKEVSEE,0
4uvw,B,1035,1043,8,FVNAIIHKG,0
4uvw,B,1045,1049,4,DERHA,0
4uvw,B,1064,1070,6,NSSKSNQ,0
4uvw,B,1074,1078,4,GIGGG,0
4uvw,B,1143,1145,2,RGE,0
4uvw,B,1002,1020,18,NKKLWERYTHRRKEVSEEN,0
4njj,B,40,44,4,DRAQA,0
4njj,B,66,76,10,DADALVATIAG,0
4njj,B,93,97,4,EPMLQ,0
4njj,B,99,109,10,DQPLVDALHAA,0
4njj,B,158,163,5,RLADYA,0
4njj,B,179,194,15,SRDLNTKLAIDWCKRH,0
4njj,B,203,208,5,THKYLN,0
4njj,B,37,42,5,REEDRA,0
4njj,B,202,208,6,QTHKYLN,0
2ops,A,27,44,17,TEEKIKALVEICTEMEKE,0
2ops,A,77,84,7,FRELNKRT,0
2ops,A,96,100,4,HPAGL,0
2ops,A,112,118,6,GDAYFSV,0
2ops,A,121,129,8,DEDFRKYTA,0
2ops,A,155,175,20,GSPAIFQSSMTKILEPFRKQN,0
2ops,A,194,211,17,EIGQHRTKIEELRQHLLR,0
2ops,A,253,268,15,TVNDIQKLVGKLNWAS,0
2ops,A,276,282,6,VRQLKL,0
2ops,A,296,310,14,TEEAELELAENREIL,0
2ops,A,363,384,21,NDVKQLTEAVQKITTESIVIWG,0
2ops,A,394,405,11,QKETWETWWTEY,0
2ops,A,473,489,16,TNQKTELQAIYLALQDS,0
2ops,A,499,509,10,SQYALGIIQAQ,0
2ops,A,515,528,13,SELVNQIIEQLIKK,0
3m3a,A,3,19,16,SEGEWQLVLHVWAKVEA,0
3m3a,A,20,36,16,DVAGHGQDIHIRLFKSH,0
3m3a,A,37,43,6,PETLEKH,0
3m3a,A,51,58,7,TEAEMKAS,0
3m3a,A,58,78,20,SEDLKKHGVTELTALGAILKK,0
3m3a,A,82,96,14,HEAELKPLAQSHATK,0
3m3a,A,100,119,19,PIKYLEFESEAIIHVLHSRH,0
3m3a,A,120,123,3,PGDF,0
3m3a,A,124,150,26,GADAQGAMNKALELFRKDIAAKYKELG,0
4e4g,H,37,57,20,SDADLAAAVESAKAAQPKWAA,0
4e4g,H,59,90,31,NPQRRARVFKFVQLLNDNNELAELSREHG,0
4e4g,H,92,112,20,TIDDAKGDIVRGLEVCEFVIG,0
4e4g,H,112,117,5,GIPHLQ,0
4e4g,H,151,164,13,GIPWFAPAIAC,0
4e4g,H,177,190,13,PSVPIRLAELIEA,0
4e4g,H,203,212,9,DKGAVDAILT,0
4e4g,H,224,238,14,STPIARYVYGTAAN,0
4e4g,H,259,273,14,DLDQAANALIGAGYG,0
4e4g,H,274,277,3,SAGE,0
4e4g,H,289,306,17,GEETANRLIDKLVPVES,0
4e4g,H,324,342,18,TKEAEQRIRSLIDSGIEQG,0
4e4g,H,375,380,5,DIYKT,0
4e4g,H,394,405,11,NYEEALSLPKH,0
4e4g,H,417,428,11,DGDAARDFASRI,0
4e4g,H,462,470,8,HGTDSIKFW,0
4e4g,H,37,58,21,SDADLAAAVESAKAAQPKWAAT,0
4e4g,H,59,77,18,NPQRRARVFKFVQLLNDN,0
4e4g,H,77,90,13,NNELAELSREHG,0
4e4g,H,92,111,19,TIDDAKGDIVRGLEVCEFVI,0
4e4g,H,289,299,10,GEETANRLIDK,0
4e4g,H,300,306,6,LVPVES,0
4e4g,H,324,341,17,TKEAEQRIRSLIDSGIEQ,0
4e4g,H,394,404,10,NYEEALSLPK,0
4e4g,H,203,213,10,DKGAVDAILTH,0
4e4g,H,92,110,18,TIDDAKGDIVRGLEVCEFV,0
4e4g,H,451,453,2,WKS,0
4e4g,H,37,56,19,SDADLAAAVESAKAAQPKWA,0
4e4g,H,59,87,28,NPQRRARVFKFVQLLNDNNELAELSR,0
4e4g,H,259,269,10,DLDQAANALIG,0
4e4g,H,272,277,5,YGSAGE,0
4e4g,H,418,428,10,GDAARDFASRI,0
4e4g,H,59,76,17,NPQRRARVFKFVQLLND,0
4e4g,H,324,340,16,TKEAEQRIRSLIDSGIE,0
4e4g,H,177,191,14,PSVPIRLAELIEAG,0
4e4g,H,224,237,13,STPIARYVYGTAA,0
4rpp,D,25,32,7,TFLEHMCR,0
4rpp,D,57,68,11,SVETLKEMIKSG,0
4rpp,D,80,96,16,THEYHAETIKNVRTATE,0
4rpp,D,97,99,2,SFA,0
4rpp,D,222,235,13,SEKDIQDLKFGVEQ,0
4rpp,D,247,259,12,KASDVHEVRKVLG,0
4rpp,D,260,263,3,EKGK,0
4rpp,D,273,279,6,NHEGVRR,0
4rpp,D,279,287,8,RFDEILEAS,0
4rpp,D,294,301,7,RGDLGIEI,0
4rpp,D,302,321,19,PAEKVFLAQKMMIGRCNRAG,0
4rpp,D,331,336,5,LESMIK,0
4rpp,D,341,355,14,TRAEGSDVANAVLDG,0
4rpp,D,362,367,5,SGETAK,0
4rpp,D,370,388,18,YPLEAVRMQHLIAREAEAA,0
4rpp,D,390,402,12,YHLQLFEELRRLA,0
4rpp,D,407,424,17,DPTEATAVGAVEASFRCC,0
4rpp,D,435,444,9,GRSAHQVARY,0
4rpp,D,456,463,7,NPQTARQA,0
4rpp,D,464,466,2,HLY,0
4rpp,D,481,500,19,AWAEDVDLRVNFAMNVGKAR,0
4rpp,D,222,236,14,SEKDIQDLKFGVEQD,0
4rpp,D,305,321,16,KVFLAQKMMIGRCNRAG,0
4rpp,D,407,423,16,DPTEATAVGAVEASFRC,0
4rpp,D,390,401,11,YHLQLFEELRRL,0
2jll,A,371,375,4,KLSDS,0
3qr9,B,26,36,10,SWPQILGRLTD,0
3qr9,B,43,54,11,GQAAWAMDQIMT,0
3qr9,B,58,73,15,RPAQIAAFAVAMTMKA,0
3qr9,B,75,90,15,TADEVGELAGVMLSHA,0
3qr9,B,117,129,12,NLSTMAAIVVAAA,0
3qr9,B,146,154,8,GGADTLEAL,0
3qr9,B,161,173,12,GPDLVARSLAEVG,0
3qr9,B,179,183,4,APRFH,0
3qr9,B,186,197,11,YRHAAAVRREIG,0
3qr9,B,200,209,9,TVFNLLGPLT,0
3qr9,B,223,237,14,FADLAEVMAGVFAAR,0
3qr9,B,275,280,5,DPAGFG,0
3qr9,B,285,290,5,QLDQLA,0
3qr9,B,293,306,13,DAQANAAAVRAVLG,0
3qr9,B,310,329,19,GPVRDAVVLNAAGAIVAHAG,0
3qr9,B,335,353,18,EWLPAWEEGLRRASAAIDT,0
3qr9,B,354,370,16,GAAEQLLARWVRFGRQI,0
3qr9,B,115,129,14,TVNLSTMAAIVVAAA,0
3qr9,B,223,236,13,FADLAEVMAGVFAA,0
3qr9,B,285,289,4,QLDQL,0
3qr9,B,310,332,22,GPVRDAVVLNAAGAIVAHAGLSS,0
3qr9,B,354,369,15,GAAEQLLARWVRFGRQ,0
4hxo,A,60,69,9,TNQLQYLLRV,0
4hxo,A,69,77,8,VVLKTLWKH,0
4hxo,A,80,84,4,AWPFQ,0
4hxo,A,96,101,5,DYYKII,0
4hxo,A,106,117,11,DMGTIKKRLENN,0
4hxo,A,121,140,19,NAQECIQDFNTMFTNCYIYN,0
4hxo,A,144,162,18,DDIVLMAEALEKLFLQKIN,0
5fgd,b,18,31,13,LGQIDYALTAVKQG,0
5fgd,b,78,96,18,MGPDYRVLVDKSRKVAHTS,0
5fgd,b,97,102,5,YKRIYG,0
5fgd,b,106,124,18,PTKLLVSEVAKIMQEATQS,0
5fgd,b,167,179,12,GSVAAKTFLEKRW,0
5fgd,b,184,200,16,ELEDAIHIALLTLKESV,0
5fgd,b,218,222,4,NPDLL,0
5fgd,b,239,249,10,TSQEINDRLEA,0
5fgd,b,1,6,5,GSRRYD,0
5fgd,b,18,29,11,LYQVEYALESIS,0
5fgd,b,79,102,23,LTADAEILINTARIHAQNYLKTYN,0
5fgd,b,106,124,18,PVEILVRRLSDIKQGYTQH,0
5fgd,b,167,179,12,NTSAAQTLLQMDY,0
5fgd,b,184,200,16,KVDDAIELALKTLSKTT,0
5fgd,b,206,208,2,TYD,0
5fgd,b,230,241,11,KPQEIKDILVKT,0
5fgd,b,15,28,13,IFQVEYALEAVKRG,0
5fgd,b,76,99,23,LNADSRILIEKARVEAQSHRLTLE,0
5fgd,b,103,118,15,TVEYLTRYVAGVQQRY,0
5fgd,b,165,177,12,NSKTVREFLEKNY,0
5fgd,b,185,199,14,TVEECVKLTVRSLLE,0
5fgd,b,223,239,16,SSEEINQYVTQIEQEKQ,0
5fgd,b,13,26,13,LFQVEYSLEAIKLG,0
5fgd,b,52,56,4,ESDSI,0
5fgd,b,76,96,20,DARSMIEHARTAAVTHNLYYD,0
5fgd,b,100,113,13,NVESLTQSVCDLAL,0
5fgd,b,167,179,12,GSEGAQAELLNEW,0
5fgd,b,184,200,16,TLKEAELLVLKILKQVM,0
5fgd,b,224,241,17,DNEKTAELIKELKEKEAA,0
5fgd,b,18,31,13,LFQVEYALEAIKQG,0
5fgd,b,76,99,23,LAPDARVLSNYLRQQCNYSSLVFN,0
5fgd,b,103,118,15,AVERAGHLLCDKAQKN,0
5fgd,b,163,179,16,RSQGAKTYLERTLDTFI,0
5fgd,b,184,197,13,NPDELIKAGVEAIS,0
5fgd,b,198,200,2,QSL,0
5fgd,b,225,233,8,DGEAVAKYI,0
5fgd,b,17,30,13,NFQVEYAVKAVENG,0
5fgd,b,77,100,23,LIPDGRHLVNRGREEAASFKKLYK,0
5fgd,b,104,119,15,PIPAFADRLGQYVQAH,0
5fgd,b,164,179,15,GRQSAKAELEKLVDHH,0
5fgd,b,184,200,16,SAREAVKQAAKIIYLAH,0
5fgd,b,201,203,2,EDN,0
5fgd,b,228,244,16,KGDLLQEAIDFAQKEIN,0
5fgd,b,2,6,4,GYDRH,0
5fgd,b,16,26,10,LYQVEYAFKAT,0
5fgd,b,27,30,3,NQTN,0
5fgd,b,56,60,4,DPTTV,0
5fgd,b,77,100,23,PIPDARNAALRAKAEAAEFRYKYG,0
5fgd,b,104,122,18,PCDVLAKRMANLSQIYTQR,0
5fgd,b,165,181,16,KQQEITTNLENHFKKSK,0
5fgd,b,189,206,17,SWEKVVEFAITHMIDALG,0
5fgd,b,228,241,13,SAENIEERLVAIAE,0
5fgd,b,48,71,23,TAADTEAVTQLIGSNIELHSLYTS,0
5fgd,b,75,90,15,RVVSALQMLKQHLFKY,0
5fgd,b,130,142,12,GSLAAMAVLESHW,0
5fgd,b,147,166,19,TKEEAIKLASDAIQAGIWND,0
5fgd,b,2,6,4,DPSSI,0
5fgd,b,55,78,23,LATDVTTLNEMFRYKTNLYKLKEE,0
5fgd,b,82,96,14,EPETFTQLVSSSLYE,0
5fgd,b,141,153,12,ASDQLFGMCESLY,0
5fgd,b,158,175,17,EPEDLFETISQALLNAAD,0
5fgd,b,51,72,21,GDTVQFAEYIQANIQLYSIRED,0
5fgd,b,76,92,16,SPQAVSSFVRQELAKSI,0
5fgd,b,135,148,13,YSGFYTFSLLDHHY,0
5fgd,b,153,172,19,TTEEGLDLLKLCVQELEKRM,0
5fgd,b,48,71,23,GAADCQFWETWLGSQCRLHELREK,0
5fgd,b,75,90,15,SVAAASKILSNLVYQY,0
5fgd,b,132,144,12,GQTFAYGVLDSNY,0
5fgd,b,149,168,19,SVEDALYLGKRSILAAAHRD,0
5fgd,b,193,205,12,VGELFWKVKEEEG,0
5fgd,b,57,79,22,FAADGDALVKRFKNSVKWYHFDH,0
5fgd,b,85,99,14,SINSAARNIQHLLYG,0
5fgd,b,142,154,12,AASLIMPFLDNQV,0
5fgd,b,176,195,19,SVEEVIKLVRDSFTSATERH,0
5fgd,b,57,76,19,ISDMQHIERLLKDLVTENAY,0
5fgd,b,88,106,18,EPSYIFEYLATVMYQRRSK,0
5fgd,b,145,156,11,GFGAHMANPLLR,0
5fgd,b,161,165,4,RESDI,0
5fgd,b,169,188,19,TVQVAEEAIVNAMRVLYYRD,0
5fgd,b,219,225,6,WDFAKDI,0
5fgd,b,48,71,23,SAADTQAIADIVQYHLELYTSQYG,0
5fgd,b,74,89,15,STETAASVFKELCYEN,0
5fgd,b,128,133,5,GSGSTF,0
5fgd,b,134,142,8,IYGYCDKNF,0
5fgd,b,147,166,19,SKEETVDFIKHSLSQAIKWD,0
5fgd,b,189,194,5,YPDEYE,0
1o7p,B,10,13,3,SESG,0
1o7p,B,19,22,3,LIHG,0
1o7p,B,23,34,11,DEELFQHELKTI,0
1o7p,B,46,48,2,SLI,0
1o7p,B,119,125,6,FEKDLYG,0
1o7p,B,129,133,4,NKKCL,0
1o7p,B,158,164,6,PLMDYLG,0
1o7p,B,165,175,10,DAAWYLEPMFK,0
1o7p,B,195,205,10,WKAPAENFVGD,0
1o7p,B,208,213,5,HVGWTH,0
1o7p,B,213,221,8,HASSLRSGE,0
1o7p,B,224,231,7,FSSLAGNA,0
1o7p,B,262,264,2,SAD,0
1o7p,B,265,285,20,LVPELMAFGGAKQERLNKEIG,0
1o7p,B,285,293,8,GDVRARIYR,0
1o7p,B,337,353,16,PEDLKRRLADSVQRTFG,0
1o7p,B,356,373,17,GFWESDDNDNMETASQNG,0
1o7p,B,374,379,5,KKYQSR,0
1o7p,B,410,425,15,ETSYRGFYRAYQAHVS,0
1o7p,B,428,436,8,NWAEFEHAS,0
1o7p,B,438,445,7,TWHTELTK,0
1o7p,B,512,524,12,SAHDAEEILRFFN,0
1o7p,B,527,547,20,DSALQQEATTLLTQEAHLLDI,0
1o7p,B,549,557,8,AYRAWLEHC,0
1o7p,B,591,604,13,NFQQLKVRVEHQLD,0
1o7p,B,607,611,4,NWGNS,0
1o7p,B,667,669,2,EGG,0
4dtn,A,64,79,15,NMRDASQWIKRMEDIG,0
4dtn,A,87,97,10,DFKLAYLSDTY,0
4dtn,A,104,108,4,DHTKI,0
4dtn,A,163,169,6,SIEIAAK,0
4dtn,A,170,174,4,LQEQG,0
4dtn,A,179,184,5,PSEIID,0
4dtn,A,193,208,15,NEKELLMEYLNFWQQK,0
4dtn,A,221,235,14,FAIPYVYNRIKNIFG,0
4dtn,A,235,240,5,GESTAK,0
4dtn,A,241,243,2,RLS,0
4dtn,A,272,281,9,DYIDLYKKFS,0
4dtn,A,289,299,10,SLDYISEFELN,0
4dtn,A,308,310,2,PIS,0
4dtn,A,311,339,28,KLRESNHQRYISYNIIAVYRVLQIDAKRQ,0
4dtn,A,339,352,13,QFINLSLDMGYYAK,0
4dtn,A,354,359,5,QIQSVF,0
4dtn,A,360,376,16,SPIKTWDAIIFNSLKEQ,0
4dtn,A,414,424,10,SLYPSIIRQVN,0
4dtn,A,426,428,2,SPE,0
4dtn,A,438,444,6,PLHDYIN,0
4dtn,A,469,503,34,GVVPTEITKVFNQRKEHKGYMLAAQRNGEIIKEAL,0
4dtn,A,523,531,8,SDEIKEKIK,0
4dtn,A,534,570,36,SAKSLNEMLFRAQRTEVAGMTAQINRKALINGLAGAL,0
4dtn,A,579,610,31,DLRNATAITTFGQMALQWIERKVNEYLNEVCG,0
4dtn,A,629,637,8,ADKIIDKVG,0
4dtn,A,638,641,3,ESKF,0
4dtn,A,643,658,15,DTNHWVDFLDKFARER,0
4dtn,A,658,674,16,RMEPAIDRGFREMCEYM,0
4dtn,A,730,734,4,LETQK,0
4dtn,A,738,755,17,PKAVQKALKECIRRMLQE,0
4dtn,A,756,771,15,GEESLQEYFKEFEKEF,0
4dtn,A,772,774,2,RQL,0
4dtn,A,775,780,5,NYISIA,0
4dtn,A,788,790,2,IAK,0
4dtn,A,802,815,13,PFHIRGILTYNRAI,0
4dtn,A,855,866,11,TDLIKDDVLHWM,0
4dtn,A,867,876,9,DYTVLLEKTF,0
4dtn,A,876,888,12,FIKPLEGFTSAAK,0
4dtn,A,896,901,5,SLFDMF,0
1p0k,B,24,26,2,GLD,0
1p0k,B,39,43,4,ALEQV,0
1p0k,B,67,86,19,GGKLTYEINKSLARAASQAG,0
1p0k,B,100,114,14,DPSERLSYEIVRKEN,0
1p0k,B,128,139,11,TAAQAKEAVEMI,0
1p0k,B,165,177,12,GALKRIEQICSRV,0
1p0k,B,191,202,11,SKASAGKLYEAG,0
1p0k,B,227,232,5,QISFFN,0
1p0k,B,237,249,12,STAASLAEIRSEF,0
1p0k,B,262,272,10,DALDVAKAIAL,0
1p0k,B,280,314,34,AGHFLKALTDSGEEGLLEEIQLILEELKLIMTVLG,0
1p0k,B,317,322,5,TIADLQ,0
1p0k,B,329,339,10,KGETHHWLTER,0
1p0k,B,343,349,6,TSSYSVR,0
1p0k,B,95,99,4,MSALK,0
1p0k,B,149,156,7,NVIQEIVM,0
1p0k,B,226,232,6,RQISFFN,0
4fiw,A,11,24,13,CVQCNATKKALDRA,0
4fiw,A,36,46,10,DEEAREYVLAL,0
4fiw,A,65,73,8,RPERIREMA,0
4jk1,Y,33,48,15,RGFGHTLGNALRRILL,0
4jk1,Y,77,87,10,DILEILLNLKG,0
4jk1,Y,212,229,17,DPEEAIRRAATILAEQLE,0
4jk1,Y,230,232,2,AFV,0
4jk1,Y,250,255,5,DPILLR,0
4jk1,Y,256,261,5,PVDDLE,0
4jk1,Y,263,273,10,TVRSANCLKAE,0
4jk1,Y,277,282,5,YIGDLV,0
4jk1,Y,285,291,6,TEVELLK,0
4jk1,Y,296,309,13,GKKSLTEIKDVLAS,0
4jk1,Y,34,48,14,GFGHTLGNALRRILL,0
4jk1,Y,111,115,4,TAADI,0
4jk1,Y,212,227,15,DPEEAIRRAATILAEQ,0
4jk1,Y,228,232,4,LEAFV,0
4jk1,Y,28,38,10,LSIQLDSFQKF,0
4jk1,Y,45,50,5,GQYGLE,0
4jk1,Y,81,86,5,DVQECQ,0
4jk1,Y,207,213,6,TIILRAL,0
4jk1,Y,216,222,6,TTEQILD,0
4jk1,Y,242,247,5,VPERLR,0
4jk1,Y,270,280,10,TARHIRQLEKD,0
4jk1,Y,291,295,4,YIAGK,0
4jk1,Y,321,329,8,LLAKLSQSG,0
4jk1,Y,345,353,8,PYISETLRV,0
4jk1,Y,358,371,13,DRLSALVEIYRMMR,0
4jk1,Y,378,390,12,REAAESLFENLFF,0
4jk1,Y,400,409,9,VGRMKFNRSL,0
4jk1,Y,423,438,15,DDIIDVMKKLIDIRNG,0
4jk1,Y,456,482,26,VGEMAENQFRVGLVRVERAVKERLSLG,0
4jk1,Y,495,507,12,AKPISAAVKEFFG,0
4jk1,Y,519,528,9,NPLSEITHKR,0
4jk1,Y,565,569,4,EGPNI,0
4jk1,Y,607,614,7,SAIEEGNY,0
4jk1,Y,662,667,5,SVGASL,0
4jk1,Y,670,674,4,FLEHD,0
4jk1,Y,675,686,11,DANRALMGANMQ,0
4jk1,Y,704,712,8,MERAVAVDS,0
4jk1,Y,819,825,6,SERVVQE,0
4jk1,Y,859,865,6,EAALSKL,0
4jk1,Y,896,907,11,TPEEKLLRAIFG,0
4jk1,Y,942,980,38,DKRALEIEEMQLKQAKKDLSEELQILEAGLFSRIRAVLV,0
4jk1,Y,985,989,4,EAEKL,0
4jk1,Y,994,999,5,RDRWLE,0
4jk1,Y,1008,1037,29,QNQLEQLAEQYDELKHEFEKKLEAKRRKIT,0
4jk1,Y,1081,1085,4,PIEDM,0
4jk1,Y,1101,1106,5,LGVPSR,0
4jk1,Y,1109,1133,24,IGQILETHLGMAAKGIGDKINAMLK,0
4jk1,Y,1141,1151,10,LREFIQRAYDL,0
4jk1,Y,1167,1175,8,EEVMRLAEN,0
4jk1,Y,1193,1200,7,AEIKELLK,0
4jk1,Y,1271,1282,11,GEMEVWALEAYG,0
4jk1,Y,1283,1292,9,AAYTLQEMLT,0
4jk1,Y,1297,1310,13,DVNGRTKMYKNIVD,0
4jk1,Y,1320,1332,12,PESFNVLLKEIRS,0
4jk1,Y,26,34,8,SPDMIRSWS,0
4jk1,Y,77,81,4,RLKHR,0
4jk1,Y,95,100,5,TKVRRE,0
4jk1,Y,113,118,5,HIWFLK,0
4jk1,Y,122,127,5,SRIGLL,0
4jk1,Y,134,139,5,DIERVL,0
4jk1,Y,161,172,11,TEEQYLDALEEF,0
4jk1,Y,181,192,11,GAEAIQALLKSM,0
4jk1,Y,193,205,12,DLEQECEQLREEL,0
4jk1,Y,213,231,18,KRKKLTKRIKLLEAFVQSG,0
4jk1,Y,233,236,3,KPEW,0
4jk1,Y,246,250,4,PPDLR,0
4jk1,Y,263,283,20,SDLNDLYRRVINRNNRLKRLL,0
4jk1,Y,288,308,20,PDIIVRNEKRMLQEAVDALLD,0
4jk1,Y,327,331,4,LADMI,0
4jk1,Y,370,377,7,KKMALELF,0
4jk1,Y,377,389,12,FKPFIYGKLELRG,0
4jk1,Y,393,403,10,TIKAAKKMVER,0
4jk1,Y,406,416,10,AVVWDILDEVI,0
4jk1,Y,430,432,2,HRL,0
4jk1,Y,473,483,10,TLEAQLEARAL,0
4jk1,Y,485,489,4,MSTNN,0
4jk1,Y,503,513,10,SQDVVLGLYYM,0
4jk1,Y,530,538,8,PKEAERLYR,0
4jk1,Y,574,580,6,VGRAILW,0
4jk1,Y,590,595,5,SIVNQA,0
4jk1,Y,599,612,13,KAISKMLNTCYRIL,0
4jk1,Y,614,636,22,LKPTVIFADQIMYTGFAYAARSG,0
4jk1,Y,640,644,4,GIDDM,0
4jk1,Y,649,670,21,KKHEIISEAEAEVAEIQEQFQS,0
4jk1,Y,677,703,26,ERYNKVIDIWAAANDRVSKAMMDNLQT,0
4jk1,Y,721,727,6,SIYMMAD,0
4jk1,Y,733,741,8,SAAQIRQLA,0
4jk1,Y,768,805,37,NVLQYFISTHGARKGLADTALKTANSGYLTRRLVDVAQ,0
4jk1,Y,868,872,4,WCDLL,0
4jk1,Y,895,900,5,CAHCYG,0
4jk1,Y,914,925,11,AIGVIAAQSIGE,0
4jk1,Y,926,930,4,PGTQL,0
4jk1,Y,1137,1147,10,GLPRVADLFEA,0
4jk1,Y,1216,1223,7,APHDILRL,0
4jk1,Y,1225,1238,13,GVHAVTRYIVNEVQ,0
4jk1,Y,1238,1245,7,QDVYRLQG,0
4jk1,Y,1249,1261,12,NDKHIEVIVRQML,0
4jk1,Y,1279,1288,9,QVEYSRVKIA,0
4jk1,Y,1295,1299,4,NGKVG,0
4jk1,Y,1308,1315,7,GITKASLA,0
4jk1,Y,1318,1326,8,SFISAASFQ,0
4jk1,Y,1327,1338,11,ETTRVLTEAAVA,0
4jk1,Y,1348,1353,5,KENVIV,0
4jk1,Y,1363,1373,10,YAYHQDRMRRR,0
4jk1,Y,9,13,4,AVEKI,0
4jk1,Y,15,32,17,NRFDLVLVAARRARQMQV,0
4jk1,Y,45,57,12,KTTVIALREIEEG,0
4jk1,Y,60,76,16,NNQILDVRERQEQQEQE,0
4jk1,Y,79,88,9,ELQAVTAIAE,0
4jk1,Y,7,16,9,SQLKLLVTRG,0
4jk1,Y,26,30,4,EVNDH,0
4jk1,Y,39,44,5,DQIEDI,0
4jk1,Y,54,64,10,QVMEEAPDADD,0
4jk1,Y,96,106,10,DPVRMYMREMG,0
4jk1,Y,112,137,25,TREGEIDIAKRIEDGINQVQCSVAEY,0
4jk1,Y,137,153,16,YPEAITYLLEQYDRVEA,0
4jk1,Y,213,237,24,DPELAREKFAELRAQYVVTRDTIKA,0
4jk1,Y,244,257,13,TAQEEILKLSEVFK,0
4jk1,Y,262,293,31,VPKQFDYLVNSMRVMMDRVRTQERLIMKLCVE,0
4jk1,Y,298,307,9,PKKNFITLFT,0
4jk1,Y,315,321,6,WFNAAIA,0
4jk1,Y,327,332,5,SEKLHD,0
4jk1,Y,333,352,19,VSEEVHRALQKLQQIEEETG,0
4jk1,Y,357,383,26,QVKDINRRMSIGEAKARRAKKEMVEAN,0
4jk1,Y,383,392,9,NLRLVISIAK,0
4jk1,Y,400,418,18,QFLDLIQEGNIGLMKAVDK,0
4jk1,Y,426,444,18,KFSTYATWWIRQAITRSIA,0
4jk1,Y,453,471,18,PVHMIETINKLNRISRQML,0
4jk1,Y,479,486,7,TPEELAER,0
4jk1,Y,491,498,7,EDKIRKVL,0
4jk1,Y,518,522,4,HLGDF,0
4jk1,Y,530,548,18,LPLDSATTESLRAATHDVL,0
4jk1,Y,549,551,2,AGL,0
4jk1,Y,552,563,11,TAREAKVLRMRF,0
4jk1,Y,572,578,6,TLEEVGK,0
4jk1,Y,584,598,14,RERIRQIEAKALRKL,0
4jk1,Y,602,609,7,SRSEVLRS,0
4jk1,Y,32,48,16,ERGFGHTLGNALRRILL,0
4jk1,Y,212,230,18,DPEEAIRRAATILAEQLEA,0
4jk1,Y,113,115,2,ADI,0
4jk1,Y,270,281,11,TARHIRQLEKDD,0
4jk1,Y,320,329,9,DLLAKLSQSG,0
4jk1,Y,551,555,4,HPTHY,0
4jk1,Y,675,689,14,DANRALMGANMQRQA,0
4jk1,Y,613,636,23,GLKPTVIFADQIMYTGFAYAARSG,0
4jk1,Y,867,872,5,QWCDLL,0
4jk1,Y,1216,1224,8,APHDILRLR,0
4jk1,Y,1238,1243,5,QDVYRL,0
4jk1,Y,60,77,17,NNQILDVRERQEQQEQEA,0
4jk1,Y,329,332,3,KLHD,0
4jk1,Y,354,383,29,TIEQVKDINRRMSIGEAKARRAKKEMVEAN,0
4jk1,Y,518,523,5,HLGDFI,0
1huo,B,12,29,17,NGGITDMLVELANFEKNV,0
1huo,B,33,49,16,IHKYNAYRKAASVIAKY,0
1huo,B,55,61,6,SGAEAKK,0
1huo,B,66,79,13,GTKIAEKIDEFLAT,0
1huo,B,82,91,9,LRKLEKIRQD,0
1huo,B,91,102,11,DDTSSSINFLTR,0
1huo,B,107,117,10,GPSAARKLVDE,0
1huo,B,121,126,5,TLEDLR,0
1huo,B,133,142,9,NHHQRIGLKY,0
1huo,B,152,170,18,REEMLQMQDIVLNEVKKLD,0
1huo,B,178,183,5,CGSFRR,0
1huo,B,208,221,13,PKLLHRVVEQLQKV,0
1huo,B,261,263,2,PKD,0
1huo,B,264,274,10,QYYCGVLYFTG,0
1huo,B,275,289,14,SDIFNKNMRAHALEK,0
1huo,B,315,323,8,SEQDIFDYI,0
1huo,B,32,49,17,AIHKYNAYRKAASVIAKY,0
1huo,B,91,101,10,DDTSSSINFLT,0
1huo,B,127,132,5,KNEDKL,0
1huo,B,133,143,10,NHHQRIGLKYF,0
1huo,B,142,148,6,YFEDFEK,0
1huo,B,179,184,5,GSFRRG,0
1huo,B,207,221,14,QPKLLHRVVEQLQKV,0
1huo,B,275,290,15,SDIFNKNMRAHALEKG,0
2rim,A,2,11,9,SLNDFLSSVL,0
2rim,A,99,113,14,SVRDITKIILEFILS,0
2rim,A,116,121,5,PNYYLQ,0
2rim,A,134,138,4,SPELI,0
2rim,A,203,207,4,DSSKN,0
2rim,A,214,234,20,NGEELKWWGFILDRLLIECF,0
2rim,A,248,257,9,DPARVRSYLR,0
2rim,A,272,276,4,SKENS,0
2rim,A,277,281,4,LAVYN,0
2rim,A,288,299,11,DPKARFIHQLAE,0
2rim,A,307,324,17,SLSSFWIELQERQEFKLS,0
2rim,A,354,367,13,SRKQFRAIKKYITG,0
2rim,A,372,392,20,TEEGAIEAFTNIRDFLLLRA,0
5a0w,G,7,21,14,VSGISAYLLGLIIGD,0
5a0w,G,44,51,7,SENLIKQH,0
5a0w,G,51,63,12,HIAPLMQFLIDEL,0
5a0w,G,84,97,13,SKKLYYYFANMLER,0
5a0w,G,98,101,3,IRLF,0
5a0w,G,102,118,16,NMREQIAFIKGLYVAAG,0
5a0w,G,131,145,14,NKALLEIVSRWLNNL,0
5a0w,G,169,177,8,DRIKFVHTI,0
5a0w,G,5,21,16,ENVSGISAYLLGLIIGD,0
5a0w,G,30,32,2,KGN,0
5a0w,G,186,195,9,PPEAAALEHH,0
4lao,B,17,27,10,PPSYIAMLEKR,0
4lao,B,47,49,2,LSS,0
4lao,B,50,60,10,ELAALDAALAD,0
4lao,B,71,76,5,STHFAS,0
4lao,B,76,87,11,SLAQKMHFMDTN,0
4lao,B,108,125,17,EAPGIADAVNAEFSDMCA,0
4lao,B,142,154,12,PVDAVKASIERVK,0
4lao,B,175,177,2,DPH,0
4lao,B,178,188,10,LLPVFEAVADA,0
4lao,B,201,206,5,PNEVYG,0
4lao,B,208,213,5,RSEEYG,0
4lao,B,214,220,6,HVLPLAL,0
4lao,B,220,236,16,LGFPMETTIAVARMYMA,0
4lao,B,237,242,5,GVFDHV,0
4lao,B,251,254,3,HSGG,0
4lao,B,255,269,14,TLPFLAGRIESCIVH,0
4lao,B,270,276,6,DGHLVKT,0
4lao,B,285,293,8,TIWTVLKEQ,0
4lao,B,302,314,12,SEVGLQAAIASSG,0
4lao,B,338,353,15,WDSSRLNAQAVIKAVG,0
4lao,B,356,364,8,SSDAAAVMG,0
4lao,B,364,371,7,GLNAVRVL,0
4lao,B,17,26,9,PPSYIAMLEK,0
4lao,B,108,126,18,EAPGIADAVNAEFSDMCAQ,0
4lao,B,270,275,5,DGHLVK,0
4lao,B,364,372,8,GLNAVRVLS,0
5h4s,A,50,60,10,SSLRIINEHCD,0
5h4s,A,70,75,5,TNDVFG,0
5h4s,A,150,160,10,SSLSTARSVCE,0
5h4s,A,170,175,5,SNDVFG,0
5h4s,A,242,252,10,SSLNIVQSACN,0
5h4s,A,262,267,5,NNNVFG,0
3fxz,A,249,261,12,SDEEILEKLRSIV,0
3fxz,A,265,269,4,DPKKK,0
3fxz,A,304,306,2,QQQ,0
3fxz,A,308,322,14,KKELIINEILVMREN,0
3fxz,A,351,359,8,SLTDVVTET,0
3fxz,A,362,383,21,DEGQIAAVCRECLQALEFLHSN,0
3fxz,A,391,393,2,KSD,0
3fxz,A,427,431,4,TPYWM,0
3fxz,A,432,438,6,APEVVTR,0
3fxz,A,443,460,17,PKVDIWSLGIMAIEMIEG,0
3fxz,A,468,480,12,NPLRALYLIATNG,0
3fxz,A,486,490,4,NPEKL,0
3fxz,A,491,502,11,SAIFRDFLNRCL,0
3fxz,A,511,516,5,SAKELL,0
3fxz,A,517,524,7,QHQFLKIA,0
3fxz,A,526,529,3,PLSS,0
3fxz,A,530,541,11,LTPLIAAAKEAT,0
6c8q,H,3,13,10,TLQEKIIQELG,0
6c8q,H,19,38,19,DPKEEVRKSIDFLKAYLTKH,0
6c8q,H,51,73,22,GQDSTLAGRLAQLAMTEMREETG,0
6c8q,H,92,103,11,EADAQAALAFIQ,0
6c8q,H,112,125,13,IKPAVDAMVGSLEN,0
6c8q,H,131,152,21,SDFNKGNMKARQRMITQYAVAG,0
6c8q,H,163,169,6,HAAENVT,0
6c8q,H,189,200,11,NKRQGKALLKEL,0
6c8q,H,203,207,4,PEALY,0
6c8q,H,222,229,7,VADEVALG,0
6c8q,H,231,240,9,TYDAIDDYLE,0
6c8q,H,245,259,14,SETDQQTIENWYKKG,0
6c8q,H,260,263,3,QHKR,0
6c8q,H,112,126,14,IKPAVDAMVGSLENA,0
6c8q,H,131,154,23,SDFNKGNMKARQRMITQYAVAGEN,0
6c8q,H,4,13,9,LQEKIIQELG,0
6c8q,H,131,155,24,SDFNKGNMKARQRMITQYAVAGENA,0
6c8q,H,163,170,7,HAAENVTA,0
6c8q,H,260,264,4,QHKRH,0
6c8q,H,163,168,5,HAAENV,0
6c8q,H,231,241,10,TYDAIDDYLEG,0
6c8q,H,112,127,15,IKPAVDAMVGSLENAG,0
6c8q,H,224,229,5,DEVALG,0
1tq7,B,1,0,-1,,0
1tq7,B,7,11,4,FEKKS,0
1tq7,B,14,13,-1,,0
1tq7,B,55,59,4,AAHCL,0
1tq7,B,60,59,-1,,0
1tq7,B,60,62,2,TEN,0
1tq7,B,125,130,5,DRETLL,0
1tq7,B,164,172,8,ERPVCKDST,0
1tq7,B,185,185,0,K,0
1tq7,B,234,244,10,LKKWIQKVIDQ,0
4wnq,D,95,99,4,QLEDS,0
4wnq,D,196,201,5,ACANAF,0
4wnq,D,95,99,4,HPEDS,0
4wnq,D,125,129,4,DLKNV,0
4wnq,D,140,148,8,SEAEISHTQ,0
4wnq,D,207,211,4,ATFWQ,0
1bp4,A,7,10,3,WRQK,0
1bp4,A,25,42,17,CWAFSAVVTIEGIIKIRT,0
1bp4,A,50,56,6,EQELLDC,0
1bp4,A,62,64,2,GCN,0
1bp4,A,68,78,10,PWSALQLVAQY,0
1bp4,A,118,125,7,QGALLYSI,0
1bp4,A,139,142,3,KDFQ,0
1bp4,A,199,201,2,VCG,0
4fjs,B,4,20,16,SRETLHQLIENKLCQAG,0
4fjs,B,22,39,17,KREHAATVAEVLVYADAR,0
4fjs,B,41,47,6,IHSHGAV,0
4fjs,B,48,58,10,RVEYYAERISK,0
4fjs,B,85,105,20,AGQVAAKMGMEHAIKTAQQNG,0
4fjs,B,120,130,10,ISYFVQQAARA,0
4fjs,B,181,190,9,AWGKVLDARS,0
4fjs,B,222,237,15,GPKGYGLMMMIDVLSG,0
4fjs,B,238,241,3,VLLG,0
4fjs,B,244,248,4,FGRQV,0
4fjs,B,270,273,3,PNFF,0
4fjs,B,275,292,17,SSELFRQHLSQTMRELNA,0
4fjs,B,306,320,14,GQDQDIKQRKAAVEG,0
4fjs,B,324,333,9,VDDIYQYLIS,0
4fjs,B,181,185,4,AWGKV,0
4fjs,B,186,191,5,LDARSR,0
4fjs,B,210,214,4,DPFAV,0
4fjs,B,306,316,10,GQDQDIKQRKA,0
3ddm,D,65,76,11,GAEHRARLVETV,0
3ddm,D,76,82,6,VLAPLLT,0
3ddm,D,88,99,11,DPAQAFAHLEAR,0
3ddm,D,100,108,8,TAVLAIQTG,0
3ddm,D,109,132,23,EPGPLAQAIAGLDIALCDLAARRA,0
3ddm,D,135,140,5,PLWAWL,0
3ddm,D,158,170,12,NPEDVVARKAAEG,0
3ddm,D,181,197,16,DDARDVRNALHVRELLG,0
3ddm,D,211,223,12,DLPRARQMAQRLG,0
3ddm,D,224,226,2,PAQ,0
3ddm,D,239,250,11,PAAEWAELAQAA,0
3ddm,D,262,273,11,GVAAFETALAAR,0
3ddm,D,286,301,15,GGFSGCLPVARAVVAA,0
3ddm,D,312,326,14,AGIGLQASAHLLAAV,0
3ddm,D,342,347,5,NPLRSL,0
3ddm,D,348,355,7,LSPALATL,0
3ddm,D,373,381,8,DLAALRAAC,0
3ddm,D,88,108,20,DPAQAFAHLEARTAVLAIQTG,0
3ddm,D,158,169,11,NPEDVVARKAAE,0
3ddm,D,211,222,11,DLPRARQMAQRL,0
3ddm,D,223,226,3,GPAQ,0
3ddm,D,109,133,24,EPGPLAQAIAGLDIALCDLAARRAG,0
3ddm,D,349,355,6,SPALATL,0
3ddm,D,373,380,7,DLAALRAA,0
3ddm,D,64,76,12,CGAEHRARLVETV,0
3ddm,D,373,379,6,DLAALRA,0
2o0t,D,31,39,8,LTQLAQEYG,0
2o0t,D,47,61,14,EDDFRSRCRETAAAF,0
2o0t,D,63,66,3,SGAN,0
2o0t,D,72,74,2,AF,0
2o0t,D,76,87,11,CSEVARWISEEG,0
2o0t,D,94,104,10,TGGELAVALHA,0
2o0t,D,107,109,2,PPE,0
2o0t,D,119,130,11,SVSELTAAVKAG,0
2o0t,D,138,153,15,SMTEIERLDAIAGEAG,0
2o0t,D,190,202,12,GAAMAAVRRVFAT,0
2o0t,D,221,247,26,VDGFELAAHRVIGLLRDVVGEFGPEKT,0
2o0t,D,271,290,19,PIAELAAKLGTIVSDESTAV,0
2o0t,D,302,307,5,GRAIAG,0
2o0t,D,343,349,6,IRTALYG,0
2o0t,D,412,416,4,RYNMV,0
2o0t,D,437,443,6,TVDDLLS,0
2o0t,D,221,243,22,VDGFELAAHRVIGLLRDVVGEFG,0
2o0t,D,76,86,10,CSEVARWISEE,0
2o0t,D,437,442,5,TVDDLL,0
1syo,B,9,13,4,FPELC,0
1syo,B,38,42,4,VAQCG,0
1syo,B,120,123,3,TAAC,0
1syo,B,125,129,4,KNIFK,0
1syo,B,149,152,3,NPLI,0
1syo,B,234,238,4,PDFCD,0
1syo,B,265,267,2,KSN,0
1syo,B,277,280,3,EYAC,0
1syo,B,281,285,4,HRDYL,0
1syo,B,293,298,5,SSAQHD,0
1syo,B,304,308,4,QPLSR,0
1syo,B,336,340,4,APICN,0
1syo,B,428,431,3,KYAC,0
1syo,B,1009,1013,4,FPELC,0
1syo,B,1120,1123,3,TAAC,0
1syo,B,1149,1152,3,NPLI,0
1syo,B,1184,1189,5,SPQVRV,0
1syo,B,1277,1280,3,EYAC,0
1syo,B,1281,1284,3,HRDY,0
1syo,B,1293,1298,5,SSAQHD,0
1syo,B,1304,1308,4,QPLSR,0
1syo,B,1336,1340,4,APICN,0
1syo,B,1428,1431,3,KYAC,0
4f9u,B,37,49,12,DEVHFNRTLDSIL,0
4f9u,B,56,73,17,SRGHQQVREYLVQSLNGL,0
4f9u,B,132,146,14,SAVPCAILLNTAKTL,0
4f9u,B,146,151,5,LGAYLQ,0
4f9u,B,152,156,4,KEFRN,0
4f9u,B,182,195,13,VYGSKHLAAKLASK,0
4f9u,B,206,209,3,RNID,0
4f9u,B,231,233,2,YEN,0
4f9u,B,234,251,17,TDGLHSSLVQIEKSLRTA,0
4f9u,B,274,279,5,HRPFLD,0
4f9u,B,302,306,4,NAANL,0
4f9u,B,307,329,22,HWPSIRNFNRVFRNFVYQYLKRH,0
4f9u,B,182,194,12,VYGSKHLAAKLAS,0
4f9u,B,307,328,21,HWPSIRNFNRVFRNFVYQYLKR,0
4f9u,B,332,336,4,PVNLR,0
3c1t,D,15,28,13,GFIGSWLVMRLLER,0
3c1t,D,41,50,9,NVKKVKHLLD,0
3c1t,D,53,57,4,KAETH,0
3c1t,D,71,76,5,FDEAIK,0
3c1t,D,94,99,5,DPENEV,0
3c1t,D,99,117,18,VIKPTIEGMLGIMKSCAAA,0
3c1t,D,128,132,4,SAGTV,0
3c1t,D,149,157,8,DMEFCRAKK,0
3c1t,D,160,181,21,AWMYFVSKTLAEQAAWKYAKEN,0
3c1t,D,203,210,7,PPSLITAL,0
3c1t,D,210,215,5,LSPITG,0
3c1t,D,216,220,4,NEAHY,0
3c1t,D,231,244,13,LDDLCNAHIYLFEN,0
3c1t,D,260,271,11,ILDLAKMLREKY,0
3c1t,D,294,300,6,SKKLTDL,0
3c1t,D,307,322,15,SLEDMFTGAVDTCRAK,0
3c1t,D,99,118,19,VIKPTIEGMLGIMKSCAAAK,0
3c1t,D,216,218,2,NEA,0
3c1t,D,219,224,5,HYSIIR,0
3c1t,D,294,301,7,SKKLTDLG,0
3c1t,D,15,29,14,GFIGSWLVMRLLERG,0
5dih,F,4,9,5,APERFD,0
5dih,F,29,44,15,SIARGITVADAALKRA,0
5dih,F,55,57,2,SSG,0
5dih,F,66,82,16,QVAEVEESMIAAREIAG,0
5dih,F,98,105,7,HEQLWRFL,0
5dih,F,128,140,12,TVCAAIDSADAAL,0
5dih,F,167,174,7,ELADVEAA,0
5dih,F,175,183,8,AEVVRERCG,0
5dih,F,128,143,15,TVCAAIDSADAALKTA,0
5dih,F,167,183,16,ELADVEAAAEVVRERCG,0
5dih,F,196,200,4,VDELR,0
5dih,F,29,42,13,SIARGITVADAALK,0
5dih,F,128,141,13,TVCAAIDSADAALK,0
5dih,F,66,81,15,QVAEVEESMIAAREIA,0
5dih,F,99,105,6,EQLWRFL,0
5dih,F,101,105,4,LWRFL,0
5gvm,C,6,11,5,PLEQID,0
5gvm,C,11,27,16,DKELHDILADEEKRQRE,0
5gvm,C,39,47,8,NGAVRECLG,0
5gvm,C,48,53,5,NRVSNK,0
5gvm,C,67,85,18,NDFIDKIEELCQKRALEAF,0
5gvm,C,100,114,14,SGSAANVQALYALVG,0
5gvm,C,124,127,3,LCSG,0
5gvm,C,129,133,4,HLTHG,0
5gvm,C,142,146,4,SITSD,0
5gvm,C,162,174,12,DLDAVREMALSFK,0
5gvm,C,190,201,11,DYQQFRQICDEV,0
5gvm,C,212,218,6,ISSFVAC,0
5gvm,C,223,227,4,NPFLH,0
5gvm,C,256,266,10,GIEQKINSAVF,0
5gvm,C,274,289,15,HNNKIAAVACQLKEVH,0
5gvm,C,290,314,24,SPAFKEYTQQVLLNSKALAKALISK,0
5gvm,C,320,322,2,TNG,0
5gvm,C,333,336,3,RKFS,0
5gvm,C,338,349,11,TGSKLQETCNAI,0
5gvm,C,374,380,6,TPAMTTR,0
5gvm,C,383,385,2,KEK,0
5gvm,C,386,409,23,DMEFIADVLARAIKITVDLQEQYG,0
5gvm,C,411,416,5,KLVDFK,0
5gvm,C,422,439,17,NAQLQQLKQEVVTWAGAL,0
5gvm,C,190,202,12,DYQQFRQICDEVN,0
5gvm,C,411,418,7,KLVDFKKG,0
5gvm,C,385,409,24,KDMEFIADVLARAIKITVDLQEQYG,0
5gvm,C,411,419,8,KLVDFKKGL,0
5gvm,C,422,437,15,NAQLQQLKQEVVTWAG,0
4d0z,F,77,81,4,RWPDF,0
4d0z,F,82,88,6,NQEAYVG,0
4d0z,F,105,111,6,NQVESDK,0
4d0z,F,123,129,6,HDQCQRK,0
4d0z,F,148,163,15,ARSALLRTVVSVLKKS,0
4d0z,F,164,166,2,PPH,0
4d0z,F,181,186,5,PEDGAL,0
4d0z,F,187,189,2,LGK,0
4d0z,F,202,215,13,EGLMRSRVRGADAA,0
4d0z,F,234,244,10,LEPLLERVAED,0
4d0z,F,286,294,8,TPEQRRSRQ,0
4d0z,F,315,321,6,KFYFEEL,0
4d0z,F,333,345,12,GENLEISFRVWQC,0
4d0z,F,372,389,17,GSGTVFARNTRRAAEVWM,0
4d0z,F,392,400,8,YKNFYYAAV,0
4d0z,F,401,406,5,PSARNV,0
4d0z,F,411,421,10,IQSRLELRKKL,0
4d0z,F,425,433,8,PFKWYLENV,0
4d0z,F,477,481,4,GGNQE,0
4d0z,F,517,520,3,DSRQ,0
4d0z,F,558,562,4,ALSQQ,0
4d0z,F,82,89,7,NQEAYVGG,0
4d0z,F,105,112,7,NQVESDKL,0
4d0z,F,203,215,12,GLMRSRVRGADAA,0
4d0z,F,380,389,9,NTRRAAEVWM,0
4d0z,F,411,422,11,IQSRLELRKKLS,0
4d0z,F,286,292,6,TPEQRRS,0
4zdk,B,23,38,15,GKGLTASSLGQLLTAR,0
4zdk,B,54,58,4,DPGTM,0
4zdk,B,59,64,5,NPFQHG,0
4zdk,B,77,87,10,LDVGHYERFLD,0
4zdk,B,91,93,2,PGS,0
4zdk,B,98,111,13,TGQVYSTVIAKERR,0
4zdk,B,120,135,15,QVIPHITDEIKRRILA,0
4zdk,B,136,138,2,MAQ,0
4zdk,B,162,177,15,SQPFLEAARQVRHYLG,0
4zdk,B,200,213,13,TKPTQHSVAALRSI,0
4zdk,B,229,241,12,PEALKNKIALMCD,0
4zdk,B,243,245,2,DID,0
4zdk,B,255,257,2,SIY,0
4zdk,B,258,266,8,DIPKVLHRE,0
4zdk,B,267,276,9,ELDAFVVRRL,0
4zdk,B,285,297,12,WTEWDDLLRRVHE,0
4zdk,B,314,316,2,SDA,0
4zdk,B,317,331,14,YLSVAEALRAGGFKH,0
4zdk,B,343,346,3,DGCE,0
4zdk,B,347,356,9,TTSGAAAALG,0
4zdk,B,372,386,14,IEGKIGAIAYARARG,0
4zdk,B,393,407,14,CLGLQCIVIEAARSV,0
4zdk,B,459,466,7,SVVAQAYQ,0
4zdk,B,484,489,5,YRDKIA,0
4zdk,B,490,492,2,ESG,0
4zdk,B,524,529,5,HPELKS,0
4zdk,B,535,553,18,HPLFVAFVGAAIDYKAGEL,0
4zdk,B,535,552,17,HPLFVAFVGAAIDYKAGE,0
3bdi,A,38,45,7,TSDWDKA,0
3bdi,A,46,53,7,DLFNNYSK,0
3bdi,A,81,96,15,DLKHAAEFIRDYLKAN,0
3bdi,A,107,120,13,SGGGVITTLQY,0
3bdi,A,135,137,2,VES,0
3bdi,A,138,143,5,LKGDK,0
3bdi,A,161,172,11,PIALSKEYASII,0
3bdi,A,186,191,5,PVYIEK,0
3bdi,A,191,205,14,KPEEFVRITVDFLRN,0
5mig,A,55,59,4,DPSML,0
5mig,A,74,78,4,TNWAD,0
5mig,A,115,120,5,TQYCDG,0
5mig,A,134,138,4,NASLY,0
5mig,A,142,144,2,DDT,0
5mig,A,156,160,4,LAQQE,0
5mig,A,273,277,4,FDGGI,0
5mig,A,305,309,4,VETDL,0
5mig,A,354,361,7,PVLLQILS,0
5mig,A,365,369,4,NAQDL,0
5mig,A,455,461,6,IDWHLEA,0
5mig,A,473,478,5,DTASAN,0
5mig,A,481,486,5,PQAWSD,0
5mig,A,486,495,9,DLCPAYDQAH,0
4u2w,A,61,65,4,AAHCY,0
4u2w,A,167,175,8,SDSSCKSAY,0
4u2w,A,235,245,10,YVSWIKQTIAS,0
5v6a,B,1506,1511,5,TYRSQL,0
5v6a,B,1527,1531,4,DEKQN,0
5v6a,B,1542,1554,12,TADETKALKELYG,0
5v6a,B,1559,1572,13,TFLHRFYSLKAAVH,0
5v6a,B,1591,1602,11,NCYLNAVIMTLD,0
5v6a,B,1611,1622,11,IPALQHAFMKHK,0
5v6a,B,1626,1637,11,STDFIALIMAYG,0
5v6a,B,1646,1656,10,DASRLLHTVLA,0
5v6a,B,1685,1687,2,LKA,0
5v6a,B,1695,1700,5,TVEDLR,0
5v6a,B,22,32,10,TIENVKAKIQD,0
5v6a,B,37,39,2,PPD,0
2lpj,A,12,29,17,NPGLAENFMNSFMQGLSS,0
2lpj,A,34,58,24,TASQLDDMSTIAQSMVQSIQSLAAQ,0
2lpj,A,62,82,20,SPNKLQALNMAFASSMAEIAA,0
2lpj,A,90,109,19,LSTKTSSIASAMSNAFLQTT,0
2lpj,A,113,131,18,NQPFINEITQLVSMFAQAG,0
1cer,D,10,22,12,RIGRQVFRILHSR,0
1cer,D,37,45,8,NKTLAHLLK,0
1cer,D,79,81,2,PKE,0
1cer,D,84,87,3,WAEA,0
1cer,D,102,111,9,ADKAKAHLEG,0
1cer,D,134,136,2,HEA,0
1cer,D,149,164,15,CTTNSLAPVMKVLEEA,0
1cer,D,210,216,6,AAKATAL,0
1cer,D,219,221,2,PSL,0
1cer,D,252,263,11,AEEVNAALKAAA,0
1cer,D,280,283,3,LQDI,0
1cer,D,294,296,2,AKL,0
1cer,D,315,330,15,WGYANRVADLVELVLR,0
1cer,D,85,87,2,AEA,0
1cer,D,102,110,8,ADKAKAHLE,0
1cer,D,199,201,2,AAI,0
1cer,D,213,216,3,ATAL,0
1cer,D,252,264,12,AEEVNAALKAAAE,0
1cer,D,315,331,16,WGYANRVADLVELVLRK,0
1cer,D,10,21,11,RIGRQVFRILHS,0
1cer,D,210,217,7,AAKATALV,0
1cer,D,280,282,2,LQD,0
1cer,D,212,216,4,KATAL,0
4r8a,F,20,37,17,FYYLHNFRAVLAWIGERY,0
4r8a,F,42,54,12,DDQERAFIAAFAE,0
4r8a,F,56,69,13,PEASQALLVRMVMR,0
4r8a,F,77,79,2,GKL,0
4r8a,F,86,91,5,DTRAAV,0
4r8a,F,91,97,6,VQPLLAL,0
4r8a,F,107,115,8,ELAQLFGLL,0
4r8a,F,116,124,8,KKDELSQLF,0
4r8a,F,125,128,3,RDHL,0
4r8a,F,134,143,9,RKDALLERLQ,0
4r8a,F,152,156,4,LAEWQ,0
4r8a,F,168,180,12,CMALCDRLRLMYF,0
4r8a,F,187,195,8,WSEFVLADL,0
4r8a,F,214,232,18,LRADVDAYLHLFDCRQRFD,0
4r8a,F,236,244,8,PLEELLAGL,0
4r8a,F,251,272,21,NPWLEGRRVKLLFQFAQHCEKQ,0
4r8a,F,274,283,9,DFDLAQRLYR,0
4r8a,F,289,301,12,GARLRAIRSLERG,0
4r8a,F,303,317,14,RFAEAHALAREASCA,0
4r8a,F,320,338,18,SDAERQGLARLLPRLQGKL,0
4r8a,F,366,375,9,SVEWAVREHL,0
4r8a,F,387,398,11,NGLINSLFGLLC,0
4r8a,F,398,403,5,CWEAIF,0
4r8a,F,427,429,2,RQR,0
4r8a,F,430,438,8,RAALFEACL,0
4r8a,F,444,458,14,GSYRDAIRCRYRDKF,0
4r8a,F,471,482,11,GEELLEQALDCL,0
4r8a,F,483,497,14,PAAHLRAWFERLLED,0
4r8a,F,531,544,13,QDNQLRWLQFCRER,0
1xu8,B,3,23,20,ALQLANSAFAVDLFKQLCEKE,0
1xu8,B,31,46,15,SPICLSTSLSLAQVGA,0
1xu8,B,47,58,11,KGDTANEIGQVL,0
1xu8,B,65,81,16,DVPFGFQTVTSDVNKLS,0
1xu8,B,101,107,6,STEFISS,0
1xu8,B,124,140,16,KLEETKGQINNSIKDLT,0
1xu8,B,176,180,4,PESET,0
1xu8,B,222,224,2,QNK,0
1xu8,B,238,249,11,DESTGLEKIEKQ,0
1xu8,B,251,259,8,NSESLSQWT,0
1xu8,B,284,292,8,PKACLENLG,0
1xu8,B,4,23,19,LQLANSAFAVDLFKQLCEKE,0
1xu8,B,101,109,8,STEFISSTK,0
1xu8,B,251,260,9,NSESLSQWTN,0
1xu8,B,284,291,7,PKACLENL,0
3aeh,B,1072,1098,26,GTMARNDGQGKAAATFMHISYNNFITE,0
3aeh,B,1101,1107,6,NLNKRMG,0
4lim,A,11,22,11,SSSDMEYYYKSL,0
4lim,A,24,34,10,PFKHIFNWLNH,0
4lim,A,39,44,5,SRDMIN,0
4lim,A,64,76,12,SVQDFKAQIEKAN,0
4lim,A,115,121,6,DDYDAFR,0
4lim,A,130,151,21,CSKCWKFISLAMKITNTALRED,0
4lim,A,173,178,5,DKRARA,0
4lim,A,180,192,12,TDVQRRNVLDYVN,0
4lim,A,210,228,18,HPHLARSLEQLKPFFVSIM,0
4lim,A,237,245,8,DDQHAIQTL,0
4lim,A,246,249,3,LPAL,0
4lim,A,251,265,14,DKQLIDSLKKYWLDN,0
4lim,A,269,285,16,SSKEKWNDIDQIATSLF,0
4lim,A,289,310,21,KQDSHIIKLRECKEDLVLMTLY,0
4lim,A,314,320,6,DVEVTKQ,0
4lim,A,347,351,4,APEKA,0
4lim,A,353,364,11,KLIDLQTEMEKN,0
4lim,A,366,370,4,DVSLT,0
4lim,A,372,392,20,LQPFINQFQAYVSSLLKNELG,0
3s8e,H,56,60,4,FWHLT,0
3s8e,H,66,81,15,GTCADRDNLTRRFSDL,0
3s8e,H,92,106,14,KAEELLLKIHEVSTV,0
3s8e,H,136,141,5,IQTLTG,0
3s8e,H,142,144,2,LFK,0
3s8e,H,148,152,4,CHSLV,0
3s8e,H,226,240,14,SWYIQDLCEMLGKYG,0
3s8e,H,244,259,15,EFTELLTLVNRKVDQR,0
3s8e,H,136,142,6,IQTLTGL,0
1dva,Y,231,241,10,VSQYIEWLQKL,0
1dva,Y,48,53,5,DQCASS,0
1dva,Y,93,98,5,NENGGC,0
1dva,Y,9,14,5,DRWYCQ,0
5uph,B,71,77,6,NPEEILR,0
5uph,B,121,124,3,RDQS,0
5uph,B,137,149,12,NIPVLTVIEWSQV,0
5uph,B,152,163,11,LREIIEAMLKAY,0
5uph,B,173,179,6,VDELLWG,0
5uph,B,182,192,10,DEILSLIHVFR,0
5uph,B,327,331,4,SICKN,0
5uph,B,340,343,3,PHFY,0
5uph,B,346,352,6,DERFVSA,0
5uph,B,359,364,5,NQEDHE,0
5uph,B,395,399,4,FVETG,0
5uph,B,418,428,10,DKETASRLKSM,0
5uph,B,418,426,8,DKETASRLK,0
5lgr,D,136,142,6,SVFSERT,0
5lgr,D,143,154,11,EESSAVQYFQFY,0
5lgr,D,156,165,9,YLSQQQNMMQ,0
5lgr,D,166,179,13,DYVRTGTYQRAILQ,0
5lgr,D,180,184,4,NHTDF,0
5lgr,D,197,206,9,GILSFFAAQA,0
5lgr,D,218,230,12,TMAQHAEVLVKSN,0
5lgr,D,268,276,8,RMLESYLHA,0
5lgr,D,300,312,12,DEQLYMEQFTKAN,0
5lgr,D,313,315,2,FWY,0
5lgr,D,324,326,2,LSA,0
5lgr,D,327,337,10,LRGAAVDEYFR,0
5lgr,D,345,349,4,DIRIL,0
5lgr,D,364,368,4,KEGDL,0
5lgr,D,166,180,14,DYVRTGTYQRAILQN,0
5lgr,D,181,184,3,HTDF,0
5lgr,D,313,316,3,FWYQ,0
5lgr,D,318,322,4,SFHGV,0
5lgr,D,136,141,5,SVFSER,0
5lgr,D,265,267,2,FNE,0
5lgr,D,143,155,12,EESSAVQYFQFYG,0
5lgr,D,156,166,10,YLSQQQNMMQD,0
3eg5,D,15,26,11,GKTCLLISYTTN,0
3eg5,D,61,65,4,QEDYD,0
3eg5,D,67,72,5,LRPLSY,0
3eg5,D,86,96,10,SPSSFENVKEK,0
3eg5,D,96,105,9,KWVPEITHHC,0
3eg5,D,116,120,4,QIDLR,0
3eg5,D,122,132,10,DPSTIEKLAKN,0
3eg5,D,138,149,11,TPETAEKLARDL,0
3eg5,D,164,178,14,GLKNVFDEAILAALE,0
3eg5,D,84,94,10,LVLFEQMLVDM,0
3eg5,D,97,106,9,NEEKQQPLRE,0
3eg5,D,108,123,15,DIVIKREMVSQYLHTS,0
3eg5,D,135,144,9,SAMMYIQELR,0
3eg5,D,148,166,18,RDMHLLSCLESLRVSLTSH,0
3eg5,D,167,191,24,PVSWVQTFGAEGLASLLDILKRLHD,0
3eg5,D,201,216,15,DSRNQHEIIRCLKAFM,0
3eg5,D,218,227,9,NKFGIKTMLE,0
3eg5,D,230,238,8,EGILLLVRA,0
3eg5,D,243,259,16,VPNMMIDAAKLLSALCI,0
3eg5,D,265,282,17,DMNERVLEAMTERAEMDE,0
3eg5,D,286,292,6,FQPLLDG,0
3eg5,D,298,314,16,SIALKVGCLQLINALIT,0
3eg5,D,318,332,14,ELDFRVHIRSELMRL,0
3eg5,D,333,342,9,GLHQVLQELR,0
3eg5,D,346,378,32,NEDMKVQLCVFDEQGDEDFFDLKGRLDDIRMEM,0
3eg5,D,380,392,12,DFGEVFQIILNTV,0
3eg5,D,397,408,11,AEPHFLSILQHL,0
3eg5,D,417,434,17,ARPQYYKLIEECVSQIVL,0
3eg5,D,116,121,5,QIDLRD,0
1l0p,A,12,23,11,NWQDVAQECEQY,0
1l0p,A,23,28,5,YLGPKG,0
1l0p,A,45,51,6,QWWTRYQ,0
1l0p,A,63,77,14,NRAQFIDMVNRCSAA,0
1l0p,A,112,116,4,SPQDF,0
1l0p,A,125,130,5,SDYGND,0
1l0p,A,130,137,7,DRYRVQNC,0
1l0p,A,149,167,18,SNYVQNTIAAYINDLQAIG,0
1l0p,A,175,179,4,ASKHV,0
1l0p,A,180,189,9,AASDIQSLMA,0
1l0p,A,210,215,5,GASEYL,0
1l0p,A,222,236,14,EFKYSTELGNTFRNG,0
1l0p,A,237,244,7,SLAWLSNF,0
1l0p,A,245,249,4,GEGWG,0
1l0p,A,252,254,2,PSS,0
1l0p,A,264,268,4,DNQRG,0
1l0p,A,277,280,3,TFED,0
1l0p,A,281,294,13,GRLYDLANVFMLAY,0
1l0p,A,335,338,3,CEHR,0
1l0p,A,339,352,13,WSYIAGGVDFRNNT,0
4dzy,A,54,82,28,GSHLLKSGRYLQQELPVRIAHRIKGFRSL,0
4dzy,A,83,88,5,PFIIGC,0
4dzy,A,89,109,20,NPTILHVHELYIRAFQKLTDF,0
4dzy,A,114,132,18,DQADEAQYCQLVRQLLDDH,0
4dzy,A,134,147,13,DVVTLLAEGLRESR,0
4dzy,A,148,150,2,KHI,0
4dzy,A,152,180,28,DEKLVRYFLDKTLTSRLGIRMLATHHLAL,0
4dzy,A,196,217,21,SPKKIIEKWVDFARRLCEHKYG,0
4dzy,A,235,257,22,IPMPLDYILPELLKNAMRATMES,0
4dzy,A,291,296,5,AHKDLD,0
4dzy,A,338,350,12,FGLPTSRAYAEYL,0
1n8i,A,14,23,9,RVLYDFVNNE,0
1n8i,A,31,70,39,DPDSFWAGVDKVVADLTPQNQALLNARDELQAQIDKWHRR,0
1n8i,A,77,88,11,DMDAYRQFLTEI,0
1n8i,A,106,111,5,DAEITT,0
1n8i,A,123,132,9,NARFALNAAN,0
1n8i,A,138,144,6,LYDALYG,0
1n8i,A,161,180,19,NKVRGDKVIAYARKFLDDSV,0
1n8i,A,186,190,4,SFGDA,0
1n8i,A,213,215,2,NPG,0
1n8i,A,249,253,4,VGTTD,0
1n8i,A,280,296,16,DAADKVLGYRNWLGLNK,0
1n8i,A,360,373,13,EGIMDALFTGLIAI,0
1n8i,A,374,377,3,HGLK,0
1n8i,A,402,421,19,GPAEVAFTCELFSRVEDVLG,0
1n8i,A,435,440,5,ERRTTV,0
1n8i,A,441,449,8,NLKACIKAA,0
1n8i,A,459,471,12,GFLDRTGDEIHTS,0
1n8i,A,472,475,3,MEAG,0
1n8i,A,479,485,6,RKGTMKS,0
1n8i,A,486,503,17,QPWILAYEDHNVDAGLAA,0
1n8i,A,521,529,8,LMADMVETK,0
1n8i,A,530,535,5,IAQPRA,0
1n8i,A,544,558,14,SPTAATLHALHYHQV,0
1n8i,A,559,568,9,DVAAVQQGLA,0
1n8i,A,574,579,5,TIEQLL,0
1n8i,A,590,616,26,APDEIREEVDNNCQSILGYVVRWVDQG,0
1n8i,A,633,650,17,DRATLRISSQLLANWLRH,0
1n8i,A,654,673,19,TSADVRASLERMAPLVDRQN,0
1n8i,A,685,688,3,NFDD,0
1n8i,A,689,701,12,SIAFLAAQELILS,0
1n8i,A,702,709,7,GAQQPNGY,0
1n8i,A,710,727,17,TEPILHRRRREFKARAAE,0
2jy0,A,3,8,5,REMAAS,0
2jy0,A,11,23,12,GAVFVGLVLLTLS,0
1xkz,D,352,357,5,KSKIFG,0
1xkz,D,377,382,5,NEKESR,0
1xkz,D,387,390,3,PNST,0
1xkz,D,391,402,11,YKIYLAMFGLDR,0
1xkz,D,421,425,4,FDAWN,0
1xkz,D,429,436,7,DLNTAMQN,0
1xkz,D,438,447,9,VNWYFERISD,0
1xkz,D,450,462,12,PKNYTATQLKQLN,0
1xkz,D,484,497,13,NLEQVIVFKNMMEQ,0
1xkz,D,502,513,11,SKKAKNQLSSSL,0
1xkz,D,564,579,15,SGKNAELISEKILKEM,0
4djp,B,86,91,5,GRNLLT,0
3ep1,B,80,85,5,PRQQWA,0
3ep1,B,108,113,5,GPDTCS,0
3ep1,B,131,146,15,CTEQIVKALQDADFKE,0
3ep1,B,198,215,17,SQALQDALSKLIICGQAA,0
3ep1,B,227,232,5,TPAMSG,0
3ep1,B,232,241,9,GQAFYDMLDR,0
3ep1,B,232,242,10,GQAFYDMLDRC,0
1ufu,A,44,50,6,APWITRI,0
1ufu,A,51,56,5,PQELVK,0
2au5,A,11,13,2,NFE,0
2au5,A,14,35,21,YEEITRSFLSNLAFTRGHFTG,0
2au5,A,41,51,10,SPIVLAEEKD,0
2au5,A,53,71,18,NWLEEAAGGQGVIVQSLL,0
2au5,A,78,98,20,SVEQLKGELARLIRLYFALAK,0
2au5,A,102,122,20,TENQESLYVDLFDKFTFLLLC,0
2au5,A,123,132,9,SDEFIYLDS,0
3eb0,C,48,55,7,NRELDIMK,0
3eb0,C,124,134,10,LHKVLKSFIRS,0
3eb0,C,139,159,20,PMNLISIYIYQLFRAVGFIHS,0
3eb0,C,168,170,2,KPQ,0
3eb0,C,209,214,5,APELML,0
3eb0,C,221,238,17,PSIDLWSIGCVFGELILG,0
3eb0,C,246,259,13,TSIDQLVRIIQIMG,0
3eb0,C,262,270,8,TKEQMIRMN,0
3eb0,C,285,290,5,DWRKIL,0
3eb0,C,295,306,11,PSLAIDLLEQIL,0
3eb0,C,309,313,4,EPDLR,0
3eb0,C,315,321,6,NPYEAMA,0
3eb0,C,322,324,2,HPF,0
3eb0,C,325,331,6,FDHLRNS,0
3eb0,C,357,364,7,SPYELSII,0
3eb0,C,365,373,8,PGNVLNRIL,0
3eb0,C,124,135,11,LHKVLKSFIRSG,0
3eb0,C,325,330,5,FDHLRN,0
4re4,A,-3,2,5,APFTYW,0
4re4,A,4,9,5,NPEIYD,0
4re4,A,14,18,4,SRRAF,0
4re4,A,29,34,5,SAYQVE,0
4re4,A,45,53,8,SIWDAFIEK,0
4re4,A,57,61,4,IPNNA,0
4re4,A,68,83,15,DEYHRYKEDVNIMKNM,0
4re4,A,93,98,5,SWSRIF,0
4re4,A,106,123,17,NQEGVDYYNRLIDYMVKK,0
4re4,A,137,145,8,PLALHEQYL,0
4re4,A,146,150,4,GWLSP,0
4re4,A,151,168,17,NIVEAFADYADFCFQTFG,0
4re4,A,179,189,10,EPRCVAALGYD,0
4re4,A,209,233,24,TEPYLAAHHLILSHAAAVKRYREKY,0
4re4,A,233,238,5,YQLYQK,0
4re4,A,256,271,15,SNADRAAAQRARDFHL,0
4re4,A,271,281,10,LGWFLDPIIHG,0
4re4,A,284,292,8,PYSMLEIVK,0
4re4,A,293,295,2,DRM,0
4re4,A,299,307,8,SDEESRMVK,0
4re4,A,335,340,5,SYQDDW,0
4re4,A,366,380,14,PWGINKAVTYVKETY,0
4re4,A,399,404,5,SITQGV,0
4re4,A,406,426,20,DTVRIRYYRNYITELKKAIDD,0
4re4,A,443,447,4,EWRLG,0
4re4,A,467,477,10,KDSAFWFKNML,0
2m6x,F,1,17,16,GAKNVIVLNAASAAGNH,0
2m6x,F,18,41,23,GFFWGLLVVTLAWHVKGRLVPGAT,0
2m6x,F,47,57,10,VWPLLLVRLLR,0
2m6x,F,5,17,12,VIVLNAASAAGNH,0
2m6x,F,19,41,22,FFWGLLVVTLAWHVKGRLVPGAT,0
2m6x,F,1,3,2,GAK,0
2m6x,F,4,17,13,NVIVLNAASAAGNH,0
2m6x,F,18,32,14,GFFWGLLVVTLAWHV,0
2m6x,F,32,41,9,VKGRLVPGAT,0
2m6x,F,2,17,15,AKNVIVLNAASAAGNH,0
2m6x,F,48,57,9,WPLLLVRLLR,0
1jul,A,7,17,10,GWLKDVVQLSL,0
1jul,A,33,43,10,LNERILEFNKR,0
1jul,A,66,75,9,PIEYSKFMER,0
1jul,A,93,100,7,YETLRKIA,0
1jul,A,116,125,9,ESQIDDAYNL,0
1jul,A,134,136,2,VKI,0
1jul,A,139,152,13,ERELESLLEYARSY,0
1jul,A,163,171,8,ENDLDIALR,0
1jul,A,191,200,9,KENQRKLISM,0
1jul,A,216,225,9,RNEIEELRKL,0
1jul,A,234,238,4,SSLMR,0
1jul,A,240,246,6,PEKIKEF,0
2hhf,B,6,10,4,KAADL,0
2hhf,B,65,70,5,SSSLHY,0
2hhf,B,92,107,15,RPWLNMDRMLRSAMRL,0
2hhf,B,113,128,15,DKLELLECIRRLIEVD,0
2hhf,B,129,132,3,KDWV,0
2hhf,B,203,208,5,LGGNYG,0
2hhf,B,209,219,10,PTVLVQQEALK,0
2hhf,B,268,282,14,GVVRQSLLDMAQTWG,0
2hhf,B,292,302,10,TMKQLLRALEE,0
2hhf,B,334,338,4,TMENG,0
2hhf,B,339,354,15,PELILRFQKELKEIQY,0
2hhf,B,506,510,4,KAADL,0
2hhf,B,565,570,5,SSSLHY,0
2hhf,B,592,607,15,RPWLNMDRMLRSAMRL,0
2hhf,B,613,628,15,DKLELLECIRRLIEVD,0
2hhf,B,629,632,3,KDWV,0
2hhf,B,674,678,4,FPGGS,0
2hhf,B,703,708,5,LGGNYG,0
2hhf,B,709,720,11,PTVLVQQEALKR,0
2hhf,B,768,782,14,GVVRQSLLDMAQTWG,0
2hhf,B,792,802,10,TMKQLLRALEE,0
2hhf,B,839,854,15,PELILRFQKELKEIQY,0
5cab,B,11,17,6,KPDGVQR,0
5cab,B,19,31,12,LVGEIIARFERKG,0
5cab,B,43,51,8,TTEQAQGHY,0
5cab,B,52,55,3,KDLC,0
5cab,B,59,68,9,FFPALVKYFS,0
5cab,B,81,91,10,NVVKSGRVLLG,0
5cab,B,94,98,4,NPADS,0
5cab,B,102,108,6,TIRGDFA,0
5cab,B,110,114,4,DVGRN,0
5cab,B,121,133,12,SVESAEREIAFWF,0
5cab,B,134,138,4,KADEI,0
5kg4,A,16,26,10,CFFVQVEQRQN,0
5kg4,A,27,30,3,PHLR,0
5kg4,A,51,56,5,SYEARA,0
5kg4,A,64,72,8,WADDAKKLC,0
5kg4,A,89,104,15,LTKYREASVEVMEIMS,0
5kg4,A,121,133,12,LTSAVQERLQKLQ,0
5kg4,A,138,142,4,SADLL,0
5kg4,A,162,178,16,QKEGMRKQGLFQWLDSL,0
5kg4,A,185,209,24,SPDLQLTVGAVIVEEMRAAIERETG,0
5kg4,A,219,230,11,NKVLAKLACGLN,0
5kg4,A,242,249,7,SVPQLFSQ,0
5kg4,A,250,255,5,MPIRKI,0
5kg4,A,260,271,11,GKLGASVIEILG,0
5kg4,A,274,281,7,YMGELTQF,0
5kg4,A,282,291,9,TESQLQSHFG,0
5kg4,A,291,302,11,GEKNGSWLYAMC,0
5kg4,A,326,330,4,PGKTA,0
5kg4,A,334,360,26,REQVQWWLLQLAQELEERLTKDRNDND,0
5kg4,A,391,404,13,DAHKMSHDAFTVIK,0
5kg4,A,405,407,2,NCN,0
1kd1,4,4,11,7,IQGQRRGR,0
1kd1,4,12,12,0,G,0
1kd1,4,13,17,4,TSTFR,0
1kd1,4,19,23,4,PSHRY,0
1kd1,4,163,167,4,GRTDK,0
1kd1,4,171,180,9,KAGNKHHKMK,0
1kd1,4,190,194,4,RGVAM,0
1kd1,4,195,199,4,NAVDH,0
1kd1,4,108,112,4,ELDRT,0
1kd1,4,120,135,15,DPDAAEEQIRDAHEAG,0
1kd1,4,147,151,4,VPDAV,0
1kd1,4,170,185,15,SVSDRLDHALDIVEDG,0
1kd1,4,189,194,5,AMNDIF,0
1kd1,4,213,219,6,GPVKRWG,0
1kd1,4,224,230,6,KGKHARQ,0
1kd1,4,19,24,5,PDVFET,0
1kd1,4,27,42,15,RSDLIGKAVRAAQANR,0
1kd1,4,103,118,15,NDKERQLAVRSALAAT,0
1kd1,4,120,127,7,DADLVADR,0
1kd1,4,141,147,6,SDDFEDL,0
1kd1,4,149,160,11,KTQEVVSLLEAL,0
1kd1,4,162,169,7,VHADIDRA,0
1kd1,4,177,183,6,GQGSARG,0
1kd1,4,201,206,5,STAARN,0
1kd1,4,219,224,5,NTEDLA,0
1kd1,4,225,228,3,PGGA,0
1kd1,4,237,244,7,ESALAEVA,0
1kd1,4,37,46,9,AEDILGEITG,0
1kd1,4,77,88,11,DEMAEEFLQTAL,0
1kd1,4,89,91,2,PLA,0
1kd1,4,139,144,5,YRVAKR,0
1kd1,4,152,156,4,PTKHR,0
1kd1,4,158,168,10,NPADAVAFIES,0
1kd1,4,55,77,22,NAKTMSTIGTFQSHIENMFHGVT,0
1kd1,4,106,110,4,NFLGE,0
1kd1,4,137,152,15,DIEAVGQTAADIEQLT,0
1kd1,4,9,27,18,PADLEDDALEALEVARDTG,0
1kd1,4,32,43,11,GTNETTKSIERG,0
1kd1,4,57,62,5,EEIVMH,0
1kd1,4,62,69,7,HIPELADE,0
1kd1,4,79,87,8,QQDDLGHAA,0
1kd1,4,104,118,14,AATVLEEIADKVEEL,0
1kd1,4,13,29,16,PEWKQEEVDAIVEMIES,0
1kd1,4,63,72,9,RNTLLERALD,0
1kd1,4,2,6,4,PGAMY,0
1kd1,4,58,70,12,HNALEAARVAANR,0
1kd1,4,141,148,7,NVEEAWRR,0
1kd1,4,18,31,13,IMGRVASQVAEQAL,0
1kd1,4,40,43,3,NAER,0
1kd1,4,49,63,14,REEQIVEKYEKRVDI,0
1kd1,4,74,85,11,RPDGIFKRTIRG,0
1kd1,4,91,100,9,KQRGREAFES,0
1kd1,4,122,126,4,DRLSN,0
1kd1,4,132,140,8,LGEISETLG,0
1kd1,4,116,118,2,EVA,0
1kd1,4,121,126,5,FGSVAS,0
1kd1,4,3,7,4,KKKRQ,0
1kd1,4,23,28,5,GAGHRG,0
1kd1,4,54,58,4,PQKVQ,0
1kd1,4,66,72,6,VREIDEN,0
1kd1,4,94,96,2,RDV,0
1kd1,4,126,136,10,SEGAREKVEGA,0
1kd1,4,4,13,9,AYSYIREAWK,0
1kd1,4,17,32,15,EGQIAELMWHRMQEWR,0
1kd1,4,45,53,8,RLDRARSLG,0
1kd1,4,82,86,4,RSKRM,0
1kd1,4,96,109,13,NIQRIAEERANRKF,0
1kd1,4,147,156,9,LSWISRTRHR,0
1kd1,4,158,162,4,RTFRG,0
1kd1,4,164,171,7,TSAGRRCR,0
1kd1,4,187,191,4,LRVNG,0
1kd1,4,10,15,5,MRRRRE,0
1kd1,4,19,29,10,DYHQRLRLLKS,0
1kd1,4,64,70,6,SDLAEYG,0
1kd1,4,77,95,18,NMPSAYLTGLLAGLRAQEA,0
1kd1,4,113,125,12,SKVFAIQEGAIDA,0
1kd1,4,132,136,4,NDDVL,0
1kd1,4,139,144,5,WQRTRG,0
1kd1,4,144,153,9,GAHIAEYDEQ,0
1kd1,4,168,180,12,LPEHFDELRETLL,0
1kd1,4,4,21,17,NPRLSSLIADLKSAARSS,0
1kd1,4,24,35,11,AVWGDVAERLEK,0
1kd1,4,36,40,4,PRRTH,0
1kd1,4,45,52,7,LGRIERYA,0
1kd1,4,82,93,11,SGTAETKIDQVG,0
1kd1,4,98,105,7,LEQAIENN,0
1kd1,4,3,14,11,LSAQKRLAADVL,0
1kd1,4,17,19,2,GKN,0
1kd1,4,27,33,6,RQGDIAD,0
1kd1,4,36,46,10,TREDVRELVDE,0
1kd1,4,59,71,12,RGRARERQKKRAK,0
1kd1,4,76,80,4,GAGSR,0
1kd1,4,83,88,5,KAGARQ,0
1kd1,4,89,111,22,NSKEDWESRIRAQRTKLRELRDE,0
1kd1,4,115,128,13,SSSQYRDLYDKAGG,0
1kd1,4,133,142,9,SVADLERYID,0
1kd1,4,17,21,4,KPRDR,0
1kd1,4,26,31,5,PQRAVE,0
1kd1,4,53,57,4,HPRFD,0
1kd1,4,87,89,2,TAA,0
1kd1,4,24,36,12,SFKHSKAIAREIK,0
1kd1,4,39,53,14,TAGEAVDYLEAVIEG,0
1kd1,4,81,101,20,PEKASKAFLDLLENAVGNADH,0
1kd1,4,11,22,11,TEKAMNDMDFQN,0
1kd1,4,33,46,13,SKGEVADAVEEQYD,0
1kd1,4,73,80,7,DAQEVASR,0
1kd1,4,3,13,10,QPDKQRKSQRR,0
1kd1,4,15,22,7,PLHERHKQ,0
1kd1,4,28,36,8,SADLREEYG,0
1kd1,4,92,94,2,DTS,0
1kd1,4,105,114,9,DEKREARLES,0
1kd1,4,33,41,8,SSKCENNAD,0
1kd1,4,45,49,4,EARNL,0
1kd1,4,4,10,6,HVQEIRD,0
1kd1,4,12,36,24,TPAEREAELDDLKTELLNARAVQAA,0
1kd1,4,43,64,21,PGRIKELRKAIARIKTIQGEEG,0
1kd1,4,14,24,10,HTDIQDTLEML,0
1kd1,4,38,48,10,TDAYRGMVAKV,0
1kd1,4,58,70,12,SQETLETVLATRA,0
1kd1,4,80,88,8,DDEWVAEHT,0
1kd1,4,92,102,10,DISGLAFALLS,0
1kd1,4,131,135,4,PVKEG,0
1kd1,4,142,153,11,DTEGIDDLLEAM,0
1kd1,4,15,20,5,RDARAE,0
1kd1,4,21,23,2,PNH,0
1kd1,4,24,41,17,KRADKAMILIREHLAKHF,0
1kd1,4,51,59,8,DPSINEAAW,0
1kd1,4,110,124,14,SDEDARLLTQRHRVG,0
1kd1,4,165,169,4,EAGFR,0
1kd1,4,190,194,4,VDDLE,0
1kd1,4,210,224,14,GARKRERIEEEAEDA,0
1kd1,4,10,15,5,RTGRFG,0
1kd1,4,19,34,15,GLKIRVRVADVEIKHK,0
1kd1,4,73,82,9,TVAGKAVMKA,0
1kd1,4,4,9,5,GTPSQG,0
1kd1,4,48,52,4,YEWQS,0
1kd1,4,4,18,14,SKATKKRLAKLDNQN,0
1kd1,4,22,29,7,PAWVMLKT,0
1kd1,4,34,44,10,KWIDRQRERNS,0
1kd1,4,49,54,5,DGKFSK,0
2wbf,X,573,577,4,NRLKD,0
2wbf,X,581,585,4,CISNL,0
2wbf,X,595,612,17,TSWIFASKYHLETIRCMK,0
2wbf,X,620,627,7,SALYVANC,0
2wbf,X,641,653,12,SPMEFLQIIEDYG,0
2wbf,X,664,668,4,NYVKV,0
2wbf,X,709,712,3,ERFH,0
2wbf,X,714,730,16,NMDAFVKIIKTEVMNKG,0
2wbf,X,737,742,5,KAENVM,0
2wbf,X,743,748,5,GYEFSG,0
4c1x,A,130,134,4,NASNG,0
4c1x,A,142,148,6,ELDKLKK,0
4c1x,A,257,261,4,FIKDM,0
4c1x,A,297,304,7,TPEEVQKR,0
2io1,F,369,381,12,TEDMEKEISNALG,0
2io1,F,399,403,4,RGDIQ,0
2io1,F,404,406,2,TLK,0
2io1,F,413,431,18,DEVINFYMNLLVERNKKQG,0
2io1,F,441,455,14,FFYPKLKSGGYQAVK,0
2io1,F,456,459,3,RWTK,0
2io1,F,462,466,4,NLFEQ,0
2io1,F,501,521,20,GHRICEILLQYLQDESKTKRN,0
2io1,F,547,561,14,DSGMFTCKYADYISR,0
2io1,F,571,586,15,QMPLFRKKMVWEILHQ,0
2io1,F,39,51,12,LSKLMKAYCERQG,0
2io1,F,53,55,2,SMR,0
2io1,F,412,431,19,NDEVINFYMNLLVERNKKQG,0
2io1,F,441,450,9,FFYPKLKSGG,0
2io1,F,450,455,5,GYQAVK,0
2io1,F,525,529,4,NLLEW,0
2io1,F,568,570,2,TQH,0
2io1,F,501,520,19,GHRICEILLQYLQDESKTKR,0
2io1,F,547,560,13,DSGMFTCKYADYIS,0
2io1,F,39,49,10,LSKLMKAYCER,0
3i08,D,1454,1459,5,ECQEDA,0
3i08,D,1465,1469,4,SLQCN,0
3i08,D,1470,1472,2,NHA,0
3i08,D,1473,1478,5,CGWDGG,0
3i08,D,1492,1500,8,TQSLQCWKY,0
3i08,D,1507,1511,4,DSQCN,0
3i08,D,1512,1521,9,SAGCLFDGFD,0
3i08,D,1530,1539,9,NPLYDQYCKD,0
3i08,D,1547,1551,4,DQGCN,0
3i08,D,1552,1561,9,SAECEWDGLD,0
3i08,D,1582,1589,7,PPEQLRNS,0
3i08,D,1589,1602,13,SSFHFLRELSRVLH,0
3i08,D,1685,1690,5,QCVQAS,0
3i08,D,1696,1710,14,SATDVAAFLGALASL,0
3i08,D,1475,1479,4,WDGGD,0
3i08,D,1486,1491,5,DPWKNC,0
3i08,D,1530,1541,11,NPLYDQYCKDHF,0
2isw,B,5,16,11,TLRQMLGEARKH,0
2isw,B,27,41,14,NMEQIQGIMKAVVQL,0
2isw,B,51,57,6,RGALKYS,0
2isw,B,59,73,14,MIYLKKLCEAALEKH,0
2isw,B,87,97,10,TLESVKMAIDL,0
2isw,B,110,127,17,PFDENVRITKEVVAYAHA,0
2isw,B,154,166,12,EPQDAKKFVELTG,0
2isw,B,193,204,11,IDRVKTISDLTG,0
2isw,B,216,226,10,PKDVKDMINKY,0
2isw,B,237,247,10,PIESIVHAIGE,0
2isw,B,255,273,18,DSDSRMAMTGAIRKVFVEH,0
2isw,B,279,302,23,PRDYLGPGRDAITEMLIPKIKAFG,0
2isw,B,314,319,5,SLEEAK,0
2isw,B,320,322,2,AWY,0
2isw,B,50,57,7,SRGALKYS,0
2isw,B,192,204,12,AIDRVKTISDLTG,0
2isw,B,320,323,3,AWYK,0
1jxo,B,440,446,6,DKTKDCG,0
1jxo,B,490,504,14,SKRRVERREWSRLKA,0
1jxo,B,543,555,12,TKDRANDDLLSEF,0
1jxo,B,585,595,10,SREKMEKDIQA,0
1jxo,B,633,641,8,NAVRRLQAA,0
1jxo,B,654,662,8,SLENVLEIN,0
1jxo,B,666,685,19,TEEQARKAFDRATKLEQEFT,0
1jxo,B,696,711,15,SFEEIYHKVKRVIEDL,0
3hi4,F,31,34,3,DADM,0
3hi4,F,35,44,9,WEYQMEYLSS,0
3hi4,F,68,84,16,DYDTFADDIAQLIEHLD,0
3hi4,F,95,108,13,MGGGDVARYIARHG,0
3hi4,F,136,164,28,PLDVFARFKTELLKDRAQFISDFNAPFYG,0
3hi4,F,165,168,3,INKG,0
3hi4,F,172,186,14,SQGVQTQTLQIALLA,0
3hi4,F,187,201,14,SLKATVDCVTAFAET,0
3hi4,F,203,210,7,FRPDMAKI,0
3hi4,F,226,229,3,PFET,0
3hi4,F,230,238,8,TGKVAAELI,0
3hi4,F,252,257,5,GFAVTH,0
3hi4,F,257,271,14,HAQQLNEDLLAFLKR,0
3hi4,F,257,270,13,HAQQLNEDLLAFLK,0
3hi4,F,68,83,15,DYDTFADDIAQLIEHL,0
3hi4,F,136,163,27,PLDVFARFKTELLKDRAQFISDFNAPFY,0
3hi4,F,164,168,4,GINKG,0
3hi4,F,172,185,13,SQGVQTQTLQIALL,0
3hi4,F,203,209,6,FRPDMAK,0
3hi4,F,203,208,5,FRPDMA,0
4ppm,B,376,387,11,SRLAFIDAVIAQ,0
4ppm,B,390,402,12,AREDTLDRYHQYI,0
4ppm,B,403,413,10,NPMMVDFLKLQ,0
4ppm,B,440,444,4,AGYGC,0
4ppm,B,451,464,13,PQPVVNALKNYLDA,0
4ppm,B,476,490,14,PEQTAKLAEVLCRLA,0
4ppm,B,502,519,17,SGTEAVEAAMKIAKASTG,0
4ppm,B,534,539,5,TLGALS,0
4ppm,B,543,548,5,RDKHRR,0
4ppm,B,564,574,10,DLAALREALNR,0
4ppm,B,597,609,12,GYLQAVQQLCRET,0
4ppm,B,629,634,5,FACEWD,0
4ppm,B,644,649,5,SKSLSG,0
4ppm,B,660,669,9,RADLWQKAYG,0
4ppm,B,684,701,17,GNLASVVALSALREILAQ,0
4ppm,B,702,723,21,DLVGHAERMGAYFKQALSEIAA,0
4ppm,B,767,771,4,TTWKF,0
4ppm,B,773,808,35,PDPVQAHLRAAMDRMEQALGEMFCMKFVTKLCQDHK,0
4ppm,B,830,852,22,SKAEIDRFVGAFATVCEELSTFL,0
4ppm,B,403,414,11,NPMMVDFLKLQR,0
4ppm,B,439,443,4,VAGYG,0
4ppm,B,549,551,2,YFT,0
4ppm,B,629,635,6,FACEWDG,0
4ppm,B,766,771,5,HTTWKF,0
4ppm,B,830,847,17,SKAEIDRFVGAFATVCEE,0
4ppm,B,848,853,5,LSTFLD,0
4b24,A,3,15,12,KDSDYKRAEKHLS,0
4b24,A,18,29,11,DNKWSSLVKKVG,0
4b24,A,40,52,12,APYEGIIRAITSQ,0
4b24,A,55,70,15,SDAATNSIINKFCTQC,0
4b24,A,78,84,6,TPKQIME,0
4b24,A,86,93,7,DVETLHEC,0
4b24,A,96,112,16,SKLKSQEIHIVAEAALN,0
4b24,A,117,124,7,SKSEIEKM,0
4b24,A,125,134,9,SEEELMESLS,0
4b24,A,140,151,11,KRWTIEMYSIFT,0
4b24,A,162,173,11,DSTLKNEAKEFF,0
4b24,A,180,188,8,QTEEVEKLT,0
4b24,A,189,192,3,KPCK,0
4b24,A,194,204,10,YRTIAAWYLWQ,0
4b24,A,205,208,3,IPKL,0
2eup,A,15,33,18,SYEDFQKVYNAIALKLRED,0
2eup,A,35,40,5,EYDNYI,0
2eup,A,42,55,13,YGPVLVRLAWHISG,0
2eup,A,69,72,3,GTYR,0
2eup,A,73,78,5,FKKEFN,0
2eup,A,79,84,5,DPSNAG,0
2eup,A,85,99,14,LQNGFKFLEPIHKEF,0
2eup,A,103,119,16,SSGDLFSLGGVTAVQEM,0
2eup,A,134,138,4,PEDTT,0
2eup,A,150,160,10,DAGYVRTFFQR,0
2eup,A,164,173,9,NDREVVALMG,0
2eup,A,174,177,3,AHAL,0
2eup,A,181,186,5,HLKNSG,0
2eup,A,200,209,9,NEFYLNLLNE,0
2eup,A,232,241,9,LPTDYSLIQD,0
2eup,A,241,254,13,DPKYLSIVKEYAND,0
2eup,A,254,272,18,DQDKFFKDFSKAFEKLLEN,0
2eup,A,289,293,4,LEEQG,0
1e3e,B,46,52,6,CPTDINA,0
1e3e,B,100,105,5,CKLCLS,0
1e3e,B,119,123,4,YPTID,0
1e3e,B,169,174,5,NLERVC,0
1e3e,B,175,177,2,LIG,0
1e3e,B,178,189,11,CGFSSGYGAAIN,0
1e3e,B,205,218,13,GCVGLSAIIGCKIA,0
1e3e,B,229,231,2,NGE,0
1e3e,B,232,239,7,KFPKAKAL,0
1e3e,B,246,250,4,NPREL,0
1e3e,B,253,263,10,PVQDVITELTA,0
1e3e,B,275,285,10,TAQTLKAAVDC,0
1e3e,B,307,312,5,TVDVIL,0
1e3e,B,320,324,4,FFGGW,0
1e3e,B,325,339,14,KSVDSVPNLVSDYKN,0
1e3e,B,343,348,5,DLDLLV,0
1e3e,B,356,366,10,SINDAIDLMKE,0
1e3e,B,205,219,14,GCVGLSAIIGCKIAG,0
1e3e,B,253,262,9,PVQDVITELT,0
1e3e,B,356,365,9,SINDAIDLMK,0
2qg9,D,11,15,4,SINDL,0
2qg9,D,16,33,17,SRDDLNLVLATAAKLKAN,0
2qg9,D,52,66,14,STRTRLSFETSMHRL,0
2qg9,D,87,99,12,TLADTISVISTYV,0
2qg9,D,110,119,9,GAARLATEFS,0
2qg9,D,134,150,16,HPTQTLLDLFTIQETQG,0
2qg9,D,168,177,9,TVHSLTQALA,0
2qg9,D,189,193,4,PDALA,0
2qg9,D,196,206,10,QYILDMLDEKG,0
2qg9,D,214,218,4,SIEEV,0
2qg9,D,236,244,8,DPSEYANVK,0
2qg9,D,245,247,2,AQF,0
2qg9,D,251,256,5,ASDLHN,0
2qg9,D,274,280,6,ATDVDKT,0
2qg9,D,284,305,21,WYFQQAGNGIFARQALLALVLN,0
2qg9,D,24,33,9,QIGFKLLSLF,0
2qg9,D,67,75,8,SEDQVDQLA,0
2qg9,D,147,152,5,HNVVLA,0
2qg9,D,52,65,13,STRTRLSFETSMHR,0
2qg9,D,76,79,3,SANT,0
2qg9,D,87,96,9,TLADTISVIS,0
2qg9,D,110,116,6,GAARLAT,0
2qg9,D,195,205,10,PQYILDMLDEK,0
2qg9,D,236,245,9,DPSEYANVKA,0
2qg9,D,250,255,5,RASDLH,0
2qg9,D,25,33,8,IGFKLLSLF,0
2qg9,D,114,118,4,CISHA,0
2qg9,D,147,151,4,HNVVL,0
3bmy,A,23,36,13,QAEIAQLMSLIINT,0
3bmy,A,42,66,24,EIFLRELISNSSDALDKIRYESLTD,0
3bmy,A,67,71,4,PSKLD,0
3bmy,A,99,109,10,TKADLINNLGT,0
3bmy,A,111,124,13,AKSGTKAFMEALQA,0
3bmy,A,127,135,8,DISMIGQFG,0
3bmy,A,136,143,7,VGFYSAYL,0
3bmy,A,192,198,6,EDQTEYL,0
3bmy,A,199,212,13,EERRIKEIVKKHSQ,0
1xhx,D,43,55,12,SLDEFMAWVLKVQ,0
1xhx,D,62,76,14,NLKFAGAFIINWLER,0
1xhx,D,123,125,2,LKK,0
1xhx,D,129,138,9,PVKKIAKDFK,0
1xhx,D,159,182,23,TPEEYAYIKNDIQIIAEALLIQFK,0
1xhx,D,189,203,14,TAGSDSLKGFKDIIT,0
1xhx,D,203,211,8,TTKKFKKVF,0
1xhx,D,215,224,9,SLGLDKEVRY,0
1xhx,D,235,238,3,DRFK,0
1xhx,D,252,261,9,SLYPAQMYSR,0
1xhx,D,330,339,9,NVDLELMKEH,0
1xhx,D,360,373,13,FKDFIDKWTYIKTT,0
1xhx,D,375,388,13,EGAIKQLAKLMLNS,0
1xhx,D,388,394,6,SLYGKFA,0
1xhx,D,426,448,22,YTPMGVFITAWARYTTITAAQAC,0
1xhx,D,468,475,7,PDVIKDIV,0
1xhx,D,534,539,5,TDKIKK,0
1xhx,D,375,395,20,EGAIKQLAKLMLNSLYGKFAS,0
1xhx,D,62,75,13,NLKFAGAFIINWLE,0
1xhx,D,215,225,10,SLGLDKEVRYA,0
1xhx,D,375,389,14,EGAIKQLAKLMLNSL,0
1xhx,D,390,394,4,YGKFA,0
1xhx,D,468,472,4,PDVIK,0
1xhx,D,122,126,4,SLKKL,0
1xhx,D,129,137,8,PVKKIAKDF,0
1xhx,D,159,183,24,TPEEYAYIKNDIQIIAEALLIQFKQ,0
5ap0,A,561,579,18,DNQTLDSYRNEIAYLNKLQ,0
5ap0,A,609,616,7,LNSWLKKK,0
5ap0,A,620,640,20,DPWERKSYWKNMLEAVHTIHQ,0
5ap0,A,649,651,2,KPA,0
5ap0,A,691,698,7,PPEAIKDM,0
5ap0,A,712,730,18,SPKSDVWSLGCILYYMTYG,0
5ap0,A,739,749,10,NQISKLHAIID,0
5ap0,A,761,772,11,EKDLQDVLKCCL,0
5ap0,A,781,787,6,SIPELLA,0
5ap0,A,788,793,5,HPYVQI,0
3ppq,B,41,59,18,MTESEIVANMIAQLIEHDT,0
3ppq,B,71,81,10,SNYVQHQAMLG,0
3ppq,B,92,98,6,SGTDLTS,0
3ppq,B,107,124,17,DPKKALNIVQNEFQKRFS,0
3ppq,B,143,150,7,KKFAEKEH,0
3ppq,B,154,163,9,VSDLKKNASQ,0
3ppq,B,171,175,4,AWLKR,0
3ppq,B,179,188,9,GYKGFVSTYG,0
3ppq,B,198,200,2,QIG,0
3ppq,B,201,208,7,LVYDAVKN,0
3ppq,B,221,226,5,GRIKAY,0
3ppq,B,249,255,6,EKVLKEH,0
3ppq,B,257,264,7,ELEGVINK,0
3ppq,B,270,283,13,DTETMQELNYEVDG,0
3ppq,B,287,299,12,EPSVVAKEFLEKH,0
3ppq,B,300,303,3,HYFD,0
3ppq,B,71,82,11,SNYVQHQAMLGG,0
3ppq,B,144,149,5,KFAEKE,0
3ppq,B,154,159,5,VSDLKK,0
3ppq,B,160,163,3,NASQ,0
3ppq,B,257,263,6,ELEGVIN,0
1j7i,A,7,15,8,SPELKKLIE,0
1j7i,A,56,67,11,DVEREKDMMLWL,0
1j7i,A,107,123,16,SPEKIIELYAECIRLFH,0
1j7i,A,135,148,13,SLDSRLAELDYLLN,0
1j7i,A,158,163,5,NWEEDT,0
1j7i,A,167,179,12,DPRELYDFLKTEK,0
1j7i,A,217,232,15,KWYDIAFCVRSIREDI,0
1j7i,A,236,245,9,QYVELFFDLL,0
1j7i,A,250,264,14,DWEKIKYYILLDELF,0
3otn,B,38,50,12,TSKESALALTNSA,0
3otn,B,51,58,7,YLKNTVFN,0
3otn,B,69,73,4,ILLLE,0
3otn,B,83,86,3,NSQS,0
3otn,B,87,93,6,NYKDFQD,0
3otn,B,102,125,23,YIEDWWQDCYAGIANCNLALQKLG,0
3otn,B,131,158,27,DASLVNGYAEVKFRALYYFYLVRIFG,0
3otn,B,166,170,4,VQSEL,0
3otn,B,179,187,8,PVKEIYDEI,0
3otn,B,187,197,10,IIIPDLLEAEQ,0
3otn,B,210,227,17,SGAVKALLADVYLTYAG,0
3otn,B,233,250,17,GKSYYAESAKRSLEVIKS,0
3otn,B,259,268,9,YESLRLPSQN,0
3otn,B,286,292,6,NESVRIF,0
3otn,B,312,317,5,TKEFVE,0
3otn,B,323,327,4,DKRTE,0
3otn,B,347,351,4,AAELE,0
3otn,B,365,371,6,DQVAVDN,0
3otn,B,384,400,16,YTDVLLYAEAQVNADG,0
3otn,B,403,417,14,NQQSIDIVNQIRGRA,0
3otn,B,426,443,17,NASAFLEEVWDQRYFDLC,0
3otn,B,447,456,9,KWFDLRTR,0
3otn,B,481,486,5,TETQLL,0
3otn,B,490,497,7,PLSERQAN,0
3otn,B,67,71,4,NTILL,0
3otn,B,233,251,18,GKSYYAESAKRSLEVIKSN,0
3otn,B,258,268,10,DYESLRLPSQN,0
1yd9,D,27,31,4,DIASI,0
1yd9,D,48,74,26,GEVGSTLEKKGGKEFVEAVLELRKKNG,0
1yd9,D,106,125,19,KCEELLEKTVKNCLALADDR,0
1yd9,D,143,160,17,PKQTAAQLILKAISSYFV,0
1yd9,D,176,188,12,DSESIGIYVQEMA,0
1yd9,D,143,162,19,PKQTAAQLILKAISSYFVST,0
1yd9,D,176,190,14,DSESIGIYVQEMAKL,0
1yd9,D,28,31,3,IASI,0
4d06,F,18,20,2,SED,0
4d06,F,21,32,11,YRPKLQRWIYKV,0
4d06,F,32,42,10,VHIPDSISQFE,0
4d06,F,59,64,5,QGDRFG,0
4d06,F,81,86,5,DPRLEI,0
4d06,F,94,101,7,PMDVLVWQ,0
4d06,F,119,125,6,DAGNAAR,0
4d06,F,155,158,3,IEDG,0
4d06,F,174,185,11,DKAEGEKWLFEK,0
4d06,F,185,193,8,KVVPILQAA,0
4d06,F,205,209,4,KKDIN,0
4d06,F,223,232,9,NQSGWYKVMV,0
4d06,F,233,238,5,DDMKAL,0
4d06,F,270,275,5,NNLANY,0
4d06,F,95,101,6,MDVLVWQ,0
4d06,F,271,275,4,NLANY,0
3o92,D,11,16,5,TEDFVA,0
3o92,D,24,30,6,GAPAQAI,0
3o92,D,30,44,14,ISDAISKVTRLAFER,0
3o92,D,62,67,5,HPESKL,0
3o92,D,76,80,4,TSGRN,0
3o92,D,83,93,10,GDLGIFYQEHG,0
3o92,D,113,121,8,DLDIRLRER,0
3o92,D,135,147,12,IVLHTAIDAYNL,0
3o92,D,162,176,14,WPENHQFALGHFKNT,0
3o92,D,24,29,5,GAPAQA,0
3o92,D,30,45,15,ISDAISKVTRLAFERG,0
5kgp,B,8,21,13,DFSSIVDLWNKNIG,0
5kgp,B,27,38,11,NLELFKQNYIND,0
5kgp,B,85,88,3,INFR,0
5kgp,B,91,107,16,GIGTKLLDAAEEELINS,0
5kgp,B,128,130,2,ECL,0
5kgp,B,131,139,8,PSEEFFLVR,0
5kgp,B,174,176,2,KPE,0
5kgp,B,177,189,12,DRKGLFEFLEKSF,0
5kgp,B,191,201,10,GRWLEEFIEFF,0
5kgp,B,206,208,2,KER,0
5kgp,B,234,238,4,GPPIY,0
5kgp,B,239,243,4,WKALL,0
5kgp,B,257,260,3,KTYR,0
5kgp,B,263,279,16,GLGRLLLYESLQILKKR,0
5kgp,B,293,299,6,IINFYGR,0
5kgp,B,155,157,2,SKV,0
5kgp,B,191,203,12,GRWLEEFIEFFQV,0
2dm3,A,74,78,4,TSRDA,0
5v69,B,1506,1511,5,TYRSQL,0
5v69,B,1527,1531,4,DEKQN,0
5v69,B,1542,1554,12,TADETKALKELYG,0
5v69,B,1559,1571,12,TFLHRFYSLKAAV,0
5v69,B,1572,1574,2,HGW,0
5v69,B,1591,1602,11,NCYLNAVIMTLD,0
5v69,B,1611,1623,12,IPALQHAFMKHKG,0
5v69,B,1626,1637,11,STDFIALIMAYG,0
5v69,B,1646,1656,10,DASRLLHTVLA,0
5v69,B,1685,1687,2,LKA,0
5v69,B,1695,1700,5,TVEDLR,0
5v69,B,22,35,13,TIENVKAKIQDKEG,0
5v69,B,37,39,2,PPD,0
2qlm,A,13,17,4,ISVRG,0
2qlm,A,20,38,18,GVENVTELKKNFNRHLHFT,0
2qlm,A,47,78,31,TPRDYYFALAHTVRDHLVGRWIRTQQHYYEKD,0
2qlm,A,94,102,8,TLQNTMVNL,0
2qlm,A,104,115,11,LENACDEATYQL,0
2qlm,A,118,124,6,DMEELEE,0
2qlm,A,134,150,16,GGLGRLAACFLDSMATL,0
2qlm,A,194,197,3,PEFT,0
2qlm,A,261,268,7,GYIQAVLD,0
2qlm,A,268,274,6,DRNLAEN,0
2qlm,A,275,277,2,ISR,0
2qlm,A,289,313,24,KELRLKQEYFVVAATLQDIIRRFKS,0
2qlm,A,325,327,2,NFD,0
2qlm,A,328,332,4,AFPDK,0
2qlm,A,344,356,12,LAIPELMRVLVDL,0
2qlm,A,360,371,11,DWDKAWEVTVKT,0
2qlm,A,380,384,4,LPEAL,0
2qlm,A,389,396,7,VHLLETLL,0
2qlm,A,396,418,22,LPRHLQIIYEINQRFLNRVAAAF,0
2qlm,A,421,429,8,DVDRLRRMS,0
2qlm,A,441,448,7,MAHLCIAG,0
2qlm,A,456,466,10,ARIHSEILKKT,0
2qlm,A,468,475,7,FKDFYELE,0
2qlm,A,487,492,5,TPRRWL,0
2qlm,A,496,508,12,NPGLAEIIAERIG,0
2qlm,A,509,525,16,EEYISDLDQLRKLLSYV,0
2qlm,A,527,554,27,DEAFIRDVAKVKQENKLKFAAYLEREYK,0
2qlm,A,571,574,3,HEYK,0
2qlm,A,575,593,18,RQLLNCLHVITLYNRIKKE,0
2qlm,A,613,631,18,YHMAKMIIKLITAIGDVVN,0
2qlm,A,649,657,8,RVSLAEKVI,0
2qlm,A,658,660,2,PAA,0
2qlm,A,676,684,8,TGNMFMLN,0
2qlm,A,695,704,9,ANVEMAEEAG,0
2qlm,A,705,708,3,EENF,0
2qlm,A,714,725,11,RVEDVDRLDQRG,0
2qlm,A,727,735,8,NAQEYYDRI,0
2qlm,A,735,748,13,IPELRQIIEQLSSG,0
2qlm,A,758,768,10,FKDIVNMLMHH,0
2qlm,A,773,775,2,VFA,0
2qlm,A,776,792,16,DYEEYVKCQERVSALYK,0
2qlm,A,793,806,13,NPREWTRMVIRNIA,0
2qlm,A,807,811,4,TSGKF,0
2qlm,A,812,824,12,SSDRTIAQYAREI,0
3faa,E,176,186,10,TLKDLIYDMTT,0
3faa,E,194,203,9,PLLVQRTIAR,0
3faa,E,238,249,11,EERSWFREAEIY,0
3faa,E,270,273,3,NGTW,0
3faa,E,287,295,8,SLFDYLNRY,0
3faa,E,298,318,20,TVEGMIKLALSTASGLAHLHM,0
3faa,E,351,355,4,DLGLA,0
3faa,E,380,385,5,APEVLD,0
3faa,E,393,413,20,FESFKRADIYAMGLVFWEIAR,0
3faa,E,437,446,9,SVEEMRKVVC,0
3faa,E,455,459,4,PNRWQ,0
3faa,E,461,475,14,CEALRVMAKIMRECW,0
3faa,E,484,499,15,TALRIKKTLSQLSQQE,0
3faa,E,176,187,11,TLKDLIYDMTTS,0
3faa,E,194,204,10,PLLVQRTIART,0
3faa,E,238,250,12,EERSWFREAEIYQ,0
3faa,E,270,274,4,NGTWT,0
3faa,E,335,337,2,KSK,0
3faa,E,375,379,4,TKRYM,0
3faa,E,392,413,21,HFESFKRADIYAMGLVFWEIAR,0
3faa,E,456,460,4,NRWQS,0
3faa,E,461,476,15,CEALRVMAKIMRECWY,0
3faa,E,478,482,4,NGAAR,0
3faa,E,176,185,9,TLKDLIYDMT,0
3faa,E,235,237,2,SSR,0
3faa,E,288,292,4,LFDYL,0
3faa,E,300,318,18,EGMIKLALSTASGLAHLHM,0
3faa,E,438,447,9,VEEMRKVVCE,0
3faa,E,461,473,12,CEALRVMAKIMRE,0
3faa,E,484,492,8,TALRIKKTL,0
3faa,E,493,497,4,SQLSQ,0
3faa,E,194,205,11,PLLVQRTIARTI,0
3faa,E,287,294,7,SLFDYLNR,0
3faa,E,437,445,8,SVEEMRKVV,0
3faa,E,484,497,13,TALRIKKTLSQLSQ,0
3faa,E,393,414,21,FESFKRADIYAMGLVFWEIARR,0
3faa,E,437,447,10,SVEEMRKVVCE,0
3faa,E,484,498,14,TALRIKKTLSQLSQQ,0
2c4q,C,25,29,4,FANGV,0
2c4q,C,97,112,15,TNSDCELIVKAMQGLL,0
2c4q,C,116,124,8,NPIPSAIAA,0
2c4q,C,78,81,3,PVAA,0
2c4q,C,97,113,16,TNSDCELIVKAMQGLLK,0
2c4q,C,37,41,4,SRSQA,0
3ejj,X,4,10,6,SEHCSHM,0
3ejj,X,12,24,12,GNGHLKVLQQLID,0
3ejj,X,45,64,19,DPVCYLKKAFFLVQDIIDET,0
3ejj,X,71,87,16,TPNANATERLQELSNNL,0
3ejj,X,88,91,3,NSCF,0
3ejj,X,109,131,22,TPLQLLEKIKNFFNETKNLLEKD,0
3ejj,X,139,146,7,CNNSFAKC,0
3ejj,X,5,10,5,EHCSHM,0
3ejj,X,15,25,10,HLKVLQQLIDS,0
3ejj,X,40,43,3,QEQL,0
3ejj,X,71,86,15,TPNANATERLQELSNN,0
3ejj,X,75,79,4,TFKNT,0
3ejj,X,131,136,5,DPALKD,0
3ejj,X,168,172,4,KVLDS,0
2yxt,B,20,31,11,GNRAATFPLQVL,0
2yxt,B,58,72,14,NSDELQELYEGLRLN,0
2yxt,B,87,105,18,DKSFLAMVVDIVQELKQQN,0
2yxt,B,131,139,8,DLLPVYKEK,0
2yxt,B,140,144,4,VVPLA,0
2yxt,B,150,159,9,NQFEAELLSG,0
2yxt,B,164,179,15,SQEEALRVMDMLHSMG,0
2yxt,B,232,248,16,GTGDLFAAMLLAWTHKH,0
2yxt,B,251,278,27,NLKVACEKTVSTLHHVLQRTIQCAKAQA,0
2yxt,B,293,295,2,MVQ,0
2yxt,B,296,302,6,SKRDIED,0
2yxt,B,139,144,5,KVVPLA,0
2yxt,B,251,276,25,NLKVACEKTVSTLHHVLQRTIQCAKA,0
4m05,E,2,7,5,DREKLL,0
4m05,E,23,28,5,HDWWDL,0
4m05,E,29,48,19,PGESRVISVAEVKGLVEQWS,0
4m05,E,75,89,14,TLSDTQQFLSAFMGT,0
4m05,E,91,93,2,LGR,0
4m05,E,110,114,4,YVAGF,0
4m05,E,115,123,8,PESMKTELQ,0
4m05,E,142,148,6,DAEWWAL,0
4m05,E,149,165,16,DQEARTALMQEHTQAAL,0
4m05,E,166,168,2,PYL,0
4m05,E,194,207,13,RLEDFHNLVRALQQ,0
4m05,E,209,212,3,KEFR,0
4m05,E,228,234,6,PLDEILE,0
4m05,E,235,237,2,KFA,0
4m05,E,75,87,12,TLSDTQQFLSAFM,0
4m05,E,115,124,9,PESMKTELQV,0
4m05,E,228,236,8,PLDEILEKF,0
4m05,E,2,6,4,DREKL,0
4m05,E,228,235,7,PLDEILEK,0
4m05,E,194,206,12,RLEDFHNLVRALQ,0
4m05,E,207,208,1,QV,0
4m05,E,3,7,4,REKLL,0
2duj,A,7,14,7,PWGLARIS,0
2duj,A,46,50,4,HPEFE,0
2duj,A,68,79,11,GHGTHCAGTVGS,0
2duj,A,103,118,15,QYSTIIAGMDFVASDK,0
2duj,A,119,121,2,NNR,0
2duj,A,138,151,13,SSSVNSAAARLQSS,0
2duj,A,165,167,2,DAR,0
2duj,A,222,240,18,GTSMATPHVAGLAAYLMTL,0
2duj,A,247,255,8,SACRYIADT,0
3ae0,B,2,19,17,TMMDMNFKYCHKIMKKHS,0
3ae0,B,22,27,5,FSYAAD,0
3ae0,B,30,53,23,PEDQRKAVWAIYAVCRKIDDSIDV,0
3ae0,B,56,73,17,DIQFLNQIKEDIQSIEKY,0
3ae0,B,83,95,12,DRRIMMALQHVAQ,0
3ae0,B,100,114,14,AFQSFYNLIDTVYKD,0
3ae0,B,122,134,12,TDAELFGYCYGVA,0
3ae0,B,134,146,12,AGTVGEVLTPILS,0
3ae0,B,150,179,29,THQTYDVARRLGESLQLINILRDVGEDFEN,0
3ae0,B,185,192,7,SKQRLKQY,0
3ae0,B,195,203,8,DIAEVYQNG,0
3ae0,B,205,229,24,NNHYIDLWEYYAAIAEKDFRDVMDQ,0
3ae0,B,230,233,3,IKVF,0
3ae0,B,236,258,22,EAQPIIELAARIYIEILDEVRQA,0
3ae0,B,269,284,15,EKRKKAKLFHEINSKY,0
3ae0,B,30,50,20,PEDQRKAVWAIYAVCRKIDDS,0
3ae0,B,150,172,22,THQTYDVARRLGESLQLINILRD,0
3ae0,B,172,179,7,DVGEDFEN,0
3ae0,B,185,193,8,SKQRLKQYE,0
3ae0,B,237,258,21,AQPIIELAARIYIEILDEVRQA,0
3ae0,B,269,282,13,EKRKKAKLFHEINS,0
2kiu,A,8,19,11,TYASLIRQAILE,0
2kiu,A,26,38,12,TLNEIYNWFTRMF,0
2kiu,A,39,42,3,PYFR,0
2kiu,A,44,59,15,NAATWKNAVRHNLSLH,0
2kiu,A,76,83,7,DEVEFQKR,0
1uv0,A,34,43,9,SWTDADLACQ,0
1uv0,A,55,67,12,SGAEGSFVSSLVK,0
1uv0,A,110,114,4,NPSTI,0
1uv0,A,126,128,2,STA,0
3vkb,B,23,32,9,GRVLARLREH,0
3vkb,B,46,60,14,PVTEAVEKAAELTRL,0
3vkb,B,74,90,16,SFESHMEPYVAAVKAAT,0
3vkb,B,125,130,5,DDYFVW,0
3vkb,B,130,140,10,WKSFLETLAAF,0
3vkb,B,145,149,4,PREEW,0
3vkb,B,163,171,8,DPRTGDLLG,0
3vkb,B,180,193,13,TEEIDRYLHVARAF,0
3vkb,B,208,219,11,PPEVVRHFRKGL,0
3vkb,B,233,243,10,SGRQVTEYLDS,0
3vkb,B,251,255,4,AGALE,0
3vkb,B,258,267,9,DWRSALAEIA,0
3vkb,B,46,61,15,PVTEAVEKAAELTRLG,0
3l6x,B,367,375,8,ELPEVIAML,0
3l6x,B,379,395,16,LDAVKSNAAAYLQHLCY,0
3l6x,B,397,407,10,NDKVKTDVRKL,0
3l6x,B,408,416,8,KGIPVLVGL,0
3l6x,B,417,419,2,LDH,0
3l6x,B,421,436,15,KKEVHLGACGALKNIS,0
3l6x,B,440,450,10,DQDNKIAIKNC,0
3l6x,B,451,463,12,DGVPALVRLLRKA,0
3l6x,B,465,480,15,DMDLTEVITGTLWNLS,0
3l6x,B,481,484,3,SHDS,0
3l6x,B,485,493,8,IKMEIVDHA,0
3l6x,B,493,501,8,ALHALTDEV,0
3l6x,B,501,507,6,VIIPHSG,0
3l6x,B,523,538,15,WESVLTNTAGCLRNVS,0
3l6x,B,541,551,10,RSEARRKLREC,0
3l6x,B,553,568,15,GLVDALIFIVQAEIGQ,0
3l6x,B,573,588,15,SKLVENCVCLLRNLSY,0
3l6x,B,589,594,5,QVHREI,0
3l6x,B,648,654,6,RGYELLF,0
3l6x,B,655,669,14,QPEVVRIYISLLKES,0
3l6x,B,671,687,16,TPAILEASAGAIQNLCA,0
3l6x,B,690,701,11,WTYGRYIRSALR,0
3l6x,B,702,712,10,QEKALSAIADL,0
3l6x,B,713,715,2,LTN,0
3l6x,B,717,733,16,HERVVKAASGALRNLAV,0
3l6x,B,737,752,15,NKELIGKHAIPNLVKN,0
3l6x,B,759,763,4,NSSWN,0
3l6x,B,765,781,16,SEDTVISILNTINEVIA,0
3l6x,B,783,793,10,NLEAAKKLRET,0
3l6x,B,794,804,10,QGIEKLVLINK,0
3l6x,B,809,825,16,SEKEVRAAALVLQTIWG,0
3l6x,B,826,835,9,YKELRKPLEK,0
3l6x,B,839,844,5,KKSDFQ,0
3l6x,B,770,774,4,DLSQL,0
5xqp,D,18,20,2,TPA,0
5xqp,D,33,35,2,PFA,0
5xqp,D,36,41,5,EMSQIV,0
5xqp,D,56,60,4,MPGMV,0
5xqp,D,33,40,7,PFAEMSQI,0
2eoe,A,24,33,9,QNSHLANHQR,0
2eoe,A,34,36,2,IHT,0
5x5j,A,21,35,14,DYDIGDIIENYLKRE,0
5x5j,A,44,55,11,NGKQAIELHASQ,0
5x5j,A,70,80,10,NGWEVLNKIRQ,0
5x5j,A,96,102,6,IDKVMAL,0
5x5j,A,115,129,14,NPNEVIARVQAVLRR,0
3nt0,A,108,113,5,PGEVDG,0
3nt0,A,147,155,8,KTGRQVAMG,0
3nt0,A,164,169,5,DDEILK,0
3nt0,A,201,208,7,DVMTAAVG,0
3nt0,A,356,372,16,DPMLDMMGMQMLMEKYG,0
3nt0,A,373,377,4,DQAMA,0
3nt0,A,463,467,4,AAHRA,0
3nt0,A,491,495,4,PKEHA,0
3nt0,A,502,508,6,LLEHEDT,0
3nkh,B,3,21,18,ELNEIESIIKDINTKAQK,0
3nkh,B,23,44,21,SGIHKRFYLFVALTEFQALNG,0
3nkh,B,46,52,6,RIGELA,0
3nkh,B,54,56,2,QNE,0
3nkh,B,99,120,21,SSRSCEILKKAILENKKDSKWN,0
3nkh,B,139,154,15,QTERFNKILREAAKDV,0
3nkh,B,161,176,15,SSHILRHSHISLLSQQ,0
3nkh,B,179,188,9,SLKAIDRVG,0
3nkh,B,191,209,18,DHRTTLSIYSHVTEQDKD,0
3nkh,B,209,216,7,DNKLEQ,0
3nkh,B,3,20,17,ELNEIESIIKDINTKAQK,0
3nkh,B,209,215,6,DNKLE,0
1f3y,A,52,66,14,DPRNAAIRELREETG,0
1f3y,A,85,92,7,PPKVREKL,0
1f3y,A,93,96,3,NIQW,0
1f3y,A,115,119,4,QDQEI,0
1f3y,A,138,146,8,TPEQLIDLT,0
1f3y,A,147,149,2,VEF,0
1f3y,A,150,162,12,KKPVYKEVLSVFA,0
1f3y,A,163,165,2,PHL,0
4duu,A,26,37,11,SIEECAAKCEED,0
4duu,A,78,82,4,KVYLS,0
4duu,A,706,711,5,ENKVCN,0
4duu,A,777,791,14,VSRFVTWIEGVMRNN,0
3bfb,A,7,25,18,PEVFDLVAEDKARCMSEHG,0
3bfb,A,27,36,9,TQAQIDDVDK,0
3bfb,A,42,56,14,EPSITCYMYCLLEAF,0
3bfb,A,66,74,8,DEDIMLGLL,0
3bfb,A,78,90,12,LQERAQSVMGKCL,0
3bfb,A,96,112,16,DNCNKIYNLAKCVQESA,0
4jn5,B,12,23,11,TSAQHEVWLAQQ,0
4jn5,B,44,58,14,DHAVLSRALRLTVAG,0
4jn5,B,59,62,3,TETL,0
4jn5,B,112,126,14,DPEGEAQRWMDRDRA,0
4jn5,B,161,182,21,DGTSMALFYERLAEVYRALRDG,0
4jn5,B,192,206,14,DTDRMVAGEEAYRAS,0
4jn5,B,206,220,14,SARYERDRAYWTGLF,0
4jn5,B,248,263,15,PPERTEVLGRAAEATG,0
4jn5,B,265,283,18,HWARVVIAGVAAFLHRTTG,0
4jn5,B,300,304,4,NARIT,0
4jn5,B,323,340,17,SFARVVETVSEAMSGLLA,0
4jn5,B,345,354,9,RGEDLDRELG,0
4jn5,B,416,437,21,GGQDLTVLQERFVRFLAELAAD,0
4jn5,B,12,24,12,TSAQHEVWLAQQL,0
4jn5,B,44,59,15,DHAVLSRALRLTVAGT,0
4jn5,B,60,62,2,ETL,0
4jn5,B,161,181,20,DGTSMALFYERLAEVYRALRD,0
4jn5,B,207,220,13,ARYERDRAYWTGLF,0
4jn5,B,298,303,5,GANARI,0
4jn5,B,323,341,18,SFARVVETVSEAMSGLLAH,0
4jn5,B,421,437,16,TVLQERFVRFLAELAAD,0
4jn5,B,441,445,4,TVDEV,0
3t0t,D,11,15,4,GPASE,0
3t0t,D,16,27,11,SEEMIEKLINAG,0
3t0t,D,39,57,18,SHEEHKGRIDTIRKVAKRL,0
3t0t,D,110,115,5,NLINDV,0
3t0t,D,171,184,13,TEKDAEDIRFGIKE,0
3t0t,D,196,211,15,RPSDVLEIREILEEQK,0
3t0t,D,222,228,6,NQEGIDN,0
3t0t,D,228,234,6,NIEEILE,0
3t0t,D,243,250,7,RGDMGVEI,0
3t0t,D,254,269,15,KVPMVQKDLIRQCNKL,0
3t0t,D,280,285,5,LDSMQR,0
3t0t,D,290,304,14,TRAEASDVANAIYDG,0
3t0t,D,311,316,5,SGETAA,0
3t0t,D,319,337,18,YPEEAVKTMRNIAVSAEAA,0
3t0t,D,339,351,12,DYKKLLSDRTKLV,0
3t0t,D,357,371,14,NAIGISVAHTALNLN,0
3t0t,D,382,391,9,GSTARTISKY,0
3t0t,D,404,409,5,EETARQ,0
3t0t,D,410,413,3,CSIV,0
3t0t,D,426,441,15,STDALLNNAVATAVET,0
3t0t,D,497,501,4,VKDLE,0
3t0t,D,519,524,5,FVPYVE,0
3t0t,D,538,547,9,SPSAIVGLEK,0
3t0t,D,557,562,5,KAVKNI,0
3t0t,D,110,114,4,NLIND,0
3t0t,D,354,356,2,SLV,0
5ph9,A,30,41,11,DFDKYIAYMESQ,0
5ph9,A,42,46,4,GAHRA,0
5ph9,A,98,106,8,VGEYRHLAN,0
5ph9,A,117,129,12,NFEDLERKYWKNR,0
5ph9,A,130,132,2,IYN,0
5ph9,A,159,169,10,TIQDLLEKECG,0
5ph9,A,194,198,4,EDMDL,0
5ph9,A,216,218,2,PPE,0
5ph9,A,219,231,12,HGQRLERLARELF,0
5ph9,A,231,238,7,FPGSSRGC,0
5ph9,A,240,245,5,AFLRHK,0
5ph9,A,250,257,7,SPTVLKEN,0
5ph9,A,299,307,8,RWIDYGKMA,0
5ph9,A,319,329,10,FSMDAFVRILQ,0
5ph9,A,329,341,12,QPERYDLWKRGQD,0
3s7i,B,178,180,2,PSR,0
3s7i,B,198,203,5,RFDQRS,0
3s7i,B,204,210,6,RQFQNLQ,0
3s7i,B,311,316,5,SYLQGF,0
3s7i,B,317,326,9,SRNTLEAAFN,0
3s7i,B,328,336,8,EFNEIRRVL,0
3s7i,B,369,378,9,SKEHVEELTK,0
3s7i,B,423,430,7,NPQLQDLD,0
3s7i,B,549,554,5,NVIDQI,0
3s7i,B,555,563,8,EKQAKDLAF,0
3s7i,B,566,576,10,SGEQVEKLIKN,0
3s7i,B,369,377,8,SKEHVEELT,0
3s4w,B,1,9,8,MDLKILSLA,0
3s4w,B,14,23,9,TDKLQEFLQT,0
3s4w,B,28,39,11,DLASLLQNQAVK,0
3s4w,B,40,53,13,GRAVGTLLRAVLKG,0
3s4w,B,58,79,21,EEDGALRRYKIYSCCIQLVESG,0
3s4w,B,82,97,15,QQDVASEIIGLLMLEV,0
3s4w,B,101,118,17,PGPLLVDLASDFVGAVRE,0
3s4w,B,123,127,4,NGKSL,0
3s4w,B,128,138,10,ELLPIILTALA,0
3s4w,B,152,167,15,NGEEYKRQLIDTLCSV,0
3s4w,B,173,182,9,YMIQLTSVFK,0
3s4w,B,187,201,14,TPEEMNLVVAKVLTM,0
3s4w,B,202,205,3,FSKL,0
3s4w,B,206,208,2,NLQ,0
3s4w,B,209,222,13,EIPPLVYQLLVLSS,0
3s4w,B,225,249,24,SRRSVLDGIIAFFRELDKQHREEQS,0
3s4w,B,260,282,22,PADELYHVEGTVILHIVFAIKLD,0
3s4w,B,283,294,11,CELGRELLKHLK,0
3s4w,B,299,305,6,GDPSKCL,0
3s4w,B,306,317,11,CPFSIALLLSLT,0
3s4w,B,321,345,24,RFEEQVFDLLKTSVVKSFKDLQLLQ,0
3s4w,B,347,354,7,SKFLQTLV,0
3s4w,B,359,370,11,CVSTMILEVVRN,0
3s4w,B,371,374,3,SVHS,0
3s4w,B,375,394,19,WDHVTQGLIEFGFILMDSYG,0
3s4w,B,411,433,22,SKMTNQHACKLGANILLETFKIH,0
3s4w,B,436,451,15,IRQEILEQVLNRVVTR,0
3s4w,B,456,470,14,INHFLDLFSDIIMYA,0
3s4w,B,470,475,5,APLILQ,0
3s4w,B,477,483,6,CSKVTET,0
3s4w,B,484,486,2,FDY,0
3s4w,B,491,502,11,PLQTVQGLLKAV,0
3s4w,B,502,507,5,VQPLLK,0
3s4w,B,509,524,15,SMSMRDSLILVLRKAM,0
3s4w,B,528,545,17,QLDARKSAVAGFLLLLKN,0
3s4w,B,545,550,5,NFKVLG,0
3s4w,B,554,560,6,SSQCTQS,0
3s4w,B,571,592,21,HSRYSAVANETFCLEIIDSLKR,0
3s4w,B,593,596,3,SLGQ,0
3s4w,B,597,615,18,QADIRLMLYDGFYDVLRRN,0
3s4w,B,618,634,16,LASSIMQTLFSQLKQFY,0
3s4w,B,646,648,2,LGA,0
3s4w,B,662,680,18,PLDHLLSCIQHCLAWYKSR,0
3s4w,B,696,715,19,ELYSELDDMLESITVRMIKS,0
3s4w,B,732,760,28,TNVGIKNNICACLIMGVCEVLMEYNFSIS,0
3s4w,B,763,787,24,SKSKFEEILSLFTCYKKFSDILSEK,0
3s4w,B,805,818,13,SLKFVSDLLTALFR,0
3s4w,B,822,827,5,QSHEES,0
3s4w,B,828,833,5,LSVLRS,0
3s4w,B,835,855,20,GEFMHYAVNVTLQKIQQLIRT,0
3s4w,B,865,886,21,NPDKIFQNLCDITRVLLWRYTS,0
3s4w,B,902,921,19,SISLLCLEGLQKTFSVVLQF,0
3s4w,B,922,924,2,YQP,0
3s4w,B,925,933,8,KVQQFLQAL,0
3s4w,B,946,968,22,TVTQRASFQIRQFQRSLLNLLSS,0
3s4w,B,974,990,16,NSKEALLLIAVLSTLSR,0
3s4w,B,996,1013,17,SPQFVQMLSWTSKICKEY,0
3s4w,B,1017,1033,16,DASFCKSLMNLFFSLHV,0
3s4w,B,1038,1054,16,PVTLLRDLSQDIHGQLG,0
3s4w,B,1072,1077,5,NLRTAA,0
3s4w,B,1078,1104,26,PTVCLLVLSQAEKVLEEVDWLIAKIKG,0
3s4w,B,1127,1150,23,PTLLIEKAIVMQLGTLVTFFHELV,0
3s4w,B,1158,1185,27,SCVDTLLKGLSKIYSTLTAFVKYYLQVC,0
3s4w,B,1192,1200,8,PNTVEKLVK,0
3s4w,B,1201,1206,5,LSGSHL,0
3s4w,B,1206,1222,16,LTPVCYSFISYVQNKSS,0
3s4w,B,1248,1270,22,PIPNLVFAIEQYEKFLIQLSKKS,0
3s4w,B,1291,1298,7,SVLDMVLR,0
3s4w,B,44,53,9,SVFVKLLKAS,0
3s4w,B,71,84,13,VIFQRKLFQALRKH,0
3s4w,B,86,102,16,AYPKVIEEFVNGLESYT,0
3s4w,B,104,112,8,DSESLRNCL,0
3s4w,B,132,140,8,SLIKLLLGI,0
3s4w,B,143,160,17,LQPAIIKMLFEKVPQFLF,0
3s4w,B,169,176,7,NMARLIIN,0
3s4w,B,177,179,2,QLK,0
3s4w,B,186,201,15,DGKDLTAQMMQLISVA,0
3s4w,B,205,212,7,LQHDFITS,0
3s4w,B,212,217,5,SLPEIL,0
3s4w,B,218,220,2,GDS,0
3s4w,B,221,236,15,QHANVGKELGELLVQN,0
3s4w,B,239,250,11,LTVPILDVFSSL,0
3s4w,B,253,267,14,DPNFLSKIRQLVMGK,0
3s4w,B,274,286,12,EDFPVIVKFLLHS,0
3s4w,B,291,305,14,TSLEVIAELRENLNV,0
3s4w,B,335,355,20,NSDKDCIVLVFDVIKSAIRYE,0
3s4w,B,355,369,14,EKTISEAWFKAIERI,0
3s4w,B,370,372,2,ESA,0
3s4w,B,377,390,13,SLDVVMLLIIYSTS,0
3s4w,B,390,406,16,STQTKKGVEKLLRNKIQ,0
3s4w,B,411,427,16,QEQLLDSAFSTHYLVLK,0
3s4w,B,429,442,13,ICPSILLLAQTLFH,0
3s4w,B,445,462,17,DQRIILFGSLLYKYAFKF,0
3s4w,B,464,482,18,DTYCQQEVVGALVTHVCSG,0
3s4w,B,483,501,18,TEAEVDTALDVLLELIVLN,0
3s4w,B,501,508,7,NASAMRLN,0
3s4w,B,508,514,6,NAAFVKG,0
3s4w,B,515,522,7,ILDYLENM,0
3s4w,B,523,542,19,SPQQIRKIFCILSTLAFSQQ,0
3s4w,B,547,562,15,NHIQDDMHLVIRKQLS,0
3s4w,B,565,583,18,VFKYKLIGIIGAVTMAGIM,0
3s4w,B,602,620,18,SEQRTQVTSLLQLVHSCTE,0
3s4w,B,622,640,18,SPWASSLYYDEFANLIQER,0
3s4w,B,643,662,19,APKTLEWVGQTIFNDFQDAF,0
3s4w,B,696,707,11,NLLPLFYQECAK,0
3s4w,B,726,743,17,CLASHFRLLRLCVARQHD,0
3s4w,B,749,753,4,IDGLL,0
3s4w,B,773,798,25,AKDRSLMCSLTFLTFNWFREVVNAFC,0
3s4w,B,802,828,26,SPEMKGKVLSRLKDLVELQGILEKYLA,0
3s4w,B,915,920,5,SLQNYR,0
3s4w,B,927,936,9,DIEVFSILHS,0
3s4w,B,959,979,20,GPAELLFLLEDLSQKLENMLT,0
3s4w,B,1006,1035,29,SVQDIVHCVVQLLTPMCNHLENIHNFFQCL,0
3s4w,B,1049,1072,23,TAQEQHTMACCYQKLLQVLHALFA,0
3s4w,B,1081,1091,10,KHRLLHSALEV,0
3s4w,B,1104,1118,14,PLEELVSQSFSYLQN,0
3s4w,B,1119,1123,4,FHHSV,0
3s4w,B,1125,1141,16,SFQCGLYLLRLLMALLE,0
3s4w,B,1148,1161,13,QKKEKLASLAKQLL,0
3s4w,B,1173,1191,18,NPTFNDHLHDVLYIYLEHT,0
3s4w,B,1193,1204,11,NVLKAIEEITGV,0
3s4w,B,1206,1211,5,VPELVS,0
3s4w,B,1225,1245,20,TRHTFVIFFRVMMAELEKTVK,0
3s4w,B,1253,1281,28,ADSQQVHEEKLLYWNMAVRDFSILLNLMK,0
3s4w,B,1286,1306,20,YPVLHVCLKYGRRFVEAFLKQ,0
3s4w,B,1306,1315,9,QCMPLLDFSF,0
3s4w,B,1318,1341,23,HREDVLSLLQTLQLNTRLLHHLCG,0
3s4w,B,1343,1347,4,SKIRQ,0
3s4w,B,1348,1353,5,DTRLTK,0
3s4w,B,1354,1374,20,HVPLLKKSLELLVCRVKAMLV,0
3s4w,B,1378,1388,10,CREAFWLGTLK,0
5ko1,A,239,257,18,SIAIVRQTFNKEIKTMKKF,0
5ko1,A,291,298,7,LRELLDRE,0
5ko1,A,302,323,21,TLGKRMVLVLGAARGLYRLHHS,0
5ko1,A,333,335,2,RSS,0
5ko1,A,372,377,5,KSTAYL,0
5ko1,A,378,384,6,SPQELED,0
5ko1,A,390,408,18,DVKSEIYSFGIVLWEIATG,0
5ko1,A,416,426,10,NSEKIRKLVAV,0
5ko1,A,438,449,11,PSELREIIDECR,0
5ko1,A,452,456,4,DPSVR,0
5ko1,A,458,468,10,SVDEILKKLST,0
4de6,A,9,38,29,STEVEAAVNRLVNLYLRASYTYLSLGFYFD,0
4de6,A,44,73,29,LEGVCHFFRELAEEKREGAERLLKMQNQRG,0
4de6,A,91,120,29,TTLDAMKAAIVLEKSLNQALLDLHALGSAQ,0
4de6,A,122,133,11,DPHLCDFLESHF,0
4de6,A,133,154,21,FLDEEVKLIKKMGDHLTNIQRL,0
4de6,A,159,170,11,AGLGEYLFERLT,0
5dtq,B,32,48,16,DAAHEIIETIRWVCEEI,0
5dtq,B,48,55,7,IPDLKLAM,0
5dtq,B,57,61,4,NYVLI,0
5dtq,B,67,91,24,SFESMQRLCDKYNRAIDSIHQLWKG,0
5dtq,B,103,119,16,STGLLRHILQQVYNHSV,0
5dtq,B,121,126,5,DPEKLN,0
5dtq,B,132,136,4,SPEVY,0
5dtq,B,139,152,13,TSFDLVAQMIDEIK,0
5dtq,B,167,177,10,GQVVLQVAAAT,0
5dtq,B,188,210,22,ADIPAKYAETMDREFRKWMKWYG,0
5dtq,B,226,234,8,EEWRERIAN,0
5dtq,B,246,258,12,GPEVDHQLKERFA,0
5dtq,B,286,289,3,DIGT,0
5dtq,B,319,331,12,RTILENYFSSLKN,0
5dtq,B,56,61,5,ENYVLI,0
5dtq,B,139,151,12,TSFDLVAQMIDEI,0
5dtq,B,319,330,11,RTILENYFSSLK,0
6fnz,D,287,302,15,SFEQVLTDITEAIKLE,0
6fnz,D,319,324,5,CLHDFF,0
6fnz,D,287,303,16,SFEQVLTDITEAIKLET,0
6fnz,D,319,325,6,CLHDFFG,0
6ccb,L,523,528,5,LGAAGS,0
6ccb,L,529,534,5,TMGAAS,0
6ccb,L,536,543,7,TLTVQARQ,0
6ccb,L,547,552,5,GIVQQQ,0
6ccb,L,569,596,27,TVWGIKQLQARVLALERYLKDQQLLGIW,0
6ccb,L,618,624,6,TYNDIWD,0
6ccb,L,627,636,9,TWLQWDKEIS,0
6ccb,L,638,650,12,YTDIIYGLIEESQ,0
6ccb,L,652,663,11,QQEKNEQDLLAL,0
6ccb,L,638,649,11,YTDIIYGLIEES,0
6ccb,L,650,663,13,QIQQEKNEQDLLAL,0
6ccb,L,98,117,19,NDMVEQMHEDIINLWDQSLK,0
6ccb,L,195,198,3,SCNT,0
6ccb,L,335,350,15,KTEWNDTLRQVAEQLS,0
6ccb,L,351,353,2,KHF,0
6ccb,L,368,373,5,DLEITT,0
6ccb,L,425,429,4,NMWQQ,0
6ccb,L,475,481,6,MRDNWRS,0
6ccb,L,61,64,3,PSLN,0
6ccb,L,83,87,4,TPADT,0
6ccb,L,100,99,-1,,0
6ccb,L,185,189,4,PSSSL,0
6ccb,L,79,83,4,EAGDE,0
6ccb,L,122,128,6,SSEELQA,0
6ccb,L,182,189,7,TPEQWKSH,0
6ccb,L,98,115,17,NDMVEQMHEDIINLWDQS,0
6ccb,L,387,390,3,TSKL,0
5ohi,A,76,80,4,DNLCK,0
5ohi,A,88,94,6,DFDELCL,0
5ohi,A,103,107,4,TKDRC,0
5ohi,A,122,127,5,DCLSRG,0
5ohi,A,132,139,7,NYQVVCKG,0
5ohi,A,142,146,4,HWVDD,0
5ohi,A,174,184,10,RASYMKKGSKV,0
5ohi,A,185,195,10,MPNIEKLRSCG,0
5ohi,A,208,219,11,KTFPNLYTLATG,0
5ohi,A,221,226,5,YPESHG,0
5ohi,A,246,254,8,REKFNHRWW,0
5ohi,A,258,266,8,PLWITATKQ,0
5ohi,A,280,293,13,PHERRILTILQWLS,0
5ohi,A,311,318,7,DFSGHKYG,0
5ohi,A,321,323,2,GPE,0
5ohi,A,324,345,21,MTNPLREIDKTVGQLMDGLKQL,0
5ohi,A,373,375,2,SNY,0
5ohi,A,403,412,9,DPKAIIANLT,0
5ohi,A,426,428,2,QHL,0
5ohi,A,429,433,4,PKRLH,0
5ohi,A,480,484,4,VNSMQ,0
5ohi,A,507,516,9,ELYNVMCDLL,0
5ohi,A,530,534,4,LNHLL,0
5ohi,A,558,562,4,LQSDF,0
5ohi,A,641,645,4,PEHLT,0
5ohi,A,655,659,4,SPGFS,0
5ohi,A,661,668,7,NCLAYKND,0
5ohi,A,678,682,4,PPYLS,0
5ohi,A,684,692,8,SPEAKYDAF,0
5ohi,A,693,695,2,LVT,0
5ohi,A,701,714,13,YPAFKRVWTYFQRV,0
5ohi,A,714,724,10,VLVKKYASERN,0
5ohi,A,744,748,4,IEDEI,0
5ohi,A,776,780,4,PADKC,0
5ohi,A,806,809,3,DESK,0
5ohi,A,810,818,8,WVEELMKMH,0
5ohi,A,821,830,9,RVRDIEHLTG,0
5ohi,A,840,850,10,SYSEILTLKTY,0
6etz,A,28,36,8,GAADIQDLE,0
6etz,A,79,83,4,GWQLG,0
6etz,A,97,102,5,SWPMHG,0
6etz,A,138,142,4,GPEFF,0
6etz,A,198,204,6,SAASYVE,0
6etz,A,264,267,3,PELA,0
6etz,A,345,359,14,PRDVVEAELRLMKQH,0
6etz,A,374,383,9,QFLALADQLG,0
6etz,A,394,401,7,THGFESAG,0
6etz,A,405,411,6,NPSDDPQ,0
6etz,A,412,428,16,WEDALVDRMRRTVERDK,0
6etz,A,445,459,14,GRNLAAMSRWTKDRD,0
6etz,A,484,493,9,SQAETALIGQ,0
6etz,A,501,510,9,DAALDARRRA,0
6etz,A,528,539,11,GMSEYQALFEKY,0
6etz,A,578,583,5,DGNFVT,0
6etz,A,594,604,10,RPGLLDFKKVI,0
6etz,A,666,676,10,PGSVAALAAGL,0
6etz,A,766,770,4,DNDLG,0
6etz,A,780,789,9,PLATQWKDAG,0
6etz,A,905,908,3,AKMD,0
6etz,A,950,957,7,SQDVLDAA,0
6etz,A,959,963,4,HRPDL,0
6etz,A,990,994,4,LEQYR,0
1uk7,A,39,45,6,SAYANWR,0
1uk7,A,47,52,5,TIPALS,0
1uk7,A,77,92,15,SKDSWVDHIIGIMDAL,0
1uk7,A,103,116,13,AFGGGLAIATALRY,0
1uk7,A,136,144,8,TEGLNAVWG,0
1uk7,A,148,160,12,SIENMRNLLDIFA,0
1uk7,A,162,166,4,DRSLV,0
1uk7,A,167,179,12,TDELARLRYEASI,0
1uk7,A,182,189,7,GFQESFSS,0
1uk7,A,195,203,8,RQRWIDALA,0
1uk7,A,205,210,5,SDEDIK,0
1uk7,A,228,239,11,PLSSSLRLGELI,0
1uk7,A,253,258,5,WTQIEQ,0
1uk7,A,258,272,14,QTDRFNRLVVEFFNE,0
2iu5,B,5,22,17,IITQKIIAKAFKDLMQSN,0
2iu5,B,23,27,4,AYHQI,0
2iu5,B,28,37,9,SVSDIMQTAK,0
2iu5,B,39,46,7,RRQTFYNY,0
2iu5,B,49,67,18,NQEELLSWIFENDFAELIN,0
2iu5,B,74,89,15,GWQNELLLLLRYLDEN,0
2iu5,B,89,100,11,NQIFYQKIFVID,0
2iu5,B,102,126,24,NFEHFFLIQWENLLDKVIFDQEKKS,0
2iu5,B,131,157,26,SDLEKSFICRYNAAAICAITRESIIRG,0
2iu5,B,160,162,2,LEK,0
2iu5,B,163,177,14,LYSQIVNLLLAQIKI,0
2iu5,B,4,22,18,SIITQKIIAKAFKDLMQSN,0
2iu5,B,49,68,19,NQEELLSWIFENDFAELIND,0
1n9h,A,3,18,15,SEGEWQLVLHVWAKVE,0
1n9h,A,20,36,16,DVAGHGQDIYIRLFKSH,0
1n9h,A,37,43,6,PETLEKF,0
1n9h,A,51,58,7,TEAEMKAS,0
1n9h,A,58,78,20,SEDLKKQGVRVLTALGAILKK,0
1n9h,A,82,96,14,HEAELKPLAQSHATK,0
1n9h,A,100,119,19,PIKYLEFISEAIIHVLHSRH,0
1n9h,A,124,150,26,GADAQGAMNKALELFRKDIAAKYKELG,0
1c0t,B,77,82,5,FRELNK,0
1c0t,B,96,100,4,HPAGL,0
1c0t,B,114,118,4,AYFSV,0
1c0t,B,122,129,7,EDFRKYTA,0
1c0t,B,155,175,20,GSPAIFQSSMTKILEPFRKQN,0
1c0t,B,194,212,18,EIGQHRTKIEELRQHLLRW,0
1c0t,B,254,269,15,VNDIQKLVGKLNWASQ,0
1c0t,B,296,310,14,TEEAELELAENREIL,0
1c0t,B,363,384,21,NDVKQLTEAVQKITTESIVIWG,0
1c0t,B,394,405,11,QKETWETWWTEY,0
1c0t,B,473,488,15,TNQKTELQAIYLALQD,0
1c0t,B,499,508,9,SQYALGIIQA,0
1c0t,B,515,528,13,SELVNQIIEQLIKK,0
1c0t,B,27,44,17,TEEKIKALVEICTEMEKE,0
1c0t,B,77,83,6,FRELNKR,0
1c0t,B,99,103,4,GLKKK,0
1c0t,B,112,118,6,GDAYFSV,0
1c0t,B,124,129,5,FRKYTA,0
1c0t,B,134,138,4,SINNE,0
1c0t,B,154,160,6,KGSPAIF,0
1c0t,B,160,168,8,FQSSMTKIL,0
1c0t,B,170,175,5,PFRKQN,0
1c0t,B,253,271,18,TVNDIQKLVGKLNWASQIY,0
1c0t,B,276,282,6,VRQLCKL,0
1c0t,B,394,406,12,QKETWETWWTEYW,0
2xib,D,50,60,10,DPAMQKFRDNR,0
2xib,D,68,72,4,GLYAI,0
2xib,D,85,87,2,AAE,0
2xib,D,88,93,5,WLKSWA,0
2xib,D,96,102,6,PADEWLK,0
2xib,D,103,107,4,LMDQW,0
2xib,D,113,125,12,DAKKWAKMAKEMG,0
2xib,D,151,154,3,VANT,0
2xib,D,159,171,12,DILGELVKAYNDE,0
2xib,D,195,220,25,SKEDSIAFSRFLEFTDNQLKELATRY,0
2xib,D,233,238,5,DASVKK,0
2xib,D,239,254,15,NGWWTAHAEQMLKELV,0
2xib,D,261,264,3,SRLR,0
2xib,D,297,303,6,DLKVTQW,0
2xib,D,321,325,4,DWSLS,0
2xib,D,329,343,14,TPIEVIDRIVHAVSM,0
2xib,D,360,378,18,RPEEKAMATAIGKWMNRYG,0
2xib,D,379,381,2,KAV,0
2xib,D,196,220,24,KEDSIAFSRFLEFTDNQLKELATRY,0
5a02,F,15,21,6,GYYATRI,0
5a02,F,22,29,7,IMPRFAEC,0
5a02,F,41,53,12,TPEKLKTYGEQYG,0
5a02,F,55,57,2,PET,0
5a02,F,64,71,7,TFDRIIDN,0
5a02,F,82,84,2,PNS,0
5a02,F,85,96,11,LHRPFTERAARA,0
5a02,F,109,123,14,TVADCEAMIAACKKA,0
5a02,F,131,135,4,YRSRF,0
5a02,F,136,148,12,QAHNIEAIKLVRD,0
5a02,F,170,173,3,QWRL,0
5a02,F,174,179,5,NRALAG,0
5a02,F,181,186,5,GSLMDI,0
5a02,F,186,199,13,IGIYSLNAARYLTG,0
5a02,F,291,307,16,NQFSAQLDHLSECILTG,0
5a02,F,313,334,21,GGDDGLKDLRVIEAIYRAAREG,0
5a02,F,41,52,11,TPEKLKTYGEQY,0
5a02,F,136,149,13,QAHNIEAIKLVRDG,0
5a02,F,109,124,15,TVADCEAMIAACKKAG,0
5xnk,A,15,29,14,GPVVTAEFLKSIYEY,0
5xnk,A,35,39,4,KEQES,0
5xnk,A,52,58,6,DRTGSID,0
5xnk,A,61,80,19,KEREFIDFIQVNLEHLNKLA,0
5xnk,A,88,94,6,CTAHYAL,0
5xnk,A,100,103,3,NLKD,0
5xnk,A,107,120,13,SLIKIADQELQEYN,0
5xnk,A,128,134,6,STGTYQK,0
5xnk,A,135,141,6,KLFQEGC,0
5xnk,A,143,145,2,TAD,0
5xnk,A,151,165,14,SESDQKLIHEMIYKV,0
5xnk,A,172,186,14,PLSILRDIEALLEKY,0
5xnk,A,197,209,12,EFHLLTKSLKLKG,0
5xnk,A,217,225,8,DPLSTIAQN,0
5xnk,A,225,230,5,NFSQLI,0
3zu7,B,59,76,17,HQTYCQRTLREIKILLRF,0
3zu7,B,110,117,7,LYKLLKTQ,0
3zu7,B,120,141,21,SNDHICYFLYQILRGLKYIHSA,0
3zu7,B,149,151,2,KPS,0
3zu7,B,193,198,5,APEIML,0
3zu7,B,205,222,17,KSIDIWSVGCILAEMLSN,0
3zu7,B,230,243,13,HYLDQLNHILGILG,0
3zu7,B,246,252,6,SQEDLNC,0
3zu7,B,255,264,9,NLKARNYLLS,0
3zu7,B,272,277,5,PWNRLF,0
3zu7,B,281,292,11,DSKALDLLDKML,0
3zu7,B,301,307,6,EVEQALA,0
3zu7,B,308,312,4,HPYLE,0
3zu7,B,316,320,4,DPSDE,0
3zu7,B,337,349,12,PKEKLKELIFEET,0
3zu7,B,350,353,3,ARFQ,0
3zu7,B,13,25,12,DLGKKLLEAARAG,0
3zu7,B,26,36,10,QDDEVRILMAN,0
3zu7,B,49,58,9,TPLHLAAWIG,0
3zu7,B,59,69,10,HPEIVEVLLKH,0
3zu7,B,82,91,9,TPLHLAADNG,0
3zu7,B,92,102,10,HLEIVEVLLKY,0
3zu7,B,115,123,8,TPLHLAADR,0
3zu7,B,125,135,10,HLEIVEVLLKH,0
3zu7,B,148,157,9,TAFDISIDNG,0
3zu7,B,158,165,7,NEDLAEIL,0
2omf,A,104,112,8,VVYDALGYT,0
2omf,A,143,146,3,NFFG,0
2omf,A,198,201,3,NLQE,0
4hca,A,285,296,11,CNACGLYHKMNG,0
4hca,A,339,350,11,CNACGLYYKLHN,0
3sxu,B,19,35,16,SAVEQLVCEIAAERWRS,0
3sxu,B,45,56,11,DEKQAYRLDEAL,0
3sxu,B,104,110,6,ADFATAF,0
3sxu,B,120,122,2,EDS,0
3sxu,B,123,137,14,LKQLARERYKAYRVA,0
3sxu,B,51,62,11,DPLVSDVLRALT,0
3sxu,B,64,66,2,SPD,0
3sxu,B,72,77,5,TPEKIA,0
3sxu,B,107,114,7,ALTDLRAN,0
3sxu,B,114,128,14,NPTARAALWQQICTY,0
3sxu,B,128,133,5,YEHDFF,0
3igv,B,26,31,5,LSNSLL,0
3igv,B,33,35,2,HHN,0
3igv,B,41,43,2,TSR,0
3igv,B,44,53,9,SAGLRQKKVT,0
3igv,B,61,76,15,DDHYRDVLKEMKAKAS,0
3igv,B,84,90,6,SVEEACK,0
3igv,B,104,110,6,GAKDVRN,0
3igv,B,112,129,17,SSKAVNHIHSVWKDLLED,0
3igv,B,164,188,24,DLGVRVCEKMALYDVVSTLPQVVMG,0
3igv,B,189,195,6,SSYGFQY,0
3igv,B,196,210,14,SPGQRVEFLVNTWKS,0
3igv,B,223,228,5,CFDSTV,0
3igv,B,229,241,12,TENDIRVEESIYQ,0
3igv,B,246,260,14,APEARQAIKSLTERL,0
3igv,B,286,306,20,TTSCGNTLTCYLKASAACRAA,0
3igv,B,328,346,18,GTQEDAASLRVFTEAMTRY,0
3igv,B,359,363,4,DLELI,0
3igv,B,388,401,13,PTTPLARAAWETAR,0
3igv,B,406,416,10,NSWLGNIIMYA,0
3igv,B,418,424,6,TLWARMI,0
3igv,B,424,437,13,ILMTHFFSILLAQE,0
3igv,B,455,457,2,EPL,0
3igv,B,458,468,10,DLPQIIERLHG,0
3igv,B,469,473,4,LSAFS,0
3igv,B,478,493,15,SPGEINRVASCLRKLG,0
3igv,B,496,513,17,PLRVWRHRARSVRARLLS,0
3igv,B,515,526,11,GGRAATCGKYLF,0
3igv,B,527,530,3,NWAV,0
3igv,B,84,91,7,SVEEACKL,0
3igv,B,104,111,7,GAKDVRNL,0
3igv,B,229,242,13,TENDIRVEESIYQC,0
3igv,B,406,415,9,NSWLGNIIMY,0
3igv,B,496,515,19,PLRVWRHRARSVRARLLSQG,0
3igv,B,541,545,4,AASQL,0
1aiy,L,13,19,6,LYQLENY,0
1aiy,L,4,7,3,QHLC,0
1aiy,L,9,19,10,SHLVEALYLVC,0
1aiy,L,10,19,9,HLVEALYLVC,0
3on4,H,7,24,17,NTKERILAVAEALIQKDG,0
3on4,H,25,28,3,YNAF,0
3on4,H,29,38,9,SFKDIATAIN,0
3on4,H,40,48,8,KTASIHYHF,0
3on4,H,50,75,25,SKEDLGVAVISWHTDKIAAVLSDISN,0
3on4,H,80,96,16,SAKEKIQKFFDAILTLT,0
3on4,H,104,113,9,CLGGFASDF,0
3on4,H,114,116,2,QSL,0
3on4,H,117,142,25,PVSIQNQAKKFFELIIEWLKGVLETN,0
3on4,H,145,171,26,DNESSLSLAKQIISLVEGGLLLARLYG,0
3on4,H,173,187,14,ETFLEGVRHFIDQTI,0
3on4,H,117,141,24,PVSIQNQAKKFFELIIEWLKGVLET,0
3on4,H,104,112,8,CLGGFASD,0
3on4,H,113,116,3,FQSL,0
3on4,H,50,76,26,SKEDLGVAVISWHTDKIAAVLSDISNN,0
2wkw,B,74,79,5,TGMTWE,0
2wkw,B,87,95,8,GWDEYFLRK,0
2wkw,B,114,122,8,ISAINAVKL,0
2wkw,B,126,130,4,PASSL,0
2wkw,B,137,145,8,GHEAAWAIF,0
2wkw,B,161,163,2,PVQ,0
2wkw,B,164,172,8,AQAELWQQM,0
2wkw,B,176,180,4,WLGSM,0
2wkw,B,184,198,14,NPTVANLSKLAIKLD,0
2wkw,B,207,209,2,QSG,0
2wkw,B,210,219,9,IYPFQTAAMN,0
2wkw,B,236,240,4,KPEDV,0
2wkw,B,240,244,4,VKPLT,0
2wkw,B,262,279,17,WAPRLKACHAFIDALNAA,0
2wkw,B,289,292,3,PALG,0
2wkw,B,299,303,4,MMMQD,0
2wkw,B,305,322,17,NNLQVADLILDWIGRNTA,0
2wkw,B,114,123,9,ISAINAVKLG,0
2wkw,B,164,171,7,AQAELWQQ,0
2wkw,B,305,321,16,NNLQVADLILDWIGRNT,0
3bol,B,3,14,11,NRREVSKLLSER,0
3bol,B,22,29,7,YGTEFMKY,0
3bol,B,34,36,2,LPE,0
3bol,B,37,42,5,ELNIKA,0
3bol,B,42,57,15,APDVVLKVHRSYIESG,0
3bol,B,69,75,6,TRMKLRK,0
3bol,B,76,77,1,HG,0
3bol,B,78,80,2,LED,0
3bol,B,81,98,17,KLDPIVRNAVRIARRAAG,0
3bol,B,120,138,18,LFEEFYENFRETVEIMVEE,0
3bol,B,150,165,15,DILELKAAVLAAREVS,0
3bol,B,187,197,10,DPANFAITFDE,0
3bol,B,210,225,15,GPEEILPIFQELSQYT,0
3bol,B,250,256,6,KPHDFAV,0
3bol,B,257,264,7,HIDSYYEL,0
3bol,B,276,288,12,TPEHVKLFRKVLG,0
3bol,B,327,337,10,RKKLWAEMQKG,0
3bol,B,339,352,13,EEIVIKEAKTQVEK,0
3bol,B,363,367,4,IESQI,0
3bol,B,368,383,15,DVRYVEKIVQTLPYVS,0
3bol,B,393,404,11,NVDLTERALRAY,0
3bol,B,416,431,15,DEEELEMKINLLKKYG,0
3bol,B,446,464,18,SFEERKEYFEKALKILERH,0
3bol,B,466,468,2,FSD,0
3bol,B,478,482,4,PLGAE,0
3bol,B,484,498,14,KPVEVLKTIEFISSK,0
3bol,B,505,510,5,GLSNLS,0
3bol,B,515,530,15,DRSYYNTAFLVLGISK,0
3bol,B,541,555,14,DETLMKTLNATLVIL,0
3bol,B,22,27,5,YGTEFM,0
3bol,B,28,30,2,KYG,0
3bol,B,69,74,5,TRMKLR,0
3bol,B,75,77,2,KHG,0
3bol,B,120,139,19,LFEEFYENFRETVEIMVEEG,0
3bol,B,210,223,13,GPEEILPIFQELSQ,0
3bol,B,257,263,6,HIDSYYE,0
3bol,B,327,336,9,RKKLWAEMQK,0
3bol,B,505,509,4,GLSNL,0
5crx,B,21,32,11,DEVRKNLMDMFR,0
5crx,B,34,36,2,RQA,0
5crx,B,39,58,19,EHTWKMLLSVCRSWAAWCKL,0
5crx,B,68,81,13,PEDVRDYLLYLQAR,0
5crx,B,85,100,15,VKTIQQHLGQLNMLHR,0
5crx,B,107,109,2,PSD,0
5crx,B,111,125,14,NAVSLVMRRIRKENV,0
5crx,B,139,149,10,RTDFDQVRSLM,0
5crx,B,155,170,15,CQDIRNLAFLGIAYNT,0
5crx,B,174,179,5,IAEIAR,0
5crx,B,216,228,12,GVTKLVERWISVS,0
5crx,B,258,273,15,TRALEGIFEATHRLIY,0
5crx,B,290,301,11,SARVGAARDMAR,0
5crx,B,306,311,5,IPEIMQ,0
5crx,B,326,328,2,RNL,0
5crx,B,334,339,5,AMVRLL,0
5crx,B,20,36,16,SDEVRKNLMDMFRDRQA,0
5crx,B,68,80,12,PEDVRDYLLYLQA,0
5crx,B,85,102,17,VKTIQQHLGQLNMLHRRS,0
5crx,B,111,126,15,NAVSLVMRRIRKENVD,0
5crx,B,174,177,3,IAEI,0
5crx,B,182,184,2,VKD,0
5crx,B,215,228,13,LGVTKLVERWISVS,0
5crx,B,230,232,2,VAD,0
5crx,B,290,300,10,SARVGAARDMA,0
5crx,B,306,313,7,IPEIMQAG,0
1bk8,A,17,27,10,TAHCDKQCQDW,0
5bzn,A,49,60,11,SRTEAADLCQAF,0
5bzn,A,66,76,10,TMDQMKLALSK,0
5bzn,A,101,105,4,CAANH,0
5bzn,A,169,173,4,HQEDI,0
5h7t,A,1,5,4,GVGSI,0
5h7t,A,7,16,9,SSDVFNSIVG,0
5h7t,A,23,27,4,AGNGF,0
5h7t,A,29,39,10,TYDSFISAANA,0
5h7t,A,48,67,19,SSDVNKREIAAFFANAAHET,0
5h7t,A,108,120,12,WNYNYGAAGSYIQ,0
5h7t,A,126,132,6,NPEIVGT,0
5h7t,A,133,147,14,DSTISFKTAVWFWMV,0
5h7t,A,150,157,7,NCHTAITS,0
5h7t,A,160,170,10,GFGATIRAINS,0
5h7t,A,171,173,2,MEC,0
5h7t,A,177,195,18,NAATVASRVNYYQKFCQQL,0
3l3z,B,672,681,9,IFLNVLEAIE,0
3l3z,B,696,721,25,SFAALLSSLNELGERQLVHVVKWAKA,0
3l3z,B,724,728,4,GFRNL,0
3l3z,B,729,758,29,HVDDQMAVIQYSWMGLMVFAMGWRSFTNVN,0
3l3z,B,771,778,7,NEYRMHKS,0
3l3z,B,780,797,17,MYSQCVRMRHLSQEFGWL,0
3l3z,B,800,813,13,TPQEFLCMKALLLF,0
3l3z,B,823,842,19,NQKFFDELRMNYIKELDRII,0
3l3z,B,848,883,35,NPTSCSRRFYQLTKLLDSVQPIARELHQFTFDLLIK,0
3l3z,B,883,888,5,KSHMVS,0
3l3z,B,892,908,16,PEMMAEIISVQVPKILS,0
3l3z,B,735,744,9,NALLRYLLDR,0
4jgq,B,40,80,40,KDTIAAEHKQEASVLLNLHRNKINYLIGETARTSLSIAI,0
4jgq,B,85,97,12,DIKKQSILEKTF,0
4jgq,B,131,141,10,ASFFIKAKETK,0
4jgq,B,182,193,11,IDYLKNLINLLS,0
4jgq,B,213,218,5,QASHAE,0
4jgq,B,42,80,38,TIAAEHKQEASVLLNLHRNKINYLIGETARTSLSIAI,0
4jgq,B,85,98,13,DIKKQSILEKTFD,0
5elx,A,100,110,10,APELLKGIYAM,0
5elx,A,116,128,12,SKIQERALPLLLH,0
5elx,A,143,156,13,GKTAAFSLTMLTRV,0
5elx,A,171,186,15,SRELARQTLEVVQEMG,0
5elx,A,215,225,10,TPGTVLDLMRR,0
5elx,A,240,247,7,EADNMLDQ,0
5elx,A,249,259,10,GLGDQCIRVKR,0
5elx,A,275,286,11,ADAVRQYAKKIV,0
5elx,A,295,299,4,QTNEV,0
5elx,A,313,326,13,NEADKFDVLTELYG,0
5elx,A,339,353,14,TKKTANVLYGKLKSE,0
5elx,A,365,378,13,QTQERDRLIDDFRE,0
5elx,A,388,391,3,NVLA,0
5elx,A,416,425,9,DPATYIHRIG,0
5elx,A,442,456,14,DKNSFNILSAIQKYF,0
5elx,A,468,481,13,DWDEVEKIVKKVLK,0
1b00,B,12,24,12,APIREMVCFVLEQ,0
1b00,B,35,41,6,YDSAVNQ,0
1b00,B,61,70,9,GIQFIKHLKR,0
1b00,B,87,94,7,EEEDRVRG,0
1b00,B,109,121,12,PKELVARIKAVMR,0
1b00,B,12,25,13,APIREMVCFVLEQN,0
1b00,B,88,94,6,EEDRVRG,0
3fmw,C,21,34,13,GPVGLMLAGELRAG,0
3fmw,C,57,66,9,HIRTVETLDL,0
3fmw,C,69,74,5,LLDRFL,0
3fmw,C,94,98,4,DFGLV,0
3fmw,C,109,125,16,PQSRTEALLAEHAREAG,0
3fmw,C,170,176,6,STVRRLA,0
3fmw,C,244,252,8,TLEDLGAAV,0
3fmw,C,291,293,2,GDA,0
3fmw,C,303,325,22,QGLNTGLQDAVNLGWKLAARVRG,0
3fmw,C,328,357,29,SEELLDTYHDERHPVAERVLLNTRAQLALM,0
3fmw,C,363,375,12,HTTPLRGFVEELL,0
3fmw,C,377,390,13,TDEVNRYFTGMITG,0
3fmw,C,429,433,4,VAELL,0
3fmw,C,446,452,6,RADLREA,0
3fmw,C,493,506,13,TADELRASLARWFG,0
4ety,D,54,58,4,KHDLY,0
4ety,D,90,94,4,NETIT,0
4yur,A,8,10,2,KIE,0
4yur,A,45,51,6,KKAMYKA,0
4yur,A,53,65,12,MVQRVQNEVKIHC,0
4yur,A,97,103,6,MNRYLKN,0
4yur,A,109,129,20,SENEARHFMHQIITGMLYLHS,0
4yur,A,138,140,2,TLS,0
4yur,A,190,207,17,LESDVWSLGCMFYTLLIG,0
4yur,A,216,225,9,VKNTLNKVVL,0
4yur,A,235,246,11,SIEAKDLIHQLL,0
4yur,A,249,253,4,NPADR,0
4yur,A,255,266,11,SLSSVLDHPFMS,0
3lkp,A,49,53,4,APWIE,0
3lkp,A,56,85,29,GPEYWDRNTQIFKTNTQTYRESLRNLRGYY,0
3lkp,A,137,150,13,DTAAQITQRKWEAA,0
3lkp,A,151,162,11,RVAEQLRAYLEG,0
3lkp,A,162,175,13,GLCVEWLRRYLENG,0
3lkp,A,175,180,5,GKETLQ,0
3lkp,A,225,228,3,TQDT,0
3lkp,A,253,255,2,EEQ,0
4qk3,A,12,19,7,GPEHWHKD,0
4qk3,A,20,25,5,FPIAKG,0
4qk3,A,130,135,5,DFGKAV,0
4qk3,A,154,156,2,KPG,0
4qk3,A,157,164,7,LQKVVDVL,0
4qk3,A,165,168,3,DSIK,0
4qk3,A,180,185,5,DPRGLL,0
4qk3,A,219,227,8,SSEQVLKFR,0
3j30,H,30,34,4,DSYGN,0
3j30,H,83,87,4,EADDV,0
3j30,H,125,132,7,SSKLGTSG,0
3j30,H,187,191,4,KDEYE,0
3j30,H,528,532,4,SFTSF,0
3j30,H,587,591,4,TSEDS,0
3j30,H,660,662,2,SGS,0
3j30,H,690,692,2,STW,0
3j30,H,1030,1034,4,DSYGN,0
3j30,H,1083,1087,4,EADDV,0
3j30,H,1125,1132,7,SSKLGTSG,0
3j30,H,1187,1191,4,KDEYE,0
3j30,H,1528,1532,4,SFTSF,0
3j30,H,1587,1591,4,TSEDS,0
3j30,H,1660,1662,2,SGS,0
3j30,H,1690,1692,2,STW,0
3j30,H,2030,2034,4,DSYGN,0
3j30,H,2083,2087,4,EADDV,0
3j30,H,2125,2132,7,SSKLGTSG,0
3j30,H,2187,2191,4,KDEYE,0
3j30,H,2528,2532,4,SFTSF,0
3j30,H,2587,2591,4,TSEDS,0
3j30,H,2660,2662,2,SGS,0
3j30,H,2690,2692,2,STW,0
3j30,H,3030,3034,4,DSYGN,0
3j30,H,3083,3087,4,EADDV,0
3j30,H,3125,3132,7,SSKLGTSG,0
3j30,H,3187,3191,4,KDEYE,0
3j30,H,3528,3532,4,SFTSF,0
3j30,H,3587,3591,4,TSEDS,0
3j30,H,3660,3662,2,SGS,0
3j30,H,3690,3692,2,STW,0
3wgp,A,125,143,18,SEEQQRIIAILLDAHHKTY,0
3wgp,A,149,153,4,DFCQF,0
3wgp,A,216,224,8,SVTLELSQL,0
3wgp,A,226,247,21,MLPHLADLVSYSIQKVIGFAKM,0
3wgp,A,250,254,4,GFRDL,0
3wgp,A,255,275,20,TSEDQIVLLKSSAIEVIMLRS,0
3wgp,A,290,292,2,NQD,0
3wgp,A,296,302,6,RVSDVTK,0
3wgp,A,306,322,16,SLELIEPLIKFQVGLKK,0
3wgp,A,326,339,13,HEEEHVLLMAICIV,0
3wgp,A,348,371,23,DAALIEAIQDRLSNTLQTYIRCRH,0
3wgp,A,379,406,27,LYAKMIQKLADLRSLNEEHSKQYRCLSF,0
3wgp,A,409,414,5,ECSMKL,0
3wgp,A,415,423,8,TPLVLEVFG,0
2vha,B,8,17,9,STLDKIAKNG,0
2vha,B,41,58,17,GYSQDYSNAIVEAVKKKL,0
2vha,B,74,81,7,NRIPLLQN,0
2vha,B,94,99,5,NVERQK,0
2vha,B,124,129,5,DFADLK,0
2vha,B,139,152,13,TTSEVLLNKLNEEQ,0
2vha,B,163,173,10,DHGDSFRTLES,0
2vha,B,183,191,8,DALLAGERA,0
2vha,B,195,197,2,KPD,0
2vha,B,219,236,17,DPQFKKLMDDTIAQVQTS,0
2vha,B,237,249,12,GEAEKWFDKWFKN,0
2vha,B,263,272,9,SDEMKALFKE,0
5j4u,A,14,27,13,SPFGMRVRLALAEK,0
5j4u,A,42,49,7,SALLLQMN,0
5j4u,A,67,79,12,ESLIIVQYIDEVW,0
5j4u,A,89,106,17,DPYQRAQSRFWADFVDKK,0
5j4u,A,106,117,11,KIYDLGRKIWTK,0
5j4u,A,118,141,23,KGEEQEAAKKDFIDSLKLMEGELG,0
5j4u,A,152,159,7,GYVDIALV,0
5j4u,A,161,173,12,FYSWFYAYETIGN,0
5j4u,A,175,180,5,NIEAEC,0
5j4u,A,180,192,12,CPKMIAYCKRCLQ,0
5j4u,A,193,200,7,KETVSKAL,0
5j4u,A,202,217,15,DPQKVYDFVLMLMKKF,0
3l9l,D,11,32,21,EQESVKEFLAKAKEDFLKKWES,0
3l9l,D,39,41,2,HLD,0
3l9l,D,76,82,6,KQKVVKL,0
3l9l,D,84,98,14,QIEHTLNEKRILQAV,0
3l9l,D,127,136,9,EMFSHLRRIG,0
3l9l,D,139,160,21,SEPHARFYAAQIVLTFEYLHSL,0
3l9l,D,168,170,2,KPE,0
3l9l,D,201,205,4,TPEYL,0
3l9l,D,206,211,5,APEIIL,0
3l9l,D,217,234,17,KAVDWWALGVLIYEMAAG,0
3l9l,D,242,253,11,QPIQIYEKIVSG,0
3l9l,D,262,273,11,SSDLKDLLRNLL,0
3l9l,D,288,293,5,VNDIKN,0
3l9l,D,294,298,4,HKWFA,0
3l9l,D,301,307,6,DWIAIYQ,0
3l9l,D,344,348,4,GKEFS,0
3l9l,D,5,12,7,TTYADFIA,0
3l9l,D,12,32,20,QESVKEFLAKAKEDFLKKWES,0
3l9l,D,84,96,12,QIEHTLNEKRILQ,0
5lbr,A,11,15,4,PLYLG,0
5lbr,A,20,27,7,TTENCERE,0
5lbr,A,57,63,6,NAATFLG,0
5lbr,A,65,70,5,EPTVLR,0
5lbr,A,73,78,5,TLAALL,0
5lbr,A,81,89,8,QWPALQAAL,0
5lbr,A,141,150,9,RNAMFALESA,0
5lbr,A,152,169,17,NLRALAEVATQTVRELTG,0
5lbr,A,204,208,4,PASDI,0
5lbr,A,209,219,10,PAQARALYTRH,0
5lbr,A,257,267,10,SPMHMQYLRNM,0
5lbr,A,298,320,22,PPDLRTTLEYLGRLLSLQVQVKE,0
2fc2,B,-2,18,20,SHMEILWNEAKAFIAECYQEL,0
2fc2,B,20,22,2,KEE,0
2fc2,B,23,38,15,EVKDRLDSIKSEIDLT,0
2fc2,B,44,58,14,TKEELEHGAKMAWRN,0
2fc2,B,64,71,7,GRLFWNSL,0
2fc2,B,81,98,17,TKEDVRDALFHHIETATN,0
2fc2,B,99,101,2,NGK,0
2fc2,B,144,153,9,SCSLTAACEQ,0
2fc2,B,184,188,4,PRSLV,0
2fc2,B,198,205,7,IEAFSDLE,0
2fc2,B,236,242,6,MGTEIGA,0
2fc2,B,253,261,8,KLKKVASVI,0
2fc2,B,267,270,3,YNTD,0
2fc2,B,271,291,20,LWKDQALVELNKAVLYSYKKQ,0
2fc2,B,297,316,19,DHHTAASQFKRFEEQEEEAG,0
2fc2,B,322,327,5,DWTWLI,0
2fc2,B,331,335,4,SPAAT,0
2fc2,B,336,340,4,HIFHR,0
2fc2,B,237,242,5,GTEIGA,0
2fc2,B,331,340,9,SPAATHIFHR,0
2kh2,B,35,39,4,DMEQQ,0
2kh2,B,96,98,2,EKR,0
2kh2,B,79,83,4,QPEDF,0
2kh2,B,216,220,4,RAEDT,0
1uhi,B,9,24,15,NPRWIGRHKHMFNFLD,0
1uhi,B,33,47,14,LDEMVYKASDIVINN,0
1uhi,B,51,69,18,TPEQAKRHKDAVEAFFGGA,0
1uhi,B,79,99,20,WPAYIEGWKKLATDELEKYAK,0
1uhi,B,103,117,14,TLIRIWGDALFDIVD,0
1uhi,B,125,137,12,TLDEWKAYTKAAG,0
1uhi,B,141,152,11,SSEDCEETFRVC,0
1uhi,B,162,174,12,VDEMTRQHLGFWY,0
1uhi,B,177,181,4,DPACE,0
1uhi,B,184,188,4,YGGAV,0
1uhi,B,51,68,17,TPEQAKRHKDAVEAFFGG,0
3s6m,A,20,34,14,APKTVENFLNYVKKG,0
3s6m,A,71,75,4,EANNG,0
3s6m,A,105,109,4,NEFLN,0
3s6m,A,129,137,8,GQDIVDKIK,0
1rt3,B,28,43,15,EEKIKALVEICTEMEK,0
1rt3,B,78,83,5,RELNKR,0
1rt3,B,97,99,2,PAG,0
1rt3,B,113,117,4,DAYFS,0
1rt3,B,125,128,3,RKYT,0
1rt3,B,156,175,19,SPAIFQSSMTKILEPFRKQN,0
1rt3,B,195,212,17,IGQHRTKIEELRQHLLRW,0
1rt3,B,219,221,2,QKH,0
1rt3,B,254,269,15,VNDIQKLVGKLNWASQ,0
1rt3,B,278,281,3,QLK,0
1rt3,B,297,311,14,EEAELELAENREILK,0
1rt3,B,364,383,19,DVKQLTEAVQKITTESIVIW,0
1rt3,B,395,404,9,KETWETWWTE,0
1rt3,B,474,488,14,NQKTELQAIYLALQD,0
1rt3,B,500,508,8,QYALGIIQA,0
1rt3,B,516,527,11,ELVNQIIEQLIK,0
1rt3,B,98,102,4,AGLKK,0
1rt3,B,112,117,5,GDAYFS,0
1rt3,B,122,128,6,EDFRKYT,0
1rt3,B,135,137,2,INN,0
1rt3,B,154,172,18,KGSPAIFQSSMTKILEPFR,0
1rt3,B,236,238,2,PDK,0
1rt3,B,277,283,6,RQLCKLL,0
1rt3,B,395,405,10,KETWETWWTEY,0
1rt3,B,421,425,4,PLVKL,0
2xdw,A,28,33,5,YAWLED,0
2xdw,A,36,57,21,SEQTKAFVEAQNKITVPFLEQC,0
2xdw,A,58,72,14,PIRGLYKERMTELYD,0
2xdw,A,115,120,5,DPNILS,0
2xdw,A,218,222,4,DQSED,0
2xdw,A,267,269,2,QQE,0
2xdw,A,322,326,4,EESKW,0
2xdw,A,431,433,2,DAS,0
2xdw,A,485,496,11,SVSRLIFVRHMG,0
2xdw,A,510,517,7,YGETWHKG,0
2xdw,A,518,522,4,GILAN,0
2xdw,A,523,540,17,KQNCFDDFQCAAEYLIKE,0
2xdw,A,544,546,2,SPK,0
2xdw,A,554,567,13,SNGGLLVATCANQR,0
2xdw,A,568,571,3,PDLF,0
2xdw,A,585,589,4,KFHKY,0
2xdw,A,591,594,3,IGHA,0
2xdw,A,595,600,5,WTTDYG,0
2xdw,A,604,615,11,SKQHFEWLIKYS,0
2xdw,A,616,619,3,PLHN,0
2xdw,A,646,660,14,PLHSLKFIATLQYIV,0
2xdw,A,685,705,20,PTAKVIEEVSDMFAFIARCLN,0
5w5n,B,246,252,6,KPKDTLM,0
5w5n,B,309,315,6,LHQDWLN,0
5w5n,B,354,360,6,SQEEMTK,0
5w5n,B,414,419,5,KSRWQE,0
5w5n,B,432,434,2,LHN,0
5w5n,B,236,238,2,AAS,0
5w5n,B,432,436,4,LHNHY,0
1htd,B,16,22,6,HRVFMKY,0
1htd,B,26,45,19,LNTIRTRVHEIVNFINGFYR,0
1htd,B,71,90,19,SSDTLNAFAEWRETDLLNRK,0
1htd,B,133,148,15,NLLMGVTMAHELGHNL,0
1htd,B,180,194,14,DDSMHYYERFLKQYK,0
1opk,A,140,144,4,SLEKH,0
1opk,A,152,160,8,SRNAAEYLL,0
1opk,A,161,163,2,SSG,0
1opk,A,213,222,9,TLAELVHHHS,0
1opk,A,257,259,2,ERT,0
1opk,A,268,271,3,GGGQ,0
1opk,A,282,284,2,KYS,0
1opk,A,298,312,14,EVEEFLKEAAVMKEI,0
1opk,A,341,349,8,NLLDYLREC,0
1opk,A,355,376,21,SAVVLLYMATQISSAMEYLEKK,0
1opk,A,384,386,2,AAR,0
1opk,A,392,394,2,ENH,0
1opk,A,421,425,4,PIKWT,0
1opk,A,426,433,7,APESLAYN,0
1opk,A,436,453,17,SIKSDVWAFGVLLWEIAT,0
1opk,A,463,465,2,DLS,0
1opk,A,466,473,7,QVYELLEK,0
1opk,A,484,495,11,PEKVYELMRACW,0
1opk,A,498,502,4,NPSDR,0
1opk,A,504,514,10,SFAEIHQAFET,0
1opk,A,520,531,11,SISDEVEKELGK,0
5g2f,C,38,56,18,ANLAAGQSYVRNVALALEA,0
5g2f,C,38,57,19,ANLAAGQSYVRNVALALEAQ,0
5g2f,C,41,57,16,AAGQSYVRNVALALEAQ,0
1v3b,B,152,157,5,NPDDFW,0
1v3b,B,275,282,7,DERSDYAS,0
1v3b,B,305,309,4,KNNNI,0
1v3b,B,359,367,8,TQRDCNQAS,0
1v3b,B,368,368,0,H,0
1v3b,B,369,373,4,SPWFS,0
1v3b,B,441,445,4,DYSDI,0
5adm,B,85,90,5,TLCAQS,0
5adm,B,121,140,19,PAEQLLSQARDFINQYYSSI,0
5adm,B,145,163,18,SQAHEERLQEVEAEVASTG,0
5adm,B,168,182,14,RESELVFGAKQAWRN,0
5adm,B,188,192,4,GRIQW,0
5adm,B,205,222,17,SAQEMFTYICNHIKYATN,0
5adm,B,223,225,2,RGN,0
5adm,B,269,279,10,NVEITELCIQH,0
5adm,B,308,312,4,PPELV,0
5adm,B,322,329,7,LEWFAALG,0
5adm,B,361,366,5,STEIGT,0
5adm,B,366,371,5,TRNLCD,0
5adm,B,377,385,8,ILEDVAVM,0
5adm,B,391,394,3,TTSS,0
5adm,B,395,415,20,LWKDKAAVEINLAVLHSFQLA,0
5adm,B,421,441,20,DHHAATVSFMKHLDNEQKARG,0
5adm,B,446,451,5,DWAWIV,0
5adm,B,455,459,4,SGSLT,0
5adm,B,459,463,4,TPVFH,0
5adm,B,360,366,6,MSTEIGT,0
2jjd,F,119,127,8,HLEEEIRIR,0
2jjd,F,138,142,4,EFNSL,0
2jjd,F,156,163,7,KEENREKN,0
2jjd,F,211,213,2,KQE,0
2jjd,F,214,225,11,TVNDFWRMVWEQ,0
2jjd,F,310,324,14,PIGMLKFLKKVKTLN,0
2jjd,F,340,359,19,GRTGTFIVIDAMMAMMHAEQ,0
2jjd,F,362,372,10,DVFEFVSRIRN,0
2jjd,F,380,397,17,TDMQYTFIYQALLEYYLY,0
2jjd,F,425,435,10,GLEEEFRKLTN,0
2jjd,F,443,448,5,MRTGNL,0
2jjd,F,448,453,5,LPANMK,0
2jjd,F,506,517,11,TVEDFWRMIWEW,0
2jjd,F,604,621,17,GKGMIDLIAAVQKQQQQT,0
2jjd,F,635,654,19,GRTGTFIALSNILERVKAEG,0
2jjd,F,657,667,10,DVFQAVKSLRL,0
2jjd,F,675,691,16,TLEQYEFCYKVVQDFID,0
2jjd,F,133,140,7,KQFREEFN,0
2jjd,F,152,156,4,ELANK,0
2jjd,F,463,466,3,YDFN,0
2jjd,F,503,505,2,LAH,0
2jjd,F,134,140,6,QFREEFN,0
2jjd,F,425,434,9,GLEEEFRKLT,0
2jjd,F,439,442,3,MKEN,0
2jjd,F,463,465,2,YDF,0
2jjd,F,604,622,18,GKGMIDLIAAVQKQQQQTG,0
2jjd,F,657,669,12,DVFQAVKSLRLQR,0
2jjd,F,675,690,15,TLEQYEFCYKVVQDFI,0
2jjd,F,132,140,8,CKQFREEFN,0
2jjd,F,425,436,11,GLEEEFRKLTNV,0
1g4r,A,44,49,5,DPEYLK,0
1g4r,A,98,109,11,TRLQERLIKKLG,0
1g4r,A,159,163,4,HKRNS,0
1g4r,A,312,315,3,REIL,0
3fow,B,11,15,4,SKEQI,0
3fow,B,24,33,9,DPGRVDKIKV,0
3fow,B,67,80,13,GSAGCAICFEELCQ,0
3fow,B,116,122,6,RVSHLLI,0
3fow,B,131,145,14,DFDVYDTLNKCAQEL,0
3fow,B,169,176,7,RLEDYSKA,0
3fow,B,184,195,11,ELATLMVIGTLR,0
3fow,B,222,243,21,VPHQLENMIKIALGACAKLATK,0
1miy,B,2,18,16,KPPFQEALGIIQQLKQH,0
1miy,B,26,35,9,GGAVRDLLLG,0
1miy,B,48,56,8,LPEDVMAIF,0
1miy,B,103,109,6,SLEEDLK,0
1miy,B,113,117,4,FTMNA,0
1miy,B,131,139,8,GGREAIRRR,0
1miy,B,146,154,8,EAEKRFRED,0
1miy,B,156,168,12,LRMMRAVRFVSEL,0
1miy,B,173,184,11,APDTEQAIVQNA,0
1miy,B,185,190,5,PLLAHI,0
1miy,B,191,203,12,SVERMTMEMEKLL,0
1miy,B,207,218,11,FAARALPLLAET,0
1miy,B,230,237,7,KEKQLRLA,0
1miy,B,238,240,2,AAY,0
1miy,B,241,245,4,RWPWL,0
1miy,B,247,259,12,AREERWALLCHAL,0
1miy,B,263,271,8,ESRPFLRAW,0
1miy,B,274,291,17,PNKVVDEAGAILTALADI,0
1miy,B,293,297,4,RPEAW,0
1miy,B,298,306,8,TNEQLFSAG,0
1miy,B,306,322,16,GLERALSVETVRAAFTG,0
1miy,B,325,337,12,PGPWHEKLRRRFA,0
1miy,B,350,359,9,NGKDVIEWVG,0
1miy,B,363,378,15,GPWVKEALDAIWRAVV,0
1miy,B,385,398,13,EKERIYAWLMERNR,0
1miy,B,398,403,5,RTREKN,0
1miy,B,325,336,11,PGPWHEKLRRRF,0
2vsn,B,23,31,8,WLMLADAEL,0
2vsn,B,38,47,9,DTTAGEMAVQ,0
2vsn,B,59,70,11,AVARLGRVRWTQ,0
2vsn,B,72,86,14,RHAEAAVLLQQASDA,0
2vsn,B,90,103,13,HPGIALWLGHALED,0
2vsn,B,106,120,14,QAEAAAAAYTRAHQL,0
2vsn,B,124,139,15,EPYITAQLLNWRRRLC,0
2vsn,B,143,158,15,ALDVLSAQVRAAVAQG,0
2vsn,B,163,168,5,EPFAFL,0
2vsn,B,173,191,18,SAAEQLACARTRAQAIAAS,0
2vsn,B,218,235,17,HPTGLLTVALFEALQRRQ,0
2vsn,B,251,259,8,STLRTRLAQ,0
2vsn,B,270,281,11,GHLATAKHIRHH,0
2vsn,B,297,303,6,RPEVFAL,0
2vsn,B,335,342,7,PPALEPFY,0
2vsn,B,368,372,4,RTQCG,0
2vsn,B,385,389,4,NSYKL,0
2vsn,B,390,404,14,NPQSMARMLAVLREV,0
2vsn,B,417,429,12,EADARLRAFAHAQ,0
2vsn,B,432,434,2,DAQ,0
2vsn,B,443,451,8,PHPQYLARY,0
2vsn,B,452,454,2,RHA,0
2vsn,B,466,476,10,HTTASDALWTG,0
2vsn,B,486,489,3,TFAA,0
2vsn,B,490,500,10,RVAGSLNHHLG,0
2vsn,B,501,504,3,LDEM,0
2vsn,B,508,522,14,DDAAFVAKAVALASD,0
2vsn,B,522,540,18,DPAALTALHARVDVLRRAS,0
2vsn,B,541,543,2,GVF,0
2vsn,B,544,562,18,HMDGFADDFGALLQALARR,0
2vsn,B,24,34,10,AWLMLADAELG,0
2vsn,B,43,51,8,AGEMAVQRG,0
2vsn,B,58,70,12,EAVARLGRVRWTQ,0
2kv4,A,6,11,5,CPLSHD,0
2v4j,F,8,14,6,KLDQLES,0
2v4j,F,19,34,15,SFVSDIKQEAAYRAAN,0
2v4j,F,45,61,16,DCPEDLLGVLELSYDEG,0
2v4j,F,91,95,4,FPGVA,0
2v4j,F,112,126,14,ADYLRQLCDIWDLRG,0
2v4j,F,145,147,2,QTP,0
2v4j,F,148,159,11,QLEEIFFELTHN,0
2v4j,F,178,182,4,LGKSR,0
2v4j,F,189,201,12,DSQAACYELTMEY,0
2v4j,F,201,207,6,YQDELHR,0
2v4j,F,227,232,5,ASIARS,0
2v4j,F,247,256,9,DAEAVKAYVA,0
2v4j,F,260,265,5,KPNAGA,0
2v4j,F,275,280,5,DIEAEV,0
2v4j,F,281,284,3,VNRC,0
2v4j,F,300,303,3,NKEC,0
2v4j,F,307,313,6,MHCINTM,0
2v4j,F,355,373,18,FDEIKEVVEKIWDWWMEEG,0
2v4j,F,378,387,9,RLGETMKRLS,0
2v4j,F,387,395,8,SFQKLLEVT,0
2v4j,F,400,403,3,VPQH,0
2v4j,F,416,420,4,KEEEV,0
2v4j,F,427,435,8,DITEYRKRH,0
2v4j,F,31,38,7,PPVIAKNF,0
2v4j,F,75,89,14,ITHIREMCDIADKYC,0
2v4j,F,107,121,14,DEASLKALKEDLASR,0
2v4j,F,146,150,4,QGWVH,0
2v4j,F,158,174,16,ASGPVKAIMDEVFEDFQ,0
2v4j,F,195,199,4,AVHCS,0
2v4j,F,214,222,8,DHEWTDQLC,0
2v4j,F,223,230,7,EIPLAVAS,0
2v4j,F,255,258,3,NERC,0
2v4j,F,262,268,6,GNCYTMC,0
2v4j,F,313,331,18,WPSLTKTIKHIIEVYSANA,0
2v4j,F,336,345,9,RLGEWAERIG,0
2v4j,F,345,354,9,GWERFFSLTG,0
2v4j,F,358,362,4,SHHLI,0
2v4j,F,366,372,6,RDPAYYT,0
2v4j,F,21,25,4,RFDDW,0
2v4j,F,26,34,8,CPEWVEYVK,0
2v4j,F,35,38,3,ESEG,0
2v4j,F,43,61,18,SPDHQKIIDFLQDYYKKNG,0
2v4j,F,65,74,9,MVRILSKNTG,0
2v4j,F,76,84,8,KLKEVYELF,0
2v4j,F,86,91,5,SGPGKG,0
2v4j,F,91,97,6,GACKMAG,0
4gmy,A,845,847,2,EER,0
4gmy,A,888,904,16,TEEHLRDFEREIEILKS,0
4gmy,A,918,923,5,YSAGRR,0
4gmy,A,936,944,8,SLRDYLQKH,0
4gmy,A,945,948,3,KERI,0
4gmy,A,949,970,21,DHIKLLQYTSQICKGMEYLGTK,0
4gmy,A,994,998,4,DFGLT,0
4gmy,A,1017,1021,4,PIFWY,0
4gmy,A,1022,1029,7,APESLTES,0
4gmy,A,1032,1050,18,SVASDVWSFGVVLYELFTY,0
4gmy,A,1056,1066,10,SPPAEFMRMIG,0
4gmy,A,1071,1084,13,GQMIVFHLIELLKN,0
4gmy,A,1095,1106,11,PDEIYMIMTECW,0
4gmy,A,1109,1113,4,NVNQR,0
4gmy,A,1115,1130,15,SFRDLALRVDQIRDNM,0
4pw1,B,63,67,4,PWNLY,0
4pw1,B,76,90,14,EEEIVSFAANSVRIL,0
4pw1,B,96,101,5,TDEELY,0
4pw1,B,102,104,2,PLI,0
4pw1,B,154,175,21,TADEDQALGKLQEDWEKFLSD,0
4pw1,B,205,224,19,NAFYFFRCQLSDQRKE,0
4pw1,B,230,244,14,IGDNLYTIWELVLKS,0
4pw1,B,230,232,2,IGD,0
4pw1,B,233,244,11,NLYTIWELVLKS,0
4egp,B,27,33,6,SLDFFDD,0
4egp,B,33,44,11,DPYPDQQTLRDA,0
4egp,B,60,70,10,RYAEVHAVLND,0
4egp,B,105,116,11,HTRPRAVLSKVL,0
4egp,B,117,141,24,SPATMKTIRDGFAAAADAKVDELLQ,0
4egp,B,153,165,12,EAYPLSVFPDAMG,0
4egp,B,170,172,2,GRE,0
4egp,B,173,185,12,HLLPYAGLVFNAF,0
4egp,B,189,198,9,NELRQTAIER,0
4egp,B,199,210,11,SAPHQAYVNEQC,0
4egp,B,211,215,4,QRPNL,0
4egp,B,219,231,12,GFGACIHAFTDTG,0
4egp,B,236,249,13,DEAPLLVRSLLSAG,0
4egp,B,250,267,17,LDTTVNGIGAAVYCLARF,0
4egp,B,267,277,10,FPGELQRLRSD,0
4egp,B,280,293,13,LARNAFEEAVRFES,0
4egp,B,322,328,6,FLGSANR,0
4egp,B,360,378,18,GQLVARLEGEVMLSALARK,0
4egp,B,34,44,10,PYPDQQTLRDA,0
4egp,B,60,69,9,RYAEVHAVLN,0
4egp,B,117,130,13,SPATMKTIRDGFAA,0
4egp,B,132,141,9,ADAKVDELLQ,0
4egp,B,159,165,6,VFPDAMG,0
4egp,B,191,197,6,LRQTAIE,0
4egp,B,199,211,12,SAPHQAYVNEQCQ,0
4egp,B,212,215,3,RPNL,0
4egp,B,220,226,6,FGACIHA,0
4egp,B,236,250,14,DEAPLLVRSLLSAGL,0
4egp,B,250,265,15,LDTTVNGIGAAVYCLA,0
4egp,B,281,293,12,ARNAFEEAVRFES,0
4egp,B,323,328,5,LGSANR,0
4egp,B,360,365,5,GQLVAR,0
6bp7,A,422,428,6,GVEELLN,0
6bp7,A,507,511,4,RPHAR,0
6bp7,A,554,564,10,DPAEAAKLFSV,0
6bp7,A,566,586,20,DFVGDACKAIASRVRGAVASV,0
6bp7,A,594,604,10,NSARIIRMAVF,0
6bp7,A,647,803,156,DQRTRDALQRSVQLAIEITTNSQEAAAKHEAQRLEQEARGRLERQKILDQSEAEKARKELLELEAMSMAVESTGNAKAEAESRAEAARIEGEGSVLQAKLKAQALAIETEAELERVKKVREMELIYARAQLELEVSKAQQLANVEAKKFKEMTEALG,0
6bp7,A,803,813,10,GPGTIRDLAVA,0
3pje,B,19,31,12,SIAYGIAQAMHRE,0
3pje,B,41,55,14,NDKLKGRVEEFAAQL,0
3pje,B,67,82,15,EDASIDTMFAELGKVW,0
3pje,B,96,100,4,PGDQL,0
3pje,B,103,108,5,DYVNAV,0
3pje,B,109,121,12,TREGFKIAHDISS,0
3pje,B,121,131,10,SYSFVAMAKAC,0
3pje,B,132,135,3,RSML,0
3pje,B,146,150,4,YLGAE,0
3pje,B,157,178,21,NVMGLAKASLEANVRYMANAMG,0
3pje,B,196,200,4,AASGI,0
3pje,B,203,214,11,FRKMLAHCEAVT,0
3pje,B,221,234,13,TIEDVGNSAAFLCS,0
3pje,B,235,238,3,DLSA,0
3pje,B,250,254,4,GFSIA,0
3pje,B,67,79,12,EDASIDTMFAELG,0
3pje,B,96,101,5,PGDQLD,0
3pje,B,121,132,11,SYSFVAMAKACR,0
3pje,B,133,135,2,SML,0
3pje,B,179,181,2,PEG,0
3pje,B,195,199,4,LAASG,0
3pje,B,203,213,10,FRKMLAHCEAV,0
3pje,B,221,233,12,TIEDVGNSAAFLC,0
3pje,B,234,238,4,SDLSA,0
2vz0,D,13,27,14,KRIGRAIAVKLHQTG,0
2vz0,D,37,52,15,SAEAAVSLADELNKER,0
2vz0,D,68,85,17,VLPASCEEIINSCFRAFG,0
2vz0,D,115,128,13,TVETQVAELIGTNA,0
2vz0,D,128,142,14,AIAPFLLTMSFAQRQ,0
2vz0,D,171,193,22,FSLYNMGKHALVGLTQSAALELA,0
2vz0,D,194,196,2,PYG,0
2vz0,D,214,223,9,GEEEKDKWRR,0
2vz0,D,233,246,13,SAEQIADAVIFLVS,0
2vz0,D,247,250,3,GSAQ,0
2vz0,D,262,266,4,GLSLV,0
2vz0,D,128,141,13,AIAPFLLTMSFAQR,0
2vz0,D,13,26,13,KRIGRAIAVKLHQT,0
3cwa,D,11,23,12,DWSWMLGFLAARA,0
3cwa,D,65,69,4,AGLEP,0
3cwa,D,70,83,13,VAAECLAKMSRLFD,0
3cwa,D,87,96,9,NPQIVNGALG,0
3cwa,D,96,101,5,GRLGAA,0
3cwa,D,112,123,11,DAFEQGVRAILG,0
3cwa,D,127,143,16,SVAMAAKLTARVAQLYG,0
3cwa,D,157,163,6,TPQRLAA,0
3cwa,D,165,172,7,DPQALKAL,0
3cwa,D,175,192,17,PLKRAEALIHLANAALEG,0
3cwa,D,201,210,9,DVEQAMKTLQ,0
3cwa,D,216,228,12,GRWTANYFALRGW,0
3cwa,D,238,243,5,DYLIKQ,0
3cwa,D,249,258,9,TPAQIRRYAE,0
3cwa,D,259,261,2,RWK,0
3cwa,D,263,273,10,WRSYALLHIWY,0
3cwa,D,11,22,11,DWSWMLGFLAAR,0
3cwa,D,70,82,12,VAAECLAKMSRLF,0
3cwa,D,97,100,3,RLGA,0
3cwa,D,167,174,7,QALKALGM,0
3cwa,D,201,211,10,DVEQAMKTLQT,0
3cwa,D,238,245,7,DYLIKQRF,0
3cwa,D,157,164,7,TPQRLAAA,0
3cwa,D,165,171,6,DPQALKA,0
3cwa,D,112,122,10,DAFEQGVRAIL,0
3cwa,D,175,191,16,PLKRAEALIHLANAALE,0
2lp3,B,2,21,19,SELETAMETLINVFHAHSGK,0
2lp3,B,29,41,12,SKKELKELLQTEL,0
2lp3,B,46,50,4,DAQKD,0
2lp3,B,51,62,11,VDAVDKVMKELD,0
2lp3,B,71,93,22,FQEYVVLVAALTVACNNFFWENS,0
2qak,B,86,91,5,GRNLMT,0
2qak,B,92,94,2,QIG,0
5v5x,D,344,348,4,SGENA,0
5v5x,D,449,453,4,VGSNG,0
5v5x,D,465,472,7,EPKALSSF,0
5v5x,D,566,570,4,SGHNA,0
5v5x,D,465,467,2,EPK,0
5v5x,D,468,472,4,ALSSF,0
5v5x,D,449,454,5,VGSNGL,0
5aqo,F,52,58,6,GDAAKNQ,0
5aqo,F,69,73,4,DAKRL,0
5aqo,F,80,87,7,DAVVQSDM,0
5aqo,F,88,90,2,KHW,0
5aqo,F,115,136,21,YPEEVSSMVLTKMKEIAEAYLG,0
5aqo,F,151,165,14,NDSQRQATKDAGTIA,0
5aqo,F,175,183,8,EPTAAAIAY,0
5aqo,F,229,250,21,GGEDFDNRMVNHFIAEFKRKHK,0
5aqo,F,256,274,18,NKRAVRRLRTACERAKRTL,0
5aqo,F,299,306,7,RARFEELN,0
5aqo,F,306,313,7,NADLFRGT,0
5aqo,F,313,324,11,TLDPVEKALRDA,0
5aqo,F,327,331,4,DKSQI,0
5aqo,F,338,342,4,GGSTR,0
5aqo,F,343,354,11,IPKIQKLLQDFF,0
5aqo,F,367,380,13,EAVAYGAAVQAAIL,0
5aqo,F,152,188,36,SPQEEVELKKLKHLEKSVEKIADQLEELNKELTGIQQ,0
5aqo,F,192,203,11,PKDLQAEALCKL,0
5aqo,F,203,222,19,LDRRVKATIEQFMKILEEID,0
5aqo,F,230,256,26,FKDSRLKRKGLVKKVQAFLAECDTVEQ,0
5aqo,F,80,88,8,DAVVQSDMK,0
5aqo,F,192,202,10,PKDLQAEALCK,0
5aqo,F,230,258,28,FKDSRLKRKGLVKKVQAFLAECDTVEQNI,0
3u5y,B,13,17,4,DATRI,0
3u5y,B,18,22,4,SRSDF,0
3u5y,B,33,38,5,SAYQIE,0
3u5y,B,49,58,9,SIWDTFTHRR,0
3u5y,B,59,66,7,PDMIRGGT,0
3u5y,B,73,89,16,DSYHLYKEDVNILKNLG,0
3u5y,B,98,103,5,SWSRVL,0
3u5y,B,107,111,4,RLSGG,0
3u5y,B,113,130,17,NKEGINYYNNLIDGLLAN,0
3u5y,B,144,152,8,PQALEDEYG,0
3u5y,B,153,157,4,GFLSP,0
3u5y,B,158,175,17,RIVDDFCEYAELCFWEFG,0
3u5y,B,186,196,10,QPWTFSVHGYA,0
3u5y,B,237,261,24,TEPYWVTHHLLLAHAAAVELYKNKF,0
3u5y,B,261,266,5,FQRGQE,0
3u5y,B,285,300,15,SASDVEAAARALDFML,0
3u5y,B,300,305,5,LGWFME,0
3u5y,B,305,310,5,EPITSG,0
3u5y,B,313,321,8,PKSMKKFVG,0
3u5y,B,322,324,2,SRL,0
3u5y,B,328,336,8,SPEQSKMLK,0
3u5y,B,366,371,5,SYNTDI,0
3u5y,B,397,412,15,PEGIRKILVYTKKTYN,0
3u5y,B,432,437,5,TLSEAR,0
3u5y,B,439,459,20,DSMRLKYLQDHIFNVRQAMND,0
3u5y,B,476,480,4,EWGEG,0
3u5y,B,501,512,11,KDSAVWLMNSFH,0
3u5y,B,287,298,11,SDVEAAARALDF,0
1og3,A,22,39,17,VNKMEEKAPLLLQEDFNM,0
1og3,A,41,57,16,AKLKVAWEEAKKRWNNI,0
1og3,A,68,79,11,NDFHGTALVAYT,0
1og3,A,81,92,11,SIAVDFNRAVRE,0
1og3,A,103,116,13,KAFHYYLTRALQLL,0
1og3,A,152,156,4,KKVAQ,0
3avl,B,93,108,15,TGQETAYFLLKLAGRW,0
3avl,B,117,123,6,NGSNFTS,0
3avl,B,123,134,11,STTVKAACWWAG,0
3avl,B,145,166,21,PQSQGVIESMNKELKKIIGQVR,0
3avl,B,167,169,2,DQA,0
3avl,B,171,186,15,HLKTAVQMAVFIHNHK,0
3avl,B,195,209,14,SAGERIVDIIATDIQ,0
3avl,B,144,166,22,NPQSQGVIESMNKELKKIIGQVR,0
2z6f,A,563,568,5,SVMDGF,0
2z6f,A,590,592,2,DDS,0
2z6f,A,611,614,3,PKNN,0
2z6f,A,638,641,3,ANIG,0
1fha,A,14,43,29,QDSEAAINRQINLELYASYVYLSMSYYFDR,0
1fha,A,50,76,26,NFAKYFLHQSHEEREHAEKLMKLQNQR,0
1fha,A,96,123,27,GLNAMECALHLEKNVNQSLLELHKLATD,0
1fha,A,129,158,29,LCDFIETHYLNEQVKAIKELGDHVTNLRKM,0
1fha,A,171,180,9,SGLAEYLFDK,0
4bb7,D,452,456,4,RPEQT,0
4bb7,D,492,497,5,FTRYQR,0
4bb7,D,527,532,5,TWKACL,0
4bb7,D,533,537,4,PEEIR,0
4bb7,D,558,562,4,IRHLL,0
4bb7,D,452,455,3,RPEQ,0
5bpv,B,220,232,12,SAKDLRNIMYDHL,0
5bpv,B,237,253,16,TAFHQLVQVICKLGKDS,0
5bpv,B,255,269,14,SLDIIHAEFQASLAE,0
5bpv,B,272,284,12,SPQCALAQITKRV,0
5bpv,B,285,288,3,PIFQ,0
5bpv,B,299,303,4,SRGDI,0
5bpv,B,304,309,5,PRACQK,0
5bpv,B,319,322,3,KIDR,0
3qpj,B,86,91,5,GRNLLT,0
3qpj,B,92,94,2,QIG,0
3qpj,B,86,93,7,GRNLLTQI,0
2crn,A,12,19,7,LLEPLLAM,0
2crn,A,22,34,12,PVHTALKALAATG,0
2crn,A,37,49,12,TAEEALAWLHDHC,0
1crq,A,15,25,10,GKSALTIQLIQ,0
1crq,A,66,75,9,AMRDQYMRTG,0
1crq,A,87,104,17,TKSFEDIHQYREQIKRVK,0
1crq,A,127,138,11,SRQAQDLARSYG,0
1crq,A,152,166,14,VEDAFYTLVREIRQH,0
