PDB ID,Chain,Helix Start,Helix End,Helix Length,Helix Sequence,Is Transmembrane
4p6h,C,11,30,19,PVLQKILIGLILGAIVGLIL,0
4p6h,C,35,43,8,YAHAVHTYV,0
4p6h,C,43,56,13,VKPFGDLFVRLLCM,0
4p6h,C,57,74,17,LVMPIVFASLVVGAASIS,0
4p6h,C,79,107,28,GRVGVKIVVYYLLTSAFAVTLGIIMARLF,0
4p6h,C,129,136,7,PLVHILLD,0
4p6h,C,141,148,7,NPFGALAN,0
4p6h,C,150,169,19,QVLPTIFFAIILGIAITYLM,0
4p6h,C,173,202,29,NEKVRKSAETLLDAINGLAEAMYKIVNGVM,0
4p6h,C,204,219,15,YAPIGVFALIAYVMAE,0
4p6h,C,222,246,24,VHVVGELAKVTAAVYVGLTLQILLV,0
4p6h,C,246,253,7,VYFVLLKI,0
4p6h,C,257,276,19,DPISFIKHAKDAMLTAFVTR,0
4p6h,C,281,292,11,TLPVTMRVAKEM,0
4p6h,C,295,307,12,SEGIYSFTLPLGA,0
4p6h,C,311,329,18,MDGTALYQGVATFFIANAL,0
4p6h,C,337,350,13,QQLTIVLTAVLASI,0
4p6h,C,357,370,13,GAGAIMLCMVLHSV,0
4p6h,C,376,416,40,DPNVAAAYAMILGIDAILDMGRTMVNVTGDLTGTAIVAKTE,0
2b5f,D,39,64,25,RAAIAEFIATLLFLYITVATVIGHSK,0
2b5f,D,73,92,19,GLLGIAWAFGGMIFVLVYCT,0
2b5f,D,93,96,3,AGIS,0
2b5f,D,101,110,9,NPAVTFGLFL,0
2b5f,D,115,139,24,SLLRALVYMIAQCLGAICGVGLVKA,0
2b5f,D,141,148,7,MKGPYNQF,0
2b5f,D,160,182,22,NKGTALGAEIIGTFVLVYTVFSA,0
2b5f,D,198,218,20,APLPIGFAVFMVHLATIPITG,0
2b5f,D,222,234,12,NPARSFGAAVIFN,0
2b5f,D,235,242,7,SNKVWDDQ,0
2b5f,D,243,260,17,WIFWVGPFIGAAVAAAYH,0
2b5f,D,73,97,24,GLLGIAWAFGGMIFVLVYCTAGISG,0
2b5f,D,115,141,26,SLLRALVYMIAQCLGAICGVGLVKAFM,0
2b5f,D,149,152,3,GGGA,0
2b5f,D,199,214,15,PLPIGFAVFMVHLATI,0
2b5f,D,39,65,26,RAAIAEFIATLLFLYITVATVIGHSKE,0
2b5f,D,101,111,10,NPAVTFGLFLA,0
2b5f,D,115,148,33,SLLRALVYMIAQCLGAICGVGLVKAFMKGPYNQF,0
2b5f,D,199,218,19,PLPIGFAVFMVHLATIPITG,0
2b5f,D,243,258,15,WIFWVGPFIGAAVAAA,0
2b5f,D,72,93,21,VGLLGIAWAFGGMIFVLVYCTA,0
2b5f,D,142,148,6,KGPYNQF,0
2b5f,D,243,263,20,WIFWVGPFIGAAVAAAYHQYV,0
4zln,A,1,6,5,MPNFFI,0
4zln,A,8,27,19,RPIFAWVIAIIIMLAGGLAI,0
4zln,A,53,61,8,DAKTVQDTV,0
4zln,A,62,67,5,TQVIEQ,0
4zln,A,99,112,13,DADIAQVQVQNKLQ,0
4zln,A,113,118,5,LAMPLL,0
4zln,A,119,126,7,PQEVQQQG,0
4zln,A,150,161,11,TQEDISDYVAAN,0
4zln,A,162,167,5,MKDAIS,0
4zln,A,189,196,7,NPNELNKF,0
4zln,A,199,211,12,TPVDVITAIKAQN,0
4zln,A,242,248,6,STEEFGK,0
4zln,A,299,311,12,ALDTAAAIRAELA,0
4zln,A,330,359,29,TPFVKISIHEVVKTLVEAIILVFLVMYLFL,0
4zln,A,365,385,20,TLIPTIAVPVVLLGTFAVLAA,0
4zln,A,391,424,33,NTLTMFGMVLAIGLLVDDAIVVVENVERVMAEEG,0
4zln,A,426,454,28,PPKEATRKSMGQIQGALVGIAMVLSAVFV,0
4zln,A,455,458,3,PMAF,0
4zln,A,460,496,36,GGSTGAIYRQFSITIVSAMALSVLVALILTPALCATM,0
4zln,A,511,535,24,GFFGWFNRMFEKSTHHYTDSVGGIL,0
4zln,A,539,559,20,GRYLVLYLIIVVGMAYLFVRL,0
4zln,A,583,601,18,TQERTQKVLNEVTHYYLTK,0
4zln,A,628,632,4,DWADR,0
4zln,A,638,651,13,KVEAITMRATRAFS,0
4zln,A,687,701,14,HEKLTQARNQLLAEA,0
4zln,A,727,734,7,DQEKAQAL,0
4zln,A,737,751,14,SINDINTTLGAAWGG,0
4zln,A,772,775,3,AKYR,0
4zln,A,777,783,6,LPDDIGD,0
4zln,A,831,843,12,STGEAMELMEQLA,0
4zln,A,844,846,2,SKL,0
4zln,A,856,859,3,GMSY,0
4zln,A,867,888,21,QAPSLYAISLIVVFLCLAALYE,0
4zln,A,892,898,6,IPFSVML,0
4zln,A,900,913,13,VPLGVIGALLAATF,0
4zln,A,919,950,31,DVYFQVGLLTTIGLSAKNAILIVEFAKDLMDK,0
4zln,A,954,964,10,GLIEATLDAVR,0
4zln,A,966,981,15,RLRPILMTSLAFILGV,0
4zln,A,981,987,6,VMPLVIS,0
4zln,A,991,1028,37,GSGAQNAVGTGVMGGMVTATVLAIFFVPVFFVVVRRRF,0
3t53,A,158,171,13,WVEAQSEYLLLRET,0
3t53,A,174,188,14,TATQTEGILERLRLA,0
3t53,A,191,202,11,PEADIRRLIATQ,0
3t53,A,254,259,5,IAWLVK,0
3t53,A,390,397,7,NISGALER,0
3t53,A,85,92,7,DPTQTQNL,0
3t53,A,174,187,13,TATQTEGILERLRL,0
3t53,A,253,258,5,SIAWLV,0
3t53,A,381,392,11,GLFLIDSEANIS,0
3t53,A,393,401,8,GALERMRSE,0
3t53,A,6,11,5,IRRSVA,0
3t53,A,16,33,17,VLMGALFLSIWGTWTIIN,0
3t53,A,57,66,9,APQIVENQVT,0
3t53,A,66,75,9,TYPLTTTMLS,0
3t53,A,102,116,14,DPYWARSRVLEYLNQ,0
3t53,A,134,136,2,TGV,0
3t53,A,152,163,11,DLADLRSLQDWF,0
3t53,A,163,170,7,FLKYELKT,0
3t53,A,192,199,7,DPQRLAQY,0
3t53,A,202,211,9,SLAEVKSALD,0
3t53,A,239,245,6,TLDDFNH,0
3t53,A,296,312,16,NAREVIAAVKDKLETLK,0
3t53,A,327,357,30,RSQLIDRAIDNLSGKLLEEFIVVAVVCALFL,0
3t53,A,359,368,9,HVRSALVAII,0
3t53,A,370,385,15,LPLGLCIAFIVMHFQG,0
3t53,A,389,394,5,NIMSLG,0
3t53,A,394,399,5,GGIAIA,0
3t53,A,399,404,5,AVGAMV,0
3t53,A,407,416,9,AIVMIENAHK,0
3t53,A,420,425,5,EWQHQH,0
3t53,A,433,446,13,KTRWQVITDASVEV,0
3t53,A,446,458,12,VGPALFISLLIIT,0
3t53,A,461,467,6,FIPIFTL,0
3t53,A,469,492,23,GQEGRLFGPLAFTKTYAMAGAALL,0
3t53,A,496,504,8,VIPILMGYW,0
3t53,A,518,526,8,NRFLIRVYH,0
3t53,A,535,550,15,WPKTTLLVAALSVLTV,0
3t53,A,551,556,5,LWPLNK,0
3t53,A,581,597,16,SAAEAASMLQKTDKLIM,0
3t53,A,641,653,12,TMDKIIEELDNTV,0
3t53,A,664,675,11,PPIRNRIDMLST,0
3t53,A,689,705,16,VLADIDAMAEQIEEVAR,0
3t53,A,729,736,7,NREKAARY,0
3t53,A,739,749,10,TVADVQLFVTS,0
3t53,A,773,778,5,PQSWRD,0
3t53,A,779,785,6,SPQALRQ,0
3t53,A,832,848,16,DMVSVVHDLQKAIAEKV,0
3t53,A,861,873,12,QFELLERANHKLK,0
3t53,A,875,891,16,MVPMTLMIIFVLLYLAF,0
3t53,A,893,902,9,RVGEALLIIS,0
3t53,A,903,919,16,SVPFALVGGIWLLWWMG,0
3t53,A,923,950,27,SVATGTGFIALAGVAAEFGVVMLMYLRH,0
3t53,A,958,963,5,LNNPQT,0
3t53,A,967,996,29,QKLDEALYHGAVLRVRPKAMTVAVIIAGLL,0
3t53,A,997,1000,3,PILW,0
3t53,A,1005,1012,7,GSEVMSRI,0
3t53,A,1013,1023,10,AAPMIGGMITA,0
3t53,A,1023,1028,5,APLLSL,0
3t53,A,1031,1036,5,IPAAYK,0
3t53,A,1038,1043,5,MWLHRH,0
5twv,H,52,58,6,QGRFLQD,0
5twv,H,58,66,8,DVFTTLVDL,0
5twv,H,67,93,26,KWPHTLLIFTMSFLCSWLLFAMVWWLI,0
5twv,H,116,130,14,SFSSAFLFSIEVQVT,0
5twv,H,144,172,28,LAILILIVQNIVGLMINAIMLGCIFMKTA,0
5twv,H,174,180,6,AHRRAET,0
5twv,H,265,270,5,SPLYDL,0
5twv,H,271,279,8,APSDLHHHQ,0
5twv,H,345,354,9,TARQLDEDRS,0
5twv,H,10,18,8,NHSAAYRVD,0
5twv,H,18,25,7,DQGVLNNG,0
5twv,H,26,42,16,CFVDALNVVPHVFLLFI,0
5twv,H,42,53,11,ITFPILFIGWGS,0
5twv,H,70,98,28,GHNLRWILTFILLFVLVCEIAEGILSDGV,0
5twv,H,107,128,21,YMPAGMAFMAAITSVVYYHNIE,0
5twv,H,133,160,27,PKLLIALLIYWTLAFITKTIKFVKFYDH,0
5twv,H,166,187,21,QLRFCLTGLLVILYGMLLLVEV,0
5twv,H,208,216,8,EDLQDLGVR,0
5twv,H,230,242,12,YWWMNAFIKTAHK,0
5twv,H,242,250,8,KKPIDLRAI,0
5twv,H,252,257,5,KLPIAM,0
5twv,H,261,277,16,TNYQRLCVAFDAQARKD,0
5twv,H,283,296,13,GARAIWRALCHAFG,0
5twv,H,296,316,20,GRRLILSSTFRILADLLGFAG,0
5twv,H,316,327,11,GPLCIFGIVDHL,0
5twv,H,351,403,52,FLGNAYVLAVLLFLALLLQRTFLQASYYVAIETGINLRGAIQTKIYNKIMHMS,0
5twv,H,405,411,6,SNLSMGE,0
5twv,H,412,430,18,MTAGQICNLVAIDTNQLMW,0
5twv,H,434,456,22,LCPNLWTMPVQIIVGVILLYYIL,0
5twv,H,457,508,51,GVSALIGAAVIILLAPVQYFVATKLSQAQRTTLEHSNERLKQTNEMLRGMKL,0
5twv,H,510,568,58,KLYAWESIFCSRVEVTRRKEMTSLRAFAVYTSISIFMNTAIPIAAVLITFVGHVSFFKE,0
5twv,H,573,614,41,PSVAFASLSLFHILVTPLFLLSSVVRSTVKALVSVQKLSEFL,0
5twv,H,718,727,9,GKSSLLLATL,0
5twv,H,783,790,7,TVEENITF,0
5twv,H,795,806,11,NKQRYKMVIEAC,0
5twv,H,808,814,6,LQPDIDI,0
5twv,H,817,821,4,HGDQT,0
5twv,H,831,847,16,SGGQRQRISVARALYQQ,0
5twv,H,861,877,16,DVHLSDHLMQAGILELL,0
5twv,H,893,897,4,YLPHA,0
5twv,H,913,920,7,TLKDFQRS,0
5twv,H,922,928,6,CQLFEHW,0
5twv,H,1003,1007,4,KYLSS,0
5twv,H,1010,1043,33,ILLLSLLVFSQLLKHMVLVAIDYWLAKWTDSALV,0
5twv,H,1063,1071,8,VYAMVFTLL,0
5twv,H,1073,1082,9,SLGIVLCLVT,0
5twv,H,1088,1105,17,WTGLKVAKRLHRSLLNRI,0
5twv,H,1109,1115,6,PMRFFET,0
5twv,H,1117,1161,44,PLGSILNRFSSDCNTIDQHIPSTLECLSRSTLLCVSALTVISYVT,0
5twv,H,1167,1196,29,ALLPLAVVCYFIQKYFRVASRDLQQLDDTT,0
5twv,H,1197,1210,13,QLPLVSHFAETVEG,0
5twv,H,1210,1217,7,GLTTIRAF,0
5twv,H,1220,1273,53,EARFQQKLLEYTDSNNIASLFLTAANRWLEVCMEYIGACVVLIAAATSISNSLH,0
5twv,H,1282,1319,37,GLGLTYALMVSNYLNWMVRNLADMEIQLGAVKRIHALL,0
5twv,H,1381,1394,13,TGSGKSSFSLAFFR,0
5twv,H,1411,1413,2,AKL,0
5twv,H,1414,1421,7,PLHTLRSR,0
5twv,H,1435,1440,5,TIRFNL,0
5twv,H,1447,1458,11,SDSTLWEALEIA,0
5twv,H,1460,1466,6,LKLVVKA,0
5twv,H,1469,1473,4,GGLDA,0
5twv,H,1475,1479,4,ITEGG,0
5twv,H,1483,1499,16,SQGQRQLFCLARAFVRK,0
5twv,H,1514,1529,15,MATENILQKVVMTAFA,0
5twv,H,1541,1546,5,HTILSA,0
5twv,H,1562,1570,8,KPETLLSQK,0
5twv,H,1571,1577,6,DSVFASF,0
5twv,H,67,98,31,KWPHTLLIFTMSFLCSWLLFAMVWWLIAFAHG,0
2ahz,B,1,19,18,MLSFLLTLKRMLRACLRAW,0
2ahz,B,21,45,24,DKEFQVLFVLTILTLISGTIFYSTV,0
2ahz,B,49,62,13,RPIDALYFSVVTLT,0
2ahz,B,73,103,30,TDFGKIFTILYIFIGIGLVFGFIHKLAVNVQ,0
2ahz,B,73,102,29,TDFGKIFTILYIFIGIGLVFGFIHKLAVNV,0
4aps,B,13,47,34,LGLSTLFMTEMWERFSYYGMRAILLYYMWFLISTG,0
4aps,B,52,81,29,TRATAASIMAIYASMVYLSGTIGGFVADRI,0
4aps,B,83,104,21,GARPAVFWGGVLIMLGHIVLAL,0
4aps,B,109,137,28,SALFGSIILIIIGTGFLKPNVSTLVGTLY,0
4aps,B,142,173,31,RRRDAGFSIFVFGINLGAFIAPLIVGAAQEAA,0
4aps,B,174,199,25,GYHVAFSLAAIGMFIGLLVYYFGGKK,0
4aps,B,213,227,14,APEEVKPLLVKVSLA,0
4aps,B,227,242,15,AVAGFIAIIVVMNLVG,0
4aps,B,247,269,22,PAYINLLTIVAIAIPVFYFAWMI,0
4aps,B,284,300,16,SYIPLFIAAVLFWAIEE,0
4aps,B,301,303,2,QGS,0
4aps,B,304,313,9,VVLATFAAER,0
4aps,B,321,325,4,VSWFQ,0
4aps,B,326,346,20,SLNPLFIMLYTPFFAWLWTAW,0
4aps,B,353,369,16,SPTKFAVGLMFAGLSFL,0
4aps,B,371,378,7,MAIPGALY,0
4aps,B,386,402,16,PLWLVGSWALVILGEML,0
4aps,B,405,415,10,PVGLSVTTKLA,0
4aps,B,424,442,18,MSMWFLSSSVGSALNAQLV,0
4aps,B,443,448,5,TLYNAK,0
4aps,B,451,457,6,VAYFSYF,0
4aps,B,457,471,14,FGLGSVVLGIVLVFL,0
4aps,B,14,47,33,GLSTLFMTEMWERFSYYGMRAILLYYMWFLISTG,0
4aps,B,174,198,24,GYHVAFSLAAIGMFIGLLVYYFGGK,0
3nsb,A,11,15,4,IWLAL,0
3nsb,A,36,49,13,DPDAKKFYAITTLV,0
3nsb,A,89,99,10,TTPLLLLDLAL,0
3nsb,A,105,108,3,QGTI,0
3nsb,A,114,124,10,ADGIMIGTGLV,0
3nsb,A,145,148,3,MLYI,0
3nsb,A,151,155,4,VLFFG,0
3nsb,A,169,176,7,STFKVLRN,0
1zcd,B,12,31,19,ASGGIILIIAAILAMIMANS,0
1zcd,B,34,42,8,TSGWYHDFL,0
1zcd,B,59,85,26,MLLWINDALMAVFFLLVGLEVKRELMQ,0
1zcd,B,94,105,11,AAFPVIAAIGGM,0
1zcd,B,108,113,5,PALLYL,0
1zcd,B,114,116,2,AFN,0
1zcd,B,121,126,5,ITREGW,0
1zcd,B,133,143,10,DIAFALGVLAL,0
1zcd,B,152,175,23,LKIFLMALAIIDDLGAIIIIALFY,0
1zcd,B,180,200,20,SMASLGVAAVAIAVLAVLNLC,0
1zcd,B,205,219,14,TGVYILVGVVLWTAV,0
1zcd,B,222,237,15,SGVHATLAGVIVGFFI,0
1zcd,B,240,244,4,KEKHG,0
1zcd,B,246,262,16,SPAKRLEHVLHPWVAYL,0
1zcd,B,262,272,10,LILPLFAFANA,0
1zcd,B,283,288,5,GLTSIL,0
1zcd,B,293,299,6,IAGLLIG,0
1zcd,B,300,304,4,KPLGI,0
1zcd,B,324,329,5,TYQQIM,0
1zcd,B,330,335,5,VVGILC,0
1zcd,B,338,350,12,GFTMSIFIASLAF,0
1zcd,B,357,371,14,LINWAKLGILVGSIS,0
1zcd,B,377,381,4,YSWLR,0
2j7a,R,49,53,4,RNSAF,0
2j7a,R,57,66,9,FPKQYASYER,0
2j7a,R,67,69,2,NDE,0
2j7a,R,101,106,5,YLKNLW,0
2j7a,R,109,113,4,YPFMY,0
2j7a,R,120,122,2,GHT,0
2j7a,R,123,129,6,YAIQDFL,0
2j7a,R,145,149,4,ATCWN,0
2j7a,R,154,163,9,KMMEWVKESG,0
2j7a,R,164,166,2,DGF,0
2j7a,R,171,175,4,VNEFR,0
2j7a,R,186,191,5,GCATCH,0
2j7a,R,202,211,9,SVPLTDYLVS,0
2j7a,R,220,231,11,PRNEMRALVCGQ,0
2j7a,R,258,269,11,DPADMYRYYDKH,0
2j7a,R,299,305,6,PEYETWI,0
2j7a,R,315,321,6,TCADCHM,0
2j7a,R,339,343,4,SPMKD,0
2j7a,R,357,395,38,TPDYLKSRVLFTQKRTFDLLLAAQEVSVKAHEAVRLANE,0
2j7a,R,403,427,24,GYDDLMIQAREMVRKGQFFWDYVSA,0
2j7a,R,435,460,25,NPAKALDTLAQSQQFSQKAIDLAMEA,0
2j7a,R,465,470,5,IGKDLS,0
2j7a,R,472,477,5,DIKTIV,0
2j7a,R,486,490,4,KLQQD,0
2j7a,R,492,496,4,EFMKT,0
2j7a,R,497,503,6,HKWFQYL,0
2j7a,R,49,54,5,RNSAFK,0
2j7a,R,57,65,8,FPKQYASYE,0
2j7a,R,66,69,3,RNDE,0
2j7a,R,171,174,3,VNEF,0
2j7a,R,202,212,10,SVPLTDYLVSQ,0
2j7a,R,215,219,4,DPKKL,0
2j7a,R,220,228,8,PRNEMRALV,0
2j7a,R,346,351,5,MRACRQ,0
2j7a,R,403,428,25,GYDDLMIQAREMVRKGQFFWDYVSAE,0
2j7a,R,435,461,26,NPAKALDTLAQSQQFSQKAIDLAMEAT,0
2j7a,R,465,469,4,IGKDL,0
2j7a,R,19,37,18,GATLGVVALATVAFGMKYT,0
2j7a,R,39,44,5,QRPFCT,0
2j7a,R,45,48,3,SCHI,0
2j7a,R,49,59,10,MNPVGVTHKLS,0
2j7a,R,66,71,5,CNDCHA,0
2j7a,R,74,95,21,NLLAKLPFKAIAGARDVYMNTL,0
2j7a,R,105,125,20,GMETKEVVNANCKACHTMTNV,0
2j7a,R,135,139,4,YCTDC,0
2j7a,R,140,144,4,HRNVQ,0
2j7a,R,150,154,4,PISTR,0
2j7a,R,186,190,4,GCATC,0
2j7a,R,307,312,5,GTHGAA,0
2j7a,R,123,131,8,YAIQDFLHI,0
2j7a,R,229,232,3,CGQC,0
2j7a,R,499,503,4,WFQYL,0
2j7a,R,18,23,5,GGATLG,0
2j7a,R,23,37,14,GVVALATVAFGMKYT,0
2j7a,R,49,58,9,MNPVGVTHKL,0
2j7a,R,105,120,15,GMETKEVVNANCKACH,0
2j7a,R,120,125,5,HTMTNV,0
2j7a,R,145,151,6,ATCWNCK,0
2j7a,R,309,313,4,HGAAG,0
2j7a,R,153,163,10,PKMMEWVKESG,0
2j7a,R,164,167,3,DGFW,0
2j7a,R,348,352,4,ACRQC,0
2j7a,R,19,24,5,GATLGV,0
2j7a,R,25,37,12,VALATVAFGMKYT,0
2j7a,R,18,37,19,GGATLGVVALATVAFGMKYT,0
2j7a,R,65,71,6,SCNDCHA,0
3cll,A,34,64,30,LWSFWRAAIAEFIATLLFLYITVATVIGHSK,0
3cll,A,72,97,25,VGLLGIAWAFGGMIFVLVYCTAGISG,0
3cll,A,101,111,10,NPAVTFGLFLA,0
3cll,A,115,141,26,ELLRALVYMIAQCLGAICGVGLVKAFM,0
3cll,A,141,148,7,MKGPYNQF,0
3cll,A,160,182,22,NKGTALGAEIIGTFVLVYTVFSA,0
3cll,A,198,218,20,APLPIGFAVFMVHLATIPITG,0
3cll,A,222,234,12,NPARSFGAAVIFN,0
3cll,A,235,242,7,SNKVWDDQ,0
3cll,A,243,262,19,WIFWVGPFIGAAVAAAYHQY,0
2c3e,A,7,38,31,FLKDFLAGGVAAAISKTAVAPIERVKLLLQVQ,0
2c3e,A,39,41,2,HAS,0
2c3e,A,52,65,13,GIIDCVVRIPKEQG,0
2c3e,A,66,71,5,FLSFWR,0
2c3e,A,72,99,27,GNLANVIRYFPTQALNFAFKDKYKQIFL,0
2c3e,A,107,142,35,QFWRYFAGNLASGGAAGATSLCFVYPLDFARTRLAA,0
2c3e,A,155,173,18,GLGNCITKIFKSDGLRGLY,0
2c3e,A,175,201,26,GFNVSVQGIIIYRAAYFGVYDTAKGML,0
2c3e,A,209,227,18,IIVSWMIAQTVTAVAGLVS,0
2c3e,A,227,239,12,SYPFDTVRRRMMM,0
2c3e,A,252,264,12,GTVDCWRKIAKDE,0
2c3e,A,267,271,4,KAFFK,0
2c3e,A,274,291,17,WSNVLRGMGGAFVLVLYD,0
5fil,W,11,16,5,ILEERI,0
5fil,W,78,82,4,NDKLI,0
5fil,W,150,157,7,IKAVDSLV,0
5fil,W,174,191,17,GKTSIAIDTIINQKRFND,0
5fil,W,209,223,14,KRSTVAQLVKRLTDA,0
5fil,W,224,227,3,DAMK,0
5fil,W,239,260,21,AAPLQYLAPYSGCSMGEYFRDN,0
5fil,W,270,285,15,DLSKQAVAYRQMSLLL,0
5fil,W,290,294,4,GREAY,0
5fil,W,297,308,11,DVFYLHSRLLER,0
5fil,W,313,317,4,NDAFG,0
5fil,W,336,346,10,AYIPTNVISIT,0
5fil,W,353,360,7,ETELFYKG,0
5fil,W,374,379,5,VGSAAQ,0
5fil,W,380,402,22,TRAMKQVAGTMKLELAQYREVAA,0
5fil,W,411,429,18,DAATQQLLSRGVRLTELLK,0
5fil,W,437,450,13,AIEEQVAVIYAGVR,0
5fil,W,452,456,4,YLDKL,0
5fil,W,457,475,18,EPSKITKFENAFLSHVISQ,0
5fil,W,476,487,11,HQALLGKIRTDG,0
5fil,W,490,509,19,SEESDAKLKEIVTNFLAGFE,0
5fil,W,225,227,2,AMK,0
5fil,W,239,259,20,AAPLQYLAPYSGCSMGEYFRD,0
5fil,W,380,399,19,TRAMKQVAGTMKLELAQYRE,0
5fil,W,490,507,17,SEESDAKLKEIVTNFLAG,0
5fil,W,174,186,12,GKTSIAIDTIINQ,0
5fil,W,186,191,5,QKRFND,0
5fil,W,380,403,23,TRAMKQVAGTMKLELAQYREVAAF,0
5fil,W,457,459,2,EPS,0
5fil,W,460,475,15,KITKFENAFLSHVISQ,0
5fil,W,490,510,20,SEESDAKLKEIVTNFLAGFEA,0
5fil,W,87,91,4,GPETL,0
5fil,W,122,126,4,EFVEM,0
5fil,W,137,144,7,IKVVDLLA,0
5fil,W,161,173,12,GKTVLIMELINNV,0
5fil,W,189,204,15,RTREGNDLYHEMIESG,0
5fil,W,225,246,21,PPGARARVALTGLTVAEYFRDQ,0
5fil,W,257,272,15,NIFRFTQAGSEVSALL,0
5fil,W,277,281,4,SAVGY,0
5fil,W,284,294,10,TLATDMGTMQE,0
5fil,W,312,316,4,VPADD,0
5fil,W,319,328,9,DPAPATTFAH,0
5fil,W,336,342,6,SRAIAEL,0
5fil,W,363,392,29,VGSEHYDVARGVQKILQDYKSLQDIIAILG,0
5fil,W,399,415,16,EDKLTVSRARKIQRFLS,0
5fil,W,421,426,5,AEVFTG,0
5fil,W,433,446,13,PLKETIKGFQQILA,0
5fil,W,462,474,12,PIEEAVAKADKLA,0
5fil,W,87,90,3,GPET,0
5fil,W,161,178,17,GKTVLIMELINNVAKAHG,0
5fil,W,364,391,27,GSEHYDVARGVQKILQDYKSLQDIIAIL,0
5fil,W,397,415,18,SEEDKLTVSRARKIQRFLS,0
5fil,W,453,458,5,PEQAFY,0
5fil,W,463,473,10,IEEAVAKADKL,0
5fil,W,161,176,15,GKTVLIMELINNVAKA,0
5fil,W,257,270,13,NIFRFTQAGSEVSA,0
5fil,W,313,316,3,PADD,0
5fil,W,319,326,7,DPAPATTF,0
5fil,W,327,329,2,AHL,0
5fil,W,433,447,14,PLKETIKGFQQILAG,0
5fil,W,462,473,11,PIEEAVAKADKL,0
5fil,W,2,49,47,TLKDITRRLKSIKNIQKITKSMKMVAAAKYARAERELKPARVYGVGSL,0
5fil,W,80,91,11,AIHSSVAKQMKS,0
5fil,W,137,150,13,TFGDASVIALELLN,0
5fil,W,197,266,69,DADVLRNYQEYSLANIIYYSLKESTTSEQSARMTAMDNASKNASEMIDKLTLTFNRTRQAVITKELIEII,0
5fil,W,101,103,2,DML,0
5fil,W,104,120,16,DLGAAKANLEKAQSELL,0
5fil,W,123,144,21,ADEATRAEIQIRIEANEALVKA,0
5fil,W,10,25,15,SYIRYSQICAKAVRDA,0
5fil,W,31,38,7,KANAMKTS,0
5fil,W,12,17,5,GAATVG,0
5fil,W,18,36,18,VAGSGAGIGTVFGSLIIGY,0
5fil,W,41,47,6,SLKQQLF,0
5fil,W,50,71,21,AILGFALSEAMGLFCLMVAFLI,0
5fil,W,4,14,10,TAAKFIGAGAA,0
5fil,W,15,19,4,TVGVA,0
5fil,W,20,29,9,GSGAGIGTVF,0
5fil,W,29,34,5,FGSLII,0
5fil,W,49,54,5,YAILGF,0
5fil,W,58,70,12,EAMGLFCLMVAFL,0
5fil,W,13,20,7,AATVGVAG,0
5fil,W,22,35,13,GAGIGTVFGSLIIG,0
5fil,W,41,46,5,SLKQQL,0
5fil,W,47,52,5,FSYAIL,0
5fil,W,7,12,5,KFIGAG,0
5fil,W,14,17,3,ATVG,0
5fil,W,18,29,11,VAGSGAGIGTVF,0
5fil,W,45,71,26,QLFSYAILGFALSEAMGLFCLMVAFLI,0
5fil,W,15,17,2,TVG,0
5fil,W,18,34,16,VAGSGAGIGTVFGSLII,0
5fil,W,41,45,4,SLKQQ,0
5fil,W,46,54,8,LFSYAILGF,0
5fil,W,60,69,9,MGLFCLMVAF,0
5fil,W,13,17,4,AATVG,0
5fil,W,18,24,6,VAGSGAG,0
5fil,W,24,29,5,GIGTVF,0
5fil,W,45,55,10,QLFSYAILGFA,0
5fil,W,58,63,5,EAMGLF,0
5fil,W,5,14,9,AAKFIGAGAA,0
5fil,W,17,29,12,GVAGSGAGIGTVF,0
5fil,W,30,36,6,GSLIIGY,0
5fil,W,49,56,7,YAILGFAL,0
5fil,W,58,65,7,EAMGLFCL,0
5fil,W,14,18,4,ATVGV,0
5fil,W,22,32,10,GAGIGTVFGSL,0
5fil,W,52,57,5,LGFALS,0
5fil,W,64,69,5,CLMVAF,0
5fil,W,15,26,11,EGRYATALYSAA,0
5fil,W,27,30,3,SKQN,0
5fil,W,31,48,17,KLEQVEKELLRVGQILKE,0
5fil,W,49,54,5,PKMAAS,0
5fil,W,85,90,5,LINLLA,0
5fil,W,93,96,3,GRLT,0
5fil,W,97,107,10,NTPAVISAFST,0
5fil,W,134,143,9,LKTVLKSFLS,0
5fil,W,161,167,6,GMIVRIG,0
5fil,W,1,18,17,PYVLGTGLILYLLSKEIY,0
5fil,W,23,148,125,ETFSAISTIGFLVYIVKKYGASVGEFADKLNEQKIAQLEEVKQASIKQIQDAIDMEKSQQALVQKRHYLFDVQRNNIAMALEVTYRERLHRVYREVKNRLDYHISVQNMMRQKEQEHMINWVEKRV,0
5fil,W,150,155,5,QSISAQ,0
5fil,W,155,174,19,QQEKETIAKCIADLKLLSKK,0
5fil,W,11,16,5,DWVAFG,0
5fil,W,20,44,24,PRNQKAVANSLKSWNETLTSRLATL,0
5fil,W,52,60,8,DWAYYKANV,0
5fil,W,62,76,14,KAGLVDDFEKKFNAL,0
5fil,W,84,86,2,KYT,0
5fil,W,87,98,11,AQVDAEEKEDVK,0
5fil,W,100,122,22,CAEFLTQSKTRIQEYEKELEKMR,0
5fil,W,7,24,17,PVQKLFVDKIREYRTKRQ,0
5fil,W,34,51,17,PEYQQDLDRELFKLKQMY,0
5fil,W,10,34,24,ITPVILGLPLVTLIVLFPSLLFPTS,0
5fil,W,39,47,8,SNRFVTLQQ,0
5fil,W,47,57,10,QWMLQLVSKQM,0
5fil,W,58,60,2,MSI,0
5fil,W,65,86,21,GQTWTLMLMSLILFIGSTNLLG,0
5fil,W,95,104,9,TTQLSMNLGM,0
5fil,W,104,116,12,MAIPLWAGAVITG,0
5fil,W,124,129,5,SLAHFL,0
5fil,W,138,150,12,IPMLVIIETISLF,0
5fil,W,150,182,32,FIQPMALAVRLTANITAGHLLIHLIGGATLALM,0
5fil,W,188,226,38,TALITFTILILLTILEFAVAMIQAYVFTLLVSLYLHDNT,0
1t5t,A,8,17,9,STEECLAYFG,0
1t5t,A,25,37,12,TPDQVKRHLEKYG,0
1t5t,A,49,55,6,LWELVIE,0
1t5t,A,61,78,17,LVRILLLAACISFVLAWF,0
1t5t,A,85,123,38,ITAFVEPFVILLILIANAIVGVWQERNAENAIEALKEYE,0
1t5t,A,143,145,2,RDI,0
1t5t,A,177,182,5,QSILTG,0
1t5t,A,200,204,4,VNQDK,0
1t5t,A,226,230,4,TGVST,0
1t5t,A,232,236,4,IGKIR,0
1t5t,A,247,275,28,TPLQQKLDEFGEQLSKVISLICVAVWLIN,0
1t5t,A,281,285,4,DPVHG,0
1t5t,A,289,307,18,IRGAIYYFKIAVALAVAAI,0
1t5t,A,310,329,19,GLPAVITTCLALGTRRMAKK,0
1t5t,A,337,344,7,PSVETLGC,0
1t5t,A,403,406,3,RSGQ,0
1t5t,A,407,420,13,FDGLVELATICALC,0
1t5t,A,439,453,14,EATETALTTLVEKMN,0
1t5t,A,463,468,5,SKVERA,0
1t5t,A,469,477,8,NACNSVIRQ,0
1t5t,A,517,524,7,APEGVIDR,0
1t5t,A,538,555,17,TGPVKEKILSVIKEWGTG,0
1t5t,A,572,576,4,KREEM,0
1t5t,A,580,582,2,DSS,0
1t5t,A,583,588,5,RFMEYE,0
1t5t,A,606,617,11,EVMGSIQLCRDA,0
1t5t,A,628,640,12,NKGTAIAICRRIG,0
1t5t,A,655,661,6,GREFDDL,0
1t5t,A,662,673,11,PLAEQREACRRA,0
1t5t,A,680,693,13,EPSHKSKIVEYLQS,0
1t5t,A,704,706,2,GVN,0
1t5t,A,707,714,7,DAPALKKA,0
1t5t,A,724,730,6,TAVAKTA,0
1t5t,A,740,782,42,FSTIVAAVEEGRAIYNNMKQFIRYLISSNVGEVVCIFLTAALG,0
1t5t,A,788,800,12,IPVQLLWVNLVTD,0
1t5t,A,801,808,7,GLPATALG,0
1t5t,A,830,857,27,SGWLFFRYMAIGGYVGAATVGAAAWWFM,0
1t5t,A,868,872,4,HQLTH,0
1t5t,A,893,914,21,APEPMTMALSVLVTIEMCNALN,0
1t5t,A,915,917,2,SLS,0
1t5t,A,926,929,3,PPWV,0
1t5t,A,930,950,20,NIWLLGSICLSMSLHFLILYV,0
1t5t,A,952,957,5,PLPMIF,0
1t5t,A,962,975,13,LDLTQWLMVLKISL,0
1t5t,A,975,991,16,LPVIGLDEILKFIARNY,0
3zot,A,94,115,21,GPVTWVMMIACVVVFIAMQILG,0
3zot,A,115,124,9,GDQEVMLWLA,0
3zot,A,128,132,4,DPTLK,0
3zot,A,136,141,5,WRYFTH,0
3zot,A,142,144,2,ALM,0
3zot,A,147,170,23,SLMHILFNLLWWWYLGGAVEKRLG,0
3zot,A,170,194,24,GSGKLIVITLISALLSGYVQQKFSG,0
3zot,A,200,218,18,LSGVVYALMGYVWLRGERD,0
3zot,A,219,222,3,PQSG,0
3zot,A,226,242,16,QRGLIIFALIWIVAGWF,0
3zot,A,250,269,19,ANGAHIAGLAVGLAMAFVDS,0
4hqj,E,40,49,9,SLDELHRKYG,0
4hqj,E,57,69,12,TPARAAEILARDG,0
4hqj,E,83,91,8,VKFCRQLFG,0
4hqj,E,93,114,21,FSMLLWIGAILCFLAYGIQAAT,0
4hqj,E,123,157,34,LYLGVVLSAVVIITGCFSYYQEAKSSKIMESFKNM,0
4hqj,E,259,261,2,VMG,0
4hqj,E,262,267,5,RIATLA,0
4hqj,E,275,306,31,TPIAAEIEHFIHIITGVAVFLGVSFFILSLIL,0
4hqj,E,309,325,16,TWLEAVIFLIGIIVANV,0
4hqj,E,327,347,20,EGLLATVTVCLTLTAKRMARK,0
4hqj,E,355,362,7,EAVETLGS,0
4hqj,E,408,421,13,SATWLALSRIAGLC,0
4hqj,E,434,438,4,PILKR,0
4hqj,E,443,457,14,DASESALLKCIELCC,0
4hqj,E,459,467,8,SVKEMRERY,0
4hqj,E,503,510,7,APERILDR,0
4hqj,E,524,540,16,DEELKDAFQNAYLELGG,0
4hqj,E,590,601,11,AAVPDAVGKCRS,0
4hqj,E,613,624,11,HPITAKAIAKGV,0
4hqj,E,633,641,8,TVEDIAARL,0
4hqj,E,644,648,4,PVSQV,0
4hqj,E,660,665,5,GSDLKD,0
4hqj,E,667,678,11,TSEQLDDILKYH,0
4hqj,E,687,699,12,SPQQKLIIVEGCQ,0
4hqj,E,711,713,2,GVN,0
4hqj,E,714,721,7,DSPASKKA,0
4hqj,E,732,739,7,SDVSKQAA,0
4hqj,E,749,789,40,ASIVTGVEEGRLIFDNLKKSIAYTLTSNIPEITPFLIFIIA,0
4hqj,E,796,807,11,GTVTILCIDLGT,0
4hqj,E,808,815,7,DMVPAISL,0
4hqj,E,816,818,2,AYE,0
4hqj,E,841,848,7,QLISMAYG,0
4hqj,E,849,868,19,QIGMIQALGGFFTYFVILAE,0
4hqj,E,872,876,4,LPIHL,0
4hqj,E,879,884,5,LRVNWD,0
4hqj,E,900,931,31,TYEQRKIVEFTCHTPFFVTIVVVQWADLVICK,0
4hqj,E,936,941,5,SVFQQG,0
4hqj,E,944,964,20,NKILIFGLFEETALAAFLSYC,0
4hqj,E,966,971,5,GMGVAL,0
4hqj,E,978,983,5,PTWWFC,0
4hqj,E,984,1005,21,AFPYSLLIFVYDEVRKLIIRRR,0
4hqj,E,33,57,24,FKILLFYVIFYGCLAGIFIGTIQVM,0
4hqj,E,94,109,15,DPQSYESYVVSIVRFL,0
4hqj,E,233,235,2,GGY,0
4hqj,E,246,251,5,YGKLLQ,0
4hqj,E,23,46,23,YETVRNGGLIFAALAFIVGLIILL,0
4hqj,E,258,262,4,TVMGR,0
4hqj,E,849,869,20,QIGMIQALGGFFTYFVILAEN,0
2nop,A,6,25,19,DKADNAFMMICTALVLFMTI,0
2nop,A,26,36,10,PGIALFYGGLI,0
2nop,A,37,39,2,RGK,0
2nop,A,40,62,22,NVLSMLTQVTVTFALVCILWVVY,0
2nop,A,62,69,7,YGYSLAFG,0
2nop,A,80,84,4,WLMLK,0
2nop,A,97,120,23,QYIHVAFQGSFACITVGLIVGALA,0
2nop,A,124,139,15,RFSAVLIFVVVWLTLS,0
2nop,A,139,149,10,SYIPIAHMVWG,0
2nop,A,151,156,5,GLLASH,0
2nop,A,167,181,14,VHINAAIAGLVGAYL,0
2nop,A,197,218,21,NLPMVFTGTAILYIGWFGFNAG,0
2nop,A,219,221,2,SAG,0
2nop,A,224,254,30,NEIAALAFVNTVVATAAAILGWIFGEWALRG,0
2nop,A,257,273,16,SLLGACSGAIAGLVGVT,0
2nop,A,280,301,21,GVGGALIIGVVAGLAGLWGVTM,0
2nop,A,313,333,20,DVFGVHGVCGIVGCIMTGIFA,0
2nop,A,334,338,4,ASSLG,0
2nop,A,347,381,34,TMGHQLLVQLESIAITIVWSGVVAFIGYKLADLTV,0
4kjp,F,17,27,10,RRRQLIRQLLE,0
4kjp,F,32,71,39,PLAILFMAAVVGTLVGLAAVAFDKGVAWLQNQRMGALVHT,0
4kjp,F,74,101,27,NYPLLLTVAFLCSAVLAMFGYFLVRKYA,0
4kjp,F,102,105,3,PEAG,0
4kjp,F,108,117,9,GIPEIEGALE,0
4kjp,F,123,141,18,RWWRVLPVKFFGGLGTLGG,0
4kjp,F,147,166,19,REGPTVQIGGNIGRMVLDIF,0
4kjp,F,170,191,21,GDEARHTLLATGAAAGLAAAFN,0
4kjp,F,192,201,9,APLAGILFII,0
4kjp,F,214,234,20,SIKAVFIGVIMSTIMYRIFNH,0
4kjp,F,248,251,3,PLNT,0
4kjp,F,252,285,33,LWLYLILGIIFGIFGPIFNKWVLGMQDLLHRVHG,0
4kjp,F,287,309,22,NITKWVLMGGAIGGLCGLLGFVA,0
4kjp,F,310,313,3,PATS,0
4kjp,F,318,325,7,NLIPIATA,0
4kjp,F,329,349,20,SMGMLVFIFVARVITTLLCFS,0
4kjp,F,356,379,23,IFAPMLALGTVLGTAFGMVAVELF,0
4kjp,F,380,383,3,PQYH,0
4kjp,F,385,395,10,EAGTFAIAGMG,0
4kjp,F,396,401,5,ALLAAS,0
4kjp,F,404,417,13,APLTGIILVLEMTD,0
4kjp,F,418,420,2,NYQ,0
4kjp,F,421,439,18,LILPMIITGLGATLLAQFT,0
4kjp,F,445,459,14,YSAILARTLAKQEAE,0
4kjp,F,19,27,8,RQLIRQLLE,0
4kjp,F,248,250,2,PLN,0
4kjp,F,251,285,34,TLWLYLILGIIFGIFGPIFNKWVLGMQDLLHRVHG,0
4kjp,F,386,395,9,AGTFAIAGMG,0
4kjp,F,445,455,10,YSAILARTLAK,0
4kjp,F,87,91,4,RSEDT,0
4kjp,F,164,166,2,SGS,0
4kjp,F,194,196,2,SSW,0
4kjp,F,208,211,3,PASS,0
4kjp,F,78,82,4,EAEDA,0
4kjp,F,120,125,5,SSEQLT,0
4kjp,F,182,187,5,KDEYER,0
3bhs,A,9,35,26,NEARLVAQYNYSINILAMLLVGFGFLM,0
3bhs,A,36,38,2,VFV,0
3bhs,A,41,66,25,YGFSATTGTYLVVATGLPLYILLRAN,0
3bhs,A,77,99,22,SVDAVIYAEFAVATGLIAMGAVL,0
3bhs,A,103,126,23,RVFQYALLALFIVPVYLLNEWLVL,0
3bhs,A,145,161,16,IHAFGAYFGLGVSIALT,0
3bhs,A,162,167,5,TAAQRA,0
3bhs,A,173,197,24,DATSDRFSMLGSMVLWLFWPSFATA,0
3bhs,A,200,202,2,PFE,0
3bhs,A,203,230,27,QMPQTIVNTLLALCGATLATYFLSALFH,0
3bhs,A,235,243,8,SIVDMANAA,0
3bhs,A,244,251,7,LAGGVAIG,0
3bhs,A,258,279,21,GPVGAFVIGLLGGAISVVGFVF,0
3bhs,A,279,288,9,FIQPMLESKA,0
3bhs,A,295,300,5,GVHNLH,0
3bhs,A,300,315,15,HGLPGLLGGFSAILIV,0
3bhs,A,318,346,28,IAVAQLTGIGITLALALIGGVIAGALIKL,0
3bhs,A,355,359,4,EDSHE,0
3bhs,A,365,369,4,GPEDE,0
3bhs,A,370,385,15,HKAERLVLEAKTEIQG,0
5eqh,A,9,32,23,TGRLMLAVGGAVLGSLQFGYNTGV,0
5eqh,A,36,53,17,PQKVIEEFYNQTWVHRYG,0
5eqh,A,57,91,34,LPTTLTTLWSLSVAIFSVGGMIGSFSVGLFVNRFG,0
5eqh,A,92,99,7,RRNSMLMM,0
5eqh,A,99,112,13,MNLLAFVSAVLMGF,0
5eqh,A,118,146,28,SFEMLILGRFIIGVYCGLTTGFVPMYVGE,0
5eqh,A,149,157,8,PTALRGALG,0
5eqh,A,158,174,16,TLHQLGIVVGILIAQVF,0
5eqh,A,185,192,7,LWPLLLSI,0
5eqh,A,193,204,11,IFIPALLQCIVL,0
5eqh,A,205,207,2,PFC,0
5eqh,A,210,216,6,SPRFLLI,0
5eqh,A,220,232,12,EENRAKSVLKKLR,0
5eqh,A,237,252,15,VTHDLQEMKEESRQMM,0
5eqh,A,258,265,7,TILELFRS,0
5eqh,A,268,284,16,YRQPILIAVVLQLSQQL,0
5eqh,A,287,301,14,INAVFYYSTSIFEKA,0
5eqh,A,305,329,24,QPVYATIGSGIVNTAFTVVSLFVVE,0
5eqh,A,332,357,25,GRRTLHLIGLAGMAGCAILMTIALAL,0
5eqh,A,363,380,17,WMSYLSIVAIFGFVAFFE,0
5eqh,A,387,392,5,PWFIVA,0
5eqh,A,399,430,31,PRPAAIAVAGFSNWTSNFIVGMCFQYVEQLCG,0
5eqh,A,432,451,19,YVFIIFTVLLVLFFIFTYFK,0
4yeu,E,60,70,10,NTQIERWINNG,0
4yeu,E,118,121,3,LFPF,0
4yeu,E,203,208,5,SYIPNI,0
4yeu,E,208,220,12,IILPMLFILFISW,0
4yeu,E,221,224,3,TAFW,0
4yeu,E,227,250,23,SYEANVTLVVSTLIAHIAFNILVE,0
4yeu,E,260,289,29,TYTGAIIFMIYLFYFVAVIEVTVQHYLKVE,0
4yeu,E,291,322,31,QPARAASITRASRIAFPVVFLLANIILAFLFF,0
4u9l,B,272,276,4,VYSEA,0
4u9l,B,277,297,20,GPVALWLARVRWLVILILTGM,0
4u9l,B,297,306,9,MVTSSILQGF,0
4u9l,B,306,313,7,FESVLEAV,0
4u9l,B,314,318,4,TALAF,0
4u9l,B,319,344,25,YVPVLLGTGGNTGNQSATLIIRALAT,0
4u9l,B,348,350,2,DLR,0
4u9l,B,351,382,31,DWRRVFLKEMGVGLLLGLTLSFLLVGKVYWDG,0
4u9l,B,383,385,2,HPL,0
4u9l,B,386,415,29,LLPVVGVSLVLIVFFANLVGAMLPFLLRRL,0
4u9l,B,422,448,26,VSNPLVATLSDVTGLLIYLSVARLLLE,0
4u9l,B,277,306,29,GPVALWLARVRWLVILILTGMVTSSILQGF,0
4u9l,B,418,421,3,DPAL,0
3h1k,W,3,11,8,TYAQTLQNI,0
3h1k,W,54,63,9,GAGYFVEHLA,0
3h1k,W,71,81,10,PCAAFEKEVES,0
3h1k,W,105,119,14,DMPKVVELLADVVQN,0
3h1k,W,123,142,19,EESQIEKERGVILQELKEMD,0
3h1k,W,144,158,14,DMTNVTFDYLHATAF,0
3h1k,W,161,165,4,TALAR,0
3h1k,W,170,177,7,TTENIKHL,0
3h1k,W,178,190,12,TRADLASYIDTHF,0
3h1k,W,191,194,3,KAPR,0
3h1k,W,204,216,12,SHKELVDAARQHF,0
3h1k,W,223,227,4,YKEDA,0
3h1k,W,266,278,12,DNVVLHVANAIIG,0
3h1k,W,286,290,4,GGKHL,0
3h1k,W,292,301,9,SRLAALAVEH,0
3h1k,W,330,349,19,SIDDMMFCAQGEWMRLCTST,0
3h1k,W,350,369,19,TESEVKRAKNHLRSAMVAQL,0
3h1k,W,372,387,15,TTPVCETIGSHLLNYG,0
3h1k,W,391,401,10,SLEEWDSRISA,0
3h1k,W,403,415,12,DARMVRDVCSKYI,0
3h1k,W,433,440,7,DYNRIRSG,0
3h1k,W,64,72,8,GTAHLLRLA,0
3h1k,W,81,91,10,SSFRITRGIEA,0
3h1k,W,115,129,14,HVDTVMEYLLNVTTA,0
3h1k,W,133,139,6,RPWEVTD,0
3h1k,W,141,152,11,QPQLKVDKAVAF,0
3h1k,W,154,166,12,SPQVGVLENLHAA,0
3h1k,W,170,174,4,TALAN,0
3h1k,W,187,199,12,TSEQLHHFVQNNF,0
3h1k,W,200,202,2,TSA,0
3h1k,W,212,224,12,KHSDLKQVAEQFL,0
3h1k,W,268,280,12,EANAFSVLQHVLG,0
3h1k,W,293,303,10,SKLYQGVAKAT,0
3h1k,W,332,349,17,HAGEVIRAAMNQLKAAAQ,0
3h1k,W,353,372,19,TEEDVTKAKNQLKATYLMSV,0
3h1k,W,374,389,15,TAQGLLNEIGSEALLS,0
3h1k,W,394,403,9,APSVVAQKID,0
3h1k,W,406,420,14,TSADVVNAAKKFVSG,0
3h1k,W,430,433,3,LGST,0
3h1k,W,435,439,4,FLDEL,0
3h1k,W,11,16,5,LLKMIN,0
3h1k,W,29,32,3,SAWW,0
3h1k,W,33,54,21,NFGSLLAVCLMTQILTGLLLAM,0
3h1k,W,62,73,11,LAFSSVAHTCRN,0
3h1k,W,76,105,29,YGWLIRNLHANGASFFFICIFLHIGRGLYY,0
3h1k,W,106,109,3,GSYL,0
3h1k,W,110,134,24,YKETWNTGVILLLTLMATAFVGYVL,0
3h1k,W,137,149,12,GQMSFWGATVITN,0
3h1k,W,150,154,4,LFSAI,0
3h1k,W,158,167,9,GHTLVEWAWG,0
3h1k,W,172,202,30,DNPTLTRFFALHFLLPFAIAGITIIHLTFLH,0
3h1k,W,221,247,26,FHPYYSFKDILGLTLMLTPFLTLALFS,0
3h1k,W,248,251,3,PNLL,0
3h1k,W,253,258,5,DPENFT,0
3h1k,W,272,285,13,EWYFLFAYAILRSI,0
3h1k,W,287,301,14,NKLGGVLALAASVLI,0
3h1k,W,302,309,7,LFLIPFLH,0
3h1k,W,315,318,3,TMTF,0
3h1k,W,319,341,22,RPLSQTLFWLLVANLLILTWIGS,0
3h1k,W,347,365,18,PFIIIGQMASLSYFTILLI,0
3h1k,W,365,378,13,ILFPTIGTLENKML,0
3h1k,W,22,36,14,DHSSVRRGFQVYKQV,0
3h1k,W,37,40,3,CSAC,0
3h1k,W,47,52,5,AFRNLI,0
3h1k,W,57,67,10,TEAEAKALAEE,0
3h1k,W,97,104,7,NPEAARAA,0
3h1k,W,115,120,5,YIVNAR,0
3h1k,W,122,132,10,GGEDYVFSLLT,0
3h1k,W,178,195,17,TMSQIAKDVCTFLRWAAE,0
3h1k,W,197,232,35,EHDQRKRMGLKMLLISALLTSLLYYMKRHKWSVLKS,0
3h1k,W,1,5,4,VHNDV,0
3h1k,W,10,14,4,FSAYR,0
3h1k,W,24,63,39,SSQTSSEDRKGFSYLVTATACVATAYAAKNVVTQFISSLS,0
3h1k,W,11,25,14,RLMDRIRKWYYNAAG,0
3h1k,W,26,30,4,FNKYG,0
3h1k,W,32,36,4,MRDDT,0
3h1k,W,40,50,10,DDDVKEALKRL,0
3h1k,W,51,72,21,PEDLYNERMFRIKRALDLSLKH,0
3h1k,W,82,86,4,KYEED,0
3h1k,W,90,108,18,LEPYLKEVIRERLEREAWN,0
3h1k,W,32,69,37,DALPNVWRRFSSQVFKVAPPFLGAYLLYSWGTQEFERL,0
3h1k,W,73,78,5,NPADYE,0
3h1k,W,15,26,11,DPLTTIREHCEQ,0
3h1k,W,27,47,20,TEKCVKARERLELCDARVSSR,0
3h1k,W,54,77,23,CTEELFDFLHARDHCVAHKLFNKL,0
3h1k,W,37,42,5,,0
3h1k,W,4,13,9,ALLRQAYSAL,0
3h1k,W,16,46,30,RTSTFALTVVLGAVLFERAFDQGADAIFEHL,0
3h1k,W,265,278,13,PDNVVLHVANAIIG,0
3h1k,W,212,222,10,KHSDLKQVAEQ,0
3h1k,W,329,331,2,QAA,0
3h1k,W,156,167,11,YIGHTLVEWAWG,0
3h1k,W,254,258,4,PENFT,0
3h1k,W,22,35,13,DHSSVRRGFQVYKQ,0
3h1k,W,36,40,4,VCSAC,0
3h1k,W,65,71,6,SADVLAL,0
3h1k,W,106,110,4,INQEA,0
3h1k,W,139,143,4,CTHLG,0
3h1k,W,12,25,13,LMDRIRKWYYNAAG,0
3h1k,W,76,80,4,PKEQW,0
3h1k,W,20,23,3,PFEQ,0
1yq4,D,27,40,13,GGAGLRAAFGLSEA,0
1yq4,D,51,60,9,FPTRSHTVAA,0
1yq4,D,75,87,12,NWRWHFYDTVKGS,0
1yq4,D,92,113,21,DQDAIHYMTEQAPAAVIELENY,0
1yq4,D,135,139,4,LQFGK,0
1yq4,D,152,166,14,RTGHSLLHTLYGRSL,0
1yq4,D,216,220,4,YGRTY,0
1yq4,D,231,240,9,GDGTAMVTRA,0
1yq4,D,266,271,5,EGCRGE,0
1yq4,D,283,288,5,FMERYA,0
1yq4,D,291,295,4,AKDLA,0
1yq4,D,296,310,14,SRDVVSRSMTIEIRE,0
1yq4,D,329,337,8,PPQQLATRL,0
1yq4,D,337,349,12,LPGISETAMIFAG,0
1yq4,D,412,432,20,NSLLDLVVFGRACALTIAETC,0
1yq4,D,446,459,13,GEESVANLDKLRFA,0
1yq4,D,465,480,15,TSEARLNMQKTMQSHA,0
1yq4,D,485,502,17,TGSILQEGCEKLSQIYRD,0
1yq4,D,516,542,26,NTDLVETLELQNLMLCALQTIYGAEAR,0
1yq4,D,574,578,4,PFEEH,0
1yq4,D,38,40,2,NKC,0
1yq4,D,43,55,12,MVLDALIKIKNEL,0
1yq4,D,85,87,2,CTK,0
1yq4,D,115,125,10,LSNFYAQYKSI,0
1yq4,D,145,151,6,SIEDRQK,0
1yq4,D,164,167,3,CSTS,0
1yq4,D,168,175,7,CPSYWWNG,0
1yq4,D,180,192,12,GPAVLMQAYRWMI,0
1yq4,D,198,205,7,YTEERLAQ,0
1yq4,D,219,225,6,MNCTRTC,0
1yq4,D,230,243,13,NPGKAIAEIKKMMA,0
1yq4,D,4,18,14,TAKEEMARFWEKNTK,0
1yq4,D,33,63,30,SLPMAMSITHRGTGVALSLGVSLFSLAALLL,0
1yq4,D,66,76,10,QFPHYVAVVKS,0
1yq4,D,80,110,30,SPALIYSAKFALVFPLSYHTWNGIRHLVWDM,0
1yq4,D,115,140,25,KLSQVEQSGVVVLILTLLSSAGIAAI,0
1yq4,D,4,30,26,KAASLHWTSERAVSALLLGLLPAAYLY,0
1yq4,D,32,59,27,GPAVDYSLAAALTLHGHWGLGQVITDYV,0
1yq4,D,61,90,29,GDTPIKVANTGLYVLSAITFTGLCYFNYYD,0
1yq4,D,92,101,9,GICKAVAMLW,0
4a82,D,1,10,9,MIKRYLQFVK,0
4a82,D,12,25,13,YKYRIFATIIVGII,0
4a82,D,27,45,18,FGIPMLIPLLIKYAIDGVI,0
4a82,D,51,73,22,TTDEKVHHLTIAIGIALFIFVIV,0
4a82,D,73,107,34,VRPPIEFIRQYLAQWTSNKILYDIRKKLYNHLQAL,0
4a82,D,108,114,6,SARFYAN,0
4a82,D,116,137,21,QVGQVISRVINDVEQTKDFILT,0
4a82,D,141,160,19,NIWLDCITIIIALSIMFFLD,0
4a82,D,163,168,5,LTLAAL,0
4a82,D,169,216,47,FIFPFYILTVYVFFGRLRKLTRERSQALAEVQGFLHERVQGISVVKSF,0
4a82,D,218,273,55,IEDNEAKNFDKKNTNFLTRALKHTRWNAYSFAAINTVTDIGPIIVIGVGAYLAISG,0
4a82,D,276,286,10,TVGTLAAFVGY,0
4a82,D,286,291,5,YLELLF,0
4a82,D,292,319,27,GPLRRLVASFTTLTQSFASMDRVFQLID,0
4a82,D,379,385,6,GKSTLIN,0
4a82,D,406,408,2,KDF,0
4a82,D,409,416,7,LTGSLRNQ,0
4a82,D,430,436,6,TVKENIL,0
4a82,D,437,439,2,LGR,0
4a82,D,443,454,11,TDEEVVEAAKMA,0
4a82,D,456,462,6,AHDFIMN,0
4a82,D,465,469,4,QGYDT,0
4a82,D,472,476,4,GERGV,0
4a82,D,479,495,16,SGGQKQRLSIARIFLNN,0
4a82,D,509,524,15,DLESESIIQEALDVLS,0
4a82,D,535,539,4,RLSTI,0
4a82,D,558,565,7,THRELIAK,0
4a82,D,567,574,7,GAYEHLYS,0
4a82,D,27,44,17,FGIPMLIPLLIKYAIDGV,0
4a82,D,54,59,5,EKVHHL,0
4a82,D,61,73,12,IAIGIALFIFVIV,0
4a82,D,160,169,9,DVKLTLAALF,0
4a82,D,218,271,53,IEDNEAKNFDKKNTNFLTRALKHTRWNAYSFAAINTVTDIGPIIVIGVGAYLAI,0
4a82,D,278,291,13,GTLAAFVGYLELLF,0
2wlh,A,36,44,8,DHYHDLLTV,0
2wlh,A,45,72,27,SWPVFITLITGLYLVTNALFALAYLACG,0
2wlh,A,82,95,13,SFTDAFFFSVQTMA,0
2wlh,A,105,136,31,IGPLANTLVTLEALCGMLGLAVAASLIYARFT,0
2wlh,A,228,235,7,TDETLRNS,0
2wlh,A,288,291,3,GKFH,0
5e1a,C,87,91,4,TSEDS,0
5e1a,C,79,83,4,ESEDI,0
5e1a,C,121,127,6,SSEQLTS,0
5e1a,C,183,187,4,KDEYE,0
5e1a,C,24,52,28,CHWRAAGAATVLLVIVLLAGSYLAVLAER,0
5e1a,C,61,74,13,TYPRALWWSVETAT,0
5e1a,C,85,122,37,TLWGRLVAVVVMVAGITSFGLVTAALATWFVGCEQERR,0
3tlm,A,8,17,9,TTEECLAYFG,0
3tlm,A,25,37,12,TPDQVKRHLEKYG,0
3tlm,A,59,79,20,DLLVRILLLAACISFVLAWFE,0
3tlm,A,88,121,33,FVEPFVILLILIANAIVGVWQERNAENAIEALKE,0
3tlm,A,143,145,2,RDI,0
3tlm,A,200,204,4,VNQDK,0
3tlm,A,247,274,27,TPLQQKLDEFGEQLSKVISLICVAVWLI,0
3tlm,A,287,307,20,SWIRGAIYYFKIAVALAVAAI,0
3tlm,A,310,329,19,GLPAVITTCLALGTRRMAKK,0
3tlm,A,337,343,6,PSVETLG,0
3tlm,A,403,406,3,RSGQ,0
3tlm,A,407,420,13,YDGLVELATICALC,0
3tlm,A,439,453,14,EATETALTTLVEKMN,0
3tlm,A,463,468,5,SKVERA,0
3tlm,A,469,477,8,NACNSVIRQ,0
3tlm,A,516,523,7,APEGVIDR,0
3tlm,A,537,553,16,TGPVKEKILSVIKEWGT,0
3tlm,A,571,575,4,KREEM,0
3tlm,A,579,581,2,DST,0
3tlm,A,582,587,5,KFMEYE,0
3tlm,A,605,616,11,EVMGSIQLCRDA,0
3tlm,A,627,639,12,NKGTAIAICRRIG,0
3tlm,A,654,660,6,GREFDDL,0
3tlm,A,661,672,11,PLAEQREACRRA,0
3tlm,A,681,692,11,THKSKIVEYLQS,0
3tlm,A,703,705,2,GVN,0
3tlm,A,706,713,7,DAPALKKA,0
3tlm,A,723,730,7,TAVAKTAS,0
3tlm,A,739,775,36,FSTIVAAVEEGRAIYNNMKQFIRYLISSNVGEVVCIF,0
3tlm,A,787,799,12,IPVQLLWVNLVTD,0
3tlm,A,800,805,5,GLPATA,0
3tlm,A,806,809,3,LGFN,0
3tlm,A,814,818,4,DIMDR,0
3tlm,A,829,845,16,SGWLFFRYMAIGGYVGA,0
3tlm,A,848,856,8,VGAAAWWFL,0
3tlm,A,888,892,4,EVFEA,0
3tlm,A,893,912,19,PQPMTMALSVLVTIEMCNAL,0
3tlm,A,913,915,2,NSL,0
3tlm,A,925,928,3,PPWV,0
3tlm,A,929,949,20,NIWLVGSIGLSMSLHFLILYV,0
3tlm,A,952,956,4,LPMIF,0
3tlm,A,964,974,10,YHWLMVLKISL,0
3tlm,A,974,988,14,LPVIGLDEILKFVAR,0
2m3b,E,1,15,14,MEKVQYLTRSAIRRA,0
2m3b,E,23,52,29,QARQNLQNLFINFCLILICLLLICIIVMLL,0
2m3b,E,2,15,13,EKVQYLTRSAIRRA,0
3p4p,P,13,27,14,GGAGLRAAIAAAQAN,0
3p4p,P,39,48,9,YPMRSHTVAA,0
3p4p,P,61,73,12,SFEYHFHDTVAGG,0
3p4p,P,78,100,22,EQDVVDYFVHHCPTEMTQLELWG,0
3p4p,P,130,146,16,KTGFHMLHTLFQTSLQF,0
3p4p,P,195,199,4,AGRVY,0
3p4p,P,210,219,9,GDGMGMALSH,0
3p4p,P,245,250,5,EGCRGE,0
3p4p,P,261,266,5,RYLQDY,0
3p4p,P,281,285,4,YMELG,0
3p4p,P,286,301,15,PRDKVSQAFWHEWRKG,0
3p4p,P,319,328,9,LGEKKLHERL,0
3p4p,P,328,339,11,LPFICELAKAYV,0
3p4p,P,393,416,23,SNSLAELVVFGRLAGEQATERAAT,0
3p4p,P,421,442,21,NEAAIEAQAAGVEQRLKDLVNQ,0
3p4p,P,447,463,16,NWAKIRDEMGLAMEEGC,0
3p4p,P,468,488,20,TPELMQKTIDKLAELQERFKR,0
3p4p,P,499,525,26,NTDLLYTIELGHGLNVAECMAHSAMAR,0
3p4p,P,35,47,12,SLLDALGYIKDNL,0
3p4p,P,77,79,2,CKT,0
3p4p,P,80,85,5,FLRDYT,0
3p4p,P,106,116,10,MTHFIESLEAI,0
3p4p,P,126,130,4,TADQG,0
3p4p,P,135,141,6,TPAQMAK,0
3p4p,P,142,147,5,YHQFSG,0
3p4p,P,152,158,6,GLCYAAC,0
3p4p,P,158,164,6,CPQFGLN,0
3p4p,P,169,181,12,GPAAITLAHRYNE,0
3p4p,P,187,197,10,GKKERMAQLNS,0
3p4p,P,200,204,4,GVWSC,0
3p4p,P,208,214,6,GYCSEVC,0
3p4p,P,219,240,21,DPAAAIQQGKVESSKDFLIATL,0
3p4p,P,19,31,12,LPFYRFYMLREGT,0
3p4p,P,31,51,20,TAVPAVWFSIELIFGLFALKN,0
3p4p,P,52,64,12,GPEAWAGFVDFLQ,0
3p4p,P,65,90,25,NPVIVIINLITLAAALLHTKTWFELA,0
3p4p,P,91,94,3,PKAA,0
3p4p,P,105,129,24,PEPIIKSLWAVTVVATIVILFVALY,0
3p4p,P,9,27,18,DEPVFWGLFGAGGMWSAII,0
3p4p,P,27,37,10,IAPVMILLVGI,0
3p4p,P,50,59,9,SYERVLAFAQ,0
3p4p,P,60,90,30,SFIGRVFLFLMIVLPLWCGLHRMHHAMHDLK,0
3p4p,P,95,116,21,AGKWVFYGLAAILTVVTLIGVV,0
3p4p,P,39,43,4,YPMRS,0
3p4p,P,61,74,13,SFEYHFHDTVAGGD,0
3p4p,P,78,99,21,EQDVVDYFVHHCPTEMTQLELW,0
3p4p,P,127,131,4,AADKT,0
3p4p,P,132,146,14,GFHMLHTLFQTSLQF,0
3p4p,P,245,251,6,EGCRGEG,0
3p4p,P,261,267,6,RYLQDYG,0
3p4p,P,320,328,8,GEKKLHERL,0
3p4p,P,543,548,5,DDVNFL,0
3p4p,P,35,46,11,SLLDALGYIKDN,0
3p4p,P,169,182,13,GPAAITLAHRYNED,0
3p4p,P,104,130,26,GPEPIIKSLWAVTVVATIVILFVALYW,0
3p4p,P,9,37,28,DEPVFWGLFGAGGMWSAIIAPVMILLVGI,0
3p4p,P,37,42,5,ILLPLG,0
3p4p,P,60,89,29,SFIGRVFLFLMIVLPLWCGLHRMHHAMHDL,0
3p4p,P,95,118,23,AGKWVFYGLAAILTVVTLIGVVTI,0
4pdl,B,21,46,25,DKEFQVLFVLTILTLISGTIFYSTVE,0
4pdl,B,49,62,13,RPIDALYFSVVTLT,0
4pdl,B,73,101,28,TDFGKIFTILYIFIGIGLVFGFIHKLAVN,0
4pdl,B,102,110,8,VQLPSILSN,0
4pdl,B,20,45,25,KDKEFQVLFVLTILTLISGTIFYSTV,0
4pdl,B,73,102,29,TDFGKIFTILYIFIGIGLVFGFIHKLAVNV,0
4pdl,B,102,111,9,VQLPSILSNL,0
3w5b,A,3,7,4,AAHSK,0
3w5b,A,8,17,9,STEECLAYFG,0
3w5b,A,25,36,11,TPDQVKRHLEKY,0
3w5b,A,48,57,9,SLWELVIEQF,0
3w5b,A,59,75,16,DLLVRILLLAACISFVL,0
3w5b,A,84,121,37,TITAFVEPFVILLILIANAIVGVWQERNAENAIEALKE,0
3w5b,A,141,145,4,KARDI,0
3w5b,A,177,182,5,QSILTG,0
3w5b,A,247,275,28,TPLQQKLDEFGEQLSKVISLICVAVWLIN,0
3w5b,A,281,285,4,DPVHG,0
3w5b,A,287,307,20,SWIRGAIYYFKIAVALAVAAI,0
3w5b,A,310,329,19,GLPAVITTCLALGTRRMAKK,0
3w5b,A,335,344,9,SLPSVETLGC,0
3w5b,A,403,406,3,RSGQ,0
3w5b,A,407,420,13,FDGLVELATICALC,0
3w5b,A,439,453,14,EATETALTTLVEKMN,0
3w5b,A,466,468,2,ERA,0
3w5b,A,469,477,8,NACNSVIRQ,0
3w5b,A,517,524,7,APEGVIDR,0
3w5b,A,538,554,16,TGPVKEKILSVIKEWGT,0
3w5b,A,580,588,8,DSSRFMEYE,0
3w5b,A,606,617,11,EVMGSIQLCRDA,0
3w5b,A,628,639,11,NKGTAIAICRRI,0
3w5b,A,655,660,5,GREFDD,0
3w5b,A,662,671,9,PLAEQREACR,0
3w5b,A,680,693,13,EPSHKSKIVEYLQS,0
3w5b,A,704,706,2,GVN,0
3w5b,A,707,714,7,DAPALKKA,0
3w5b,A,724,729,5,TAVAKT,0
3w5b,A,739,781,42,NFSTIVAAVEEGRAIYNNMKQFIRYLISSNVGEVVCIFLTAAL,0
3w5b,A,788,800,12,IPVQLLWVNLVTD,0
3w5b,A,804,810,6,ATALGFN,0
3w5b,A,830,856,26,SGWLFFRYMAIGGYVGAATVGAAAWWF,0
3w5b,A,887,891,4,DCEIF,0
3w5b,A,896,915,19,PMTMALSVLVTIEMCNALNS,0
3w5b,A,926,929,3,PPWV,0
3w5b,A,930,950,20,NIWLLGSICLSMSLHFLILYV,0
3w5b,A,951,957,6,DPLPMIF,0
3w5b,A,963,975,12,DLTQWLMVLKISL,0
3w5b,A,975,991,16,LPVIGLDEILKFIARNY,0
3zmh,A,94,115,21,GPVTWVMMIACVVVFIAMQILG,0
3zmh,A,115,124,9,GDQEVMLWLA,0
3zmh,A,128,132,4,DPTLK,0
3zmh,A,136,141,5,WRYFTH,0
3zmh,A,142,144,2,ALM,0
3zmh,A,147,170,23,SLMHILFNLLWWWYLGGAVEKRLG,0
3zmh,A,170,194,24,GSGKLIVITLISALLSGYVQQKFSG,0
3zmh,A,200,218,18,LSGVVYALMGYVWLRGERD,0
3zmh,A,219,222,3,PQSG,0
3zmh,A,226,242,16,QRGLIIFALIWIVAGWF,0
3zmh,A,250,269,19,ANGAHIAGLAVGLAMAFVDS,0
2fyu,K,3,10,7,TYAQALQS,0
2fyu,K,44,48,4,GSRYE,0
2fyu,K,54,63,9,GAGYFVEHLA,0
2fyu,K,73,82,9,NALEKEVESM,0
2fyu,K,105,120,15,DLPKAVELLADIVQNC,0
2fyu,K,123,142,19,EDSQIEKERDVILQELQEND,0
2fyu,K,144,158,14,SMRDVVFNYLHATAF,0
2fyu,K,161,165,4,TPLAQ,0
2fyu,K,170,177,7,PSENVRKL,0
2fyu,K,178,190,12,SRADLTEYLSRHY,0
2fyu,K,191,193,2,KAP,0
2fyu,K,204,216,12,EHRQLLDLAQKHF,0
2fyu,K,266,278,12,DNVALQVANAIIG,0
2fyu,K,292,302,10,SPLASIAATNK,0
2fyu,K,330,349,19,SIDDMMFVLQGQWMRLCTSA,0
2fyu,K,350,369,19,TESEVLRGKNLLRNALVSHL,0
2fyu,K,371,386,15,GTTPVCEDIGRSLLTY,0
2fyu,K,391,401,10,PLAEWESRIAE,0
2fyu,K,403,416,13,DARVVREVCSKYFY,0
2fyu,K,433,440,7,DYNRIRSG,0
2fyu,K,54,58,4,GSRYE,0
2fyu,K,64,72,8,GTSHLLRLA,0
2fyu,K,81,92,11,SSFKITRGIEAV,0
2fyu,K,115,129,14,DVDILMEFLLNVTTA,0
2fyu,K,133,152,19,RRWEVAALQPQLRIDKAVAL,0
2fyu,K,154,168,14,NPQAHVIENLHAAAY,0
2fyu,K,179,183,4,PDYRI,0
2fyu,K,187,199,12,TPVELHDYVQNHF,0
2fyu,K,200,202,2,TSA,0
2fyu,K,212,224,12,SHPVLKQVAEQFL,0
2fyu,K,266,280,14,SAEANAFSVLQHVLG,0
2fyu,K,293,303,10,SSLYQAVAKGV,0
2fyu,K,332,349,17,SAGDVIKAAYNQVKTIAQ,0
2fyu,K,353,372,19,SNPDVQAAKNKLKAGYLMSV,0
2fyu,K,374,390,16,SSEGFLDEVGSQALAAG,0
2fyu,K,394,404,10,PPSTVLQQIDA,0
2fyu,K,406,420,14,ADADVINAAKKFVSG,0
2fyu,K,3,8,5,NIRKSH,0
2fyu,K,8,19,11,HPLMKIVNNAFI,0
2fyu,K,28,31,3,SSWW,0
2fyu,K,32,53,21,NFGSLLGICLILQILTGLFLAM,0
2fyu,K,61,72,11,TAFSSVTHICRD,0
2fyu,K,75,104,29,YGWIIRYMHANGASMFFICLYMHVGRGLYY,0
2fyu,K,105,108,3,GSYT,0
2fyu,K,109,133,24,FLETWNIGVILLLTVMATAFMGYVL,0
2fyu,K,136,149,13,GQMSFWGATVITNL,0
2fyu,K,150,153,3,LSAI,0
2fyu,K,156,166,10,IGTNLVEWIWG,0
2fyu,K,171,202,31,DKATLTRFFAFHFILPFIIMAIAMVHLLFLHE,0
2fyu,K,220,246,26,FHPYYTIKDILGALLLILALMLLVLFA,0
2fyu,K,252,257,5,DPDNYT,0
2fyu,K,271,273,2,EWY,0
2fyu,K,274,283,9,FLFAYAILRS,0
2fyu,K,286,300,14,NKLGGVLALAFSILI,0
2fyu,K,301,308,7,LALIPLLH,0
2fyu,K,318,340,22,RPLSQCLFWALVADLLTLTWIGG,0
2fyu,K,344,364,20,EHPYITIGQLASVLYFLLILV,0
2fyu,K,364,377,13,VLMPTAGTIENKLL,0
2fyu,K,22,36,14,DHTSIRRGFQVYKQV,0
2fyu,K,47,55,8,AYRHLVGVC,0
2fyu,K,57,67,10,TEDEAKALAEE,0
2fyu,K,97,105,8,NPEAARAAN,0
2fyu,K,123,133,10,GEDYVFSLLTG,0
2fyu,K,178,195,17,TMSQVAKDVCTFLRWAAE,0
2fyu,K,197,232,35,EHDHRKRMGLKMLLMMGLLLPLVYAMKRHKWSVLKS,0
2fyu,K,1,5,4,SHTDI,0
2fyu,K,15,19,4,RPEVL,0
2fyu,K,25,63,38,SKESSEARKGFSYLVTATTTVGVAYAAKNVVSQFVSSMS,0
2fyu,K,65,70,5,SADVLA,0
2fyu,K,79,81,2,SDI,0
2fyu,K,102,111,9,TKKEIDQEAA,0
2fyu,K,7,25,18,SASSRWLEGIRKWYYNAAG,0
2fyu,K,26,30,4,FNKLG,0
2fyu,K,32,37,5,MRDDTI,0
2fyu,K,40,50,10,NDDVKEAIRRL,0
2fyu,K,51,72,21,PENLYDDRVFRIKRALDLSMRQ,0
2fyu,K,76,80,4,PKEQW,0
2fyu,K,82,86,4,KYEED,0
2fyu,K,90,110,20,LEPYLKEVIRERKEREEWAKK,0
2fyu,K,20,23,3,PFEQ,0
2fyu,K,32,70,38,KGIPNVLRRTRACILRVAPPFVAFYLVYTWGTQEFEKSK,0
2fyu,K,15,26,11,DPLTTVREQCEQ,0
2fyu,K,27,46,19,LEKCVKARERLELCDERVSS,0
2fyu,K,54,73,19,CTEELLDFLHARDHCVAHKL,0
2fyu,K,74,76,2,FNS,0
2fyu,K,4,8,4,VAARS,0
2fyu,K,29,34,5,LVQAAV,0
2fyu,K,4,14,10,TLTARLYSLLF,0
2fyu,K,16,48,32,RTSTFALTIVVGALFFERAFDQGADAIYEHINE,0
2fyu,K,1,6,5,MLTRFL,0
2fyu,K,7,37,30,GPRYRQLARNWVPTASLWGAVGAVGLVWATD,0
2fyu,K,38,43,5,WRLILD,0
4myc,B,105,108,3,NKVR,0
4myc,B,109,127,18,IRVLIALGLLISAKILNVQ,0
4myc,B,127,138,11,QVPFFFKQTIDS,0
4myc,B,151,199,48,PAAIGLTILCYGVARFGSVLFGELRNAVFAKVAQNAIRTVSLQTFQHLM,0
4myc,B,202,209,7,DLGWHLSR,0
4myc,B,211,216,5,TGGLTR,0
4myc,B,228,235,7,VLTAMVFH,0
4myc,B,235,255,20,HIIPISFEISVVCGILTYQFG,0
4myc,B,255,304,49,GASFAAITFSTMLLYSIFTIKTTAWRTHFRRDANKADNKAASVALDSLIN,0
4myc,B,304,311,7,NFEAVKYF,0
4myc,B,314,367,53,EKYLADKYNGSLMNYRDSQIKVSQSLAFLNSGQNLIFTTALTAMMYMGCTGVIG,0
4myc,B,372,383,11,VGDLVLINQLVF,0
4myc,B,384,390,6,QLSVPLN,0
4myc,B,396,412,16,YRDLKQSLIDMETLFKL,0
4myc,B,474,476,2,GKS,0
4myc,B,477,483,6,TILKLVF,0
4myc,B,501,503,2,KEY,0
4myc,B,504,511,7,DIDALRKV,0
4myc,B,526,531,5,IWENVK,0
4myc,B,532,534,2,FGR,0
4myc,B,538,549,11,TDEEVITVVEKA,0
4myc,B,551,558,7,LAPLIKKL,0
4myc,B,560,563,3,QGFD,0
4myc,B,574,590,16,SGGEKQRLAIARVLLKN,0
4myc,B,604,619,15,DTHTEQALLRTIRDNF,0
4myc,B,632,637,5,RLRTIA,0
4myc,B,655,662,7,KHLELLAM,0
4myc,B,665,691,26,SLYRELWTIQEDLDHLENELKDQQELW,0
4myc,B,106,138,32,KVRIRVLIALGLLISAKILNVQVPFFFKQTIDS,0
4myc,B,210,221,11,QTGGLTRAMDRG,0
4myc,B,227,235,8,QVLTAMVFH,0
4myc,B,372,384,12,VGDLVLINQLVFQ,0
4myc,B,396,415,19,YRDLKQSLIDMETLFKLRKN,0
4myc,B,526,532,6,IWENVKF,0
4myc,B,105,107,2,NKV,0
4myc,B,108,138,30,RIRVLIALGLLISAKILNVQVPFFFKQTIDS,0
4myc,B,211,221,10,TGGLTRAMDRG,0
4myc,B,255,285,30,GASFAAITFSTMLLYSIFTIKTTAWRTHFRR,0
4myc,B,286,304,18,DANKADNKAASVALDSLIN,0
4myc,B,385,390,5,LSVPLN,0
2na7,C,173,182,9,NLGWLSLLLL,0
2na7,C,183,194,11,PIPLIVWVKRKE,0
2na7,C,184,194,10,IPLIVWVKRKE,0
2na7,C,172,182,10,SNLGWLSLLLL,0
1j95,D,25,52,27,HWRAAGAATVLLVIVLLAGSYLAVLAER,0
1j95,D,61,74,13,TYPRALWWSVETAT,0
1j95,D,87,117,30,WGRCVAVVVMVAGITSFGLVTAALATWFVGR,0
1j95,D,61,73,12,TYPRALWWSVETA,0
1jgj,A,1,27,26,MVGLTTLFWLGAIGMLVGTLAFAWAGR,0
1jgj,A,33,56,23,ERRYYVTLVGISGIAAVAYAVMAL,0
1jgj,A,70,92,22,VPRYIDWILTTPLIVYFLGLLAG,0
1jgj,A,94,118,24,DSREFGIVITLNTVVMLAGFAGAMV,0
1jgj,A,121,150,29,IERYALFGMGAVAFIGLVYYLVGPMTESAS,0
1jgj,A,153,181,28,SSGIKSLYVRLRNLTVVLWAIYPFIWLLG,0
1jgj,A,189,216,27,TPTVDVALIVYLDLVTKVGFGFIALDAA,0
5dwk,F,30,48,18,AFRQEGVAVLLCVVIAAWL,0
5dwk,F,51,83,32,DAVTRVLLISSVMLVMIVELLNSAIEAVVDRIG,0
5dwk,F,87,117,30,HELSGRAKDLGSAAVLIAIIDAVITWAILLW,0
5dwk,F,8,28,20,TRIIKAAGYSWKGLRAAWINE,0
5dwk,F,28,48,20,EAAFRQEGVAVLLCVVIAAWL,0
5dwk,F,51,86,35,DAVTRVLLISSVMLVMIVELLNSAIEAVVDRIG,0
5dwk,F,91,122,31,ELSGRAKDLGSAAVLIAIIDAVITWAILLWSH,0
5dwk,F,16,28,12,YSWKGLRAAWINE,0
5dwk,F,87,120,33,HELSGRAKDLGSAAVLIAIIDAVITWAILLWSHF,0
5dwk,F,35,48,13,GVAVLLCVVIAAWL,0
5dwk,F,37,48,11,AVLLCVVIAAWL,0
5dwk,F,51,87,36,DAVTRVLLISSVMLVMIVELLNSAIEAVVDRIGSEYH,0
5dwk,F,92,118,26,RAKDLGSAAVLIAIIDAVITWAILLWS,0
5dwk,F,36,47,11,VAVLLCVVIAAW,0
5dwk,F,52,80,28,AVTRVLLISSVMLVMIVELLNSAIEAVVD,0
5dwk,F,83,87,4,GSEYH,0
5dwk,F,90,118,28,SGRAKDLGSAAVLIAIIDAVITWAILLWS,0
4mma,A,10,23,13,TRLGLILAMAGYAV,0
4mma,A,24,29,5,DLGNFL,0
4mma,A,29,38,9,LRFPVQAAEN,0
4mma,A,39,42,3,GGGA,0
4mma,A,43,54,11,FMIPYIIAFLLV,0
4mma,A,54,71,17,VGIPLMWIEWAMGRYGGA,0
4mma,A,76,85,9,TTPAIFYLLW,0
4mma,A,87,124,37,NRFAKILGVFGLWIPLVVASYYVYIESWTLGFAIKFLV,0
4mma,A,137,153,16,PDSILRPFKEFLYSYIG,0
4mma,A,165,184,19,SLFAYIVFLITMFINVSILI,0
4mma,A,190,215,25,GIERFAKIAMPTLFILAVFLVIRVFL,0
4mma,A,223,232,9,AADGLNFLWT,0
4mma,A,234,239,5,DFEKLK,0
4mma,A,240,256,16,DPGVWIAAVGQIFFSLG,0
4mma,A,260,266,6,GVLITFA,0
4mma,A,267,269,2,SYV,0
4mma,A,275,292,17,IVLSGLTAATLNEKASVI,0
4mma,A,293,296,3,LGGS,0
4mma,A,297,307,10,ISIPAAVAFFG,0
4mma,A,310,317,7,NAVAIAKA,0
4mma,A,317,325,8,AGAFNLGFI,0
4mma,A,325,332,7,ITLPAIFS,0
4mma,A,336,360,24,GGTFLGFLWFFLLFFAGLTSSIAGM,0
4mma,A,360,370,10,MQGMIAFLEDE,0
4mma,A,374,396,22,SRKHAVLWTAAIVFFSAHLVMFL,0
4mma,A,398,408,10,KSLDEMDFWAT,0
4mma,A,408,425,17,TGIGVVFFGLTELIIFFW,0
4mma,A,428,438,10,GADKAWEEINR,0
4mma,A,447,454,7,IYYYVMRY,0
4mma,A,454,471,17,YITPAFLAVLLVVWAREY,0
4mma,A,471,478,7,YIPKIMEE,0
4mma,A,482,509,27,TVWITRFYIIGLFLFLTFLVFLAERRRN,0
2q68,B,1,19,18,MLSFLLTLKRMLRACLRAW,0
2q68,B,21,46,25,DKEFQVLFVLTILTLISGTIFYSTVE,0
2q68,B,49,62,13,RPIDALYFSVVTLT,0
2q68,B,73,104,31,TDFGKIFTILYIFIGIGLVFGFIHKLAVNVQL,0
2q68,B,21,45,24,DKEFQVLFVLTILTLISGTIFYSTV,0
2q68,B,73,99,26,TDFGKIFTILYIFIGIGLVFGFIHKLA,0
1btr,A,2,19,17,VLAAVIFIYFAALSPAIT,0
5d6l,A,30,61,31,EVWVVGMGIVMSLIVLAIVFGNVLVITAIAKF,0
5d6l,A,62,65,3,ERLQ,0
5d6l,A,66,86,20,TVTNYFITSLACADLVMGLAV,0
5d6l,A,86,96,10,VVPFGAAHILM,0
5d6l,A,101,137,36,FGNFWCEFWTSIDVLCVTASIETLCVIAVDRYFAITS,0
5d6l,A,146,171,25,TKNKARVIILMVWIVSGLTSFLPIQM,0
5d6l,A,178,187,9,HQEAINCYAE,0
5d6l,A,196,208,12,NQAYAIASSIVSF,0
5d6l,A,208,229,21,FYVPLVIMVFVYSRVFQEAKRQ,0
5d6l,A,1002,1011,9,NIFEMLRIDE,0
5d6l,A,1038,1051,13,SLNAAKSELDKAIG,0
5d6l,A,1059,1081,22,TKDEAEKLFNQDVDAAVRGILRN,0
5d6l,A,1084,1091,7,LKPVYDSL,0
5d6l,A,1092,1113,21,DAVRRAALINMVFQMGETGVAG,0
5d6l,A,1114,1123,9,FTNSLRMLQQ,0
5d6l,A,1125,1134,9,RWDEAAVNLA,0
5d6l,A,1136,1142,6,SRWYNQT,0
5d6l,A,1142,1156,14,TPNRAKRVITTFRTG,0
5d6l,A,1158,263,-895,,0
5d6l,A,266,299,33,LKEHKALKTLGIIMGTFTLCWLPFFIVNIVHVIQ,0
5d6l,A,304,318,14,RKEVYILLNWIGYVN,0
5d6l,A,321,326,5,FNPLIY,0
5d6l,A,329,340,11,SPDFRIAFQELL,0
3k08,B,23,46,23,EFQVLFVLTILTLISGTIFYSTVE,0
3k08,B,49,62,13,RPIDALYFSVVTLT,0
3k08,B,72,98,26,TDFGKIFTILYIFIGIGLVFGFIHKLA,0
3k08,B,101,108,7,VQLPSILS,0
3k08,B,109,111,2,NLV,0
3k08,B,19,46,27,AKDKEFQVLFVLTILTLISGTIFYSTVE,0
3k08,B,72,101,29,TDFGKIFTILYIFIGIGLVFGFIHKLAVNV,0
3k08,B,101,111,10,VQLPSILSNLV,0
3j08,B,108,116,8,AGVLLLFLA,0
3j08,B,131,147,16,IALPAIFYSGSSIFKAA,0
3j08,B,155,159,4,TLNMD,0
3j08,B,164,181,17,MGVGAAFLASVLSTAGVL,0
3j08,B,190,210,20,TSVLLLAFLLLGRTLEARAKS,0
3j08,B,216,222,6,IKKLVGL,0
3j08,B,241,243,2,EEV,0
3j08,B,272,277,5,ESMISG,0
3j08,B,308,311,3,VGGE,0
3j08,B,312,322,10,TLLAQIVKLVE,0
3j08,B,330,356,26,PIQRLADKVVAYFIPTVLLVAISAFIY,0
3j08,B,372,380,8,LIAVLVVAC,0
3j08,B,383,401,18,AFGLATPTALTVGMGKGAE,0
3j08,B,410,415,5,DALEVA,0
3j08,B,416,418,2,EKV,0
3j08,B,426,428,2,TGT,0
3j08,B,445,458,13,DERELLRLAAIAER,0
3j08,B,462,475,13,HPIAEAIVKKALEH,0
3j08,B,502,509,7,NKRLMEDF,0
3j08,B,514,526,12,SNEVELALEKLER,0
3j08,B,553,564,11,SAKPAVQELKRM,0
3j08,B,575,587,12,NWRSAEAISRELN,0
3j08,B,599,608,9,QKSEEVKKLQ,0
3j08,B,622,629,7,DAPALAQA,0
3j08,B,656,691,35,RDVVAAIQLSRKTMSKIKQNIFWALIYNVILIPAAA,0
3j08,B,703,713,10,RPEFAGLAMAM,0
3j08,B,713,722,9,MSSVSVVANS,0
4chw,D,12,29,17,PLNAVLAAPGLLAVAALT,0
4chw,D,34,62,28,SGRSRLALAALLAVIWGAYLLQLAATLLK,0
4chw,D,71,92,21,RTPKIAIDVLAVLVPLAAFLLD,0
4chw,D,94,105,11,SPDWSLYCAVWL,0
4chw,D,106,112,6,LKPLRDS,0
4chw,D,113,152,39,TFFPVLGRVLANEARNLIGVTTLFGVVLFAVALAAYVIER,0
4chw,D,161,174,13,SIPQAMWWAVVTLS,0
4chw,D,185,225,40,SFAGRVLAGAVMMSGIGIFGLWAGILATGFYQEVRRGDFVR,0
4chw,D,227,233,6,WQLVAAV,0
4chw,D,234,238,4,PLFQK,0
4chw,D,240,251,11,GPAVLVEIVRAL,0
4chw,D,297,304,7,GEMALISG,0
4chw,D,324,334,10,SADFQMLCSSS,0
4chw,D,334,349,15,SPEIAEIFRKTALERR,0
4chw,D,227,232,5,WQLVAA,0
4chw,D,233,238,5,VPLFQK,0
4x5m,C,2,18,16,DTILLTGLFAAFFTTFA,0
4x5m,C,19,30,11,FAPQSIKTIRTR,0
4x5m,C,36,58,22,SVVMYIMFLTGVISWIAYGIMRS,0
4x5m,C,59,87,28,DFAVLIANIVTLFLAAPVLVITLINRRKK,0
4x5m,C,2,19,17,DTILLTGLFAAFFTTFAF,0
4x5m,C,59,93,34,DFAVLIANIVTLFLAAPVLVITLINRRKKHVLESS,0
4x5m,C,3,19,16,TILLTGLFAAFFTTFAF,0
4x5m,C,59,91,32,DFAVLIANIVTLFLAAPVLVITLINRRKKHVLE,0
4kk5,B,16,17,1,R,0
4kk5,B,37,60,23,MAAVVGTLVGLAAVAFDKGVAWL,0
4kk5,B,61,83,22,NQRMGALVHTADNYPLLLTVAF,0
4kk5,B,84,97,13,CSAVLAMFGYFLV,0
4kk5,B,129,142,13,VKFFGGLGTLGGG,0
4kk5,B,144,156,12,LGREGPTVQIGG,0
4kk5,B,181,203,22,AAAGLAAAFNAPLAGILFIIEE,0
4kk5,B,216,232,16,AVFIGVIMSTIMYRIF,0
4kk5,B,233,252,19,HEVALIDVGKLSDAPLNTL,0
4kk5,B,253,277,24,LYLILGIIFGIFGPIFNKWVLGMQ,0
4kk5,B,290,304,14,WVLMGGAIGGLCGL,0
4kk5,B,305,337,32,GFVAPATSGGGFNLIPIATAGNFSMGMLVFIF,0
4kk5,B,338,351,13,ARVITTLLCFSSG,0
4kk5,B,353,368,15,GGIFAPMLALGTVLG,0
4kk5,B,369,392,23,AFGMVAVELFPQYHLEAGTFAIA,0
4kk5,B,393,415,22,MGALLAASIRAPLTGIILVLEM,0
4kk5,B,416,422,6,DNYQLI,0
4kk5,B,423,439,16,PMIITGLGATLLAQFT,0
4kk5,B,459,461,2,QK,0
3b5x,B,1,9,8,SLHSDESN,0
3b5x,B,30,44,14,TIALVINAAADTYM,0
3b5x,B,45,67,22,SLLKPLLDEGFGNAESNFLRIL,0
3b5x,B,68,82,14,FMILGLMFVRGLSG,0
3b5x,B,145,161,16,IVREGASIIGLLTLMF,0
3b5x,B,162,172,10,NSWQLSLVLI,0
3b5x,B,173,188,15,VAPVVAFAISFVSKR,0
3b5x,B,245,259,14,SAQSIADPVIQMIA,0
3b5x,B,260,287,27,LALFAVLFLASVDSIRAELTPGTFTVV,0
3b5x,B,288,301,13,SAMFGLMRPLKAL,0
1xrd,A,1,12,11,WRIWQLFDPRQ,0
1xrd,A,13,36,23,LVGLATFLFVLALLIHFILLSTE,0
2fed,B,1,17,16,KTDTPSLETPQAARLR,0
2fed,B,18,36,18,RQLIRQLLERDKTPLAIL,0
2fed,B,37,61,24,MAAVVGTLVGLAAVAFDKGVAWLQ,0
2fed,B,81,97,16,AFLCSAVLAMFGYFLV,0
2fed,B,98,127,29,KYAPEAGGSGIPEIEGALEDQRPVRWWRV,0
2fed,B,128,142,14,PVKFFGGLGTLGGG,0
2fed,B,144,159,15,LGREGPTVQIGGNIG,0
2fed,B,160,179,19,MVLDIFRLKGDEARHTLLA,0
2fed,B,180,203,23,GAAAGLAAAFNAPLAGILFIIEQ,0
2fed,B,204,215,11,RPQFRYTLISI,0
2fed,B,216,232,16,AVFIGVIMSTIMYRIF,0
2fed,B,253,277,24,LYLILGIIFGIFGPIFNKWVLGMQ,0
2fed,B,278,284,6,LLHRVH,0
2fed,B,285,289,4,GNIT,0
2fed,B,290,305,15,WVLMGGAIGGLCGLL,0
2fed,B,317,324,7,NLIPIAT,0
2fed,B,337,351,14,VARVITTLLCFSSG,0
2fed,B,353,368,15,GGIFAPMLALGTVLG,0
2fed,B,392,415,23,GMGALLAASIRAPLTGIILVLEM,0
2fed,B,422,439,17,LPMIITGLGATLLAQFT,0
2fed,B,440,458,18,GKPLYSAILARTLAKQEA,0
2fed,B,459,465,6,QLARSK,0
3ba6,A,1,54,53,EAAHSKSTEECLAYFGVSETTGLTPDQVKRHLEKYGHNELPAEEGKSLWELVI,0
3ba6,A,55,77,22,QFEDLLVRILLLAACISFVLAW,0
3ba6,A,86,104,18,AFVEPFVILLILIANAIV,0
3ba6,A,105,256,151,VWQERNAENAIEALKEYEPEMGKVYRADRKSVQRIKARDIVPGDIVEVAVGDKVPADIRILSIKSTTLRVDQSILTGESVSVIKHTEPVPDPRAVNQDKKNMLFSGTNIAAGKALGIVATTGVSTEIGKIRDQMAATEQDKTPLQQKLDEF,0
3ba6,A,257,275,18,EQLSKVISLICVAVWLIN,0
3ba6,A,294,313,19,YFKIAVALAVAAIPEGLPA,0
3ba6,A,314,759,445,ITTCLALGTRRMAKKNAIVRSLPSVETLGCTSVICSDKTGTLTTNQMSVCKMFIIDKVDGDFCSLNEFSITGSTYAPEGEVLKNDKPIRSGQFDGLVELATICALCNDSSLDFNETKGVYEKVGEATETALTTLVEKMNVFNTEVRNLSKVERANACNSVIRQLMKKEFTLEFSRDRKSMSVYCSPAKSSRAAVGNKMFVKGAPEGVIDRCNYVRVGTTRVPMTGPVKEKILSVIKEWGTGRDTLRCLALATRDTPPKREEMVLDDSSRFMEYETDLTFVGVVGMLDPPRKEVMGSIQLCRDAGIRVIMITGDNKGTAIAICRRIGIFGENEEVADRAYTGREFDDLPLAEQREACRRACCFARVEPSHKSKIVEYLQSYDEITAMTGDGVNDAPALKKAEIGIAMGSGTAVAKTASEMVLADDNFSTIVAAVEEGRAIYNNMKQ,0
3ba6,A,760,781,21,IRYLISSNVGEVVCIFLTAAL,0
3ba6,A,787,807,20,IPVQLLWVNLVTDGLPATAL,0
3ba6,A,808,831,23,FNPPDLDIMDRPPRSPKEPLISG,0
3ba6,A,832,852,20,LFFRYMAIGGYVGAATVGAA,0
3ba6,A,898,916,18,MALSVLVTIEMCNALNSL,0
3ba6,A,917,931,14,ENQSLMRMPPWVNI,0
3ba6,A,932,950,18,LLGSICLSMSLHFLILYV,0
3ba6,A,963,987,24,LTQWLMVLKISLPVIGLDEILKFI,0
3ba6,A,988,994,6,RNYLEG,0
4kjp,B,16,17,1,R,0
4kjp,B,37,61,24,MAAVVGTLVGLAAVAFDKGVAWLQ,0
4kjp,B,62,83,21,QRMGALVHTADNYPLLLTVAF,0
4kjp,B,84,97,13,CSAVLAMFGYFLV,0
4kjp,B,129,142,13,VKFFGGLGTLGGG,0
4kjp,B,144,156,12,LGREGPTVQIGG,0
4kjp,B,181,203,22,AAAGLAAAFNAPLAGILFIIEE,0
4kjp,B,216,232,16,AVFIGVIMSTIMYRIF,0
4kjp,B,233,252,19,HEVALIDVGKLSDAPLNTL,0
4kjp,B,253,277,24,LYLILGIIFGIFGPIFNKWVLGMQ,0
4kjp,B,290,305,15,WVLMGGAIGGLCGLL,0
4kjp,B,306,337,31,FVAPATSGGGFNLIPIATAGNFSMGMLVFIF,0
4kjp,B,338,351,13,ARVITTLLCFSSG,0
4kjp,B,353,368,15,GGIFAPMLALGTVLG,0
4kjp,B,369,391,22,AFGMVAVELFPQYHLEAGTFAI,0
4kjp,B,392,415,23,GMGALLAASIRAPLTGIILVLEM,0
4kjp,B,416,422,6,DNYQLI,0
4kjp,B,423,439,16,PMIITGLGATLLAQFT,0
4kjp,B,459,461,2,QK,0
5jsz,D,1,5,4,SKII,0
5jsz,D,29,38,9,YFIIMIFLA,0
5jsz,D,39,42,3,NWV,0
5jsz,D,43,56,13,YLVISIFGLAYVF,0
5jsz,D,72,82,10,IWMIVFTSLL,0
5jsz,D,83,108,25,TFFMAGGKVYWHWWIFTLSSEGLIN,0
5jsz,D,109,122,13,LYVFIRFAMIILV,0
5jsz,D,249,260,11,AYCLLLTILMI,0
5jsz,D,261,264,3,TRK,0
2onj,B,2,9,7,KRYLQFV,0
2onj,B,10,35,25,PYKYRIFATIIVGIIKFGIPMLIPL,0
2onj,B,36,63,27,IKYAIDGVINNHALTTDEKVHHLTIAI,0
2onj,B,64,89,25,IALFIFVIVRPPIEFIRQYLAQWTS,0
2onj,B,133,157,24,FILTGLMNIWLDCITIIIALSIMF,0
2onj,B,158,164,6,LDVKLT,0
2onj,B,165,186,21,AALFIFPFYILTVYVFFGRLR,0
2onj,B,241,263,22,RWNAYSFAAINTVTDIGPIIVI,0
2onj,B,264,285,21,VGAYLAISGSITVGTLAAFVG,0
2onj,B,286,308,22,LELLFGPLRRLVASFTTLTQSF,0
4kkc,B,16,17,1,R,0
4kkc,B,37,61,24,MAAVVGTLVGLAAVAFDKGVAWLQ,0
4kkc,B,62,83,21,QRMGALVHTADNYPLLLTVAF,0
4kkc,B,84,97,13,CSAVLAMFGYFLV,0
4kkc,B,128,142,14,PVKFFGGLGTLGGG,0
4kkc,B,144,156,12,LGRAGPTVQIGG,0
4kkc,B,180,204,24,GAAAGLAAAFNAPLAGILFIIEEM,0
4kkc,B,216,232,16,AVFIGVIMSTIMYRIF,0
4kkc,B,233,252,19,HEVALIDVGKLSDAPLNTL,0
4kkc,B,253,277,24,LYLILGIIFGIFGPIFNKWVLGMQ,0
4kkc,B,290,305,15,WVLMGGAIGGLCGLL,0
4kkc,B,306,337,31,FVAPATSGGGFNLIPIATAGNFSMGMLVFIF,0
4kkc,B,338,351,13,ARVITTLLCFSSG,0
4kkc,B,353,368,15,GGIFAPMLALGTVLG,0
4kkc,B,369,392,23,AFGMVAVELFPQYHLEAGTFAIA,0
4kkc,B,393,415,22,MGALLAASIRAPLTGIILVLEM,0
4kkc,B,416,422,6,DNYQLI,0
4kkc,B,423,439,16,PMIITGLGATLLAQFT,0
4kkc,B,459,461,2,QK,0
2qei,B,1,3,2,EV,0
2qei,B,13,32,19,LILAMAGNAVGLGNFLRFP,0
2qei,B,33,43,10,QAAENGGGAF,0
2qei,B,44,63,19,IPYIIAFLLVGIPLMWIEW,0
2qei,B,90,124,34,KILGVFGLWIPLVVAIYYVYIESWTLGFAIKFLV,0
2qei,B,125,132,7,LVPEPPP,0
2qei,B,133,134,1,A,0
2qei,B,135,166,31,DPDSILRPFKEFLYSYIGVPKGDEPILKPSL,0
2qei,B,167,185,18,AYIVFLITMFINVSILIR,0
2qei,B,191,212,21,ERFAKIAMPTLFILAVFLVIR,0
2qei,B,213,222,9,FLLETPNGT,0
2qei,B,223,230,7,ADGLNFL,0
2qei,B,231,241,10,TPDFEKLKDP,0
2qei,B,242,266,24,VWIAAVGQIFFTLSLGFGAIITYA,0
2qei,B,277,297,20,SGLTAATLNEKAEVILGGSI,0
2qei,B,298,325,27,IPAAVAFFGVANAVAIAKAGAFNLGFI,0
2qei,B,326,331,5,LPAIF,0
2qei,B,332,339,7,QTAGGTF,0
2qei,B,340,367,27,GFLWFFLLFFAGLTSSIAIMQPMIAFL,0
2qei,B,378,396,18,VLWTAAIVFFSAHLVMFL,0
2qei,B,397,399,2,KS,0
2qei,B,400,426,26,DEMDFWAGTIGVVFFGLTELIIFFWI,0
2qei,B,429,437,8,DKAWEEIN,0
2qei,B,445,469,24,RIYYYVMRYITPAFLAVLLVVWAR,0
2qei,B,470,483,13,YIPKIMEETHWTV,0
2qei,B,484,502,18,ITRFYIIGLFLFLTFLVF,0
2qei,B,602,603,1,R,0
5v57,A,58,233,175,PPLSHCGRAAPCEPLRYNVCLGSVLPYGATSTLLAGDSDSQEEAHGKLVLWSGLRNAPRCWAVIQPLLCAVYMPKCENDRVELPSRTLCQATRGPCAIVERERGWPDFLRCTPDRFPEGCTNEVQNIKFNSSGQCEVPLVRTDNPKSWYEDVEGCGIQCQNPLFTEAEHQDMHSY,0
5v57,A,234,256,22,AAFGAVTGLCTLFTLATFVADW,0
5v57,A,264,286,22,VILFYVNACFFVGSIGWLAQFM,0
5v57,A,287,288,1,G,0
5v57,A,289,294,5,RREIV,0
5v57,A,295,312,17,RADGTMRLGEPTSNETL,0
5v57,A,313,340,27,CVIIFVIVYYALMAGVVWFVVLTYAWH,0
5v57,A,358,381,23,YFHLLTWSLPFVLTVAILAVAQV,0
5v57,A,382,397,15,GDSVSGICFVGYKNY,0
5v57,A,398,424,26,YRAGFVLAPIGLVLIVGGYFLIRGVM,0
5v57,A,1135,1146,11,DIVGWAHDVRG,0
5v57,A,451,475,24,LGIFGFLAFGFVLITFSCHFYDFF,0
5v57,A,476,516,40,QAEWERSFRDYVLCQANVTIGLPTKQPIPDCEIKNRPSLL,0
5v57,A,517,542,25,EKINLFAMFGTGIAMSTWVWTKATL,0
5v57,A,543,553,10,IWRRTWCRLT,0
2x79,A,1,5,4,NSTP,0
2x79,A,34,49,15,IWFAMAIQVAIFIAA,0
2x79,A,50,61,11,QMTSSFQVWQV,0
2x79,A,62,77,15,VAIAAGCTIAVILLF,0
2x79,A,109,133,24,KALLSLFWFGFQTWLGALALDEIT,0
2x79,A,134,141,7,LLTGFTN,0
2x79,A,142,157,15,PLWIVIFGAIQVVTT,0
2x79,A,164,181,17,RWMNVFASPVLLAMGVY,0
2x79,A,182,209,27,VYLMLDGADVSLGEVMSMGGENPGMPF,0
2x79,A,210,227,17,TAIMIFVGGWIAVVVSI,0
2x79,A,254,271,17,AQWLGMVPASIIFGFIG,0
2x79,A,272,300,28,ASMVLVGEWNPVIAITEVVGGVSIPMAI,0
2x79,A,301,320,19,FQVFVLLATWSTNPAANLL,0
2x79,A,341,357,16,VSAVVGLLMMPWQFAG,0
2x79,A,358,359,1,L,0
2x79,A,360,376,16,TFLNLLASALGPLAGI,0
2x79,A,413,427,14,VYAVALAVSFLTPD,0
2x79,A,429,440,11,FVTGLIAALLL,0
2x79,A,471,501,30,VAPADESATANTKEQNQPAGGRGSHHHHHH,0
5xaa,A,55,72,17,QFEDLLVRILLLAACIS,0
5xaa,A,73,90,17,VLAWFEEGEETITAFVE,0
5xaa,A,91,111,20,FVILLILIANAIVGVWQERN,0
5xaa,A,251,274,23,KLDEFGEQLSKVISLICVAVWLI,0
5xaa,A,275,296,21,IGHFNDPVHGGSWIRGAIYYF,0
5xaa,A,297,321,24,IAVALAVAAIPEGLPAVITTCLAL,0
5xaa,A,758,781,23,QFIRYLISSNVGEVVCIFLTAAL,0
5xaa,A,782,786,4,LPEA,0
5xaa,A,787,809,22,IPVQLLWVNLVTDGLPATALGF,0
5xaa,A,833,852,19,FFRYMAIGGYVGAATVGAA,0
5xaa,A,853,898,45,WWFMYAEDGPGVTYHQLTHFMQCTEDHPHFEGLDCEIFEAPEPMT,0
5xaa,A,899,918,19,ALSVLVTIEMCNALNSLSE,0
5xaa,A,927,948,21,WVNIWLLGSICLSMSLHFLIL,0
5xaa,A,949,966,17,VDPLPMIFKLKALDLTQ,0
5xaa,A,967,987,20,LMVLKISLPVIGLDEILKFI,0
5twv,H,33,52,19,VPHVFLLFITFPILFIGWG,0
5twv,H,53,69,16,QSSKVHIHHSTWLHFP,0
5twv,H,70,87,17,HNLRWILTFILLFVLVC,0
5twv,H,111,127,16,MAFMAAITSVVYYHNI,0
5twv,H,128,133,5,TSNFP,0
5twv,H,134,150,16,LLIALLIYWTLAFITK,0
5twv,H,174,189,15,LVILYGMLLLVEVNV,0
5twv,H,190,230,40,RVRRYIFFKTPREVKPPEDLQDLGVRFLQPFVNLLSKGTY,0
5twv,H,231,241,10,WMNAFIKTAH,0
5twv,H,242,300,58,KPIDLRAIAKLPIAMRALTNYQRLCVAFDAQARKDTQSPQGARAIWRALCHAFGRRLI,0
5twv,H,301,320,19,SSTFRILADLLGFAGPLCI,0
5twv,H,358,376,18,AVLLFLALLLQRTFLQAS,0
5twv,H,377,436,59,YVAIETGINLRGAIQTKIYNKIMHMSTSNLSMGEMTAGQICNLVAIDTNQLMWFFFLCP,0
5twv,H,437,453,16,LWTMPVQIIVGVILLY,0
5twv,H,460,477,17,LIGAAVIILLAPVQYFV,0
5twv,H,478,541,63,TKLSQAQRTTLEHSNERLKQTNEMLRGMKLLKLYAWESIFCSRVEVTRRKEMTSLRAFAVYTS,0
5twv,H,542,560,18,SIFMNTAIPIAAVLITFV,0
5twv,H,578,594,16,SLSLFHILVTPLFLLS,0
5twv,H,595,615,20,VVRSTVKALVSVQKLSEFLS,0
5twv,H,678,744,66,VQIIGGFFTWTPDGIPTLSNITIRIPRGQLTMIVGQVGCGKSSLLLATLGEMQKVSGAVFWNSNLP,0
5twv,H,770,928,158,AYASQKPWLLNATVEENITFESPFNKQRYKMVIEACSLQPDIDILPHGDQTQIGERGINLSGGQRQRISVARALYQQTNVVFLDDPFSALDVHLSDHLMQAGILELLRDDKRTVVLVTHKLQYLPHADWIIAMKDGTIQREGTLKDFQRSECQLFEHW,0
5twv,H,1000,1011,11,CTKYLSSAGIL,0
5twv,H,1012,1032,20,LSLLVFSQLLKHMVLVAIDY,0
5twv,H,1072,1087,15,SLGIVLCLVTSVTVE,0
5twv,H,1088,1141,53,TGLKVAKRLHRSLLNRIILAPMRFFETTPLGSILNRFSSDCNTIDQHIPSTLE,0
5twv,H,1142,1161,19,LSRSTLLCVSALTVISYVT,0
5twv,H,1164,1179,15,LVALLPLAVVCYFIQ,0
5twv,H,1180,1247,67,YFRVASRDLQQLDDTTQLPLVSHFAETVEGLTTIRAFRYEARFQQKLLEYTDSNNIASLFLTAANRW,0
5twv,H,1248,1265,17,EVCMEYIGACVVLIAAA,0
5twv,H,1284,1301,17,LTYALMVSNYLNWMVRN,0
5twv,H,1302,1319,17,ADMEIQLGAVKRIHALL,0
5twv,H,1343,1577,234,KIQIQNLSVRYDSSLKPVLKHVNTLISPGQKIGICGRTGSGKSSFSLAFFRMVDMFEGRIIIDGIDIAKLPLHTLRSRLSIILQDPVLFSGTIRFNLDPEKKCSDSTLWEALEIAQLKLVVKALPGGLDAIITEGGENFSQGQRQLFCLARAFVRKTSIFIMDEATASIDMATENILQKVVMTAFADRTVVTIAHRVHTILSADLVMVLKRGAILEFDKPETLLSQKDSVFASF,0
2hg5,J,88,111,23,RLVAVVVMVAGITSFGLVTAALA,0
2hg5,J,112,122,10,WFVGREQERR,0
1sor,D,14,30,16,AEFFATLFYVFFGLGA,0
1sor,D,31,42,11,LRWAPGPLHVL,0
1sor,D,43,60,17,VALAFGLALATLVQAVG,0
1sor,D,65,77,12,HVNPAVTFAFLV,0
1sor,D,87,104,17,CYVVAQLLGAVAGAAVL,0
1sor,D,105,128,23,SVTPPAVRGNLALNTLHPGVSVG,0
1sor,D,129,146,17,ATIVEIFLTLQFVLCIF,0
1sor,D,160,176,16,ALAVGFSLTLGHLFGM,0
1sor,D,177,181,4,YTGA,0
1sor,D,182,194,12,MNPARSFAPAIL,0
1sor,D,195,201,6,RNFTNH,0
1sor,D,202,219,17,VYWVGPVIGAGLGSLLY,0
2oar,E,-22,0,22,GHHHHHHHHHHSSGHIDDDDKH,0
2oar,E,2,10,8,KGFKEFLA,0
2oar,E,11,18,7,GNIVDLA,0
2oar,E,19,47,28,AVVIGTAFTALVTKFTDSIITPLINRIG,0
2oar,E,67,90,23,DLNVLLSAAINFFLIAFAVYFLV,0
2oar,E,91,125,34,LPYNTLRKKGEVEQPGDTQVVLLTEIRDLLAQTN,0
2oar,E,126,151,25,DSPGRHGGRGTPSPTDGPRASTESQ,0
5heu,E,11,201,190,VDVSVSIFINKIYGVNTLEQTYKVDGYIVAQWTGKPRKTPGDKPLIVENTQIERWINNGLWVPALEFINVVGSPDTGNKRLMLFPDGRVIYNARFLGSFSNDMDFRLFPFDRQQFVLELEPFSYNNQQLRFSDIQVYTENIDNEEIDEWWIRGKASTHISDIRYDHLSSVQPNQNEFSRITVRIDAVRNP,0
5heu,E,202,222,20,YYLWSFILPLGLIIAASWSV,0
5heu,E,234,253,19,SFTLMLTVVAYAFYTSNIL,0
5heu,E,254,259,5,RLPAT,0
5heu,E,260,279,19,VIDQMIIAGYGSIFAAILL,0
5heu,E,303,317,14,FPLGFLAIGCVLVI,0
5x5y,F,8,33,25,REVLVTMSAVSAVLLVIIMSGRFIK,0
5x5y,F,34,52,18,LAQAAQGLLDPGSLFLIM,0
5x5y,F,53,77,24,FRIPGFLQLILPLGLFLGILLAYG,0
5x5y,F,84,89,5,MTVLS,0
5x5y,F,97,121,24,LLGYTMAPALLVAILVAWLSLFLA,0
5x5y,F,122,181,59,QGINQFALLLNKQDTLTEFDTLVPGRFQAMRDGTRVTYTEELSKDRGELAGIFISQKDL,0
5x5y,F,184,242,58,NQERGISILVAEKGTQNIQADGSRYLILHNGYRYDGNPGQANYRAIQYDTYGVMLPKP,0
5x5y,F,252,271,19,AVPTADLFGSDNPRYQAEL,0
5x5y,F,272,293,21,WRLSTPLLVFVVTLLAVPLSR,0
5x5y,F,300,322,22,FLKLLPAILLYMGYLALLIAVR,0
5x5y,F,323,332,9,QLDKGKIPM,0
5x5y,F,333,353,20,IGLWWVHGLFLAIGLLLFYW,0
5x5y,F,354,361,7,PLRLKLA,0
3wt8,A,20,42,22,DAQWVVFAVMALAAIVFSIAVQ,0
3wt8,A,43,49,6,RPLPLR,0
3wt8,A,50,73,23,TYYVNIAICTIAATAYYAMAVNG,0
3wt8,A,90,110,20,YARYIDWVFTTPLLLLDLVL,0
3wt8,A,111,116,5,TNMPA,0
3wt8,A,117,139,22,MIAWIMGADIAMIAFGIIGAFT,0
3wt8,A,144,166,22,WFYFVVGCIMLAVLAWGMINPI,0
3wt8,A,167,179,12,KEELQKHKEYTG,0
3wt8,A,180,204,24,YTTLLIYLIVLWVIYPIVWGLGAG,0
3wt8,A,213,235,22,IIAMGILDLLAKPLYAIGVLIT,0
3wt8,A,236,244,8,EVVYGKLG,0
5xa7,A,58,74,16,DLLVRILLLAACISFV,0
5xa7,A,75,89,14,AWFEEGEETITAFV,0
5xa7,A,90,104,14,PFVILLILIANAIV,0
5xa7,A,260,274,14,SKVISLICVAVWLI,0
5xa7,A,275,292,17,IGHFNDPVHGGSWIRGA,0
5xa7,A,293,309,16,YYFKIAVALAVAAIPE,0
5xa7,A,763,777,14,LISSNVGEVVCIFL,0
5xa7,A,778,787,9,AALGLPEAL,0
5xa7,A,788,804,16,PVQLLWVNLVTDGLPA,0
5xa7,A,832,849,17,LFFRYMAIGGYVGAATV,0
5xa7,A,850,899,49,AAAWWFMYAEDGPGVTYHQLTHFMQCTEDHPHFEGLDCEIFEAPEPMTM,0
5xa7,A,900,915,15,LSVLVTIEMCNALNS,0
5xa7,A,934,950,16,GSICLSMSLHFLILYV,0
5xa7,A,951,956,5,PLPMI,0
5xa7,A,957,967,10,KLKALDLTQW,0
5xa7,A,968,987,19,MVLKISLPVIGLDEILKFI,0
3wvf,A,334,351,17,FISQPLFKLLKWIHSFV,0
3wvf,A,356,373,17,SIIIITFIVRGIMYPLT,0
3wvf,A,374,423,49,AQYTSMAKMRMLQPKIQAMRERLGDDKQRISQEMMALYKAEKVNPLGGC,0
3wvf,A,424,438,14,PLLIQMPIFLALYY,0
3wvf,A,465,477,12,ILPILMGVTMFF,0
3wvf,A,478,479,1,Q,0
3wvf,A,493,497,4,IMTF,0
3wvf,A,498,510,12,PVIFTVFFLWFP,0
3wvf,A,512,526,14,LVLYYIVSNLVTII,0
3wvf,A,527,528,1,Q,0
3k3f,C,10,26,16,LIEFCDSVCRGCGQVM,0
3k3f,C,33,46,13,GLLFFAGIFYNST,0
3k3f,C,48,60,12,GVCAVLGTAAST,0
3k3f,C,80,92,12,NGTLAGIALPFF,0
3k3f,C,93,97,4,NYEP,0
3k3f,C,98,114,16,MLGYVALNGAFTTIIM,0
3k3f,C,115,122,7,SLLNFLG,0
3k3f,C,130,144,14,APFVLATWLLMFGV,0
3k3f,C,145,163,18,KLSLFHPGALIAPALPSV,0
3k3f,C,164,167,3,GLA,0
3k3f,C,168,177,9,MGTVTGRTF,0
3k3f,C,178,193,15,EGLFKGVGEVMFQDN,0
3k3f,C,195,205,10,TGVIFVVAIL,0
3k3f,C,212,229,17,LFAVIGSLVGLCTALIM,0
3k3f,C,230,238,8,SPETPVRL,0
3k3f,C,239,251,12,LYGFNSVLCGIA,0
3k3f,C,266,285,19,ALGCMVLGAIATGAFSVLL,0
3k3f,C,286,290,4,PIGM,0
3k3f,C,291,304,13,ALTWPFIVVTWLF,0
3k3f,C,335,337,2,SR,0
4l6r,A,140,165,25,FQVMYTVGYSLSLGALLLALAILGG,0
4l6r,A,166,174,8,SKLHCTRN,0
4l6r,A,175,197,22,IHANLFASFVLKASSVLVIDGL,0
4l6r,A,201,215,14,YSQKIGDDLSVSTW,0
4l6r,A,224,248,24,RVAAVFMQYGIVANYCWLLVEGLY,0
4l6r,A,249,265,16,HNLLGLATLPERSFFS,0
4l6r,A,266,287,21,YLGIGWGAPMLFVVPWAVVKC,0
4l6r,A,301,326,25,GFWWILRFPVFLAILINFFIFVRIV,0
4l6r,A,327,349,22,LLVAKLRARQMHHTDYKFRLAK,0
4l6r,A,350,371,21,TLTLIPLLGVHEVVFAFVTDE,0
4l6r,A,380,403,23,KLFFDLFLSSFQGLLVAVLYCFL,0
4l6r,A,405,428,23,EVQSELRRRWHRWRLGKVLWEER,0
4l6r,A,430,441,11,SNGRPLEVLFQ,0
2jj0,M,0,1,1,A,0
2jj0,M,55,72,17,GVLSLFSGLMWFFTIGI,0
2jj0,M,73,81,8,FWYQAGWN,0
2jj0,M,82,87,5,AVFLR,0
2jj0,M,88,115,27,LFFFSLEPPAPEYGLSFAAPLKEGGLW,0
2jj0,M,116,133,17,IASFFMFVAVWSWWGRT,0
2jj0,M,147,167,20,WAFLSAIWLWMVLGFIRPIL,0
2jj0,M,168,178,10,GSWSEAVPYG,0
2jj0,M,179,192,13,FSHLDWTNNFSLV,0
2jj0,M,193,199,6,GNLFYN,0
2jj0,M,200,221,21,FHGLSIAFLYGSALLFAMHGA,0
2jj0,M,269,286,17,IWMAVLVTLTGGIGILL,0
2jj0,M,287,293,6,GTVVDN,0
2jj0,M,294,300,6,YVWGQN,0
2jj0,M,301,302,1,G,0
2jj0,M,303,307,4,APLN,0
1oj9,A,1,2,1,S,0
1oj9,A,3,490,487,KCDVVVVGGGISGMAAAKLLHDSGLNVVVLEARDRVGGRTYTLRNQKVKYVDLGGSYVGPTQNRILRLAKELGLETYKVNEVERLIHHVKGKSYPFRGPFPPVWNPITYLDHNNFWRTMDDMGREIPSDAPWKAPLAEEWDNMTMKELLDKLCWTESAKQLATLFVNLCVTAETHEVSALWFLWYVKQCGGTTRIISTTNGGQERKFVGGSGQVSERIMDLLGDRVKLERPVIYIDQTRENVLVETLNHEMYEAKYVISAIPPTLGMKIHFNPPLPMMRNQMITRVPLGSVIKCIVYYKEPFWRKKDYCGTMIIDGEEAPVAYTLDDTKPEGNYAAIMGFILAHKARKLARLTKEERLKKLCELYAKVLGSLEALEPVHYEEKNWCEEQYSGGCYTTYFPPGILTQYGRVLRQPVDRIYFAGTETATHWSGYMEGAVEAGERAAREILHAMGKIPEDEIWQSEPESVDVPAQPITTTFLERHLPSVP,0
1oj9,A,491,501,10,LLRLIGLTTI,0
1oj9,A,502,520,18,SATALGFLAHKRGLLVRV,0
4ikv,A,26,47,21,TLFFTEFWERFSYYGMRAILV,0
4ikv,A,48,67,19,YMYYEVSKGGLGLDEHLAL,0
4ikv,A,68,88,20,IMSIYGALVYMSGIIGGWLA,0
4ikv,A,95,114,19,RAVFYGGLLIMAGHIALAI,0
4ikv,A,115,120,5,GGVAA,0
4ikv,A,121,140,19,FVSMALIVLGTGLLKPNVS,0
4ikv,A,160,179,19,FYMGINLGAFLAPLVVGTA,0
4ikv,A,180,187,7,MKYNFHL,0
4ikv,A,188,207,19,FGLAAVGMFLGLVVFVATR,0
4ikv,A,229,249,20,AAAIMAVGAVVIAVLLAILI,0
4ikv,A,250,253,3,NGW,0
4ikv,A,254,277,23,TVETFISLVGILGIIIPIIYFVV,0
4ikv,A,294,317,23,YIPLFVASAMFWAIQEQGSTILA,0
4ikv,A,318,336,18,YADKRTQLDVAGIHLSPA,0
4ikv,A,337,357,20,FQSLNPLFIIILAPVFAWMW,0
4ikv,A,365,386,21,TIPQKFALGLLFAGLSFIVIL,0
4ikv,A,387,400,13,PGHLSGGGLVHPI,0
4ikv,A,401,421,20,LVLSYFIVVLGELCLSPVGL,0
4ikv,A,438,455,17,LWFLSNAAAQAINAQLV,0
4ikv,A,456,466,10,FYTPENETAY,0
4ikv,A,467,485,18,GTIGGAALVLGLILLAIA,0
4ikv,A,494,507,13,IRLESSGENLYFQ,0
1dx7,A,22,45,23,YMSGLWLFSAVAIVAHLAVYIWR,0
1dx7,A,46,48,2,WF,0
4ltp,D,137,147,10,PSSPSLLRAI,0
4ltp,D,151,170,19,WIALLLLVIFYVFAVMGTK,0
4ltp,D,171,183,12,FAQSFPEWFGTL,0
4ltp,D,184,200,16,ASMYTLFQVMTLESWS,0
4ltp,D,201,213,12,GIARPVIEAYPW,0
4ltp,D,214,236,22,WIYFVSFILVSSFTVLNLFIGI,0
4ltp,D,286,288,2,KR,0
5t4p,V,1,2,1,E,0
5t4p,V,3,8,5,LNMDL,0
5t4p,V,9,23,14,YMAAAVMMGLAAIG,0
5t4p,V,63,77,14,PMIAVGLGLYVMFA,0
5t4p,V,78,79,1,A,0
4pgw,A,3,10,7,NAHESKQ,0
4pgw,A,11,17,6,IMQRIL,0
4pgw,A,18,37,19,VFVFTLLIATVGLFIGQFV,0
4pgw,A,42,58,16,LPLSILEVAMIILAFW,0
4pgw,A,59,63,4,RRRK,0
4pgw,A,64,65,1,V,0
4pgw,A,66,85,19,YAFVYTFAFVSGITLFPIV,0
4pgw,A,97,115,18,LEAFGSTFVIFAVLGTIG,0
4pgw,A,116,125,9,KMKKDLSFL,0
4pgw,A,126,145,19,SFLLVAVLALAVVGIFNIF,0
4pgw,A,153,172,19,MAYSVIGTIVFSLYILYDL,0
4pgw,A,173,186,13,QIKHRHITEDLIP,0
4pgw,A,187,207,20,MALSLYLDFINLFINLLRFF,0
4pgw,A,211,214,3,SDD,0
4pdl,E,18,20,2,AK,0
4pdl,E,25,45,20,VLFVLTILTLISGTIFYSTV,0
4pdl,E,46,50,4,GLRP,0
4pdl,E,51,67,16,DALYFSVVTLTTVGYG,0
4pdl,E,68,74,6,FSPQTD,0
4pdl,E,75,99,24,GKIFTILYIFIGIGLVFGFIHKLA,0
4pdl,E,103,109,6,LPSILS,0
1suk,A,1,15,14,EPSSKKLTGRLMLA,0
1suk,A,16,39,23,GGAVLGSLQFGYNTGVINAPQKV,0
1suk,A,64,87,23,WSLSVAIFSVGGMIGSFSVGLFV,0
1suk,A,88,90,2,RF,0
1suk,A,91,113,22,RRNSMLMMNLLAFVSAVLMGFS,0
1suk,A,121,141,20,LILGRFIIGVYCGLTTGFVP,0
1suk,A,142,156,14,YVGEVSPTAFRGAL,0
1suk,A,157,179,22,TLHQLGIVVGILIAQVFGLDSI,0
1suk,A,188,208,20,LLSIIFIPALLQCIVLPFCP,0
1suk,A,209,253,44,SPRFLLINRNEENRAKSVLKKLRGTADVTHDLQEMKEESRQMMR,0
1suk,A,254,260,6,KKVTIL,0
1suk,A,261,265,4,LFRS,0
1suk,A,266,292,26,AYRQPILIAVVLQLSQQLSGINAVFY,0
1suk,A,305,328,23,PVYATIGSGIVNTAFTVVSLFVV,0
1suk,A,329,336,7,RAGRRTL,0
1suk,A,337,357,20,LIGLAGMAGCAILMTIALAL,0
1suk,A,361,385,24,PWMSYLSIVAIFGFVAFFEVGPGP,0
1suk,A,386,400,14,PWFIVAELFSQGPR,0
1suk,A,401,423,22,AAIAVAGFSNWTSNFIVGMCFQ,0
1suk,A,432,453,21,VFIIFTVLLVLFFIFTYFKVP,0
1suk,A,454,492,38,TKGRTFDEIASGFRQGGASQSDKTPEELFHPLGADSQV,0
5dhh,A,45,49,4,LPLG,0
5dhh,A,50,75,25,KVTIVGLYLAVCVGGLLGNCLVMYV,0
5dhh,A,89,112,23,IFNLALADTLVLLTLPFQGTDIL,0
5dhh,A,113,118,5,GFWPF,0
5dhh,A,119,145,26,NALCKTVIAIDYYNMFTSTFTLTAMS,0
5dhh,A,169,191,22,VNVAIWALASVVGVPVAIMGSA,0
5dhh,A,192,208,16,VEDEEIECLVEIPTPQ,0
5dhh,A,209,233,24,YWGPVFAICIFLFSFIVPVLVISV,0
5dhh,A,266,292,26,VVVAVFVGCWTPVQVFVLAQGLGVQP,0
5dhh,A,293,296,3,SET,0
5dhh,A,297,321,24,VAILRFCTALGYVNSCLNPILYAF,0
5dhh,A,324,331,7,NFKACFR,0
1qo1,T,17,30,13,GLAAIGAAIGIGI,0
1qo1,T,31,52,21,GGKFLEGAARQPDLIPLLRTQ,0
1qo1,T,53,67,14,FIVMGLVDAIPMIA,0
3ifx,D,1,22,21,PPMLSGLLARLVKLLLGRHGS,0
3ifx,D,23,25,2,LH,0
3ifx,D,26,50,24,RAAGAATVLLVIVLLAGSYLACLA,0
3ifx,D,63,78,15,RALWWSVETATTVGY,0
3ifx,D,87,111,24,GRLVAVVVMVAGITSFGLVTAALA,0
3ifx,D,112,119,7,WFVGREQ,0
3ifx,D,120,129,9,RRGHHHHHH,0
1vjm,C,1,4,3,AQI,0
1vjm,C,5,10,5,GRPEW,0
1vjm,C,11,34,23,WLALGTALMGLGTLYFLVKGMGV,0
1vjm,C,41,62,21,FYAITTLVPAIAFTMYLSMLL,0
1vjm,C,63,79,16,YGLTMVPFGGEQNPIY,0
1vjm,C,80,100,20,ARYADWLFTTPLLLLDLALL,0
1vjm,C,106,127,21,TILALVGADGIMIGTGLVGAL,0
1vjm,C,128,133,5,KVYSY,0
1vjm,C,134,157,23,FVWWAISTAAMLYILYVLFFGFT,0
1vjm,C,171,192,21,KVLRNVTVVLWSAYPVVWLIG,0
1vjm,C,193,203,10,EGAGIVPLNI,0
1vjm,C,204,226,22,TLLFMVLDVSAKVGFGLILLRS,0
1vjm,C,233,249,16,EAPEPSAGDGAAATSD,0
3gjc,B,1,2,1,E,0
3gjc,B,3,15,12,KREHWATRLGLI,0
3gjc,B,16,35,19,AMAGNAVGLGNFLRFPVQA,0
3gjc,B,42,63,21,FMIPYIIAFLLVGIPLMWIEW,0
3gjc,B,64,89,25,MGRYGGAQGHGTTPAIFYLLWRNRF,0
3gjc,B,90,124,34,KILGVFGLWIPLVVAIYYVYIESWTLGFAIKFLV,0
3gjc,B,167,184,17,AYIVFLITMFINVSILI,0
3gjc,B,185,190,5,GISKG,0
3gjc,B,191,214,23,ERFAKIAMPTLFILAVFLVIRVF,0
3gjc,B,223,231,8,ADGLNFLW,0
3gjc,B,242,265,23,VWIAAVGQIFFTLSLGFGAIITY,0
3gjc,B,266,278,12,SYVRKDQDIVLS,0
3gjc,B,279,297,18,LTAATLNEKASVILGGSI,0
3gjc,B,319,324,5,FNLGF,0
3gjc,B,326,331,5,LPAIF,0
3gjc,B,340,364,24,GFLWFFLLFFAGLTSSIAIMQPMI,0
3gjc,B,365,377,12,FLEDELKLSRKH,0
3gjc,B,378,396,18,VLWTAAIVFFSAHLVMFL,0
3gjc,B,400,422,22,DEMDFWAGTIGVVFFGLTELII,0
3gjc,B,423,428,5,FWIFG,0
3gjc,B,429,437,8,DKAWEEIN,0
3gjc,B,438,447,9,GGIIKVPRI,0
3gjc,B,448,470,22,YYVMRYITPAFLAVLLVVWARE,0
3gjc,B,471,476,5,IPKIM,0
3gjc,B,484,501,17,ITRFYIIGLFLFLTFLV,0
3gjc,B,502,515,13,LAERL,0
3gjc,B,516,521,5,NHESA,0
3gi9,C,1,14,13,ELKNKKLSLWEAV,0
3gi9,C,15,33,18,MAVGVMIGASIFSIFGVG,0
3gi9,C,41,56,15,PETFILSGIYALLVA,0
3gi9,C,57,71,14,SYTKLGAKIVSNAG,0
3gi9,C,72,80,8,IAFIHKAI,0
3gi9,C,81,83,2,DN,0
3gi9,C,84,91,7,ITGALSI,0
3gi9,C,92,113,21,LWMSYVISIALFAKGFAGYFL,0
3gi9,C,126,140,14,ITEIGIVAFFTALN,0
3gi9,C,141,143,2,FG,0
3gi9,C,144,150,6,KAVGRA,0
3gi9,C,151,170,19,FFIVLVKLLILGLFIFAGL,0
3gi9,C,191,206,15,FASAIFFLSYMGFGV,0
3gi9,C,207,226,19,TNASEHIENPKKNVPRAIF,0
3gi9,C,227,242,15,SILIVMFVYVGVAIS,0
3gi9,C,249,254,5,DELIK,0
3gi9,C,259,268,9,LAVAAKPFL,0
3gi9,C,272,293,21,FLLISIGALFSISSAMNATIY,0
3gi9,C,294,295,1,G,0
3gi9,C,296,305,9,NVAYSLAKD,0
3gi9,C,306,323,17,ELPEFFERKVWFKSTEG,0
3gi9,C,324,340,16,YITSALGVLFALLFNM,0
3gi9,C,342,357,15,VASITSAVFMVIYLF,0
3gi9,C,358,374,16,ILSHYILIDEVGGRKE,0
3gi9,C,375,395,20,VIFSFIVVLGVFLLLLYYQW,0
3gi9,C,400,415,15,VFYGIIATFIGVLIF,0
3gi9,C,416,438,22,IIYRKVTKRTFSNNMYVKSLES,0
3gi9,C,439,444,5,GLVPR,0
3nam,A,49,54,5,WELVI,0
3nam,A,55,73,18,QFEDLLVRILLLAACISF,0
3nam,A,74,88,14,LAWFEEGEETITAF,0
3nam,A,89,110,21,EPFVILLILIANAIVGVWQER,0
3nam,A,253,275,22,DEFGEQLSKVISLICVAVWLIN,0
3nam,A,276,295,19,GHFNDPVHGGSWIRGAIYY,0
3nam,A,296,318,22,KIAVALAVAAIPEGLPAVITTC,0
3nam,A,760,781,21,IRYLISSNVGEVVCIFLTAAL,0
3nam,A,782,785,3,LPE,0
3nam,A,786,808,22,LIPVQLLWVNLVTDGLPATALG,0
3nam,A,830,852,22,GWLFFRYMAIGGYVGAATVGAA,0
3nam,A,853,897,44,WWFMYAEDGPGVTYHQLTHFMQCTEDHPHFEGLDCEIFEAPEPM,0
3nam,A,898,916,18,MALSVLVTIEMCNALNSL,0
3nam,A,931,950,19,WLLGSICLSMSLHFLILYV,0
3nam,A,951,964,13,PLPMIFKLKALDL,0
3nam,A,965,987,22,QWLMVLKISLPVIGLDEILKFI,0
2atk,F,1,21,20,APMLSGLLARLVKLLLGRHG,0
2atk,F,22,25,3,ALH,0
2atk,F,26,50,24,RAAGAATVLLVIVLLAGSYLAVLA,0
2atk,F,63,78,15,RALWWSVATATTVGY,0
2atk,F,86,111,25,WGRCVAVVVMVAGITSFGLVTAALA,0
2atk,F,112,124,12,WFVGREQERRGH,0
4iff,B,-1,0,1,S,0
4iff,B,1,31,30,PLKPEEHEDILNKLLDPELAQSERTEALQQ,0
4iff,B,32,134,102,RVNYGSFVSEYNDLTKDYTRVND,0
4iff,B,161,163,2,GG,0
2zbf,A,49,56,7,ELVIEQF,0
2zbf,A,58,73,15,LLVRILLLAACISFV,0
2zbf,A,74,89,15,AWFEEGEETITAFVE,0
2zbf,A,90,110,20,FVILLILIANAIVGVWQERN,0
2zbf,A,253,274,21,EFGEQLSKVISLICVAVWLIN,0
2zbf,A,275,295,20,GHFNDPVHGGSWIRGAIYYF,0
2zbf,A,296,318,22,IAVALAVAAIPEGLPAVITTCL,0
2zbf,A,760,781,21,RYLISSNVGEVVCIFLTAALG,0
2zbf,A,782,785,3,PEA,0
2zbf,A,786,808,22,IPVQLLWVNLVTDGLPATALGF,0
2zbf,A,833,852,19,FRYMAIGGYVGAATVGAAA,0
2zbf,A,853,897,44,WFMYAEDGPGVTYHQLTHFMQCTEDHPHFEGLDCEIFEAPEPMT,0
2zbf,A,898,916,18,ALSVLVTIEMCNALNSLS,0
2zbf,A,931,950,19,LLGSICLSMSLHFLILYVD,0
2zbf,A,951,956,5,LPMIF,0
2zbf,A,957,964,7,LKALDLT,0
2zbf,A,965,987,22,WLMVLKISLPVIGLDEILKFIA,0
2xzb,B,1,31,30,AALQEKKSCSQRMEEFQRYCWNPDTGQMLG,0
2xzb,B,38,59,21,WISLYYVAFYVVMSGIFALCI,0
2xzb,B,60,88,28,VLMRTIDPYTPDYQDQLKSPGVTLRPDV,0
2xzb,B,89,124,35,GEKGLDISYNVSDSTTWAGLAHTLHRFLAGYSPAA,0
2xzb,B,125,154,29,EGSINCTSEKYFFQESFLAPNHTKFSCKF,0
2xzb,B,155,174,19,ADMLQNCSGRPDPTFGFAE,0
2xzb,B,175,194,19,KPCFIIKMNRIVKFLPGNS,0
2xzb,B,195,208,13,APRVDCAFLDQPR,0
2xzb,B,209,213,4,GPPL,0
2xzb,B,214,223,9,VEYFPANGT,0
2xzb,B,224,243,19,SLHYFPYYGKKAQPHYSNP,0
2xzb,B,244,247,3,VAA,0
2xzb,B,248,290,42,LLNVPRNRDVVIVCKILAEHVSFDNPHDPYEGKVEFKLKIQK,0
4uvm,A,8,13,5,KWPRQ,0
4uvm,A,14,33,19,PYIIASEACERFSFYGMRN,0
4uvm,A,61,78,17,SFVIGVYFFPLLGGWIA,0
4uvm,A,79,84,5,RFFGK,0
4uvm,A,85,99,14,NTILWLSLIYCVGH,0
4uvm,A,116,131,15,FLIALGSGGIKPLVS,0
4uvm,A,132,149,17,FMGDQFDQSNKSLAQKA,0
4uvm,A,150,165,15,DMFYFTINFGSFFAS,0
4uvm,A,185,199,14,VLMFVATVFFWLGR,0
4uvm,A,200,214,14,RYIHMPPEPKDPHG,0
4uvm,A,215,224,9,LPVIRSALL,0
4uvm,A,225,236,11,KVEGKGNIGLV,0
4uvm,A,237,252,15,ALIGGVSAAYALVNI,0
4uvm,A,256,274,18,IVAGLCCAMVLVMGFVGA,0
4uvm,A,275,302,27,ASLQLERARKSHPDAAVDGVRSVLRIL,0
4uvm,A,303,319,16,LFALVTPFWSLFDQKA,0
4uvm,A,342,360,18,LNPLLVMLLIPFNNFVLY,0
4uvm,A,361,374,13,AIERMGVKLTALR,0
4uvm,A,375,389,14,MGAGIAITGLSWIV,0
4uvm,A,410,427,17,PYALLTFGEVLVSATGL,0
4uvm,A,428,443,15,FAYSQAPKAMKGTIM,0
4uvm,A,444,460,16,FWTLSVTVGNLWVLLA,0
4uvm,A,467,476,9,TVTEQIVQT,0
4uvm,A,487,502,15,FAGFAILAAIVFALY,0
4uvm,A,503,512,9,RSYQMQDHY,0
5aw8,G,4,23,19,GPDNDERFTYDYYRLRVVG,0
5aw8,G,24,40,16,IVAAVLCVIGIIILLA,0
4mrp,B,1,8,7,PPETATN,0
4mrp,B,16,27,11,WQTLKRFLPYL,0
4mrp,B,34,58,24,LRRRVVGAILMVLLGKATTLALPF,0
4mrp,B,59,85,26,YKKAVDAMTLGGGAQPALTVALAFVL,0
4mrp,B,86,106,20,YALGRFSGVLFDNLRNIVFE,0
4mrp,B,156,177,21,FLLFNIAPTVIELTAVIVIFW,0
4mrp,B,178,182,4,NFGL,0
4mrp,B,183,206,23,LVTATILAVIAYVWTTRTITEWR,0
4mrp,B,263,284,21,SLGLLNIAQALIVNLLMAGAM,0
4mrp,B,285,302,17,WTVYGWSQGKLTVGDLV,0
4mrp,B,303,323,20,VNTYLTQLFRPLDMLGMVYR,0
4mrp,B,607,614,7,EHHHHHH,0
5u09,A,100,117,17,NFMDIECFMVLNPSQQL,0
5u09,A,118,142,24,IAVLSLTLGTFTVLENLLVLCVIL,0
5u09,A,154,180,26,FIGSLAVADLLGSVIFVYSFIDFHVF,0
5u09,A,181,187,6,RKDSRN,0
5u09,A,188,215,27,FLFKLGGVTASFTASVGSLFLAAIDRY,0
5u09,A,233,256,23,VVAFCLMWTIAIVIAVLPLLGWN,0
5u09,A,257,271,14,EKLQSVCSDIFPHI,0
5u09,A,272,300,28,ETYLMFWIGVTSVLLLFIVYAYMYILWK,0
5u09,A,342,365,23,KTLVLILVVLIICWGPLLAIMVY,0
5u09,A,366,378,12,VFGKMNKLIKTV,0
5u09,A,379,401,22,AFCSMLCLLNSTVNPIIYALRS,0
5u09,A,402,409,7,DLRHAFR,0
3ag4,Z,16,35,19,IGLSVTFLSFLLPAGWVLY,0
3ag4,Z,36,43,7,LDNYKKS,0
3ag4,Z,44,46,2,AA,0
5iux,E,5,198,193,SPPPPIADEPLTVNTGIYLIESYSLDDKAETFKVNAFLSLSWKDRRLAFDPVRSGVRVKTYEPEAIWIPEIRFVNVENARDADVVDISVSPDGTVQYLERFSARVLSPLDFRRYPFDSQTLHIYLIVRSCDTRNIVLAVDLEKVGKNDDVFLTGWDIESFTAVVKPANFALEDRLESKLDYQLRISRQYFSYI,0
5iux,E,199,218,19,NIILPMLFILFISWTAFWS,0
5iux,E,222,240,18,ANVTLVVSTLIAHIAFNI,0
5iux,E,241,255,14,VETNLPKTPYMTYT,0
5iux,E,256,275,19,AIIFMIYLFYFVAVIEVTV,0
5iux,E,292,313,21,RASRIAFPVVFLLANIILAFL,0
5iux,E,314,315,1,F,0
4q65,A,1,5,4,NKHA,0
4q65,A,15,32,17,ALQIWEYFSFYGMRALL,0
4q65,A,33,51,18,LYLTNQLKYNDTHAYELF,0
4q65,A,52,68,16,AYCSLVYVTPILGGFL,0
4q65,A,78,94,16,VMLGALLMAIGHVVLG,0
4q65,A,95,104,9,SEIHPSFLY,0
4q65,A,105,121,16,SLAIIVCGYGLFKSNV,0
4q65,A,144,161,17,AAGNVGSIIAPIACGYA,0
4q65,A,162,169,7,EEYSWAM,0
4q65,A,170,187,17,FGLAAVGMIAGLVIFLC,0
4q65,A,199,203,4,KKVL,0
4q65,A,209,230,21,LPNWGWLLVLLVATPALITIL,0
4q65,A,231,235,4,WKEW,0
4q65,A,236,252,16,VYALIVATIIGLGVLA,0
4q65,A,256,258,2,KA,0
4q65,A,269,289,20,IVTLTFFSMLFWAFAQQGGS,0
4q65,A,290,300,10,ISLYIDRFVN,0
4q65,A,301,306,5,DMFGY,0
4q65,A,307,311,4,VPTA,0
4q65,A,312,328,16,FQSINAFAVMLCGVFL,0
4q65,A,333,338,5,ESVAG,0
4q65,A,345,362,17,GKFALGLGLMSAGFCIL,0
4q65,A,363,373,10,LSARWSAMYG,0
4q65,A,374,376,2,SS,0
4q65,A,377,381,4,PLMV,0
4q65,A,382,399,17,GLAVMGFAELFIDPVAM,0
4q65,A,407,409,2,PG,0
4q65,A,416,431,15,IYMLLSGAIANYLAG,0
4q65,A,432,438,6,IADQTS,0
4q65,A,439,450,11,ASFDASGAINY,0
4q65,A,451,462,11,INAYIEVFDQI,0
4q65,A,463,479,16,WGALACVGVVLMIWLY,0
4q65,A,482,493,11,KFRNRALALES,0
4jta,H,-18,31,49,AHHHHHHHHHHGLVPRGSMTVATGDPVDEAAALPGHPQDTYDPEADHES,0
4jta,H,32,163,131,ERVVINISGLRFETQLKTLAQFPETLLGDPKKRMRYFDPLRNEYFFDRNRPSFDAILYYYQSGGRLRRPVNVPLDIFSEEIRFYELGEEAMEMFREDEGYIKEEERPLPENEFQRQVWLLFEYPESSGPAR,0
4jta,H,164,182,18,IAIVSVMVILISIVSFCL,0
4jta,H,223,242,19,IVETLCIIWFSFEFLVRFF,0
4jta,H,243,253,10,CPSKAGFFTN,0
4jta,H,254,272,18,MNIIDIVAIIPYYVTIFL,0
4jta,H,289,307,18,QIFRIMRILRIFKLSRHS,0
4jta,H,308,319,11,GLQILGQTLKA,0
4jta,H,321,345,24,RELGLLIFFLFIGVILFSSAVYFA,0
4jta,H,358,374,16,DAFWWAVVSMTTVGYG,0
4jta,H,382,403,21,GKIVGSLCAIAGVLTIALPVP,0
4jta,H,404,414,10,IVSNFNYFYH,0
4jta,H,415,417,2,ET,0
4jta,H,418,495,77,GEEQAQYLQVTSSPKIPSSPDLKKSRSASTISKSDYMEIQEGVNNSNEDFREENLKTANSTLANTNYVNITKMLTDV,0
5iwp,D,327,349,22,FCVLGAIYVLYIICFTMCCVYR,0
5iwp,D,350,382,32,LKPRITNRTNPRDNTLLQQKLLQEAYVTPKDD,0
5iwp,D,383,408,25,RLVGELVSIVGAVIILLVEIPDIFR,0
5iwp,D,422,443,21,PFHVIIVTYAFMVLVTMVMRL,0
5iwp,D,444,448,4,NSDG,0
5iwp,D,449,470,21,VVPMSFALVLGWCNVMYFARG,0
5iwp,D,487,511,24,DLMRFCWQMAVVILGFASAFYIIF,0
5iwp,D,512,524,12,TEDPDELGHFYD,0
5iwp,D,525,544,19,PMALFSTFELFLTIIDGPA,0
5iwp,D,545,551,6,YDVDLP,0
5iwp,D,552,576,24,MYSITYAAFAIIATLLMLNLLIAM,0
5iwp,D,584,606,22,AHERDELWRAQVVATTVMLERK,0
3mpq,B,13,32,19,LILAMAGNAVGLGNFLRFP,0
3mpq,B,33,43,10,QAAENGGGAF,0
3mpq,B,44,63,19,IPYIIAFLLVGIPLMWIEW,0
3mpq,B,90,124,34,KILGVFGLWIPLVVAIYYVYIESWTLGFAIKFLV,0
3mpq,B,125,130,5,LVPEP,0
3mpq,B,131,135,4,PNAT,0
3mpq,B,136,166,30,PDSILRPFKEFLYSYIGVPKGDEPILKPSL,0
3mpq,B,167,184,17,AYIVFLITMFINVSILI,0
3mpq,B,191,212,21,ERFAKIAMPTLFCLAVFLVIR,0
3mpq,B,213,223,10,FLLETPNGTA,0
3mpq,B,224,230,6,DGLNFL,0
3mpq,B,231,241,10,TPDFEKLKDP,0
3mpq,B,242,265,23,VWIAAVGQIFFTLSLGFGAIITY,0
3mpq,B,278,297,19,GLTAATLNEKAEVILGGSI,0
3mpq,B,298,307,9,IPAAVAFFG,0
3mpq,B,308,317,9,ANAVAIAKA,0
3mpq,B,318,325,7,AFNLGFI,0
3mpq,B,326,331,5,LPAIF,0
3mpq,B,332,339,7,QTAGGTF,0
3mpq,B,340,366,26,GFLWFFLLFFAGLTSSIAIMQPMIAF,0
3mpq,B,378,396,18,VLWTAAIVFFSAHLVMFL,0
3mpq,B,397,399,2,KS,0
3mpq,B,400,425,25,DEMDFWAGTIGVVFFGLTELIIFFW,0
3mpq,B,429,437,8,DKAWEEIN,0
3mpq,B,445,466,21,RIYYYVMRYITPAFLAVLLVV,0
3mpq,B,467,478,11,AREYIPKIMEE,0
3mpq,B,479,483,4,HWTV,0
3mpq,B,484,502,18,ITRFYIIGLFLFLTFLVF,0
3qnq,B,1,2,1,I,0
3qnq,B,10,18,8,PVAGKVAE,0
3qnq,B,25,45,20,RDGLVLTMPFLIIGSIFLII,0
3qnq,B,46,71,25,TLPIPGYSEFMASLFGKNWNVALGY,0
3qnq,B,72,90,18,VSATFNIMALIAVFGIAY,0
3qnq,B,102,115,13,SGALSLVTFLLAT,0
3qnq,B,116,141,25,FQVAYIMPGTKESILVDGVIPAALM,0
3qnq,B,142,160,18,SQGLFVAMIIAIISTEIY,0
3qnq,B,178,186,8,AVTRSFAA,0
3qnq,B,187,201,14,IPGFIVVTVVWIIR,0
3qnq,B,202,211,9,IFEHTTFGS,0
3qnq,B,212,219,7,HNVVGKL,0
3qnq,B,220,223,3,QEP,0
3qnq,B,224,241,17,SILGASLWGAVIAVILV,0
3qnq,B,253,268,15,IVGGVMSPIWLSLMD,0
3qnq,B,269,283,14,NRIAFQAGQDVPNT,0
3qnq,B,284,297,13,TAQFFDLWIYMGG,0
3qnq,B,354,367,13,VPVVLTIVSYFAM,0
3qnq,B,368,374,6,WGLVAR,0
3qnq,B,375,397,22,SGAAVTWTTPILFSGYLGSGGK,0
3qnq,B,399,414,15,GVILQLVNFALAFVI,0
3qnq,B,435,442,7,AENLYFQ,0
2k58,B,1,4,3,RKP,0
2k58,B,5,31,26,FYTINLIIPCVLITSLAILVFYLPSD,0
4q9l,A,35,68,33,LTMFRYAGWLDRLYMLVGTLAAIIHGVALPLMM,0
4q9l,A,69,114,45,IFGDMTDSFASVGQVSKQSTQMSEADKRAMFAKLEEEMTTYAYYY,0
4q9l,A,115,139,24,GIGAGVLIVAYIQVSFWCLAAGRQ,0
4q9l,A,180,204,24,GIGDKIGMFFQAMATFFGGFIIGF,0
4q9l,A,205,208,3,RGW,0
4q9l,A,209,231,22,LTLVILAISPVLGLSAGIWAKI,0
4q9l,A,290,312,22,ANISMGAAFLLIYASYALAFWY,0
4q9l,A,313,328,15,TSLVISKEYSIGQVL,0
4q9l,A,329,352,23,VFFSVLIGAFSVGQASPNIEAFA,0
4q9l,A,695,700,5,ILKLN,0
4q9l,A,706,729,23,FVVGIFCAIINGGLQPAFSVIFS,0
4q9l,A,730,751,21,VVGVFTNGGPPETQRQNSNLF,0
4q9l,A,752,773,21,LLFLILGIISFITFFLQGFTF,0
4q9l,A,828,849,21,LAVIFQNIANLGTGIIISLIY,0
4q9l,A,850,852,2,WQ,0
4q9l,A,853,878,25,TLLLLAIVPIIAIAGVVEMKMLSGQ,0
4q9l,A,925,952,27,NAMKKAHVFGITFSFTQAMMYFSYAAC,0
4q9l,A,953,971,18,RFGAYLVTQQLMTFENVL,0
4q9l,A,972,991,19,VFSAIVFGAMAVGQVSSFA,0
5uig,A,13,34,21,LAIAVLAILGNVLVCWAVWLN,0
5uig,A,35,40,5,NLQNV,0
5uig,A,41,60,19,NYFVVSLAAADIAVGVLAI,0
5uig,A,83,102,19,VLVLTQSSIFSLLAIAIDR,0
5uig,A,103,118,15,IAIRIPLRYNGLVTG,0
5uig,A,119,139,20,RAKGIIAICWVLSFAIGLTP,0
5uig,A,176,199,23,MVYFNFFACVLVPLLLMLGVYLR,0
5uig,A,200,1048,848,FLAARRQLADLEDNWETLNDNLKVIEKADNAAQVKDALTKMRAAALDAQKATPPKL,0
5uig,A,1056,231,-825,EMKDFRHGFDILVGQIDDALKLANEGKVKEAQAAAEQLKTTRNAYIQKYLERARSTLQKEVHA,0
5uig,A,232,255,23,KSLAIIVGLFALCWLPLHIINCF,0
5uig,A,273,293,20,IVLSHTNSVVNPFIYAYRIR,0
5uig,A,294,297,3,FRQ,0
5uig,A,298,307,9,FRKIIRSHV,0
5uig,A,308,311,3,RQQ,0
1eq8,A,1,5,4,KMST,0
1eq8,A,6,20,14,ISVLLAQAVFLLLT,0
5kbs,D,514,520,6,FSFLDP,0
5kbs,D,521,543,22,AYEIWMCIVFAYIGVSVVLFLV,0
5kbs,D,545,567,22,FSPYEWHTEEFEDGRETQSSES,0
5kbs,D,568,572,4,NEFG,0
5kbs,D,573,586,13,FNSLWFSLGAFMQ,0
5kbs,D,587,592,5,GCDIS,0
5kbs,D,594,618,24,SLSGRIVGGVWWFFTLIIISSYTA,0
5kbs,D,790,813,23,NVAGVFYILVGGLGLAMLVALIE,0
5kbs,D,814,817,3,CYK,0
5kbs,D,818,1043,225,RAEAKRMKGTGLFDRGVQMLLTTVGAFAAFSLMTIAVGTDYWLYSRGVCKTKSVSEDETSKKNEEVMTHSGLWRTCCLEGNFKGLCKQIDHFPEDADYEADTAEYFLRAVRASSIFPILSVILLFMGGLCIAASEFYKTRHNIILSAGIFFVSAGLSNIIGIIVYISANAGDPSKSDSKKNSYSYGWSFYFGALSFIIAEMVGVLAVHMFIDRHKQLTGGLVPRG,0
4htt,A,-1,4,5,GMPLT,0
4htt,A,8,29,21,ELRYRLIISIIAFLIGSGIAF,0
4htt,A,30,31,1,F,0
4htt,A,32,44,12,KYVFEILKEPIL,0
4htt,A,45,66,21,SYPEVELITLSPTEPLFILIK,0
4htt,A,67,88,21,SLAVGFIIASPVILYQFWRFI,0
4htt,A,101,123,22,PLLLGSILLFMLGALFAYFIVL,0
4htt,A,124,154,30,LALKFLLGLGFTQLLATPYLSVDMYISFVL,0
4htt,A,155,174,19,LVVAFGIAFEMPIVLYVLQ,0
4htt,A,182,203,21,QLASFRKYFIVIAFVIGAIIA,0
4htt,A,204,208,4,DVST,0
4htt,A,209,227,18,VLMAIPLLLLYEISIFLG,0
4htt,A,230,416,186,TRKKKEIGSGASMNIFEMLRIDEGLRLKIYKDTEGYYTIGIGHLLTKSPSLNAAKSELDKAIGRNTNGVITKDEAEKLFNQDVDAAVRGILRNAKLKPVYDSLDAVRRAALINMVFQMGETGVAGFTNSLRMLQQKRWDEAAVNLAKSRWYNQTPNRAKRVITTFRTGTWDAYKNLELYKHHHHHH,0
2ls4,A,1,4,3,NGY,0
2ls4,A,5,19,14,CIAVAAGAGTGYFL,0
4ziw,C,12,28,16,WVIAIIIMLAGGLAIL,0
4ziw,C,29,340,311,LPVAQYPTIAPPAVTISASYPGADAKTVQDTVTQVIEQNMNGIDNLMYMSSNSDSTGTVQITLTFESGTDADIAQVQVQNKLQLAMPLLPQEVQQQGVSVEKSSSSFLMVVGVINTDGTMTQEDISDYVAANMKDAISRTSGVGDVQLFGSQYAMRIWMNPNELNKFQLTPVDVITAIKAQNAQVAAGQLGGTPPVKGQQLNASIIAQTRLTSTEEFGKILLKVNQDGSRVLLRDVAKIELGGENYDIIAEFNGQPASGLGIKLATGANALDTAAAIRAELAKMEPFFPSGLKIVYPYDTTPFVKISIHEV,0
4ziw,C,341,357,16,KTLVEAIILVFLVMYL,0
4ziw,C,366,386,20,IPTIAVPVVLLGTFAVLAAF,0
4ziw,C,387,394,7,FSINTLT,0
4ziw,C,395,410,15,FGMVLAIGLLVDDAI,0
4ziw,C,443,458,15,GIAMVLSAVFVPMAF,0
4ziw,C,459,469,10,GGSTGAIYRQ,0
4ziw,C,470,488,18,SITIVSAMALSVLVALIL,0
4ziw,C,515,534,19,FNRMFEKSTHHYTDSVGGI,0
4ziw,C,541,556,15,LVLYLIIVVGMAYLF,0
4ziw,C,557,869,312,RLPSSFLPDEDQGVFMTMVQLPAGATQERTQKVLNEVTHYYLTKEKNNVESVFAVNGGGQNTGIAFVSLKDWADRPGEENKVEAITMRATRAFSQIKDAMVFAFNLPAIVELGTATGFDFELIDQAGLGHEKLTQARNQLLAEAAKHPDMLTSVRPNGLEDTPQFKIDIDQEKAQALGVSINDINTTLGAAWGGSYVNDFIDRGRVKKVYVMSEAKYRMLPDDIGDWYVRAADGQMVPFSAFSSSRWEYGSPRLERYNGLPSMEILGQAAPGKSTGEAMELMEQLASKLPTGVGYDWTGMSYQERLSGNQAP,0
4ziw,C,870,886,16,LYAISLIVVFLCLAAL,0
4ziw,C,891,914,23,IPFSVMLVVPLGVIGALLAATFR,0
4ziw,C,915,922,7,LTNDVYF,0
4ziw,C,923,938,15,VGLLTTIGLSAKNAI,0
4ziw,C,971,987,16,MTSLAFILGVMPLVIS,0
4ziw,C,988,998,10,GAGSGAQNAV,0
4ziw,C,999,1014,15,TGVMGGMVTATVLAI,0
4ziw,C,1015,1024,9,FVPVFFVVV,0
4zjl,C,13,26,13,VIAIIIMLAGGLA,0
4zjl,C,27,342,315,LKLPVAQYPTIAPPAVTISASYPGADAKTVQDTVTQVIEQNMNGIDNLMYMSSNSDSTGTVQITLTFESGTDADIAQVQVQNKLQLAMPLLPQEVQQQGVSVEKSSSSFLMVVGVINTDGTMTQEDISDYVAANMKDAISRTSGVGDVQLFGSQYAMRIWMNPNELNKFQLTPVDVITAIKAQNAQVAAGQLGGTPPVKGQQLNASIIAQTRLTSTEEFGKILLKVNQDGSRVLLRDVAKIELGGENYDIIAEFNGQPASGLGIKLATGANALDTAAAIRAELAKMEPFFPSGLKIVYPYDTTPFVKISIHEVVK,0
4zjl,C,343,356,13,LVEAIILVFLVMY,0
4zjl,C,367,383,16,PTIAVPVVLLGTFAVL,0
4zjl,C,384,396,12,AFGFSINTLTMF,0
4zjl,C,397,409,12,MVLAIGLLVDDA,0
4zjl,C,443,456,13,GIAMVLSAVFVPM,0
4zjl,C,457,470,13,FFGGSTGAIYRQF,0
4zjl,C,471,485,14,ITIVSAMALSVLVA,0
4zjl,C,517,536,19,RMFEKSTHHYTDSVGGILR,0
4zjl,C,543,556,13,LYLIIVVGMAYLF,0
4zjl,C,557,876,319,RLPSSFLPDEDQGVFMTMVQLPAGATQERTQKVLNEVTHYYLTKEKNNVESVFAVNGFGFAGRGQNTGIAFVSLKDWADRPGEENKVEAITMRATRAFSQIKDAMVFAFNLPAIVELGTATGFDFELIDQAGLGHEKLTQARNQLLAEAAKHPDMLTSVRPNGLEDTPQFKIDIDQEKAQALGVSINDINTTLGAAWGGSYVNDFIDRGRVKKVYVMSEAKYRMLPDDIGDWYVRAADGQMVPFSAFSSSRWEYGSPRLERYNGLPSMEILGQAAPGKSTGEAMELMEQLASKLPTGVGYDWTGMSYQERLSGNQAPSL,0
4zjl,C,877,891,14,AISLIVVFLCLAAL,0
4zjl,C,899,916,17,SVMLVVPLGVIGALLAA,0
4zjl,C,917,929,12,FRGLTNDVYFQV,0
4zjl,C,930,943,13,LLTTIGLSAKNAI,0
4zjl,C,976,991,15,MTSLAFILGVMPLVI,0
4zjl,C,992,1004,12,TGAGSGAQNAVG,0
4zjl,C,1005,1018,13,GVMGGMVTATVLA,0
4zjl,C,1019,1030,11,FFVPVFFVVVR,0
3c1g,C,15,31,16,CTALVLFMTIPGIALF,0
3c1g,C,32,45,13,GGLIRGKNVLSML,0
3c1g,C,46,64,18,QVTVTFALVCILWVVYGY,0
3c1g,C,102,118,16,FQGSFACITVGLIVGA,0
3c1g,C,119,126,7,AERIRFS,0
3c1g,C,127,147,20,VLIFVVVWLTLSYIPIAHMV,0
3c1g,C,161,178,17,AGGTVVHINAAIAGLVG,0
3c1g,C,179,181,2,YL,0
3c1g,C,182,193,11,GKRVGFGKEAF,0
3c1g,C,194,201,7,PHNLPMV,0
3c1g,C,202,219,17,TGTAILYIGWFGFNAGS,0
3c1g,C,231,248,17,VNTVVATAAAILGWIFG,0
3c1g,C,249,260,11,WALRGKPSLLG,0
3c1g,C,261,276,15,CSGAIAGLVGVTPAC,0
3c1g,C,282,299,17,GALIIGVVAGLAGLWGV,0
3c1g,C,300,301,1,M,0
3c1g,C,302,310,8,KRLLRVDD,0
3c1g,C,311,313,2,CD,0
3c1g,C,314,332,18,FGVHGVCGIVGCIMTGIF,0
3c1g,C,353,377,24,VQLESIAITIVWSGVVAFIGYKLA,0
3c1g,C,378,386,8,LTVGLRVP,0
3c1g,C,387,424,37,EQEREGLDVNSHGENAYNADQAQQPAQADLEHHHHHH,0
4xp6,A,35,50,15,FLLSVIGFAVDLANV,0
4xp6,A,51,66,15,RFPYLCYKNGGGAFL,0
4xp6,A,67,85,18,PYGIMLAVGGIPLFYMEL,0
4xp6,A,112,133,21,VVLIAFYVDFYYNVIIAWSLR,0
4xp6,A,134,235,101,FFASFTNSLPWTSCNNIWNTPNCRPFEGHVEGFQSAASEYFNRYILELNRSEGIHDLGAI,0
4xp6,A,236,255,19,WDMALCLLIVYLICYFSLW,0
4xp6,A,261,277,16,GKVVWFTALFPYAVLL,0
4xp6,A,278,310,32,LLIRGLTLPGSFLGIQYYLTPNFSAIYKAEVW,0
4xp6,A,311,329,18,DAATQVFFSLGPGFGVLL,0
4xp6,A,343,359,16,DALLTSFINSATSFIA,0
4xp6,A,360,411,51,FVIFSVLGYMAHTLGVRIEDVATEGPGLVFVVYPAAIATMPASTFWALIFF,0
4xp6,A,412,429,17,MLATLGLDSSFGGSEAI,0
4xp6,A,449,464,15,GLFSLYFVVGLASCT,0
4xp6,A,465,470,5,GGFYF,0
4xp6,A,471,492,21,HLLDRYAAGYSILVAVFFEAI,0
4xp6,A,500,511,11,NRFSEDIRDMI,0
4xp6,A,518,540,22,WQVCWRFVAPIFLLFITVYGLI,0
4xp6,A,541,555,14,YEPLTYADYVYPSW,0
4xp6,A,556,572,16,NALGWCIAGSSVVMIP,0
5ezm,A,25,29,4,AATG,0
5ezm,A,30,45,15,VVLFVAVALVVWFVS,0
5ezm,A,88,100,12,HMWVTVVGYELF,0
5ezm,A,110,126,16,VALSGLLGIGVSMMAA,0
5ezm,A,127,135,8,RWFGARAA,0
5ezm,A,136,153,17,FTGLALLAAPMWSVAAH,0
5ezm,A,159,173,14,TLAGVMSCVLAFML,0
5ezm,A,174,187,13,GQHPDASVAARRG,0
5ezm,A,188,203,15,MVACWAAMGVAILTK,0
5ezm,A,205,221,16,VGIALPGLVLVVYTLV,0
5ezm,A,222,231,9,RDWGLWRRL,0
5ezm,A,232,249,17,LALGVVVMLVITVPWFY,0
5ezm,A,258,264,6,PNFFFI,0
5ezm,A,286,307,21,PLVIGGFLPWAGIFPKLWTAM,0
5ezm,A,308,309,1,A,0
5ezm,A,317,321,4,FRPA,0
5ezm,A,322,338,16,MAGIWAIAIFVFFSIS,0
5ezm,A,345,361,16,IVPVIPALGILAGVAL,0
5ezm,A,362,368,6,RLSPRS,0
5ezm,A,369,383,14,GKQLIGMAIVAACG,0
5ezm,A,414,428,14,VVMLLGIAVARLLL,0
5ezm,A,429,432,3,RGV,0
5ezm,A,433,448,15,PSVAVYAMGMYLGFT,0
1rgn,H,1,10,9,VGVTAFGNF,0
1rgn,H,11,12,1,L,0
1rgn,H,13,32,19,SLAIYSFWIFLAGLIYYLQ,0
1rgn,H,251,260,9,VAAMLAEYA,0
5gar,Z,-18,0,18,KKLLVTVLLAVFGALAFA,0
5gar,Z,1,21,20,EEAAASGGLDRGLIAVGMGL,0
5gar,Z,22,35,13,VGLAALGTGVAQA,0
5gar,Z,59,72,13,LLPETLVIFGLLI,0
5gar,Z,73,80,7,FILNGRL,0
5kum,D,62,68,6,PQRYIA,0
5kum,D,70,76,6,FTTCVD,0
5kum,D,78,104,26,WRYMLLLFSLAFLVSWLLFGLIFWLI,0
5kum,D,105,130,25,LIHGDLENPGGDDTFKPCVLQVNGF,0
5kum,D,131,147,16,AAFLFSIETQTTIGYG,0
5kum,D,148,155,7,RCVTEEC,0
5kum,D,156,184,28,LAVFMVVVQSIVGCIIDSFMIGAIMAKM,0
4hw9,G,-23,17,40,GSSHHHHHHSSGLVPRGSHTLINMDEIKTLLVDFFPQAKH,0
4hw9,G,25,49,24,VIVFCIGFYFSFFLRNKTMKLLSK,0
4hw9,G,50,55,5,DEILA,0
4hw9,G,56,79,23,FVAQVTFILILIITTIIALSTLG,0
4hw9,G,81,97,16,TTSIITVLGTVGIAVA,0
4hw9,G,98,100,2,AL,0
4hw9,G,101,115,14,DYLSSIAGGIILII,0
4hw9,G,116,270,154,HPFKKGDIIEISGLEGKVEALNFFNTSLRLHDGRLAVLPNRSVANSNIINSNNTACRRIEWVCGVGYGSDIELVHKTIKDVIDTMEKIDKNMPTFIGITDFGSSSLNFTIRVWAKIEDGIFNVRSELIERIKNALDANHIEIPFNKLDIAIKNQ,0
4hw9,G,271,285,14,SPKLINDYKDDDDK,0
1e12,D,22,23,1,V,0
1e12,D,24,29,5,ENALL,0
1e12,D,30,50,20,SSLWVNVALAGIAILVFVYM,0
1e12,D,64,82,18,ATLMIPLVSISSYLGLLS,0
1e12,D,83,105,22,LTVGMIEMPAGHALAGEMVRSQ,0
1e12,D,106,123,17,GRYLTWALSTPMILLAL,0
1e12,D,135,154,19,TVIAADIGMCVTGLAAAMT,0
1e12,D,155,159,4,SALL,0
1e12,D,160,180,20,RWAFYAISCAFFVVVLSALV,0
1e12,D,200,217,17,VLTVVLWLGYPIVWAVG,0
1e12,D,218,228,10,EGLALVQSVG,0
1e12,D,229,250,21,TSWAYSVLDVFAKYVFAFILL,0
1e12,D,263,274,11,GQTLGTMSSDD,0
5iov,D,1,27,26,RPTEACCYLKISLIILFYSRAYAQKH,0
5iov,D,28,363,335,NMDIAVILVGTTEEVAIKDVHEKDDFHHLPVTPRVELVTMQESDPKSIITRICDLMSDKKVQGVVFGDDTDQEAIAQILDFISVQTLTPILGIHGGSSMIMADKEEASMFFQFGPSIEQQASVMLNIMEEYDWYIFSIVTTYFPGYQDFENKVRSTIENSFVGWELEEVIHLDMSLDDIDSKIQNQLKKLQSPVILLYCTKEEATYIFEVAHSVGLTGYGFTWIVPSLVAGDTDTVPDEFPTGLISVSYDEWDYDLPARVRDGIAIITTAASTMLSEHNSIPQSKSSCNNIQESRVYEAHMLKRYLINVTFEGRDLSFSEDGYQMHPKLVIILLN,0
5iov,D,365,550,185,RKWERVGKYKDRSLKMWPVFDLYPNSEEHKDEHLSIVTLEEAPFVIVEDVDPLSGTCMRNTVPCRKQIRPENRTEEGGNYIKRCCKGFCIDILKKIAKTVKFTYDLYLVTNGKHGKKINGVWNGMIGEVVTKRAYMAVGSLTINEERSEVVDFSVPFIETGISVMVSRSNGTVSPSAFLEPFSAD,0
5iov,D,551,567,16,WVMMFVMLLIVSAVAV,0
5iov,D,588,602,14,IWLLWGLVFNNSLP,0
5iov,D,610,627,17,SKIMVSVWAFFAVIFLA,0
5iov,D,628,803,175,YTANLAAFMIQRRYVDQVSGLSDKKFQRPNDFSPAFRFGTVPNGSTERNIRNNYLEMHSYMVKFNQRSVQDALLSLKSGKLDAFIYDAAVLNYMAGRDEGCKLVTIGSGKVFATTGYGIAIQKDSGWKRQVDLAILQLFGDGEMEELEALWLTGICHNEKNEVMSSQLDIDNMAG,0
5iov,D,804,819,15,FYMLAAAMALSLITF,0
3j5q,G,433,453,20,FYFNFFVYCLYMIIFTAAAY,0
3j5q,G,454,473,19,RPVEGLPPYKLKNTVGDYF,0
3j5q,G,474,498,24,VTGEILSVSGGVYFFFRGIQYFLQ,0
3j5q,G,503,507,4,KSLF,0
3j5q,G,509,531,22,SYSEILFFVQSLFMLVSVVLYF,0
3j5q,G,532,537,5,QRKEY,0
3j5q,G,538,557,19,ASMVFSLAMGWTNMLYYTR,0
3j5q,G,562,575,13,GIYAVMIEKMILR,0
3j5q,G,577,598,21,CRFMFVYLVFLFGFSTAVVTL,0
3j5q,G,599,630,31,EDGKYNSL,0
3j5q,G,631,648,17,STCLELFKFTIGMGDLE,0
3j5q,G,649,657,8,TENYDFKA,0
3j5q,G,658,683,25,FIILLLAYVILTYILLLNMLIALMG,0
3j5q,G,684,711,27,TVNKIAQESKNIWKLQRAITILDTEKS,0
3ar5,A,54,73,19,QFEDLLVRILLLAACISFV,0
3ar5,A,74,89,15,AWFEEGEETITAFVE,0
3ar5,A,90,111,21,FVILLILIANAIVGVWQERNA,0
3ar5,A,253,274,21,EFGEQLSKVISLICVAVWLIN,0
3ar5,A,275,295,20,GHFNDPVHGGSWIRGAIYYF,0
3ar5,A,296,318,22,IAVALAVAAIPEGLPAVITTCL,0
3ar5,A,760,781,21,RYLISSNVGEVVCIFLTAALG,0
3ar5,A,782,785,3,PEA,0
3ar5,A,786,808,22,IPVQLLWVNLVTDGLPATALGF,0
3ar5,A,830,852,22,WLFFRYMAIGGYVGAATVGAAA,0
3ar5,A,853,897,44,WFMYAEDGPGVTYHQLTHFMQCTEDHPHFEGLDCEIFEAPEPMT,0
3ar5,A,898,916,18,ALSVLVTIEMCNALNSLS,0
3ar5,A,931,950,19,LLGSICLSMSLHFLILYVD,0
3ar5,A,952,957,5,PMIFK,0
3ar5,A,958,964,6,KALDLT,0
3ar5,A,965,987,22,WLMVLKISLPVIGLDEILKFIA,0
3vr8,D,1,27,26,LSAVRRAIPLSARILRTSLIQRCAGA,0
3vr8,D,56,79,23,TLFKIERYFAAAMVPLIPAAYFI,0
3vr8,D,80,83,3,GRE,0
3vr8,D,84,109,25,DLCLALALTLHVHWGVWGVVNDYGR,0
3vr8,D,117,139,22,AAAVRVGAYIFTACLLAGLLYF,0
3vr8,D,140,145,5,EHDVG,0
3vr8,D,146,154,8,TRAFEMVW,0
3vr8,D,155,156,1,L,0
4hyd,D,1,3,2,QI,0
4hyd,D,14,27,13,MLLFVQIIAIVLV,0
4hyd,D,28,37,9,PMQAAGLVA,0
4hyd,D,38,40,2,EN,0
4hyd,D,41,44,3,SSV,0
4hyd,D,45,64,19,NPLIFIGMLLAFTLVLLVL,0
4hyd,D,76,93,17,IGFALFMTFLYIFGALS,0
4hyd,D,94,105,11,LALGPTTAAAA,0
4hyd,D,106,118,12,TLIGAVAVTALL,0
4hyd,D,127,143,16,DILGVLISAGVASIFG,0
4hyd,D,144,148,4,SLEP,0
4hyd,D,149,163,14,PVLVLLVLLAVYDA,0
4hyd,D,180,211,31,ETKAPIMVVVPKRADYSFRKEGLNISEGEER,0
4hyd,D,216,231,15,GMGDLIMPSILVVSS,0
4hyd,D,232,234,2,VF,0
4hyd,D,235,243,8,DAPAVLWT,0
4hyd,D,244,247,3,SAP,0
4hyd,D,248,260,12,LGAMVGSLVGLA,0
4hyd,D,276,291,15,PLNGGAILGFLVGAA,0
4hyd,D,292,293,1,A,0
4hyd,D,294,301,7,SFSWLPF,0
3arc,z,8,25,17,LAALVILSFVMVIGVPV,0
3arc,z,26,39,13,YASPQDWDRSKQL,0
3arc,z,40,54,14,FLGSGLWIALVLVV,0
2i6w,C,11,26,15,AWVIAIIIMLAGGLA,0
2i6w,C,27,341,314,LKLPVAQYPTIAPPAVTISASYPGADAKTVQDTVTQVIEQNMNGIDNLMYMSSNSDSTGTVQITLTFESGTDADIAQVQVQNKLQLAMPLLPQEVQQQGVSVEKSSSSFLMVVGVINTDGTMTQEDISDYVAANMKDAISRTSGVGDVQLFGSQYAMRIWMNPNELNKFQLTPVDVITAIKAQNAQVAAGQLGGTPPVKGQQLNASIIAQTRLTSTEEFGKILLKVNQDGSRVLLRDVAKIELGGENYDIIAEFNGQPASGLGIKLATGANALDTAAAIRAELAKMEPFFPSGLKIVYPYDTTPFVKISIHEVV,0
2i6w,C,342,357,15,TLVEAIILVFLVMYL,0
2i6w,C,366,383,17,IPTIAVPVVLLGTFAVL,0
2i6w,C,384,396,12,AFGFSINTLTMF,0
2i6w,C,397,410,13,MVLAIGLLVDDAI,0
2i6w,C,442,457,15,VGIAMVLSAVFVPMA,0
2i6w,C,458,471,13,FGGSTGAIYRQFS,0
2i6w,C,472,489,17,TIVSAMALSVLVALILT,0
2i6w,C,500,510,10,AKGDHGEGKK,0
2i6w,C,513,536,23,GWFNRMFEKSTHHYTDSVGGILR,0
2i6w,C,542,556,14,VLYLIIVVGMAYLF,0
2i6w,C,557,874,317,RLPSSFLPDEDQGVFMTMVQLPAGATQERTQKVLNEVTHYYLTKEKNNVESVFAVNGFGFAGRGQNTGIAFVSLKDWADRPGEENKVEAITMRATRAFSQIKDAMVFAFNLPAIVELGTATGFDFELIDQAGLGHEKLTQARNQLLAEAAKHPDMLTSVRPNGLEDTPQFKIDIDQEKAQALGVSINDINTTLGAAWGGSYVNDFIDRGRVKKVYVMSEAKYRMLPDDIGDWYVRAADGQMVPFSAFSSSRWEYGSPRLERYNGLPSMEILGQAAPGKSTGEAMELMEQLASKLPTGVGYDWTGMSYQERLSGNQAP,0
2i6w,C,875,891,16,LYAISLIVVFLCLAAL,0
2i6w,C,899,918,19,SVMLVVPLGVIGALLAATF,0
2i6w,C,919,927,8,GLTNDVYF,0
2i6w,C,928,943,15,VGLLTTIGLSAKNAI,0
2i6w,C,976,991,15,MTSLAFILGVMPLVI,0
2i6w,C,992,1003,11,TGAGSGAQNAV,0
2i6w,C,1004,1019,15,TGVMGGMVTATVLAI,0
2i6w,C,1031,1049,18,RFSRKNEDIEHSHTVDHH,0
2pno,C,2,7,5,DEVAL,0
2pno,C,8,21,13,AAVTLLGVLLQAY,0
2pno,C,58,71,13,YFPLFLATLWVAG,0
2pno,C,72,78,6,FFHEGA,0
2pno,C,79,91,12,ALCGLVYLFARL,0
2pno,C,110,124,14,SARALWLLVALAAL,0
2pno,C,125,147,22,LLAHFLPAALRAALLGRLRTLL,0
2pno,C,148,156,8,WAHHHHHH,0
2gnu,M,2,52,50,YQNIFSQVQVRGPADLGMTEDVNLANRSGVGPFSTLLGWFGNAQLGPIYL,0
2gnu,M,53,71,18,SLGVLSLFSGLMWFFTIG,0
2gnu,M,82,88,6,AVFLRD,0
2gnu,M,119,135,16,FFMFVAVWSWWGRTYL,0
2gnu,M,136,144,8,AQALGMGK,0
2gnu,M,145,163,18,TAWAFLSAIWLWMVLGFI,0
2gnu,M,179,192,13,FSHLDWTNNFSLV,0
2gnu,M,201,220,19,HGLSIAFLYGSALLFAMHG,0
2gnu,M,221,267,46,TILAVSRFGGERELEQIADRGTAAERAALFWRWTMGFNATMEGIHR,0
2gnu,M,268,283,15,AIWMAVLVTLTGGIG,0
2gnu,M,294,299,5,YVWGQ,0
3vr9,D,1,27,26,LSAVRRAIPLSARILRTSLIQRCAGA,0
3vr9,D,28,57,29,SAAVTGAAPPQFDPIAAEKGFKPLHSHGT,0
3vr9,D,58,78,20,FKIERYFAAAMVPLIPAAYF,0
3vr9,D,84,108,24,DLCLALALTLHVHWGVWGVVNDYG,0
3vr9,D,109,116,7,PFVLGDT,0
3vr9,D,117,139,22,AAAVRVGAYIFTACLLAGLLYF,0
3vr9,D,146,154,8,TRAFEMVW,0
4tkq,A,-2,5,7,NAMQATV,0
4tkq,A,6,17,11,ESKQSIMQRIL,0
4tkq,A,18,37,19,VFVFTLLIATVGLFIGQFV,0
4tkq,A,42,61,19,LPLSILEVAMIILAFWMRR,0
4tkq,A,62,67,5,KAVGY,0
4tkq,A,68,86,18,FVYTFAFVSGITLFPIVS,0
4tkq,A,95,115,20,VVLEAFGSTFVIFAVLGTIG,0
4tkq,A,116,124,8,KMKKDLSF,0
4tkq,A,125,144,19,WSFLLVAVLALAVVGIFNI,0
4tkq,A,153,172,19,MAYSVIGTIVFSLYILYDL,0
4tkq,A,173,186,13,QIKHRHITEDLIP,0
4tkq,A,187,208,21,MALSLYLDFINLFINLLRFFG,0
4tkq,A,213,214,1,D,0
1bm1,C,1,6,5,QITGR,0
1bm1,C,7,9,2,EW,0
1bm1,C,10,33,23,WLALGTALMGLGTLYFLVKGMGV,0
1bm1,C,41,62,21,YAITTLVPAIAFTMYLSMLLG,0
1bm1,C,63,79,16,GLTMVPFGGEQNPIYW,0
1bm1,C,80,99,19,RYADWLFTTPLLLLDLALL,0
1bm1,C,106,127,21,ILALVGADGIMIGTGLVGALT,0
1bm1,C,128,133,5,VYSYR,0
1bm1,C,134,156,22,VWWAISTAAMLYILYVLFFGFT,0
1bm1,C,171,192,21,VLRNVTVVLWSAYPVVWLIGS,0
1bm1,C,193,203,10,GAGIVPLNIE,0
1bm1,C,204,225,21,LLFMVLDVSAKVGFGLILLRS,0
1bm1,C,228,248,20,FGEAEAPEPSAGDGAAATS,0
2yev,C,1,7,6,VYIALF,0
2yev,C,8,24,16,LGAALVTLFFYLILNP,0
2yev,C,33,50,17,FDLRFVLFMLLLILLAA,0
2yev,C,51,64,13,TVALMLLIGKAHH,0
2yev,C,65,66,1,L,0
3ar4,A,49,56,7,ELVIEQF,0
3ar4,A,57,75,18,DLLVRILLLAACISFVLA,0
3ar4,A,76,88,12,FEEGEETITAFV,0
3ar4,A,89,104,15,PFVILLILIANAIVG,0
3ar4,A,258,276,18,LSKVISLICVAVWLINIG,0
3ar4,A,277,295,18,FNDPVHGGSWIRGAIYYF,0
3ar4,A,296,314,18,IAVALAVAAIPEGLPAVI,0
3ar4,A,761,781,20,YLISSNVGEVVCIFLTAALG,0
3ar4,A,782,785,3,PEA,0
3ar4,A,786,807,21,IPVQLLWVNLVTDGLPATALG,0
3ar4,A,835,851,16,YMAIGGYVGAATVGAA,0
3ar4,A,852,900,48,WWFMYAEDGPGVTYHQLTHFMQCTEDHPHFEGLDCEIFEAPEPMTMAL,0
3ar4,A,901,916,15,VLVTIEMCNALNSLS,0
3ar4,A,931,947,16,LLGSICLSMSLHFLIL,0
3ar4,A,948,970,22,VDPLPMIFKLKALDLTQWLMVL,0
3ar4,A,971,987,16,ISLPVIGLDEILKFIA,0
1rkl,A,1,2,1,I,0
1rkl,A,8,29,21,SLAITFGIVMMTLIVIYHAVD,0
1rkl,A,30,36,6,TMSPKN,0
3j5p,D,433,454,21,FYFNFFVYCLYMIIFTAAAYY,0
3j5p,D,455,473,18,PVEGLPPYKLKNTVGDYF,0
3j5p,D,474,498,24,VTGEILSVSGGVYFFFRGIQYFLQ,0
3j5p,D,503,507,4,KSLF,0
3j5p,D,509,532,23,SYSEILFFVQSLFMLVSVVLYFS,0
3j5p,D,533,536,3,RKE,0
3j5p,D,537,557,20,VASMVFSLAMGWTNMLYYTR,0
3j5p,D,560,565,5,QMGIY,0
3j5p,D,566,598,32,VMIEKMILRDLCRFMFVYLVFLFGFSTAVVTL,0
3j5p,D,599,630,31,EDGKYNSL,0
3j5p,D,631,648,17,STCLELFKFTIGMGDLE,0
3j5p,D,649,657,8,TENYDFKA,0
3j5p,D,658,683,25,FIILLLAYVILTYILLLNMLIALMG,0
3j5p,D,684,710,26,TVNKIAQESKNIWKLQRAITILDTEK,0
5nda,A,9,29,20,RLKLLLLLLLLILLLILGAL,0
5nda,A,30,33,3,LGL,0
4xpa,A,35,57,22,FLLSVIGFAVDLANVWRFPYLC,0
4xpa,A,58,62,4,KNGG,0
4xpa,A,63,82,19,AFLVPYGIMLAVGGIPLFY,0
4xpa,A,112,133,21,VVLIAFYVDFYYNVIIAWSLR,0
4xpa,A,134,235,101,FFASFTNSLPWTSCNNIWNTPNCRPFEGHVEGFQSAASEYFNRYILELNRSEGIHDLGAI,0
4xpa,A,236,255,19,WDMALCLLIVYLICYFSLW,0
4xpa,A,261,281,20,GKVVWFTALFPYAVLLILLI,0
4xpa,A,282,288,6,GLTLPG,0
4xpa,A,289,297,8,FLGIQYYL,0
4xpa,A,298,303,5,PNFSA,0
4xpa,A,304,328,24,YKAEVWVDAATQVFFSLGPGFGVL,0
4xpa,A,345,362,17,LLTSFINSATSFIAGFV,0
4xpa,A,363,408,45,FSVLGYMAHTLGVRIEDVATEGPGLVFVVYPAAIATMPASTFWAL,0
4xpa,A,409,430,21,FFMMLATLGLDSSFGGSEAII,0
4xpa,A,447,464,17,VAGLFSLYFVVGLASCT,0
4xpa,A,465,470,5,GGFYF,0
4xpa,A,471,492,21,HLLDRYAAGYSILVAVFFEAI,0
4xpa,A,522,545,23,WRFVAPIFLLFITVYGLIGYEPL,0
4xpa,A,546,554,8,YADYVYPS,0
4xpa,A,555,573,18,ANALGWCIAGSSVVMIPA,0
1bad,A,1,8,7,QITGRPE,0
1bad,A,9,12,3,IWL,0
1bad,A,13,32,19,LGTALMGLGTLYFLVKGMG,0
1bad,A,33,37,4,SDPD,0
1bad,A,44,58,14,TTLVPAIAFTMYLS,0
1bad,A,59,62,3,LLG,0
1bad,A,63,73,10,GLTMVPFGGE,0
1bad,A,74,81,7,NPIYWAR,0
1bad,A,82,98,16,ADWLFTTPLLLLDLAL,0
1bad,A,101,105,4,ADQG,0
1bad,A,107,122,15,LALVGADGIMIGTGL,0
1bad,A,123,127,4,GALT,0
1bad,A,128,136,8,VYSYRFVW,0
1bad,A,138,153,15,ISTAAMLYILYVLFF,0
1bad,A,158,165,7,AESMRPE,0
1bad,A,174,190,16,NVTVVLWSAYPVVWLI,0
1bad,A,192,201,9,EGAGIVPLN,0
1bad,A,202,205,3,ETL,0
1bad,A,206,223,17,FMVLDVSAKVGFGLILL,0
1bad,A,226,248,22,AIFGEAEAPEPSAGDGAAATS,0
5gas,Z,-18,0,18,KKLLVTVLLAVFGALAFA,0
5gas,Z,1,18,17,EEAAASGGLDRGLIAVG,0
5gas,Z,19,34,15,GLAVGLAALGTGVAQ,0
5gas,Z,62,76,14,ETLVIFGLLIAFIL,0
5gas,Z,77,80,3,GRL,0
4huq,T,-13,5,18,GSSHHHHHHSQDPMSNFI,0
4huq,T,6,26,20,GRYLPLDSVVHRLDPRAKLM,0
4huq,T,27,41,14,SFCYIIVVFLANNI,0
4huq,T,43,60,17,YAILIAFTVGAILSSKI,0
4huq,T,62,87,25,GFFLKGIRPLLWLIVFTVVLQLLFS,0
4huq,T,88,99,11,AGGHTYFHWAF,0
4huq,T,101,127,26,VTQDGLINAGYIFVRFLLIIMMSTLL,0
4huq,T,128,247,119,LSTQPLDIATGLASLMKPLRWVKVPVDTLAMMLSIALRFVPTLMDEATKIMNAQRARGVDFGEGGLFKQAKSLIPLMVPLFMSAFNRAEDLSTAMEARGYQDSEHRSQYRILTWQRRDT,0
4huq,T,248,262,14,TWLLFLLGFVAILI,0
4huq,T,263,266,3,RHW,0
3te2,E,-2,0,2,GR,0
3te2,E,2,22,20,KETLDKLTNAAINSINLLNT,0
3te2,E,23,24,1,K,0
3te2,E,25,47,22,KYLVSSAFAGLYVGIGILLIFT,0
3te2,E,63,79,16,MGLSFAIALSLVIMTG,0
3te2,E,81,91,10,LFTGNNMVMS,0
3te2,E,92,104,12,GMLNKGVSIKDT,0
3te2,E,105,129,24,KIWAYSWVGNLIGALVLGIIFVGT,0
3te2,E,136,150,14,VAEFFANTAASKAS,0
3te2,E,154,174,20,ALFFRGILCNILVCVSVLCS,0
3te2,E,175,179,4,RTNS,0
3te2,E,180,197,17,TAKIIMIFLCLFAFITS,0
3te2,E,199,214,15,EHSVANMTIYSVSLF,0
3te2,E,224,249,25,GAIYNLVAVTLGNIVGGALFMGLGT,0
3te2,E,250,256,6,ILGKEK,0
3te2,E,257,265,8,NAAAENLY,0
2yiu,F,1,16,15,SHADEHAGDHGATRR,0
2yiu,F,17,18,1,F,0
2yiu,F,19,35,16,YYATAGAGTVAAGAAA,0
4or2,B,998,1001,3,GTA,0
4or2,B,1002,592,-410,LEDNWETLNDNLKVIEKADNAAQVKDALTKMRAAALDAQKATPPKLEDKSPDSPEMKDFRHGFDILVGQIDDALKLANEGKVKEAQAAAEQLKTTRNAYIQKYLIPVRYLEWSNIE,0
4or2,B,593,618,25,IIAIAFSCLGILVTLFVTLIFVLYR,0
4or2,B,627,648,21,RELCYIILAGIFLGYVCPFTL,0
4or2,B,649,658,9,AKPTTTSCY,0
4or2,B,659,684,25,QRLLVGLSSAMCYSALVTKTNRIAR,0
4or2,B,689,693,4,KKKI,0
4or2,B,701,725,24,SAWAQVIIASILISVQLTLVVTLI,0
4or2,B,726,752,26,MEPPMPILSYPSIKEVYLICNTSNLG,0
4or2,B,753,776,23,VAPLGYNGLLIMSCTYYAFKTRN,0
4or2,B,783,805,22,AKYIAFTMYTTCIIWLAFVPIY,0
4or2,B,806,813,7,GSNYKII,0
4or2,B,814,840,26,TCFAVSLSVTVALGCMFTPKMYIIIA,0
4or2,B,847,860,13,SAFTTSDVVRMHV,0
4ziv,C,13,26,13,VIAIIIMLAGGLA,0
4ziv,C,27,341,314,LKLPVAQYPTIAPPAVTISASYPGADAKTVQDTVTQVIEQNMNGIDNLMYMSSNSDSTGTVQITLTFESGTDADIAQVQVQNKLQLAMPLLPQEVQQQGVSVEKSSSSFLMVVGVINTDGTMTQEDISDYVAANMKDAISRTSGVGDVQLFGSQYAMRIWMNPNELNKFQLTPVDVITAIKAQNAQVAAGQLGGTPPVKGQQLNASIIAQTRLTSTEEFGKILLKVNQDGSRVLLRDVAKIELGGENYDIIAEFNGQPASGLGIKLATGANALDTAAAIRAELAKMEPFFPSGLKIVYPYDTTPFVKISIHEVV,0
4ziv,C,342,356,14,TLVEAIILVFLVMY,0
4ziv,C,367,383,16,PTIAVPVVLLGTFAVL,0
4ziv,C,384,395,11,AFGFSINTLTM,0
4ziv,C,396,409,13,GMVLAIGLLVDDA,0
4ziv,C,443,456,13,GIAMVLSAVFVPM,0
4ziv,C,457,470,13,FFGGSTGAIYRQF,0
4ziv,C,471,485,14,ITIVSAMALSVLVA,0
4ziv,C,515,534,19,FNRMFEKSTHHYTDSVGGI,0
4ziv,C,542,556,14,VLYLIIVVGMAYLF,0
4ziv,C,557,876,319,RLPSSFLPDEDQGVFMTMVQLPAGATQERTQKVLNEVTHYYLTKEKNNVESVFAVNGAGAAGAGQNTGIAFVSLKDWADRPGEENKVEAITMRATRAFSQIKDAMVFAFNLPAIVELGTATGFDFELIDQAGLGHEKLTQARNQLLAEAAKHPDMLTSVRPNGLEDTPQFKIDIDQEKAQALGVSINDINTTLGAAWGGSYVNDFIDRGRVKKVYVMSEAKYRMLPDDIGDWYVRAADGQMVPFSAFSSSRWEYGSPRLERYNGLPSMEILGQAAPGKSTGEAMELMEQLASKLPTGVGYDWTGMSYQERLSGNQAPSL,0
4ziv,C,877,891,14,AISLIVVFLCLAAL,0
4ziv,C,899,916,17,SVMLVVPLGVIGALLAA,0
4ziv,C,917,929,12,FRGLTNDVYFQV,0
4ziv,C,930,943,13,LLTTIGLSAKNAI,0
4ziv,C,976,991,15,MTSLAFILGVMPLVI,0
4ziv,C,992,1003,11,TGAGSGAQNAV,0
4ziv,C,1004,1018,14,TGVMGGMVTATVLA,0
4ziv,C,1019,1029,10,FFVPVFFVVV,0
5kai,r,9,21,12,LPVLLAAGWAVR,0
5kai,r,22,35,13,ILPYAVKQVQKLL,0
4x31,C,5,10,5,GRPEW,0
4x31,C,11,33,22,WLALGTALMGLGTLYFLVKGMG,0
4x31,C,41,62,21,FYAITTLVPAIAFTMYLSMLL,0
4x31,C,63,79,16,YGLTMVPFGGEQNPIY,0
4x31,C,80,100,20,ARYADWLFTTPLLLLDLALL,0
4x31,C,106,127,21,TILALVGADGIMIGTGLVGAL,0
4x31,C,128,133,5,KVYSY,0
4x31,C,134,157,23,FVWWAISTAAMLYILYVLFFGFT,0
4x31,C,171,192,21,KVLRNVTVVLWSAYPVVWLIG,0
4x31,C,193,203,10,EGAGIVPLNI,0
4x31,C,204,226,22,TLLFMVLDVSAKVGFGLILLRS,0
2k59,B,1,3,2,KM,0
2k59,B,4,22,18,LCISVLLALTVFLLLISK,0
2wsc,4,-50,29,79,ATVTTQASAAIFGPCGLKSRFLGGSSGKLNRGVAFRPVGCSPSASFKVEAKKGEWLPGLASPGYLTGSLPGDNGFDPLG,0
2wsc,4,43,56,13,ELVNGRWAMLGVA,0
2wsc,4,57,91,34,MLLPEVFTSIGIINVPKWYAAGKEEYFASSSTLF,0
2wsc,4,92,105,13,IEFILSHYVEIRR,0
2wsc,4,152,166,14,EIANGRLMLAFLGF,0
2wsc,4,167,195,28,IQHNVTGKGPFDNLLQHISDPWHNTIVQ,0
2wsc,4,196,200,4,LGGN,0
2wp9,L,1,10,9,VSNASALGR,0
2wp9,L,15,36,21,FILVRATAIVLTLYIIYMVGF,0
2wp9,L,37,56,19,ATSGELTYEVWIGFFASAF,0
2wp9,L,57,80,23,KVFTLLALFSILIHAWIGMWQVL,0
2wp9,L,89,110,21,RLMLQLVIVVALVVYVIYGFV,0
2wp9,L,111,115,4,VWGV,0
1btr,A,4,19,15,AVIFIYFAALSPAIT,0
1btr,A,20,21,1,G,0
5l1h,D,525,543,18,WMCIVFAYIGVSVVLFLV,0
5l1h,D,545,553,8,TDSTNEFG,0
5l1h,D,573,577,4,FNSL,0
5l1h,D,578,588,10,FSLGAFMQQG,0
5l1h,D,589,591,2,DI,0
5l1h,D,592,596,4,PRSL,0
5l1h,D,597,614,17,GRIVGGVWWFFTLIIIS,0
5l1h,D,793,810,17,GVFYILVGGLGLAMLVA,0
5l1h,D,811,816,5,IEFCY,0
5l1h,D,817,831,14,SRAEAKRMKGLVPR,0
5l22,A,11,19,8,RSYLAKYK,0
5l22,A,20,42,22,TLIIVGLFSLFINILFLLPSIY,0
5l22,A,65,87,22,AVVLYFALGLLQSVRAKVMQII,0
5l22,A,88,127,39,LKLDSELNKEVFTSSFEYAIRNPSKASAQPINDLYQLKQ,0
5l22,A,128,151,23,LTSPVLFAIFDLPWVPIYFGVLF,0
5l22,A,158,180,22,VMAILSMAVIVALAILNEYITK,0
5l22,A,181,233,52,KLKESNELLVRSTNFLNRALLNAEVVEALGMRNNLYKKWMNFYSKHLSAFEE,0
5l22,A,234,256,22,TDRNNFLSNLTRIFRIMAQSLM,0
5l22,A,277,299,22,SILLGRILGPIDTIVNGWRQIG,0
5l22,A,300,315,15,TKVAYTRLNEFLKFL,0
5l22,A,326,559,233,EPKGEIELSNVVVVPPEGKTPVLRNINMRILPGEFVAIIGPSGSGKSSLVRTILGIWLPVHGTVEIDGADLKQWDRDYFGKFVGYLPQDIELFEGTVAENIARFGELDSEKIIEAAKLSGAHDVIIKLPDGYDTYIGPGGITLSGGQRQRIALARALYGNPRIVILDEPDSNLDEQGEQALYNALIELKKRKVTTIIVSHRIRLLNLVDKIAIMQDGTLKAFGKADIIIQKLL,0
2itc,F,1,21,20,APMLSGLLARLVKLLLGRHG,0
2itc,F,26,50,24,RAAGAATVLLVIVLLAGSYLAVLA,0
2itc,F,51,62,11,RGAPGAQLITY,0
2itc,F,63,79,16,RALWWSVETATTVGYG,0
2itc,F,80,86,6,LYPVTL,0
2itc,F,87,111,24,GRCVAVVVMVAGITSFGLVTAALA,0
5lid,E,11,201,190,VDVSVSIFINKIYGVNTLEQTYKVDGYIVAQWTGKPRKTPGDKPLIVENTQIERWINNGLWVPALEFINVVGSPDTGNKRLMLFPDGRVIYNARFLGSFSNDMDFRLFPFDRQQFVLELEPFSYNNQQLRFSDIQVYTENIDNEEIDEWWIRGKASTHISDIRYDHLSSVQPNQNEFSRITVRIDAVRNP,0
5lid,E,202,225,23,YYLWSFILPLGLIIAASWSVFWL,0
5lid,E,230,253,23,RLQTSFTLMLTVVAYAFYTSNIL,0
5lid,E,254,259,5,RLPYT,0
5lid,E,260,282,22,VIDQMIIAGYGSIFAAILLIIF,0
5lid,E,298,317,19,RCRLAFPLGFLAIGCVLVI,0
4q4j,B,1,9,8,PEIRRRPH,0
4q4j,B,21,32,11,TATLRRLLGYL,0
4q4j,B,33,58,25,PHTFTLIMVFVFVTVSSILGVLSPY,0
4q4j,B,59,83,24,IGKTIDVVFVPRRFDLLPRYMLIL,0
4q4j,B,84,105,21,TIYALTSLLFWLQGKIMLTLS,0
4q4j,B,151,173,22,GNSIIQFFSGIVTLAGAVIMMF,0
4q4j,B,174,180,6,VNVILS,0
4q4j,B,181,200,19,VTLSIVPLTVLITQIVSSQ,0
4q4j,B,259,278,19,SGVLPPLMNMVNNLGFALI,0
4q4j,B,279,298,19,GFGGWLALKDIITVGTIAT,0
4q4j,B,299,320,21,IGYSRQFTRPLNELSNQFNMI,0
4q4j,B,593,598,5,VVEKE,0
4h99,H,1,10,9,VGVTAFGNF,0
4h99,H,15,32,17,AIYSFWIFLAGLIYYLQ,0
4h99,H,33,250,217,ENMREGYPLENEDGTPAANQGPFPLPKPKTFILPHGRGTLTVPGPESEDRPIALARTAVSEGFPHAPTGDPMKDGVGPASWVARRDLPELDGHGHNKIKPMKAAAGFHVSAGKNPIGLPVRGCDLEIAGKVVDIWVDIPEQMARFLEVELKDGSTRLLPMQMVKVQSNRVHVNALSSDLFAGIPTIKSPTEVTLLEEDKICGYVAGGLMYAAPKRKS,0
4h99,H,251,260,9,VAAMLAEYA,0
1ymg,D,1,5,4,WELR,0
1ymg,D,6,10,4,ASFW,0
1ymg,D,11,30,19,AICAEFFASLFYVFFGLGA,0
1ymg,D,43,60,17,VALAFGLALATLVQAVG,0
1ymg,D,61,62,1,I,0
1ymg,D,63,78,15,GAHVNPAVTFAFLVG,0
1ymg,D,79,83,4,QMSL,0
1ymg,D,84,107,23,RAICYMVAQLLGAVAGAAVLYSV,0
1ymg,D,129,149,20,ATIVEIFLTLQFVLCIFATY,0
1ymg,D,150,157,7,ERRNGRL,0
1ymg,D,158,176,18,SVALAVGFSLTLGHLFGM,0
1ymg,D,180,194,14,AGMNPARSFAPAIL,0
1ymg,D,202,223,21,VYWVGPVIGAGLGSLLYDFLL,0
1ymg,D,224,239,15,PRLKSVSERLSILKG,0
1ymg,D,240,263,23,RPSESNGQPEVTGEPVELKTQAL,0
3h90,A,8,16,8,VSRAAIAA,0
3h90,A,17,36,19,AMASLLLLIKIFAWWYTGS,0
3h90,A,40,59,19,AALVDSLVDIGASLTNLLV,0
3h90,A,60,80,20,RYSLQPADDNHSFGHGKAES,0
3h90,A,81,102,21,AALAQSMFISGSALFLFLTGI,0
3h90,A,119,140,21,VTIVALICTIILVSFQRWVVR,0
3h90,A,141,145,4,TQSQ,0
3h90,A,146,164,18,VRADMLHYQSDVMMNGAI,0
3h90,A,180,202,22,LFALGIGIYILYSALRMGYEAV,0
3h90,A,203,290,87,SLLDRALPDEERQEIIDIVTSWPGVSGAHDLRTRQSGPTRFIQIHLEMEDSLPLVQAHMVADQVEQAILRRFPGSDVIIHQDPCSVV,0
5iu8,A,-1,5,6,APPIMG,0
5iu8,A,6,29,23,SVYITVELAIAVLAILGNVLVCW,0
5iu8,A,45,67,22,VSLAAADILVGVLAIPFAITIS,0
5iu8,A,68,75,7,GFCAACH,0
5iu8,A,76,98,22,CLFIACFVLVLAQSSIFSLLAI,0
5iu8,A,123,144,21,IIAICWVLSFAIGLTPMLGWN,0
5iu8,A,145,172,27,CGQPKEGKAHSQGCGEGQVACLFEDVV,0
5iu8,A,173,195,22,MNYMVYFNFFACVLVPLLLMLG,0
5iu8,A,237,259,22,IAGLFALCWLPLHIINCFTFFC,0
5iu8,A,260,264,4,DCSH,0
5iu8,A,265,287,22,PLWLMYLAIVLAHTNSVVNPFI,0
5iu8,A,293,304,11,EFRQTFRKIIR,0
3f48,B,1,4,3,EVK,0
3f48,B,13,32,19,LILAMAGNAVGLGNFLRFP,0
3f48,B,33,43,10,QAAENGGGAF,0
3f48,B,44,63,19,IPYIIAFLLVGIPLMWIEW,0
3f48,B,90,124,34,KILGVFGLWIPLVVAIYYVYIESWTLGFAIKFLV,0
3f48,B,125,132,7,LVPEPPP,0
3f48,B,133,134,1,A,0
3f48,B,135,166,31,DPDSILRPFKEFLYSYIGVPKGDEPILKPSL,0
3f48,B,167,184,17,AYIVFLITMFINVSILI,0
3f48,B,191,212,21,ERFAKIAMPTLFILAVFLVIR,0
3f48,B,213,222,9,FLLETPNGT,0
3f48,B,223,230,7,ADGLNFL,0
3f48,B,231,241,10,TPDFEKLKDP,0
3f48,B,242,265,23,VWIAAVGQIFFTLSLGFGAIITY,0
3f48,B,278,297,19,GLTAATLNEKAEVILGGSI,0
3f48,B,298,325,27,IPAAVAFFGVANAVAIAKAGAFNLGFI,0
3f48,B,326,331,5,LPAIF,0
3f48,B,332,339,7,QTAGGTF,0
3f48,B,340,367,27,GFLWFFLLFFAGLTSSIAIMQPMIAFL,0
3f48,B,378,396,18,VLWTAAIVFFSAHLVMFL,0
3f48,B,397,399,2,KS,0
3f48,B,400,426,26,DEMDFWAGTIGVVFFGLTELIIFFWI,0
3f48,B,429,437,8,DKAWEEIN,0
3f48,B,445,469,24,RIYYYVMRYITPAFLAVLLVVWAR,0
3f48,B,470,483,13,YIPKIMEETHWTV,0
3f48,B,484,502,18,ITRFYIIGLFLFLTFLVF,0
3f48,B,602,604,2,PR,0
4y6k,A,11,27,16,MPLMLLFVQIIAIVLV,0
4y6k,A,28,37,9,PMQAAGLVA,0
4y6k,A,41,43,2,SS,0
4y6k,A,44,61,17,ANPLIFIGMLLAFTLVL,0
4y6k,A,76,90,14,IGFALFMTFLYIFG,0
4y6k,A,91,105,14,LSLLALGPTTAAAA,0
4y6k,A,106,120,14,TLIGAVAVTALLYL,0
4y6k,A,126,146,20,IDILGVLISAGVASIFGISL,0
4y6k,A,148,161,13,LPVLVLLVLLAVY,0
4y6k,A,218,231,13,GDLIMPSILVVSS,0
4y6k,A,232,234,2,VF,0
4y6k,A,244,247,3,SAP,0
4y6k,A,248,260,12,LGAMVGSLVGLA,0
4y6k,A,276,292,16,PLNGGAILGFLVGAAL,0
2zbg,A,49,54,5,ELVIE,0
2zbg,A,55,74,19,FEDLLVRILLLAACISFVL,0
2zbg,A,75,89,14,WFEEGEETITAFVE,0
2zbg,A,90,110,20,FVILLILIANAIVGVWQERN,0
2zbg,A,253,274,21,EFGEQLSKVISLICVAVWLIN,0
2zbg,A,275,295,20,GHFNDPVHGGSWIRGAIYYF,0
2zbg,A,296,318,22,IAVALAVAAIPEGLPAVITTCL,0
2zbg,A,760,781,21,RYLISSNVGEVVCIFLTAALG,0
2zbg,A,782,785,3,PEA,0
2zbg,A,786,808,22,IPVQLLWVNLVTDGLPATALGF,0
2zbg,A,830,852,22,WLFFRYMAIGGYVGAATVGAAA,0
2zbg,A,853,897,44,WFMYAEDGPGVTYHQLTHFMQCTEDHPHFEGLDCEIFEAPEPMT,0
2zbg,A,898,917,19,ALSVLVTIEMCNALNSLSE,0
2zbg,A,927,950,23,VNIWLLGSICLSMSLHFLILYVD,0
2zbg,A,951,957,6,LPMIFK,0
2zbg,A,958,966,8,KALDLTQW,0
2zbg,A,967,987,20,MVLKISLPVIGLDEILKFIA,0
5aw9,G,4,24,20,GPDNDERFTYDYYRLRVVGL,0
5aw9,G,25,40,15,VAAVLCVIGIIILLA,0
4wol,B,8,10,2,ST,0
4wol,B,12,34,22,PGVLAGIVVGDLVLTVLIALAV,0
4wol,B,35,40,5,FLGRL,0
3gi8,C,15,33,18,MAVGVMIGASIFSIFGVG,0
3gi8,C,34,41,7,KIAGRNL,0
3gi8,C,42,59,17,ETFILSGIYALLVAYSY,0
3gi8,C,72,80,8,IAFIHKAI,0
3gi8,C,89,113,24,SILLWMSYVISIALFAKGFAGYFL,0
3gi8,C,114,123,9,LINAPINTF,0
3gi8,C,124,140,16,IAITEIGIVAFFTALN,0
3gi8,C,144,150,6,KAVGRA,0
3gi8,C,151,170,19,FFIVLVALLILGLFIFAGL,0
3gi8,C,171,190,19,TIHPSYVIPDLAPSAVSGM,0
3gi8,C,191,206,15,FASAIFFLSYMGFGV,0
3gi8,C,225,242,17,FISILIVMFVYVGVAIS,0
3gi8,C,243,258,15,IGNLPIDELIKASEN,0
3gi8,C,259,268,9,LAVAAKPFL,0
3gi8,C,269,271,2,NL,0
3gi8,C,272,293,21,FLLISIGALFSISSAMNATIY,0
3gi8,C,296,305,9,NVAYSLAKD,0
3gi8,C,324,341,17,YITSALGVLFALLFNME,0
3gi8,C,343,360,17,ASITSAVFMVIYLFVIL,0
3gi8,C,373,395,22,EIVIFSFIVVLGVFLLLLYYQW,0
3gi8,C,396,400,4,TNRF,0
3gi8,C,401,418,17,FYGIIATFIGVLIFEII,0
3gi8,C,436,444,8,ESSGLVPR,0
3nal,A,54,74,20,EQFEDLLVRILLLAACISFV,0
3nal,A,75,88,13,AWFEEGEETITAF,0
3nal,A,89,110,21,EPFVILLILIANAIVGVWQER,0
3nal,A,254,276,22,EFGEQLSKVISLICVAVWLINI,0
3nal,A,277,294,17,HFNDPVHGGSWIRGAIY,0
3nal,A,295,318,23,FKIAVALAVAAIPEGLPAVITTC,0
3nal,A,760,782,22,IRYLISSNVGEVVCIFLTAALG,0
3nal,A,783,785,2,PE,0
3nal,A,786,808,22,LIPVQLLWVNLVTDGLPATALG,0
3nal,A,833,854,21,FFRYMAIGGYVGAATVGAAAW,0
3nal,A,855,897,42,FMYAEDGPGVTYHQLTHFMQCTEDHPHFEGLDCEIFEAPEPM,0
3nal,A,898,916,18,MALSVLVTIEMCNALNSL,0
3nal,A,927,950,23,WVNIWLLGSICLSMSLHFLILYV,0
3nal,A,951,957,6,PLPMIF,0
3nal,A,958,964,6,LKALDL,0
3nal,A,965,987,22,QWLMVLKISLPVIGLDEILKFI,0
1qm8,C,2,11,9,QITGRPEWI,0
1qm8,C,12,29,17,LALGTALMGLGTLYFLV,0
1qm8,C,45,61,16,TTLVPAIAFTMYLSML,0
1qm8,C,62,79,17,GYGLTMVPFGGEQNPIY,0
1qm8,C,80,95,15,ARYADWLFTTPLLLL,0
1qm8,C,110,126,16,LVGADGIMIGTGLVGA,0
1qm8,C,127,134,7,TKVYSYR,0
1qm8,C,135,152,17,VWWAISTAAMLYILYVL,0
1qm8,C,175,192,17,NVTVVLWSAYPVVWLIG,0
1qm8,C,193,203,10,EGAGIVPLNI,0
1qm8,C,204,222,18,TLLFMVLDVSAKVGFGLI,0
1qm8,C,231,248,17,EAEAPEPSAGDGAAATS,0
4pj0,z,1,4,3,TIL,0
4pj0,z,5,24,19,QLALAALVILSFVMVIGVP,0
4pj0,z,40,57,17,FLGSGLWIALVLVVGVL,0
4pj0,z,58,62,4,FFVV,0
3wmm,0,0,6,6,AEQKSL,0
3wmm,0,7,28,21,GLTDDEAKEFHAIFMQSMYAW,0
3wmm,0,29,42,13,GLVVIAHLLAWLY,0
1oea,A,16,36,20,MEIFIGLCAIVGNVLVICVV,0
1oea,A,37,50,13,LNPSLQTTTFYFI,0
1oea,A,51,70,19,SLALADIAVGVLVMPLAIV,0
1oea,A,86,105,19,CLLLIFTHASIMSLLAIAV,0
1oea,A,106,128,22,RYLRVKLTVRYKRVTTHRRIWL,0
1oea,A,129,150,21,LGLCWLVSFLVGLTPMFGWNM,0
1oea,A,176,195,19,VYFSFLTWIFIPLVVMCAI,0
1oea,A,196,232,36,LDIFYIIRNKLSLNLSNSKETGAFYGREFKTAKSLF,0
1oea,A,233,252,19,VLFLFALSWLPLSIINCII,0
1oea,A,264,284,20,MGILLSHANSMMNPIVYAYK,0
1oea,A,285,286,1,K,0
1oea,A,287,296,9,FKETYLLIL,0
4n4y,C,4,6,2,PK,0
4n4y,C,7,23,16,ALAVILVLTLTILVFW,0
3lw5,4,92,108,16,QAELVNGRWAMLGVAG,0
3lw5,4,109,142,33,LLPEVFTSIGIINVPKWYAAGKEEYFASSSTLF,0
3lw5,4,143,157,14,IEFILSHYVEIRRW,0
3lw5,4,202,219,17,KEIANGRLMLAFLGFII,0
3lw5,4,220,246,26,HNVTGKGPFDNLLQHISDPWHNTIVQ,0
5c65,B,1,5,4,GTQK,0
5c65,B,7,31,24,PALIFAITVATIGSFQFGYNTGVI,0
5c65,B,32,49,17,APEKIIKEFIQKTLTDK,0
5c65,B,50,51,1,N,0
5c65,B,52,61,9,PPSEVLLTS,0
5c65,B,62,81,19,WSLSVAIFSVGGMIGSFSV,0
5c65,B,91,111,20,NSMLIVNLLAVTGGCFMGLC,0
5c65,B,112,116,4,VAKS,0
5c65,B,117,146,29,EMLILGRLVIGLFCGLCTGFVPMYIGEIS,0
5c65,B,148,166,18,ALRGAFGTLNQLGIVVGI,0
5c65,B,167,188,21,VAQIFGLEFILGSEELWPLLL,0
5c65,B,189,208,19,FTILPAILQSAALPFCPES,0
5c65,B,251,253,2,EK,0
5c65,B,273,288,15,IVLQLSQQLSGINAV,0
5c65,B,289,299,10,YYSTGIFKDA,0
5c65,B,300,302,2,VQ,0
5c65,B,303,315,12,PIYATIGAGVVN,0
5c65,B,316,332,16,IFTVVSLFLVERAGRR,0
5c65,B,334,347,13,HMIGLGGMAFCST,0
5c65,B,348,359,11,MTVSLLLKDNY,0
5c65,B,360,363,3,GMS,0
5c65,B,364,373,9,VCIGAILVF,0
5c65,B,374,391,17,AFFEIGPGPIPWFIVAE,0
5c65,B,403,424,21,VAGCSNWTSNFLVGLLFPSAA,0
5c65,B,425,430,5,YLGAY,0
5c65,B,431,450,19,FIIFTGFLITFLAFTFFKV,0
5c65,B,470,481,11,GADRAENLYFQ,0
4pdm,E,18,20,2,AK,0
4pdm,E,25,45,20,VLFVLTILTLISGTIFYSTV,0
4pdm,E,46,50,4,GLRP,0
4pdm,E,51,67,16,DALYFSVVTLTTVGYG,0
4pdm,E,68,74,6,FSPQTD,0
4pdm,E,75,99,24,GKIFTILYIFIGIGLVFGFIHKLA,0
4pdm,E,103,109,6,LPSILS,0
4pgv,A,-2,5,7,NAMQATV,0
4pgv,A,6,16,10,ESKQSIMQRI,0
4pgv,A,17,37,20,TVFVFTLLIATVGLFIGQFV,0
4pgv,A,42,61,19,LPLSILEVAMIILAFWMRR,0
4pgv,A,62,65,3,KAV,0
4pgv,A,66,85,19,YAFVYTFAFVSGITLFPIV,0
4pgv,A,97,116,19,LEAFGSTFVIFAVLGTIGA,0
4pgv,A,117,125,8,MKKDLSFL,0
4pgv,A,126,145,19,SFLLVAVLALAVVGIFNIF,0
4pgv,A,153,173,20,MAYSVIGTIVFSLYILYDLN,0
4pgv,A,174,186,12,IKHRHITEDLIP,0
4pgv,A,187,207,20,MALSLYLDFINLFINLLRFF,0
4pgv,A,213,214,1,D,0
1xio,B,7,25,18,HWIYVAGMTIGALHFWSL,0
1xio,B,26,37,11,RNPRGVPQYEY,0
1xio,B,38,55,17,VAMFIPIWSGLAYMAMA,0
1xio,B,58,66,8,GKVEAAGQ,0
1xio,B,70,87,17,ARYIDWMVTTPLLLLSL,0
1xio,B,88,102,14,WTAMQFIKKDWTLI,0
1xio,B,103,121,18,FLMSTQIVVITSGLIADL,0
1xio,B,127,146,19,RYLWYICGVCAFLIILWGI,0
1xio,B,147,168,21,NPLRAKTRTQSSELANLYDKL,0
1xio,B,169,186,17,TYFTVLWIGYPIVWIIG,0
1xio,B,198,217,19,TFLFCLLPFFSKVGFSFLD,0
1xio,B,218,226,8,HGLRNLND,0
1xio,B,227,261,34,RQTTGDRFAENTLQFVENITLFANSRRQQSRRRV,0
4ux1,B,36,55,19,WVWISLYYVAFYVVMSGIF,0
4ux1,B,56,88,32,LCIYVLMRTIDPYTPDYQDQLKSPGVTLRPDV,0
4ux1,B,125,154,29,EGSINCTSEKYFFQESFLAPNHTKFSCKF,0
4ux1,B,175,194,19,KPCFIIKMNRIVKFLPGNS,0
4ux1,B,209,213,4,GPPL,0
4ux1,B,224,243,19,SLHYFPYYGKKAQPHYSNP,0
4ux1,B,248,290,42,LLNVPRNRDVVIVCKILAEHVSFDNPHDPYEGKVEFKLKIQK,0
5t4q,V,1,2,1,E,0
5t4q,V,3,18,15,LNMDLLYMAAAVMMG,0
5t4q,V,19,32,13,AAIGAAIGIGILG,0
5t4q,V,52,65,13,FFIVMGLVDAIPM,0
5t4q,V,66,77,11,AVGLGLYVMFA,0
5t4q,V,78,79,1,A,0
5jjn,D,24,38,14,VFIFVGALTVLFGA,0
5jjn,D,39,65,26,AYGEVTAAAATGDAAAVQEAAVSAIL,0
5jjn,D,66,81,15,LIILLGINLGLVAAT,0
3nmo,A,1,21,20,KTDTPSLETPQAARLRRRQL,0
3nmo,A,37,61,24,MAAVVGTLVGLAAVAFDKGVAWLQ,0
3nmo,A,62,80,18,QRMGALVHTADNYPLLLT,0
3nmo,A,81,97,16,AFLCSAVLAMFGYFLV,0
3nmo,A,129,142,13,VKFFGGLGTLGGG,0
3nmo,A,144,156,12,LGREGPTVQIGG,0
3nmo,A,181,203,22,AAAGLAAAFNAPLAGILFIWEE,0
3nmo,A,216,230,14,AVFIGVIMSTIMYR,0
3nmo,A,231,252,21,FNHEVALIDVGKLSDAPLNTL,0
3nmo,A,253,270,17,LYLILGIIFGIFGPIFN,0
3nmo,A,292,305,13,LMGGAIGGLCGLL,0
3nmo,A,306,334,28,FVAPATSGGGFNLIPIATAGNFSMGMLV,0
3nmo,A,335,351,16,IFVARVITTLLCFSSG,0
3nmo,A,353,368,15,GGIFAPMLALGTVLG,0
3nmo,A,369,391,22,AFGMVAVELFPQYHLEAGTFAI,0
3nmo,A,392,415,23,GMGALLAASIRAPLTGIILVLEM,0
3nmo,A,416,422,6,DNYQLW,0
3nmo,A,423,436,13,PMIITGLGATLLA,0
3nmo,A,461,465,4,ARSK,0
2moz,A,1,17,16,KDPKTLLRVSIIGTTL,0
2moz,A,18,37,19,ALSSFTPVLVILLGVVGLS,0
2moz,A,43,65,22,DYVLLPALAIFIGLTIYAIQRK,0
2moz,A,66,81,15,QADASSTPKFNGVKK,0
5c5x,D,15,31,16,AEFLATLIFVFFGLGS,0
5c5x,D,32,43,11,LKWPSALPTIL,0
5c5x,D,44,61,17,IALAFGLAIGTLAQALG,0
5c5x,D,66,78,12,HINPAITLALLV,0
5c5x,D,88,105,17,FYVAAQLVGAIAGAGIL,0
5c5x,D,106,129,23,GVAPLNARGNLAVNALNNNTTQG,0
5c5x,D,130,149,19,AMVVELILTFQLALCIFAS,0
5c5x,D,160,177,17,PALSIGLSVTLGHLVGI,0
5c5x,D,178,182,4,FTGC,0
5c5x,D,183,195,12,MNPARSFGPAVV,0
5c5x,D,196,203,7,NRFSPAH,0
5c5x,D,204,221,17,VFWVGPIVGAVLAAILY,0
1qcr,K,2,20,18,TRFLGPRYRQLARNWVPT,0
1qcr,K,21,34,13,QLWGAVGAVGLVS,0
4ltq,D,137,149,12,PSSPSLLRAIPG,0
4ltq,D,152,171,19,IALLLLVIFYVFAVMGTKL,0
4ltq,D,172,182,10,AQSFPEWFGT,0
4ltq,D,183,201,18,GASMYTLFQVMTLESWSM,0
4ltq,D,202,212,10,IARPVIEAYP,0
4ltq,D,213,233,20,AWIYFVSFILVSSFTVLNLF,0
4ltq,D,286,288,2,KR,0
2jk5,F,1,21,20,PPMLSGLLARLVKLLLGRHG,0
2jk5,F,22,25,3,ALH,0
2jk5,F,26,50,24,RAAGAATVLLVIVLLAGSYLAVLA,0
2jk5,F,63,79,16,RALWWSVETATTVGYG,0
2jk5,F,87,112,25,GRCVAVVVMVAGITSFGLVTAALAT,0
2jk5,F,113,124,11,FVGREQERRGH,0
3pds,A,25,28,3,QQR,0
3pds,A,29,32,3,EVW,0
3pds,A,33,56,23,VGMGIVMSLIVLAIVFGNVLVIT,0
3pds,A,72,95,23,TSLACADLVMGLAVVPFGAACIL,0
3pds,A,96,103,7,KMWTFGN,0
3pds,A,104,126,22,WCEFWTSIDVLCVTASIETLCV,0
3pds,A,154,175,21,LMVWIVSGLTSFLPIQMHWYR,0
3pds,A,176,178,2,TH,0
3pds,A,179,186,7,EAINCYA,0
3pds,A,187,191,4,ETCC,0
3pds,A,192,217,25,FFTNQAYAIASSIVSFYVPLVIMVF,0
3pds,A,277,299,22,IMGTFTLCWLPFFIVNIVHVIQ,0
3pds,A,300,303,3,NLI,0
3pds,A,304,327,23,KEVYILLNWIGYVNSGFNPLIYC,0
3pds,A,330,340,10,DFRIAFQELL,0
3pds,A,343,354,11,RSSLKHHHHHH,0
4ymk,D,41,69,28,IRPEMKEDIHDPTYQDEEGPPPKLEYVW,0
4ymk,D,70,92,22,NIILMVLLHLGGLYGIILVPSC,0
4ymk,D,94,107,13,YTCLFGIFYYMTS,0
4ymk,D,108,127,19,LGITAGAHRLWSHRTYKAR,0
4ymk,D,128,141,13,PLRIFLIIANTMA,0
4ymk,D,142,213,71,QNDVYEWARDHRAHHKFSETHADPHNSRRGFFFSHVGWLLVRKHPAVKEKGGKLDMSDLKAEKLVMFQRRY,0
4ymk,D,214,231,17,KPGLLLMCFILPTLVPW,0
4ymk,D,239,253,14,NSLFVSTFLRYTLV,0
4ymk,D,254,314,60,NATWLVNSAAHLYGYRPYDKNIQSRENILVSLGAVGEGFHNYHHTFPFDYSASEYRWHIN,0
4ymk,D,315,325,10,TTFFIDCMAA,0
4ymk,D,326,352,26,GLAYDRKKVSKATVLARIKRTGDGSH,0
3w5a,C,1,15,14,ERSTRELCLNFTVV,0
3w5a,C,16,31,15,ITVILIWLLVRSYQY,0
2hrt,C,11,27,16,AWVIAIIIMLAGGLAI,0
2hrt,C,28,341,313,KLPVAQYPTIAPPAVTISASYPGADAKTVQDTVTQVIEQNMNGIDNLMYMSSNSDSTGTVQITLTFESGTDADIAQVQVQNKLQLAMPLLPQEVQQQGVSVEKSSSSFLMVVGVINTDGTMTQEDISDYVAANMKDAISRTSGVGDVQLFGSQYAMRIWMNPNELNKFQLTPVDVITAIKAQNAQVAAGQLGGTPPVKGQQLNASIIAQTRLTSTEEFGKILLKVNQDGSRVLLRDVAKIELGGENYDIIAEFNGQPASGLGIKLATGANALDTAAAIRAELAKMEPFFPSGLKIVYPYDTTPFVKISIHEVV,0
2hrt,C,342,358,16,TLVEAIILVFLVMYLF,0
2hrt,C,366,386,20,IPTIAVPVVLLGTFAVLAAF,0
2hrt,C,387,394,7,FSINTLT,0
2hrt,C,395,411,16,FGMVLAIGLLVDDAIV,0
2hrt,C,443,457,14,GIAMVLSAVFVPMA,0
2hrt,C,458,470,12,FGGSTGAIYRQF,0
2hrt,C,471,489,18,ITIVSAMALSVLVALILT,0
2hrt,C,514,534,20,WFNRMFEKSTHHYTDSVGGI,0
2hrt,C,541,556,15,LVLYLIIVVGMAYLF,0
2hrt,C,557,874,317,RLPSSFLPDEDQGVFMTMVQLPAGATQERTQKVLNEVTHYYLTKEKNNVESVFAVNGFGFAGRGQNTGIAFVSLKDWADRPGEENKVEAITMRATRAFSQIKDAMVFAFNLPAIVELGTATGFDFELIDQAGLGHEKLTQARNQLLAEAAKHPDMLTSVRPNGLEDTPQFKIDIDQEKAQALGVSINDINTTLGAAWGGSYVNDFIDRGRVKKVYVMSEAKYRMLPDDIGDWYVRAADGQMVPFSAFSSSRWEYGSPRLERYNGLPSMEILGQAAPGKSTGEAMELMEQLASKLPTGVGYDWTGMSYQERLSGNQAP,0
2hrt,C,875,892,17,LYAISLIVVFLCLAALY,0
2hrt,C,896,919,23,IPFSVMLVVPLGVIGALLAATFR,0
2hrt,C,920,927,7,LTNDVYF,0
2hrt,C,928,944,16,VGLLTTIGLSAKNAIL,0
2hrt,C,976,991,15,MTSLAFILGVMPLVI,0
2hrt,C,992,1003,11,TGAGSGAQNAV,0
2hrt,C,1004,1022,18,TGVMGGMVTATVLAIFFV,0
2hrt,C,1023,1030,7,VFFVVVR,0
2hrt,C,1034,1057,23,RKNEDIEHSHTVDHHLEHHHHHH,0
4ikw,A,1,2,1,A,0
4ikw,A,26,47,21,TLFFTEFWERFSYYGMRAILV,0
4ikw,A,48,66,18,YMYYEVSKGGLGLDEHLA,0
4ikw,A,67,88,21,AIMSIYGALVYMSGIIGGWLA,0
4ikw,A,95,114,19,RAVFYGGLLIMAGHIALAI,0
4ikw,A,115,119,4,GGVA,0
4ikw,A,120,140,20,LFVSMALIVLGTGLLKPNVS,0
4ikw,A,160,180,20,FYMGINLGAFLAPLVVGTAG,0
4ikw,A,181,186,5,KYNFH,0
4ikw,A,187,207,20,GFGLAAVGMFLGLVVFVATR,0
4ikw,A,229,249,20,AAAIMAVGAVVIAVLLAILI,0
4ikw,A,250,254,4,NGWF,0
4ikw,A,255,277,22,VETFISLVGILGIIIPIIYFVV,0
4ikw,A,294,317,23,YIPLFVASAMFWAIQEQGSTILA,0
4ikw,A,318,336,18,YADKRTQLDVAGIHLSPA,0
4ikw,A,337,357,20,FQSLNPLFIIILAPVFAWMW,0
4ikw,A,368,387,19,QKFALGLLFAGLSFIVILV,0
4ikw,A,388,400,12,GHLSGGGLVHPI,0
4ikw,A,401,421,20,LVLSYFIVVLGELCLSPVGL,0
4ikw,A,438,455,17,LWFLSNAAAQAINAQLV,0
4ikw,A,456,466,10,FYTPENETAY,0
4ikw,A,467,485,18,GTIGGAALVLGLILLAIA,0
4ikw,A,495,507,12,RLESSGENLYFQ,0
5m95,C,70,89,19,ILISSLAAMLLQSMTVRLG,0
5m95,C,90,108,18,ATGKDLAQMTRHFLSKPV,0
5m95,C,109,125,16,IIFWIIAELAIIATDI,0
5m95,C,218,240,22,GIIGATIMPHNLYLHSSIVQSR,0
5m95,C,241,252,11,YDRHDNEEKAQ,0
5m95,C,253,269,16,IKYATIDSNLQLSIAF,0
5m95,C,329,346,17,STITGTLAGQIVMEGFL,0
5m95,C,347,348,1,L,0
5m95,C,349,365,16,IPNWLRRLITRSLAVI,0
5m95,C,389,404,15,VFLSIALPFSLIPLQ,0
5m95,C,405,416,11,ATSNKKLMGPF,0
5m95,C,417,437,20,NKTWVNIISWTLIVILSGLN,0
2mom,C,383,400,17,ALAGVLILVLLAYFIGL,0
2mom,C,401,410,9,HHHAGYEQF,0
2qjp,F,9,11,2,TR,0
2qjp,F,12,32,20,DFLYYATAGAGAVATGAAVW,0
3k3g,C,-2,-1,1,G,0
3k3g,C,0,9,9,AFGEQLLKN,0
3k3g,C,10,18,8,LIEFCDSV,0
3k3g,C,19,28,9,RGCGQVMFQ,0
3k3g,C,29,32,3,NTV,0
3k3g,C,33,46,13,GLLFFAGIFYNST,0
3k3g,C,48,62,14,GVCAVLGTAASTLT,0
3k3g,C,63,78,15,QLLGVDKPLVRAGLF,0
3k3g,C,79,92,13,FNGTLAGIALPFF,0
3k3g,C,98,114,16,MLGYVALNGAFTTIIM,0
3k3g,C,115,128,13,SLLNFLGKWGVPA,0
3k3g,C,129,144,15,TAPFVLATWLLMFGV,0
3k3g,C,164,167,3,GLA,0
3k3g,C,178,193,15,EGLFKGVGEVMFQDN,0
3k3g,C,195,205,10,TGVIFVVAIL,0
3k3g,C,206,209,3,NSR,0
3k3g,C,210,229,19,SALFAVIGSLVGLCTALIM,0
3k3g,C,239,253,14,LYGFNSVLCGIAMG,0
3k3g,C,254,264,10,IFFYLNIRTF,0
3k3g,C,265,285,20,YALGCMVLGAIATGAFSVLL,0
3k3g,C,291,304,13,ALTWPFIVVTWLF,0
3k3g,C,305,334,29,FAGSMFRNIAQVPTEKAGTPEDNLRSLAI,0
3k3g,C,335,337,2,SR,0
3wt9,A,20,42,22,DAQWVVFAVMALAAIVFSIAVQ,0
3wt9,A,43,49,6,RPLPLR,0
3wt9,A,50,73,23,TYYVNIAICTIAATAYYAMAVNG,0
3wt9,A,90,110,20,YARYIDWVFTTPLLLLDLVL,0
3wt9,A,111,116,5,TNMPA,0
3wt9,A,117,139,22,MIAWIMGADIAMIAFGIIGAFT,0
3wt9,A,144,164,20,WFYFVVGCIMLAVLAWGMIN,0
3wt9,A,165,180,15,IFKEELQKHKEYTGA,0
3wt9,A,181,205,24,TTLLIYLIVLWVIYPIVWGLGAGG,0
3wt9,A,212,235,23,EIIAMGILDLLAKPLYAIGVLIT,0
3wt9,A,236,244,8,EVVYGKLG,0
4bot,E,-16,0,16,VLTLLLIICLALEVRS,0
4bot,E,165,171,6,VVEWIH,0
4bot,E,221,243,22,IINIIAPCVLISSLVVLVYFLP,0
4bot,E,244,250,6,QAGGQK,0
4bot,E,251,273,22,TLSISVLLAQTIFLFLIAQKVP,0
4bot,E,284,308,24,YLIFVMFVSLVIVTNCVIVLNVSL,0
4bot,E,309,314,5,TPNTH,0
4bot,E,315,413,98,LSEKIKHLFLEFLPKYLGMHLEPSEETPEKPQPRRRSSFGIMIKAEEYILKKPRSELMFEEQKDRHGLKRVNKMTSDIDIGTTVDLYKDLANFAPEIK,0
4bot,E,414,448,34,CVEACNFIAKSTKEQNDSGSENENWVLIGKVIDK,0
4bot,E,449,473,24,CFWIALLLFSLGTLAIFLTGHLNQ,0
4bot,E,477,488,11,PFPGDPRKYVP,0
1ap9,C,1,6,5,AQITG,0
1ap9,C,7,9,2,PE,0
1ap9,C,10,31,21,IWLALGTALMGLGTLYFLVKG,0
1ap9,C,44,62,18,ITTLVPAIAFTMYLSMLL,0
1ap9,C,63,79,16,YGLTMVPFGGEQNPIY,0
1ap9,C,80,97,17,ARYADWLFTTPLLLLDL,0
1ap9,C,108,127,19,LALVGADGIMIGTGLVGAL,0
1ap9,C,128,132,4,KVYS,0
1ap9,C,133,153,20,RFVWWAISTAAMLYILYVLF,0
1ap9,C,174,195,21,RNVTVVLWSAYPVVWLIGSEG,0
1ap9,C,196,203,7,GIVPLNI,0
1ap9,C,204,223,19,TLLFMVLDVSAKVGFGLIL,0
1ap9,C,226,248,22,RAIFGEAEAPEPSAGDGAAATS,0
2v8n,A,1,10,9,YYLKNTNFW,0
2v8n,A,11,34,23,FGLFFFFYFFIMGAYFPFFPIWL,0
2v8n,A,43,64,21,DTGIIFAAISLFSLLFQPLFG,0
2v8n,A,65,74,9,LSDKLGLRK,0
2v8n,A,75,96,21,LLWIITGMLVMFAPFFIFIFG,0
2v8n,A,105,129,24,GSIVGGIYLGFCFNAGAPAVEAFI,0
2v8n,A,130,142,12,KVSRRSNFEFGR,0
2v8n,A,143,162,19,RMFGCVGWALCASIVGIMF,0
2v8n,A,168,188,20,VFWLGSGCALILAVLLFFAK,0
2v8n,A,189,209,20,DAPSSATVANAVGANHSAFS,0
2v8n,A,210,216,6,KLALEL,0
2v8n,A,217,222,5,RQPKL,0
2v8n,A,223,247,24,FLSLYVIGVSCTYDVFDQQFANFF,0
2v8n,A,259,279,20,VFGYVTTMGELLNASIMFFA,0
2v8n,A,280,286,6,LIINRI,0
2v8n,A,287,288,1,G,0
2v8n,A,289,309,20,NALLLAGTIMSVRIIGSSFA,0
2v8n,A,314,333,19,VVILKTLHMFEVPFLLVGC,0
2v8n,A,334,350,16,KYITSQFEVRFSATIY,0
2v8n,A,351,373,22,VCFCFFKQLAMIFMSVLAGNMY,0
2v8n,A,379,400,21,GAYLVLGLVALGFTLISVFTL,0
2v8n,A,401,417,16,GPGPLSLLRRQVNEVA,0
3pqr,A,1,39,38,NGTEGPNFYVPFSNKTGVVRSPFEAPQYYLAEPWQFSM,0
3pqr,A,40,65,25,AAYMFLLIMLGFPINFLTLYVTVQH,0
3pqr,A,69,96,27,TPLNYILLNLAVADLFMVFGGFTTTLY,0
3pqr,A,97,112,15,SLHGYFVFGPTGCNL,0
3pqr,A,113,137,24,GFFATLGGEIALWSLVVLAIERYV,0
3pqr,A,149,172,23,ENHAIMGVAFTWVMALACAAPPL,0
3pqr,A,173,202,29,GWSRYIPEGMQCSCGIDYYTPHEETNNES,0
3pqr,A,203,228,25,VIYMFVVHFIIPLIVIFFCYGQLVF,0
3pqr,A,250,274,24,TRMVIIMVIAFLICWLPYAGVAFY,0
3pqr,A,275,289,14,FTHQGSDFGPIFMT,0
3pqr,A,290,311,21,PAFFAKTSAVYNPVIYIMMNK,0
3pqr,A,312,321,9,FRNCMVTTL,0
3pqr,A,327,348,21,LGDDEASTTVSKTETSQVAPA,0
3b9z,C,31,41,10,INEARLVAQY,0
3b9z,C,42,60,18,YSINILAMLLVGFGFLMV,0
3b9z,C,69,88,19,TTGTYLVVATGLPLYILLR,0
3b9z,C,89,104,15,NGIFGHALTPHSVDA,0
3b9z,C,105,123,18,IYAEFAVATGLIAMGAVL,0
3b9z,C,129,150,21,QYALLALFIVPVYLLNEWLVL,0
3b9z,C,151,161,10,NASGLTEGFQ,0
3b9z,C,162,183,21,SAGSIAIHAFGAYFGLGVSIA,0
3b9z,C,203,221,18,SMLGSMVLWLFWPSFATA,0
3b9z,C,222,231,9,VPFEQMPQT,0
3b9z,C,232,252,20,VNTLLALCGATLATYFLSAL,0
3b9z,C,261,278,17,DMANAALAGGVAIGSVC,0
3b9z,C,279,281,2,IV,0
3b9z,C,282,301,19,PVGAFVIGLLGGAISVVGF,0
3b9z,C,317,338,21,CGVHNLHGLPGLLGGFSAILI,0
3b9z,C,339,343,4,PGIA,0
3b9z,C,344,371,27,AQLTGIGITLALALIGGVIAGALIKLT,0
1mhs,B,113,134,21,LKFLGFFVGPIQFVMEGAAVL,0
1mhs,B,135,143,8,AGLEDWVD,0
1mhs,B,144,164,20,GVICGLLLLNAVVGFVQEFQ,0
1mhs,B,294,313,19,TILLILVIFTLLIVWVSSF,0
1mhs,B,314,319,5,RSNPI,0
1mhs,B,320,341,21,QILEFTLAITIIGVPVGLPAV,0
1mhs,B,690,713,23,YVVYRIALSIHLEIFLGLWIAIL,0
1mhs,B,714,716,2,RS,0
1mhs,B,717,737,20,NIELVVFIAIFADVATLAIA,0
1mhs,B,760,783,23,LLGVVLAVGTWITVTTMYAQGEN,0
1mhs,B,784,794,10,GIVQNFGNMD,0
1mhs,B,795,813,18,VLFLQISLTENWLIFITR,0
1mhs,B,827,843,16,SGAIFLVDILATCFTI,0
1mhs,B,844,853,9,GWFEHSDTS,0
1mhs,B,854,875,21,VAVVRIWIFSFGIFCIMGGVY,0
5v56,A,59,231,172,PLSHCGRAAPCEPLRYNVCLGSVLPYGATSTLLAGDSDSQEEAHGKLVLWSGLRNAPRCWAVIQPLLCAVYMPKCENDRVELPSRTLCQATRGPCAIVERERGWPDFLRCTPDRFPEGCTNEVQNIKFNSSGQCMVPLVRTDNPKSWYEDVEGCGIQCQNPLFTEAEHQDMH,0
5v56,A,232,256,24,YIAAFGAVTGLCTLFTLATFVADW,0
5v56,A,263,287,24,AVILFYVNACFFVGSIGWLAQFMD,0
5v56,A,289,294,5,RREIV,0
5v56,A,295,312,17,RADGTMRLGEPTSNETL,0
5v56,A,313,343,30,CVIIFVIVYYALMAGVVWFVVLTYAWHTSF,0
5v56,A,356,377,21,TSYFHLLTWSLPFVLTVAILA,0
5v56,A,378,400,22,AQVDGDSVSGICFVGYKNYRYR,0
5v56,A,401,428,27,GFVLAPIGLVLIVGGYFLIRGVMTLFS,0
5v56,A,1134,1146,12,DDIVGWAHDVRG,0
5v56,A,450,471,21,RLGIFGFLAFGFVLITFSCHF,0
5v56,A,472,517,45,DFFNQAEWERSFRDYVLCQANVTIGLPTKQPIPDCEIKNRPSLLV,0
5v56,A,518,539,21,KINLFAMFGTGIAMSTWVWTK,0
5v56,A,540,552,12,TLLIWRRTWCRL,0
4kkb,B,16,17,1,R,0
4kkb,B,37,61,24,MAAVVGTLVGLAAVAFDKGVAWLQ,0
4kkb,B,62,83,21,QRMGALVHTADNYPLLLTVAF,0
4kkb,B,84,97,13,CSAVLAMFGYFLV,0
4kkb,B,129,142,13,VKFFGGLGTLGGG,0
4kkb,B,144,156,12,LGRAGPTVQIGG,0
4kkb,B,180,203,23,GAAAGLAAAFNAPLAGILFIIEE,0
4kkb,B,216,232,16,AVFIGVIMSTIMYRIF,0
4kkb,B,233,252,19,HEVALIDVGKLSDAPLNTL,0
4kkb,B,253,277,24,LYLILGIIFGIFGPIFNKWVLGMQ,0
4kkb,B,290,305,15,WVLMGGAIGGLCGLL,0
4kkb,B,306,337,31,FVAPATSGGGFNLIPIATAGNFSMGMLVFIF,0
4kkb,B,338,351,13,ARVITTLLCFSSG,0
4kkb,B,353,368,15,GGIFAPMLALGTVLG,0
4kkb,B,369,391,22,AFGMVAVELFPQYHLEAGTFAI,0
4kkb,B,392,415,23,GMGALLAASIRAPLTGIILVLEM,0
4kkb,B,416,422,6,DNYQLI,0
4kkb,B,423,439,16,PMIITGLGATLLAQFT,0
4kkb,B,459,461,2,QK,0
5v4s,D,7,14,7,IRVYWDI,0
5v4s,D,15,30,15,VFICIFWASLESPLR,0
5v4s,D,40,55,15,LTCIYFFIDFVFALD,0
5v4s,D,56,59,3,LWN,0
5v4s,D,83,87,4,SWFI,0
5v4s,D,88,104,16,DLIAALPLEYATTTIF,0
5v4s,D,114,129,15,YLLLGVTRILKVFRI,0
5v4s,D,130,148,18,DILQRINLAFQPTPGILR,0
5v4s,D,149,167,18,VLFAFWATLVAHWCAVGW,0
5v4s,D,188,198,10,WTVATIATVG,0
5v4s,D,212,232,20,TIFVMILGAGVYATVIGNIA,0
5v4s,D,233,430,197,ILGSLDLAKAAQRKKMAQVDSFLKARNISQNIRRRVRDYYMYIIDRGWGEDENALLNDLPISLRREVKIQLHRDLLEKVPFLKGADPALVTSLVFSMKPMIFLEGDTIFRRGEKGDDLYILSEGSVDILDSDEKTILLSLQEGQFFGELALVMDAPRSATVRATTTCEIYTLSKTDFDNVLKRFSQFRSAIEESVAH,0
5f15,A,26,29,3,ATG,0
5f15,A,30,45,15,VVLFVAVALVVWFVS,0
5f15,A,88,100,12,HMWVTVVGYELF,0
5f15,A,110,125,15,VALSGLLGIGVSMMA,0
5f15,A,126,135,9,RRWFGARAA,0
5f15,A,136,153,17,FTGLALLAAPMWSVAAH,0
5f15,A,158,173,15,MTLAGVMSCVLAFML,0
5f15,A,174,187,13,GQHPDASVAARRG,0
5f15,A,188,203,15,MVACWAAMGVAILTK,0
5f15,A,205,218,13,VGIALPGLVLVVY,0
5f15,A,219,224,5,LVTRD,0
5f15,A,225,231,6,GLWRRL,0
5f15,A,232,246,14,LALGVVVMLVITVP,0
5f15,A,258,264,6,PNFFFI,0
5f15,A,282,304,22,FYFLPLVIGGFLPWAGIFPKLW,0
5f15,A,305,310,5,AMRAP,0
5f15,A,317,323,6,FRPALM,0
5f15,A,324,338,14,GIWAIAIFVFFSIS,0
5f15,A,344,358,14,YIVPVIPALGILAG,0
5f15,A,359,369,10,ALDRLSPRSW,0
5f15,A,370,386,16,KQLIGMAIVAACGLLA,0
5f15,A,413,427,14,FVVMLLGIAVARLL,0
5f15,A,428,434,6,RRGVLP,0
5f15,A,435,449,14,VAVYAMGMYLGFTV,0
2fee,B,1,17,16,KTDTPSLETPQAARLR,0
2fee,B,37,61,24,MAAVVGTLVGLAAVAFDKGVAWLQ,0
2fee,B,62,80,18,QRMGALVHTADNYPLLLT,0
2fee,B,81,97,16,AFLCSAVLAMFGYFLV,0
2fee,B,128,142,14,PVKFFGGLGTLGGG,0
2fee,B,144,159,15,LGREGPTVQIGGNIG,0
2fee,B,180,204,24,GAAAGLAAAFNAPLAGILFIIEEM,0
2fee,B,216,232,16,AVFIGVIMSTIMYRIF,0
2fee,B,233,252,19,HEVALIDVGKLSDAPLNTL,0
2fee,B,253,277,24,LYLILGIIFGIFGPIFNKWVLGMQ,0
2fee,B,278,284,6,LLHRVH,0
2fee,B,290,305,15,WVLMGGAIGGLCGLL,0
2fee,B,306,336,30,FVAPATSGGGFNLIPIATAGNFSMGMLVFI,0
2fee,B,337,351,14,VARVITTLLCFSSG,0
2fee,B,353,368,15,GGIFAPMLALGTVLG,0
2fee,B,369,391,22,AFGMVAVELFPQYHLEAGTFAI,0
2fee,B,392,415,23,GMGALLAASIRAPLTGIILVLEM,0
2fee,B,416,421,5,DNYQL,0
2fee,B,422,439,17,LPMIITGLGATLLAQFT,0
2fee,B,459,465,6,QLARSK,0
4kjq,B,16,17,1,R,0
4kjq,B,37,61,24,MAAVVGTLVGLAAVAFDKGVAWLQ,0
4kjq,B,62,83,21,QRMGALVHTADNYPLLLTVAF,0
4kjq,B,84,97,13,CSAVLAMFGYFLV,0
4kjq,B,128,142,14,PVKFFGGLGTLGGG,0
4kjq,B,144,156,12,LGREGPTVQIGG,0
4kjq,B,180,203,23,GAAAGLAAAFNAPLAGILFIIEE,0
4kjq,B,216,232,16,AVFIGVIMSTIMYRIF,0
4kjq,B,233,252,19,HEVALIDVGKLSDAPLNTL,0
4kjq,B,253,277,24,LYLILGIIFGIFGPIFNKWVLGMQ,0
4kjq,B,290,305,15,WVLMGGAIGGLCGLL,0
4kjq,B,306,337,31,FVAPATSGGGFNLIPIATAGNFSMGMLVFIF,0
4kjq,B,338,351,13,ARVITTLLCFSSG,0
4kjq,B,353,368,15,GGIFAPMLALGTVLG,0
4kjq,B,369,392,23,AFGMVAVELFPQYHLEAGTFAIA,0
4kjq,B,393,415,22,MGALLAASIRAPLTGIILVLEM,0
4kjq,B,416,422,6,DNYQLI,0
4kjq,B,423,439,16,PMIITGLGATLLAQFT,0
4kjq,B,459,461,2,QK,0
5f1c,C,29,30,1,L,0
5f1c,C,31,51,20,RLIQLLILGYIIGYVIIYQK,0
5f1c,C,343,366,23,LSPIPIAINIGSGLGLMVVATVL,0
5f1c,C,367,372,5,DLVVL,0
3b5y,B,1,9,8,HNDKDLST,0
3b5y,B,10,27,17,QTFRRLWPTIAPFKAGL,0
3b5y,B,28,44,16,VAGIALILNAASDTFM,0
3b5y,B,68,85,17,LVVIGLMILRGITSYIS,0
3b5y,B,86,143,57,YCISWVSGKVVMTMRRRLFGHMMGMPVAFFDKQSTGTLLSRITYDSEQVASSSSGAL,0
3b5y,B,144,161,17,TVVREGASIIGLFIMMF,0
3b5y,B,168,182,14,IILVVLAPIVSIAI,0
3b5y,B,183,248,65,VVSKRFRSISKNMQNTMGQVTTSAEQMLKGHKEVLIFGGQEVETKRFDKVSNKMRLQGMKMVSAS,0
3b5y,B,249,263,14,ISDPIIQLIASLAL,0
3b5y,B,291,303,12,IALMRPLKSLTN,0
3b5y,B,304,581,277,NAQFQRGMAACQTLFAILDSEQEKDEGKRVIDRATGDLEFRNVTFTYPGREVPALRNINLKIPAGKTVALVGRSGSGKSTIASLITRFYDIDEGHILMDGHDLREYTLASLRNQVALVSQNVHLFNDTVANNIAYARTEEYSREQIEEAARMAYAMDFINKMDNGLDTIIGENGVLLSGGQRQRIAIARALLRDSPILILDEATSALDTESERAIQAALDELQKNRTSLVIAHRLSTIEQADEIVVVEDGIIVERGTHSELLAQHGVYAQLHKMQFG,0
4kjs,D,1,3,2,NR,0
4kjs,D,5,19,14,FILVAAGVPLSVIG,0
4kjs,D,20,29,9,LMHWPSAVL,0
4kjs,D,30,49,19,AVYCVTIIALASYMGRATE,0
4kjs,D,54,57,3,AGP,0
4kjs,D,60,79,19,GLLNATFGNAVELIISMFA,0
4kjs,D,80,87,7,KEGLTGI,0
4kjs,D,88,110,22,LASLTGSVLGNLLLVAGLSFFV,0
4kjs,D,129,146,17,GLLIFAIIVAFVIPEVF,0
4kjs,D,147,156,9,VGMGNASKL,0
4kjs,D,157,175,18,LSIGISIIMILLYVAALY,0
4kjs,D,178,201,23,VTHRGVYQPNNAAQTEEEEEPEW,0
4kjs,D,206,224,18,TIVLFAATIVVAYISENL,0
4kjs,D,225,227,2,HT,0
4kjs,D,228,235,7,HSVAEQF,0
4kjs,D,236,240,4,WSEL,0
4kjs,D,241,260,19,IGVIIVAIVGNAAEHASAI,0
4kjs,D,273,296,23,IAVGSTLQIAMFVAPVLVICSIF,0
4kjs,D,297,302,5,PTSMP,0
4kjs,D,303,324,21,VFTLPELVAMVSAVLLMIAIS,0
4kjs,D,332,349,17,EGATLLAAYVIMAIGFF,0
4kjs,D,350,351,1,L,0
2v61,A,1,2,1,S,0
2v61,A,3,485,482,KCDVVVVGGGISGMAAAKLLHDSGLNVVVLEARDRVGGRTYTLRNQKVKYVDLGGSYVGPTQNRILRLAKELGLETYKVNEVERLIHHVKGKSYPFRGPFPPVWNPITYLDHNNFWRTMDDMGREIPSDAPWKAPLAEEWDNMTMKELLDKLCWTESAKQLATLFVNLCVTAETHEVSALWFLWYVKQCGGTTRIISTTNGGQERKFVGGSGQVSERIMDLLGDRVKLERPVIYIDQTRENVLVETLNHEMYEAKYVISAIPPTLGMKIHFNPPLPMMRNQMITRVPLGSVIKCIVYYKEPFWRKKDYCGTMIIDGEEAPVAYTLDDTKPEGNYAAIMGFILAHKARKLARLTKEERLKKLCELYAKVLGSLEALEPVHYEEKNWCEEQYSGGCYTTYFPPGILTQYGRVLRQPVDRIYFAGTETATHWSGYMEGAVEAGERAAREILHAMGKIPEDEIWQSEPESVDVPAQPITTTFLERH,0
2v61,A,486,501,15,PSVPGLLRLIGLTTI,0
2v61,A,502,520,18,SATALGFLAHKRGLLVRV,0
1j95,D,1,23,22,PPMLSGLLARLVKLLLGRHGSA,0
1j95,D,27,50,23,AAGAATVLLVIVLLAGSYLAVLA,0
1j95,D,51,65,14,RGAPGAQLITYPRA,0
1j95,D,66,79,13,WWSVETATTVGYG,0
1j95,D,80,86,6,LYPVTL,0
1j95,D,87,111,24,GRCVAVVVMVAGITSFGLVTAALA,0
1j95,D,122,125,3,GHF,0
5tzr,A,6,31,25,LSFGLYVAAFALGFPLNVLAIRGAT,0
5tzr,A,32,41,9,HARLRLTPS,0
5tzr,A,42,67,25,VYALNLGCSDLLLTVSLPLKAVEAL,0
5tzr,A,75,103,28,ASLCPVFAVAHFAPLYAGGGFLAALSAA,0
5tzr,A,104,111,7,YLGAAFP,0
5tzr,A,120,122,2,CY,0
5tzr,A,123,146,23,WGVCAAIWALVLCHLGLVFGLEA,0
5tzr,A,179,204,25,GPARFSLSLLLFFLPLAITAFCFVG,0
5tzr,A,205,2223,2018,LRALARGSNIFEMLRIDEGLRLKIYKDTEGYYTIGIGHLLTKSPSLNAAKSELDKAIGRNTNGVITKDEAEKLFNQDVDAAVRGILRNAKLKPVYDSLDAVRRAALINMVFQMGETGVAGFTNSLRMLQQKRWDEAAVNLAKSRWYNQTPNRAKRVITTFRTGTWDAYGSLTHRRKLRAA,0
5tzr,A,2224,2250,26,VAGGALLTLLLCVGPYNASNVASFLY,0
5tzr,A,2257,2280,23,RKLGLITGAWSVVLNPLVTGYLG,0
5tzr,A,2281,2284,3,GPG,0
5hj8,D,137,149,12,PSSPSLLRAIPG,0
5hj8,D,154,170,16,LLLLVIFYVFAVMGTK,0
5hj8,D,171,183,12,FAQSFPEWFGTL,0
5hj8,D,184,200,16,ASMYTLFQVMTLESWS,0
5hj8,D,201,213,12,GIARPVIEAYPW,0
5hj8,D,214,233,19,WIYFVSFILVSSFTVLNLF,0
5hj8,D,243,253,10,AHWEGGGAKR,0
5hj8,D,287,288,1,R,0
4eed,E,22,25,3,SHM,0
4eed,E,26,293,267,FEIEVMNYSIEEFREFKTTDVESVLPFRDSSTPTWINITGIHRTDVVQRVGEFFGIHPLVLEDILNVHQRPKVEFFENYVFIVLKMFTYDKNLHELESEQVSLILTKNCVLMFQEKIGDVFDPVRERIRYNRGIIRKKRADYLLYSLIDALVDDYFVLLEKIDDEIDVLEEEVLERPEKETVQRTHQLKRNLVELAATIWPLREVLSSLYRDVPPLIEKETVPYFRDVYDHTIQIADTVETFRDIVSGLLDVYLSSVSNKTNEVMKV,0
4eed,E,294,315,21,TIIATIFMPLTFIAGIYGMNF,0
4eed,E,316,325,9,YMPELRWKW,0
4eed,E,327,346,19,PVVLAVMGVIAVIMVVYFK,0
4eed,E,347,349,2,KK,0
4eed,E,350,351,1,L,0
4kk6,B,16,17,1,R,0
4kk6,B,37,61,24,MAAVVGTLVGLAAVAFDKGVAWLQ,0
4kk6,B,62,83,21,QRMGALVHTADNYPLLLTVAF,0
4kk6,B,84,97,13,CSAVLAMFGYFLV,0
4kk6,B,129,142,13,VKFFGGLGTLGGG,0
4kk6,B,144,156,12,LGREGPTVQIGG,0
4kk6,B,180,204,24,GAAAGLAAAFNAPLAGILFIIEEM,0
4kk6,B,216,232,16,AVFIGVIMSTIMYRIF,0
4kk6,B,233,252,19,HEVALIDVGKLSDAPLNTL,0
4kk6,B,253,277,24,LYLILGIIFGIFGPIFNKWVLGMQ,0
4kk6,B,290,305,15,WVLMGGAIGGLCGLL,0
4kk6,B,306,337,31,FVAPATSGGGFNLIPIATAGNFSMGMLVFIF,0
4kk6,B,338,351,13,ARVITTLLCFSSG,0
4kk6,B,353,368,15,GGIFAPMLALGTVLG,0
4kk6,B,369,391,22,AFGMVAVELFPQYHLEAGTFAI,0
4kk6,B,392,415,23,GMGALLAASIRAPLTGIILVLEM,0
4kk6,B,416,422,6,DNYQLI,0
4kk6,B,423,439,16,PMIITGLGATLLAQFT,0
4kk6,B,459,461,2,QK,0
2xow,A,92,93,1,A,0
2xow,A,94,113,19,PVTWVMMIACVVVFIAMQI,0
2xow,A,116,123,7,QEVMLWL,0
2xow,A,137,143,6,YFTHAL,0
2xow,A,148,163,15,MHILFNLLWWWYLGG,0
2xow,A,164,171,7,VEKRLGS,0
2xow,A,172,190,18,KLIVITLISALLSGYVQQ,0
2xow,A,198,214,16,GLSGVVYALMGYVWLR,0
2xow,A,215,227,12,ERDPQSGIYLQR,0
2xow,A,228,247,19,LIIFALIWIVAGWFDLFGM,0
2xow,A,250,268,18,NGAHIAGLAVGLAMAFVD,0
2xow,A,269,270,1,L,0
4b4a,A,1,4,3,PLT,0
4b4a,A,9,27,18,LRYRLIISIIAFLIGSGI,0
4b4a,A,28,69,41,FYFAKYVFEILKEPILKSYPEVELITLSPTEPLFILIKISL,0
4b4a,A,70,87,17,VGFIIASPVILYQFWRF,0
4b4a,A,101,122,21,PLLLGSILLFMLGALFAYFIV,0
4b4a,A,123,154,31,PLALKFLLGLGFTQLLATPYLSVDMYISFVL,0
4b4a,A,155,171,16,LVVAFGIAFEMPIVLY,0
4b4a,A,185,203,18,SFRKYFIVIAFVIGAIIA,0
4b4a,A,204,206,2,DV,0
4b4a,A,207,226,19,TQVLMAIPLLLLYEISIFL,0
4b4a,A,230,249,19,TRKKKEIQKAPGSENLYFQ,0
2xnd,Q,16,28,12,GVAGSGAGIGTV,0
2xnd,Q,29,51,22,GSLIIGYARNPSLKQQLFSYAI,0
2xnd,Q,52,65,13,GFALSEAMGLFCL,0
3ubb,C,94,112,18,PVTWVMMIACVVVFIAMQ,0
3ubb,C,113,139,26,LGDQEVMLWLAWPFDPTLKFEFWRYF,0
3ubb,C,140,165,25,HALMHFSLMHILFNLLWWWYLGGAV,0
3ubb,C,172,189,17,KLIVITLISALLSGYVQ,0
3ubb,C,190,198,8,KFSGPWFG,0
3ubb,C,199,214,15,LSGVVYALMGYVWLR,0
3ubb,C,226,242,16,RGLIIFALIWIVAGWF,0
3ubb,C,243,252,9,LFGMSMANG,0
3ubb,C,253,268,15,HIAGLAVGLAMAFVD,0
3ubb,C,271,272,1,A,0
4ntf,C,8,28,20,ATVTLVGVLLQAYFSLQVIS,0
4ntf,C,29,51,22,RRAFHVSPPLTSGPPEFERVFR,0
4ntf,C,52,71,19,QVNCSEYFPLFLATLWVAG,0
4ntf,C,79,97,18,ALCGLFYLFARLRYFQGY,0
4ntf,C,98,103,5,RSAQL,0
4ntf,C,104,124,20,LTPLYASARALWLLVAMAAL,0
1s54,E,5,9,4,GRPE,0
1s54,E,10,34,24,IWLALGTALMGLGALYFLVKGMGV,0
1s54,E,40,62,22,KFYAITTLVPAIAFTMYLSMLL,0
1s54,E,63,79,16,YGLTMVPFGGEQNPIY,0
1s54,E,80,100,20,ARYADWLFTTPLLLLDLALL,0
1s54,E,104,127,23,QGTILALVGADGIMIGTGLVGAL,0
1s54,E,128,133,5,KVYSY,0
1s54,E,134,157,23,FVWWAISTAAMLYILYVLFFGFT,0
1s54,E,171,192,21,KVLRNVTVVLWSAYPVVWLIG,0
1s54,E,193,202,9,EGAGIVPLN,0
1s54,E,203,226,23,ETLLFMVLDVSAKVGFGLILLRS,0
2o9j,A,55,73,18,QFEDLLVRILLLAACISF,0
2o9j,A,74,88,14,LAWFEEGEETITAF,0
2o9j,A,89,107,18,EPFVILLILIANAIVGVW,0
2o9j,A,254,274,20,EFGEQLSKVISLICVAVWLI,0
2o9j,A,276,289,13,GHFNDPVHGGSWI,0
2o9j,A,290,295,5,GAIYY,0
2o9j,A,296,317,21,KIAVALAVAAIPEGLPAVITT,0
2o9j,A,760,780,20,IRYLISSNVGEVVCIFLTAA,0
2o9j,A,781,786,5,GLPEA,0
2o9j,A,787,807,20,IPVQLLWVNLVTDGLPATAL,0
2o9j,A,830,852,22,GWLFFRYMAIGGYVGAATVGAA,0
2o9j,A,853,897,44,WWFMYAEDGPGVTYHQLTHFMQCTEDHPHFEGLDCEIFEAPEPM,0
2o9j,A,898,916,18,MALSVLVTIEMCNALNSL,0
2o9j,A,931,950,19,WLLGSICLSMSLHFLILYV,0
2o9j,A,951,956,5,PLPMI,0
2o9j,A,957,964,7,KLKALDL,0
2o9j,A,965,987,22,QWLMVLKISLPVIGLDEILKFI,0
1c17,M,95,102,7,GKSKLIA,0
1c17,M,103,121,18,LALTIFVWVFLMNLMDLL,0
1c17,M,146,163,17,VNVTLSMALGVFILILF,0
1c17,M,164,169,5,SIKMK,0
1c17,M,170,198,28,IGGFTKELTLQPFNHWAFIPVNLILEGV,0
1c17,M,199,201,2,LL,0
1c17,M,202,219,17,KPVSLGLRLFGNMYAGE,0
1c17,M,245,262,17,ILIITLQAFIFMVLTIV,0
1c17,M,263,265,2,LS,0
1c17,M,266,271,5,ASEEH,0
3k0i,C,-7,4,11,GHHHHHHMIEW,0
3k0i,C,5,15,10,IRRSVANRFL,0
3k0i,C,16,28,12,LMGALFLSIWGT,0
3k0i,C,341,354,13,LLEEFIVVAVVCA,0
3k0i,C,355,361,6,FLWHVR,0
3k0i,C,362,380,18,ALVAIISLPLGLCIAFIV,0
3k0i,C,397,408,11,IAVGAMVDAAI,0
3k0i,C,409,424,15,MIENAHKRLEEWQHQ,0
3k0i,C,425,432,7,PDATLDN,0
3k0i,C,433,450,17,TRWQVITDASVEVGPAL,0
3k0i,C,451,462,11,ISLLIITLSFI,0
3k0i,C,483,496,13,YAMAGAALLAIVV,0
3k0i,C,497,503,6,PILMGY,0
3k0i,C,504,515,11,IRGKIPPESSN,0
3k0i,C,516,518,2,LN,0
3k0i,C,519,533,14,FLIRVYHPLLLKVL,0
3k0i,C,534,540,6,WPKTTL,0
3k0i,C,541,552,11,VAALSVLTVLW,0
3k0i,C,876,888,12,PMTLMIIFVLLY,0
3k0i,C,889,897,8,AFRRVGEA,0
3k0i,C,898,914,16,LIISSVPFALVGGIWL,0
3k0i,C,930,942,12,IALAGVAAEFGV,0
3k0i,C,943,984,41,MLMYLRHAIEAVPSLNNPQTFSEQKLDEALYHGAVLRVRPK,0
3k0i,C,985,997,12,MTVAVIIAGLLP,0
3k0i,C,1014,1027,13,PMIGGMITAPLLS,0
3k0i,C,1028,1031,3,FII,0
3k0i,C,1032,1037,5,AAYKL,0
3k0i,C,1038,1039,1,W,0
3k0i,C,1040,1047,7,HRHRVRK,0
2oa0,A,55,73,18,QFEDLLVRILLLAACISF,0
2oa0,A,74,89,15,LAWFEEGEETITAFV,0
2oa0,A,90,109,19,PFVILLILIANAIVGVWQE,0
2oa0,A,254,275,21,EFGEQLSKVISLICVAVWLIN,0
2oa0,A,276,283,7,GHFNDPV,0
2oa0,A,284,295,11,GGSWIRGAIYY,0
2oa0,A,296,318,22,KIAVALAVAAIPEGLPAVITTC,0
2oa0,A,760,781,21,IRYLISSNVGEVVCIFLTAAL,0
2oa0,A,782,785,3,LPE,0
2oa0,A,786,808,22,LIPVQLLWVNLVTDGLPATALG,0
2oa0,A,833,852,19,FFRYMAIGGYVGAATVGAA,0
2oa0,A,853,882,29,WWFMYAEDGPGVTYHQLTHFMQCTEDHPH,0
2oa0,A,883,888,5,EGLDC,0
2oa0,A,889,897,8,IFEAPEPM,0
2oa0,A,898,916,18,MALSVLVTIEMCNALNSL,0
2oa0,A,927,948,21,WVNIWLLGSICLSMSLHFLIL,0
2oa0,A,949,950,1,V,0
2oa0,A,951,956,5,PLPMI,0
2oa0,A,957,966,9,KLKALDLTQ,0
2oa0,A,967,987,20,LMVLKISLPVIGLDEILKFI,0
1m2u,A,1,10,9,YYLKNTNFW,0
1m2u,A,12,17,5,GLFFF,0
1m2u,A,18,33,15,YFFIMGCYCCCFPCW,0
1m2u,A,34,46,12,HDINHISKSDTG,0
1m2u,A,47,48,1,I,0
1m2u,A,49,66,17,AACCLFSCLFCPLCGLL,0
1m2u,A,68,73,5,KLGLR,0
1m2u,A,76,95,19,LWIITGMLVMCAPFFICIF,0
1m2u,A,96,99,3,PLL,0
1m2u,A,100,113,13,YNILVGSIVGGIY,0
1m2u,A,115,126,11,FCFCAGCPACE,0
1m2u,A,132,138,6,SRRSNF,0
1m2u,A,146,158,12,CCVGCCLCCSIC,0
1m2u,A,159,167,8,IMFTINNQ,0
1m2u,A,169,179,10,FCLGSGCALI,0
1m2u,A,189,220,31,DAPSSATVANAVGANHSAFSLKLALELFRQP,0
1m2u,A,233,246,13,CCYDCCDCCCACC,0
1m2u,A,247,261,14,TSFFATGEQGTRVC,0
1m2u,A,263,275,12,VCTMGELLCASC,0
1m2u,A,279,290,11,PLIINRIGGKN,0
1m2u,A,296,310,14,TIMSVRIIGSSFAT,0
1m2u,A,311,315,4,ALEV,0
1m2u,A,317,330,13,LKTLHMFEVPFLL,0
1m2u,A,335,346,11,YITSQFEVRFS,0
1m2u,A,351,368,17,VCCCCFKQLCCIFMSVL,0
1m2u,A,369,370,1,G,0
1m2u,A,371,379,8,MYESIGFQ,0
1m2u,A,381,396,15,YLVLGLVACCFCLIS,0
1m2u,A,400,417,17,SGPGPLSLLRRQVNEVA,0
5xab,A,50,77,27,ELVIEQFEDLLVRILLLAACISFVLAW,0
5xab,A,78,85,7,EEGEETI,0
5xab,A,86,105,19,AFVEPFVILLILIANAIVG,0
5xab,A,254,274,20,EFGEQLSKVISLICVAVWLI,0
5xab,A,275,295,20,IGHFNDPVHGGSWIRGAIYY,0
5xab,A,296,314,18,KIAVALAVAAIPEGLPAV,0
5xab,A,761,780,19,RYLISSNVGEVVCIFLTAA,0
5xab,A,781,785,4,GLPE,0
5xab,A,786,806,20,LIPVQLLWVNLVTDGLPATA,0
5xab,A,830,852,22,GWLFFRYMAIGGYVGAATVGAA,0
5xab,A,853,895,42,WWFMYAEDGPGVTYHQLTHFMQCTEDHPHFEGLDCEIFEAPE,0
5xab,A,896,916,20,MTMALSVLVTIEMCNALNSL,0
5xab,A,934,951,17,GSICLSMSLHFLILYVD,0
5xab,A,953,988,35,PMIFKLKALDLTQWLMVLKISLPVIGLDEILKFIA,0
2zy9,B,-22,19,41,GSSHHHHHHSSGLGVLPGGPLHMEEKLAVSLQEALQEGDTR,0
2zy9,B,20,281,261,LREVLEEIHPQDLLALWDELKGEHRYVVLTLLPKAKAAEVLSHLSPEEQAEYLKTLPPWRLREILEELSLDDLADALQAVRKEDPAYFQRLKDLLDPRTRAEVEALARYEEDEAGGLMTPEYVAVREGMTVEEVLRFLRRAAPDAETIYYIYVVDEKGRLKGVLSLRDLIVADPRTRVAEIMNPKVVYVRTDTDQEEVARLMADYDFTVLPVVDEEGRLVGIVTVDDVLDVLEAEATEDIHKLGAVDVPDLVYSEAGPVAL,0
2zy9,B,282,305,23,LARVRWLVILILTGMVTSSILQG,0
2zy9,B,317,335,18,FYVPVLLGTGGNTGNQSA,0
2zy9,B,336,355,19,LIIRALATRDLDLRDWRRV,0
2zy9,B,356,381,25,LKEMGVGLLLGLTLSFLLVGKVYWD,0
2zy9,B,388,409,21,VVGVSLVLIVFFANLVGAMLP,0
2zy9,B,410,421,11,LLRRLGVDPAL,0
2zy9,B,422,443,21,SNPLVATLSDVTGLLIYLSVA,0
2zy9,B,449,450,1,V,0
4lcz,C,9,13,4,VQSS,0
4lcz,C,14,63,49,PWYGPDRVKYLGPFSGESPSYLTGEFPGDYGWDTAGLSADPETFAKNRE,0
4lcz,C,64,82,18,EVIHCRWAMLGALGCVFP,0
4lcz,C,97,105,8,FKAGSQIF,0
4lcz,C,126,142,16,IWACQVILMGAVEGYR,0
4lcz,C,143,179,36,AGGPLGEVVDPLYPGGSFDPLGLADDPEAFAELKVK,0
4lcz,C,180,197,17,IKNGRLAMFSMFGFFVQ,0
4lcz,C,205,214,9,LENLADHLA,0
4lcz,C,222,232,10,NFATNFVPGK,0
2h3o,A,12,26,14,IGTTLVALSSFTPV,0
2h3o,A,28,42,14,ILLGVVGLSALTGY,0
2h3o,A,51,65,14,AIFIGLTIYAIQRK,0
2h3o,A,66,70,4,QADA,0
4pd9,C,-5,1,6,PAVPRM,0
4pd9,C,5,21,16,SCCGMAVLLGIAVLLS,0
4pd9,C,22,29,7,NRKAINL,0
4pd9,C,30,47,17,TVGGAFAIQFSLGAFIL,0
4pd9,C,50,77,27,WGQELLRGFSDAVSNVINYGNDGTSFL,0
4pd9,C,103,118,15,TLIFFSALISVLYYL,0
4pd9,C,120,136,16,MQWVIRILGGGLQKAL,0
4pd9,C,137,175,38,TSRAESMSAAANIFVGQTEAPLVVRPFVPKMTQSELFA,0
4pd9,C,176,192,16,MCGGLASIAGGVLAGY,0
4pd9,C,202,220,18,VAASFMAAPGGLLFAKLM,0
4pd9,C,221,229,8,PETEKPQD,0
4pd9,C,230,240,10,EDITLDGGDD,0
4pd9,C,242,274,32,ANVIDAAAGGASAGLQLALNVGAMLIAFIGLI,0
4pd9,C,275,288,13,LINGMLGGIGGWF,0
4pd9,C,361,379,18,ALCGFANLSSIAILLGGL,0
4pd9,C,380,394,14,SLAPKRRGDIARMG,0
4pd9,C,395,412,17,KAVIAGTLSNLMAATIA,0
4pd9,C,417,418,1,F,0
5t4d,D,220,242,22,LRELVTYLLFLIVLCILTYGMM,0
5t4d,D,243,295,52,SNVYYYTRMMSQLFLDTPVSKTEKTNFKTLSSMEDFWKFTEGSLLDGLYWKM,0
5t4d,D,302,471,169,ADNRSFIFYENLLLGVPRIRQLRVRNGSCSIPQDLRDEIKECYDVYSVSSEDRAPFGPRNGTAWIYTSEKDLNGSSHWGIIATYSGAGYYLDLSRTREETAAQVASLKKNVWLDRGTRATFIDFSVYNANINLFCVVRLLVEFPATGGVIPSWQFQPLKLIRYVTTFDF,0
5t4d,D,472,493,21,LAACEIIFCFFIFYYVVEEIL,0
5t4d,D,505,528,23,FWNCLDVVIVVLSVVAIGINIYR,0
5t4d,D,529,554,25,SNVEVLLQFLEDQNTFPNFEHLAYW,0
5t4d,D,555,580,25,IQFNNIAAVTVFFVWIKLFKFINFN,0
5t4d,D,581,589,8,TMSQLSTT,0
5t4d,D,590,620,30,SRCAKDLFGFAIMFFIIFLAYAQLAYLVFG,0
5t4d,D,621,628,7,QVDDFST,0
5t4d,D,629,646,17,QECIFTQFRIILGDINF,0
5t4d,D,647,652,5,EIEEA,0
5t4d,D,654,681,27,VLGPIYFTTFVFFMFFILLNMFLAIIN,0
3w5c,A,49,55,6,WELVIE,0
3w5c,A,61,77,16,VRILLLAACISFVLAW,0
3w5c,A,78,86,8,EEGEETIT,0
3w5c,A,87,103,16,FVEPFVILLILIANAI,0
3w5c,A,258,276,18,QLSKVISLICVAVWLINI,0
3w5c,A,277,292,15,HFNDPVHGGSWIRGA,0
3w5c,A,293,314,21,YYFKIAVALAVAAIPEGLPAV,0
3w5c,A,763,781,18,LISSNVGEVVCIFLTAAL,0
3w5c,A,782,785,3,LPE,0
3w5c,A,786,806,20,LIPVQLLWVNLVTDGLPATA,0
3w5c,A,834,851,17,FRYMAIGGYVGAATVGA,0
3w5c,A,852,897,45,AWWFMYAEDGPGVTYHQLTHFMQCTEDHPHFEGLDCEIFEAPEPM,0
3w5c,A,898,916,18,MALSVLVTIEMCNALNSL,0
3w5c,A,931,950,19,WLLGSICLSMSLHFLILYV,0
3w5c,A,951,967,16,PLPMIFKLKALDLTQW,0
3w5c,A,968,987,19,MVLKISLPVIGLDEILKFI,0
1msl,E,10,18,8,RGNIVDLA,0
1msl,E,19,42,23,AVVIGTAFTALVTKFTDSIITPL,0
1msl,E,69,90,21,NVLLSAAINFFLIAFAVYFLV,0
1msl,E,91,118,27,LPYNTLRKKGEVEQPGDTQVVLLTEIR,0
2z9r,A,57,77,20,EDLLVRILLLAACISFVLAW,0
2z9r,A,78,85,7,EEGEETI,0
2z9r,A,86,104,18,AFVEPFVILLILIANAIV,0
2z9r,A,257,275,18,EQLSKVISLICVAVWLIN,0
2z9r,A,276,293,17,GHFNDPVHGGSWIRGAI,0
2z9r,A,294,313,19,YFKIAVALAVAAIPEGLPA,0
2z9r,A,760,780,20,IRYLISSNVGEVVCIFLTAA,0
2z9r,A,781,786,5,GLPEA,0
2z9r,A,787,807,20,IPVQLLWVNLVTDGLPATAL,0
2z9r,A,832,852,20,LFFRYMAIGGYVGAATVGAA,0
2z9r,A,853,897,44,WWFMYAEDGPGVTYHQLTHFMQCTEDHPHFEGLDCEIFEAPEPM,0
2z9r,A,898,916,18,MALSVLVTIEMCNALNSL,0
2z9r,A,932,950,18,LLGSICLSMSLHFLILYV,0
2z9r,A,951,964,13,PLPMIFKLKALDL,0
2z9r,A,965,987,22,QWLMVLKISLPVIGLDEILKFI,0
3kso,C,-7,4,11,GHHHHHHMIEW,0
3kso,C,5,15,10,IRRSVANRFL,0
3kso,C,16,31,15,LMGALFLSIWGTWTI,0
3kso,C,339,355,16,GKLLEEFIVVAVVCAL,0
3kso,C,356,360,4,LWHV,0
3kso,C,361,381,20,SALVAIISLPLGLCIAFIVM,0
3kso,C,395,409,14,IAIAVGAMVDAAIV,0
3kso,C,410,424,14,IENAHKRLEEWQHQ,0
3kso,C,425,432,7,PDATLDN,0
3kso,C,433,448,15,TRWQVITDASVEVGP,0
3kso,C,449,465,16,LFISLLIITLSFIPIF,0
3kso,C,480,500,20,TKTYAMAGAALLAIVVIPIL,0
3kso,C,501,502,1,G,0
3kso,C,503,514,11,WIRGKIPPESS,0
3kso,C,516,532,16,LNRFLIRVYHPLLLKV,0
3kso,C,533,538,5,HWPKT,0
3kso,C,539,554,15,LLVAALSVLTVLWPL,0
3kso,C,873,889,16,LMVPMTLMIIFVLLYL,0
3kso,C,890,897,7,FRRVGEA,0
3kso,C,898,918,20,LIISSVPFALVGGIWLLWWM,0
3kso,C,927,942,15,TGFIALAGVAAEFGV,0
3kso,C,943,984,41,MLMYLRHAIEAVPSLNNPQTFSEQKLDEALYHGAVLRVRPK,0
3kso,C,985,1000,15,MTVAVIIAGLLPILW,0
3kso,C,1013,1027,14,APMIGGMITAPLLS,0
3kso,C,1028,1037,9,FIIPAAYKL,0
3kso,C,1039,1047,8,LHRHRVRK,0
3wmo,0,0,6,6,AEQKSL,0
3wmo,0,29,42,13,GLVVIAHLLAWLY,0
3wmo,0,43,46,3,PWL,0
5m7j,D,12,29,17,AQLVWYAQWLVIWTVVL,0
5m7j,D,30,45,15,YLRREDRREGYPLVE,0
5m7j,D,61,258,197,LPYPKTFVLPHGGTVTVPRRRPETRELKLAQTDGFEGAPLQPTGNPLVDAVGPASYAERAEVVDATVDGKAKIVPLRVATDFSIAEGDVDPRGLPVVAADGVEAGTVTDLWVDRSEHYFRYLELSVAGSARTALIPLGFCDVKKDKIVVTSILSEQFANVPRLQSRDQITLREEDKVSAYYAGGLLYATPERAESLL,0
5jdg,A,7,28,21,YFLLGLILLYYGSDWFVLGSE,0
5jdg,A,29,38,9,IARHFNVSN,0
5jdg,A,39,57,18,VIGATVMAIGTSLPEILT,0
5jdg,A,74,93,19,IGSCICNIGLVLGLSAIIS,0
5jdg,A,94,101,7,IIVDKNL,0
5jdg,A,102,120,18,KNILVYLLFVIFAAVIGI,0
5jdg,A,127,144,17,GVVLLILFIIYLRWTVK,0
5jdg,A,145,148,3,GSA,0
5jdg,A,156,162,6,NNPSVV,0
5jdg,A,163,183,20,SLVLLIIGLIGVLVGAELFV,0
5jdg,A,205,222,17,AFGTSLPELMVSLAAAK,0
5jdg,A,223,226,3,NLG,0
5jdg,A,227,247,20,MVLGNVIGSNIADIGGALAV,0
5jdg,A,259,276,17,QMAVLVIMSLLLYLFAK,0
5jdg,A,277,280,3,SKI,0
5jdg,A,281,299,18,RWQGILFLALYIIAIASL,0
4ybq,A,7,21,14,KTGKLTLVLALATF,0
4ybq,A,22,38,16,AAFGSSFQYGYNVAAV,0
4ybq,A,74,91,17,SMFPFGGFIGSLMVGFL,0
4ybq,A,92,100,8,NNLGRKGA,0
4ybq,A,101,120,19,LFNNIFSILPAILMGCSKI,0
4ybq,A,126,146,20,IIASRLLVGICAGISSNVVP,0
4ybq,A,147,163,16,YLGELAPKNLRGALGV,0
4ybq,A,164,183,19,PQLFITVGILVAQLFGLRS,0
4ybq,A,191,207,16,PILLGLTGVPAGLQLL,0
4ybq,A,208,263,55,LPFFPESPRYLLIQKKNESAAEKALQTLRGWKDVDMEMEEIRKEDEAEKAAGFIS,0
4ybq,A,264,269,5,WKLFR,0
4ybq,A,270,277,7,QSLRWQL,0
4ybq,A,278,296,18,STIVLMAGQQLSGVNAIY,0
4ybq,A,316,335,19,TAGTGAVNVFMTMVTVFVV,0
4ybq,A,336,340,4,LWGR,0
4ybq,A,341,358,17,NLLLIGFSTCLTACIVL,0
4ybq,A,377,398,21,CVIVYVIGHAVGPSPIPALFI,0
4ybq,A,399,410,11,EIFLQSSRPSA,0
4ybq,A,411,428,17,MIGGSVHWLSNFIVGLI,0
4ybq,A,442,459,17,IFAIICLLTTIYIFMVV,0
4ybq,A,460,480,20,ETKGRTFVEINQIFAKKNKV,0
4buo,A,47,51,4,GSGP,0
4buo,A,52,61,9,SDLDVNTDI,0
4buo,A,62,83,21,SKVLVTAIYLALFVVGTVGNS,0
4buo,A,94,96,2,LQ,0
4buo,A,110,132,22,LSDLLILLLAMPVELYNFIWVH,0
4buo,A,133,135,2,PW,0
4buo,A,136,158,22,FGDAGCRGYYFLRDACTYATAL,0
4buo,A,194,210,16,LASALLAIPMLFTMGL,0
4buo,A,211,225,14,NLSGDGTHPGGLVC,0
4buo,A,226,251,25,PIVDTATLKVVIQVNTFMSFLFPML,0
4buo,A,271,278,7,AFNMTIE,0
4buo,A,315,334,19,AFVVCWLPYHVRRLMFCYI,0
4buo,A,335,345,10,DEQWTTFLFD,0
4buo,A,346,367,21,YHYFYMLTNALVYVSAAINPI,0
4buo,A,385,399,14,CLCPGTRELEVLFQ,0
5awz,A,11,33,22,GTDAQWVVFAVMALAAIVFSIA,0
5awz,A,34,44,10,QFRPLPLRLT,0
5awz,A,45,67,22,YVNIAICTIAATAYYAMAVNGG,0
5awz,A,83,103,20,YARYIDWVFTTPLLLLDLVL,0
5awz,A,104,109,5,TNMPA,0
5awz,A,110,132,22,MIAWIMGADIAMIAFGIIGAFT,0
5awz,A,137,160,23,WFYFVVGCIMLAVLAWGMINPIF,0
5awz,A,161,173,12,EELQKHKEYTGA,0
5awz,A,174,197,23,TTLLIYLIVLWVIYPIVWGLGAG,0
5awz,A,204,227,23,VEIIAMGILDLLAKPLYAIGVLI,0
5awz,A,228,236,8,VEVVYGKL,0
4i0u,E,1,4,3,EEK,0
4i0u,E,5,295,290,LSAKKGLPPGTLVYTGKYREDFEIEVMNYSIEEFREFKTTDVESVLPFRDSSTPTWINITGIHRTDVVQRVGEFFGIHPLVLEDILNVHQRPKVEFFENYVFIVLKMFTYDKNLHELESEQVSLILTKNCVLMFQEKIGDVFDPVRERIRYNRGIIRKKRADYLLYSLIDALVDDYFVLLEKIDDEIDVLEEEVLERPEKETVQRTHQLKRNLVELRKTIWPLREVLSSLYRDVPPLIEKETVPYFRDVYDHTIQIADTVETFRDIVSGLLDVYLSSVSNKTNEVMKVLT,0
4i0u,E,296,315,19,IATIFMPLTFIAGIYGMNF,0
4i0u,E,324,344,20,WGYPVVLAVMGVIAVIMVVY,0
4i0u,E,345,349,4,KKKK,0
4i0u,E,350,351,1,L,0
2zbe,A,50,76,26,LVIEQFEDLLVRILLLAACISFVLAW,0
2zbe,A,77,86,9,EEGEETITA,0
2zbe,A,87,106,19,VEPFVILLILIANAIVGVW,0
2zbe,A,254,273,19,FGEQLSKVISLICVAVWLI,0
2zbe,A,274,296,22,IGHFNDPVHGGSWIRGAIYYFK,0
2zbe,A,297,317,20,AVALAVAAIPEGLPAVITTC,0
2zbe,A,759,777,18,IRYLISSNVGEVVCIFLT,0
2zbe,A,778,786,8,ALGLPEAL,0
2zbe,A,787,807,20,PVQLLWVNLVTDGLPATALG,0
2zbe,A,830,852,22,WLFFRYMAIGGYVGAATVGAAA,0
2zbe,A,853,866,13,WFMYAEDGPGVTY,0
2zbe,A,867,872,5,QLTHF,0
2zbe,A,873,897,24,QCTEDHPHFEGLDCEIFEAPEPMT,0
2zbe,A,898,916,18,ALSVLVTIEMCNALNSLS,0
2zbe,A,932,950,18,LGSICLSMSLHFLILYVD,0
2zbe,A,951,956,5,LPMIF,0
2zbe,A,957,964,7,LKALDLT,0
2zbe,A,965,987,22,WLMVLKISLPVIGLDEILKFIA,0
3utx,A,1,4,3,AQI,0
3utx,A,10,32,22,IWLALGTALMGLGTLYFLVKGM,0
3utx,A,33,41,8,VSDPDAKK,0
3utx,A,42,66,24,YAIATLVPAIAFTMYLSMLLGYGL,0
3utx,A,79,99,20,WARYADWLFTTPLLLLDLAL,0
3utx,A,100,105,5,VDADQ,0
3utx,A,106,128,22,TILALVGADGIMIGTGLVGALT,0
3utx,A,134,157,23,FVWWAISTAAMLYILYVLFFGFT,0
3utx,A,158,170,12,KAESMRPEVAST,0
3utx,A,171,195,24,KVLRNVTVVLWSAYPVVWLIGSEG,0
3utx,A,202,225,23,IETLLFMVLDVSAKVGFGLILLR,0
3utx,A,226,231,5,RAIFG,0
3utx,A,232,249,17,AEAPEPSAGDGAAATSD,0
4n7w,B,1,2,1,L,0
4n7w,B,6,19,13,RLFPVWALLLSVA,0
4n7w,B,20,23,3,YFR,0
4n7w,B,24,33,9,TTFTGIGPY,0
4n7w,B,34,47,13,GPLLMLIMFAMGV,0
4n7w,B,52,58,6,DFKRVL,0
4n7w,B,68,82,14,FLHYLIMPLTAWIL,0
4n7w,B,83,96,13,MLFRMPPDLSAGM,0
4n7w,B,97,108,11,LVGSVASGTAS,0
4n7w,B,127,141,14,VSTLVGVFATPLLT,0
4n7w,B,142,156,14,LYVDATISVDVVGM,0
4n7w,B,157,171,14,KSILQIVVIPITAG,0
4n7w,B,179,188,9,KTVKRIEPY,0
4n7w,B,189,202,13,PAMSMVCILAIIS,0
4n7w,B,203,208,5,VVAGS,0
4n7w,B,209,215,6,SHIASV,0
4n7w,B,216,219,3,FVV,0
4n7w,B,220,234,14,IAVILHNGIGLLSG,0
4n7w,B,253,266,13,EVGMQNSGLAATL,0
4n7w,B,267,278,11,KIYFSPLAALP,0
4n7w,B,279,293,14,ALFSVWHNLSGSLL,0
2aul,A,34,61,27,YYSVGIFIGVVGIIGILGNGVVIYLFS,0
2aul,A,62,69,7,TKSLQTP,0
2aul,A,70,98,28,NMFIINLAMSDLSFSAINGFPLKTISAF,0
2aul,A,108,132,24,CQLYGLLGGIFGFMSINTMAMISI,0
2aul,A,133,152,19,RYNVIGRPMAASKKMSHRR,0
2aul,A,153,176,23,FLMIIFVWMWSIVWSVGPVFNWG,0
2aul,A,198,222,24,RSFILCMYFCGFMLPIIIIAFCYF,0
2aul,A,223,263,40,IVMSVSNHEKEMAAMAKRLNAKELRKAQAGASAEMKLAKI,0
2aul,A,264,288,24,MVIITQFMLSWSPYAIIALLAQFG,0
2aul,A,294,318,24,PYAAELPVLFAKASAIHNPIVYSV,0
2aul,A,319,320,1,H,0
2aul,A,321,330,9,KFREAIQTT,0
2aul,A,331,363,32,PWLLTCCQFDEKECEDANDAEEEVVASERGGE,0
5c8j,I,6,22,16,DIYYKTLDAIFMPIIK,0
5c8j,I,23,27,4,LHPA,0
5c8j,I,28,45,17,AILIIAIIVSLIINIAT,0
5c8j,I,103,119,16,IYTWVPIILIFIYLRH,0
5c8j,I,120,141,21,YGFGGVYQELNPGWNGVVVYL,0
5c8j,I,142,163,21,IILSKILFIDFWHWLGSIFYK,0
5c8j,I,175,192,17,WLGWYILCSFATSTVLR,0
5c8j,I,193,194,1,I,0
3nan,A,49,56,7,WELVIEQ,0
3nan,A,57,75,18,EDLLVRILLLAACISFVL,0
3nan,A,76,88,12,WFEEGEETITAF,0
3nan,A,89,104,15,EPFVILLILIANAIV,0
3nan,A,257,276,19,EQLSKVISLICVAVWLINI,0
3nan,A,277,295,18,HFNDPVHGGSWIRGAIYY,0
3nan,A,296,314,18,KIAVALAVAAIPEGLPAV,0
3nan,A,761,781,20,RYLISSNVGEVVCIFLTAAL,0
3nan,A,782,785,3,LPE,0
3nan,A,786,807,21,LIPVQLLWVNLVTDGLPATAL,0
3nan,A,834,851,17,FRYMAIGGYVGAATVGA,0
3nan,A,852,899,47,AWWFMYAEDGPGVTYHQLTHFMQCTEDHPHFEGLDCEIFEAPEPMTM,0
3nan,A,900,916,16,LSVLVTIEMCNALNSL,0
3nan,A,922,948,26,MRMPPWVNIWLLGSICLSMSLHFLIL,0
3nan,A,949,950,1,V,0
3nan,A,951,957,6,PLPMIF,0
3nan,A,958,968,10,LKALDLTQWL,0
3nan,A,969,987,18,VLKISLPVIGLDEILKFI,0
4lz9,A,25,39,14,AMIGMFVMALYNVV,0
4lz9,A,40,59,19,TIFISYAVGIEGVAGVTIA,0
4lz9,A,60,74,14,PIMMIMMSMAGALG,0
4lz9,A,103,117,14,ILVLSVIGFISAFT,0
4lz9,A,118,141,23,LGPALQLFGATSVTQGYATDYLF,0
4lz9,A,142,157,15,ILLGSIFFFFAFAAN,0
4lz9,A,169,183,14,MVTMIVPAVLNILL,0
4lz9,A,184,199,15,VLFIFGLNMGVLGAS,0
4lz9,A,200,213,13,ATVIAQASVTGLV,0
4lz9,A,246,259,13,PAFVQQSSASLMM,0
4lz9,A,260,281,21,AINSMLLRFGSDFYVGVFGLV,0
4lz9,A,282,294,12,RIMMFVMMPMMG,0
4lz9,A,326,341,15,TIFSIGIFALLMLFP,0
4lz9,A,342,362,20,ALLRVFTADREVIQAGVSAM,0
4lz9,A,363,376,13,ILFCVTFLIGAQI,0
4lz9,A,392,409,17,ILSLSRQIIFLIPLVLI,0
4lz9,A,410,419,9,PHIFGLSGV,0
4lz9,A,420,433,13,WAFPIADVLSFIL,0
1h68,A,2,5,3,GLT,0
1h68,A,6,26,20,LFWLGAIGMLVGTLAFAWAG,0
1h68,A,36,56,20,YVTLVGISGIAAVAYVVMAL,0
1h68,A,57,69,12,VGWVPVAERTVF,0
1h68,A,70,91,21,PRYIDWILTTPLIVYFLGLLA,0
1h68,A,96,115,19,EFGIVITLNTVVMLAGFAG,0
1h68,A,116,125,9,MVPGIERYA,0
1h68,A,126,146,20,FGMGAVAFLGLVYYLVGPMT,0
1h68,A,160,179,19,VRLRNLTVILWAIYPFIWL,0
1h68,A,180,193,13,GPPGVALLTPTVD,0
1h68,A,194,214,20,ALIVYLDLVTKVGFGFIALD,0
1h68,A,220,239,19,AEHGESLAGVDTDAPAVAD,0
3pjz,B,7,31,24,RIVGLLLALFSVTMLAPALVALLY,0
3pjz,B,32,36,4,DGAG,0
3pjz,B,37,58,21,PFVTTFFVLLFCGAMCWFPNR,0
3pjz,B,70,91,21,LIVVLFWTVLGSAGSLPFLIA,0
3pjz,B,92,98,6,NPNISV,0
3pjz,B,99,116,17,DAFFESFSALTTTGATV,0
3pjz,B,117,125,8,VGLDELPK,0
3pjz,B,126,147,21,ILFYRQFLQWFGGMGIIVLAV,0
3pjz,B,158,173,15,QLYRAEIPGPVKDTK,0
3pjz,B,183,206,23,ALWYIYLSLTIACAVAFWLAGMT,0
3pjz,B,208,225,17,DAISHSFSTIAIGGFST,0
3pjz,B,226,235,9,DASMGYFDS,0
3pjz,B,236,257,21,AINLITVVFLLISACNFTLHF,0
3pjz,B,275,296,21,FRAFIFIQVLLFLVCFLLLLK,0
3pjz,B,297,303,6,HSYTSP,0
3pjz,B,304,326,22,DAFDQALFQTVSISTTAGFTTT,0
3pjz,B,327,332,5,FADWP,0
3pjz,B,333,350,17,FLPVLLLFSSFIGGCAG,0
3pjz,B,352,366,14,GGGMKVIRILLLTL,0
3pjz,B,367,376,9,GARELKRLV,0
3pjz,B,400,423,23,GFFSAYALVFVVCMLGLIATGMD,0
3pjz,B,425,443,18,SAFSAVAATLNNLGPGLG,0
3pjz,B,444,454,10,VALHFGDVND,0
3pjz,B,455,475,20,AKWVLIVSMLFGRLEIFTLL,0
3pjz,B,485,494,9,AAAENLYFQ,0
3v3c,N,3,14,11,LIAAASVIAAG,0
3v3c,N,15,36,21,AVGLASIGPGVGQGTAAGQAV,0
3v3c,N,50,72,22,GTLLLSLAFMEALTIYGLVVAL,0
3v3c,N,73,81,8,LLFANPFV,0
3a3y,G,1,4,3,DPE,0
3a3y,G,5,22,17,PDNDERFTYDYYRLRVV,0
3a3y,G,23,40,17,LIVAAVLCVIGIIILLA,0
3a3y,G,43,74,31,RCKFNQNKRTRSNSGTATAQHLLQPGEATEC,0
5e7c,z,8,25,17,LAALVILSFVMVIGVPV,0
5e7c,z,26,39,13,YASPQDWDRSKQL,0
5e7c,z,40,55,15,FLGSGLWIALVLVVG,0
4msw,F,22,29,7,ALHWRAA,0
4msw,F,30,50,20,AATVLLVIVLLAGSYLAVLA,0
4msw,F,63,77,14,RALWWSVETATTVG,0
4msw,F,87,107,20,GRLVAVVVMVAGITSFGLVT,0
4msw,F,108,124,16,ALATWFVGREQERRGH,0
3a0b,z,5007,5023,16,ALAALVILSFVMVIGV,0
3a0b,z,5024,5040,16,VAYASPQDWDRSKQLI,0
3a0b,z,5041,5055,14,LGSGLWIALVLVVG,0
2k9y,A,523,530,7,FQTLSPE,0
2k9y,A,531,536,5,SGNLA,0
2k9y,A,537,560,23,IGGVAVGVVLLLVLAGVGFFIHR,0
2nr1,A,1,4,3,SNG,0
2nr1,A,9,24,15,SSAMWFSWGVLLNSG,0
2nr1,A,25,27,2,GE,0
4mrs,B,1,8,7,PPETATN,0
4mrs,B,16,27,11,WQTLKRFLPYL,0
4mrs,B,34,58,24,LRRRVVGAILMVLLGKATTLALPF,0
4mrs,B,59,85,26,YKKAVDAMTLGGGAQPALTVALAFVL,0
4mrs,B,86,106,20,YALGRFSGVLFDNLRNIVFE,0
4mrs,B,156,177,21,FLLFNIAPTVIELTAVIVIFW,0
4mrs,B,178,182,4,NFGL,0
4mrs,B,183,205,22,LVTATILAVIAYVWTTRTITEW,0
4mrs,B,263,284,21,SLGLLNIAQALIVNLLMAGAM,0
4mrs,B,285,303,18,WTVYGWSQGKLTVGDLVF,0
4mrs,B,304,323,19,NTYLTQLFRPLDMLGMVYR,0
4mrs,B,607,614,7,EHHHHHH,0
4q4h,B,1,9,8,PEIRRRPH,0
4q4h,B,21,28,7,TATLRRL,0
4q4h,B,33,57,24,PHTFTLIMVFVFVTVSSILGVLSP,0
4q4h,B,58,83,25,LIGKTIDVVFVPRRFDLLPRYMLIL,0
4q4h,B,84,105,21,TIYALTSLLFWLQGKIMLTLS,0
4q4h,B,151,172,21,GNSIIQFFSGIVTLAGAVIMM,0
4q4h,B,173,180,7,RVNVILS,0
4q4h,B,181,201,20,VTLSIVPLTVLITQIVSSQT,0
4q4h,B,258,278,20,FSGVLPPLMNMVNNLGFALI,0
4q4h,B,279,299,20,GFGGWLALKDIITVGTIATF,0
4q4h,B,300,321,21,GYSRQFTRPLNELSNQFNMIQ,0
4q4h,B,593,598,5,VVEKE,0
2ita,A,1,20,19,ADKTIFNDHLNTNPKTNLR,0
2ita,A,21,45,24,WVAFQMMKGAGWAGGVFFGTLLLI,0
5iws,B,8,12,4,WQKF,0
5iws,B,13,33,20,KALLVVVAVMPAAGLMISIG,0
5iws,B,44,52,8,AVHTIARV,0
5iws,B,53,76,23,EDIGWAIITNLHILFAVAIGGSW,0
5iws,B,77,81,4,KDRA,0
5iws,B,82,98,16,GAFAALLAFVLTNRIT,0
5iws,B,142,157,15,VFVGIITGFLGATLY,0
5iws,B,158,177,19,KYYNYNKLPQALAFFNGKR,0
5iws,B,178,198,20,VPFVVIVWSTVTAIVLSLLW,0
5iws,B,199,214,15,FIQSGLNEFGRWIAA,0
5iws,B,225,244,19,VYGTLERLLLPFGLHHMLT,0
5iws,B,308,322,14,GQVIGSTAALMGIA,0
5iws,B,323,342,19,AMFRNVDKEKRAKYKPMFL,0
5iws,B,343,363,20,AALAVFLTGVTEPIEFMFMF,0
5iws,B,364,366,2,AP,0
5iws,B,367,383,16,LYVVYAITTGLAFALA,0
5iws,B,415,432,17,NFVIVSLVFFGLNFTLF,0
5iws,B,433,450,17,FLIKKFNLPTPGRAGNY,0
2nrg,A,1,30,29,ADKTIFNDHLNTNPKTNLRLWVAFQMMKG,0
2nrg,A,31,56,25,GWAGGVFFGTLLLIGFFRVVGRMLP,0
2lkg,A,17,38,21,CVFDKICKIGTESVEAGRLIE,0
2lkg,A,39,46,7,SQEGGGG,0
2lkg,A,47,68,21,GPLYFVVNVIEPCKKFSELTG,0
2lkg,A,82,103,21,ESKSVLKSLTEKLKKIVELIP,0
2lkg,A,104,108,4,TSSA,0
2lkg,A,109,129,20,PLIGKYMLFTKEFVESSIKI,0
3dts,H,1,10,9,VGVTAFGNF,0
3dts,H,16,32,16,IYSFWIFLAGLIYYLQ,0
3dts,H,33,250,217,ENMREGYPLENEDGTPAANQGPFPLPKPKTFILPHGRGTLTVPGPESEDRPIALARTAVSEGFPHAPTGDPMKDGVGPASWVARRDLPELDGHGHNKIKPMKAAAGFHVSAGKNPIGLPVRGCDLEIAGKVVDIWVDIPEQMARFLEVELKDGSTRLLPMQMVKVQSNRVHVNALSSDLFAGIPTIKSPTEVTLLEEDKICGYVAGGLMYAAPKRKS,0
3dts,H,251,260,9,VAAMLAEYA,0
1y5i,F,5,28,23,MFFFDIYPYIAGAVFLIGSWLRY,0
1y5i,F,29,47,18,YGQYTWRAASSQMLDRKG,0
1y5i,F,48,72,24,NLASNLFHIGILGIFVGHFFGMLT,0
1y5i,F,73,80,7,HWMYEAW,0
1y5i,F,87,114,27,KMAMFAGGASGVLCLIGGVLLLKRRLF,0
1y5i,F,116,121,5,RVRAT,0
1y5i,F,122,124,2,TG,0
1y5i,F,125,145,20,DILILSLLVIQCALGLLTIP,0
1y5i,F,183,204,21,FRLHLVLGMTLFLLFPFSRLI,0
1y5i,F,205,225,20,IWSVPVEYLTRKYQLVRARH,0
4dve,A,-9,-1,8,HHHHHHHH,0
4dve,A,14,28,14,FMTAFIIILGFLPG,0
4dve,A,29,38,9,PIGFIPVPI,0
4dve,A,39,49,10,LQNMGIMMAG,0
4dve,A,57,72,15,TISVGAFLALALIGL,0
4dve,A,73,89,16,VLTGGNGGAASFLGPS,0
4dve,A,90,103,13,GYRIAWLFTPFLI,0
4dve,A,123,140,17,IVLLFGVIFVDFVGAIW,0
4dve,A,141,148,7,SFQSNIP,0
4dve,A,149,156,7,LTSLISN,0
4dve,A,157,173,16,VFIPGDCIKAILTVVI,0
1n7l,A,3,13,10,KVQYLTRSAI,0
1n7l,A,28,50,22,LQNLFINFALILIFLLLIAIIV,0
1n7l,A,51,53,2,LL,0
3odu,B,-9,27,36,YKDDDDAGAPEGISIYTSDNYTEEMGSGDYDSMKEP,0
3odu,B,40,60,20,LPTIYSIIFLTGIVGNGLVI,0
3odu,B,61,77,16,VMGYQKKLRSMTDKYR,0
3odu,B,78,98,20,HLSVADLLFVITLPFWAVDA,0
3odu,B,103,131,28,FGNFLCKAVHVIYTVNLYSSVWILAFIS,0
3odu,B,132,156,24,DRYLAIVHATNSQRPRKLLAEKVV,0
3odu,B,157,176,19,VGVWIPALLLTIPDFIFAN,0
3odu,B,196,220,24,VVFQFQHIMVGLILPGIVILSCYC,0
3odu,B,221,241,20,IISKLSHSGSNIFEMLRIDEGLRLKIYKDTEGYYTIGIGHLLTKSPSLNAAKSELDKAIGRNTNGVITKDEAEKLFNQDVDAAVRGILRNAKLKPVYDSLDAVRRAALINMVFQMGETGVAGFTNSLRMLQQKRWDEAAVNLAKSRWYNQTPNRAKRVITTFRTGTWDAYGSKGHQKRKALKTT,0
3odu,B,242,261,19,ILILAFFACWLPYYIGISI,0
3odu,B,284,301,17,SITEALAFFHCCLNPIL,0
3odu,B,302,319,17,AFLGAKFKTSAQHALTS,0
3odu,B,320,328,8,RPLEVLFQ,0
1y4z,F,5,28,23,MFFFDIYPYIAGAVFLIGSWLRY,0
1y4z,F,29,47,18,YGQYTWRAASSQMLDRKG,0
1y4z,F,48,72,24,NLASNLFHIGILGIFVGHFFGMLT,0
1y4z,F,73,80,7,HWMYEAW,0
1y4z,F,87,114,27,KMAMFAGGASGVLCLIGGVLLLKRRLF,0
1y4z,F,116,121,5,RVRAT,0
1y4z,F,122,124,2,TG,0
1y4z,F,125,145,20,DILILSLLVIQCALGLLTIP,0
1y4z,F,183,204,21,FRLHLVLGMTLFLLFPFSRLI,0
1y4z,F,205,225,20,IWSVPVEYLTRKYQLVRARH,0
2k73,A,2,9,7,RFLNQAS,0
2k73,A,10,12,2,GR,0
2k73,A,13,34,21,AWLLMAFTALALELTALWFQH,0
2k73,A,41,62,21,VLSIYERAALFGVLGAALIGA,0
2k73,A,63,72,9,APKTPLRYV,0
2k73,A,73,95,22,MVIWLYSAFRGVQLTYEHTMLQ,0
2k73,A,137,161,24,LGLEMPQWLLGIFIAYLIVAVLVV,0
2k73,A,162,183,21,SQPFKAKKRDLFGRGHHHHHH,0
3te0,E,-2,0,2,GR,0
3te0,E,2,22,20,KETLDKLTNAAINKINLLNT,0
3te0,E,25,47,22,KYLVSSAFAGLYVGIGILLIFT,0
3te0,E,48,62,14,GGLLTDAGSPMTKI,0
3te0,E,63,79,16,MGLSFAIALSLVIMTG,0
3te0,E,81,92,11,LFTGNNMVMSA,0
3te0,E,105,129,24,KIWAYSWVGNLIGALVLGIIFVGT,0
3te0,E,130,135,5,LVDKG,0
3te0,E,136,150,14,VAEFFANTAASEAS,0
3te0,E,151,153,2,PF,0
3te0,E,154,177,23,ALFFRGILCNILVCVSVLCSFRT,0
3te0,E,180,197,17,TAKIIMIFLCLFAFITS,0
3te0,E,199,214,15,EHSVANMTIYSVSLF,0
3te0,E,215,223,8,PTISTVTI,0
3te0,E,224,249,25,GAIYNLVAVTLGNIVGGALFMGLGT,0
3te0,E,257,265,8,NAAAENLY,0
1lly,A,11,19,8,LKMINNSL,0
1lly,A,30,47,17,WWNFGSLLAVCLMTQIL,0
1lly,A,48,87,39,GLLLAMHYTADTSLAFSSVAHTCRNVQYGWLIRNLHANG,0
1lly,A,88,104,16,SFFFICIFLHIGRGLY,0
1lly,A,114,128,14,NTGVILLLTLMATA,0
1lly,A,129,157,28,VGYVLPWGQMSFWGATVITNLFSAIPYI,0
1lly,A,158,166,8,HTLVEWAW,0
1lly,A,167,185,18,GFSVDNPTLTRFFALHFL,0
1lly,A,186,198,12,PFAIAGITIIHL,0
1lly,A,226,240,14,FKDILGLTLMLTPF,0
1lly,A,241,272,31,TLALFSPNLLGDPENFTPANPLVTPPHIKPE,0
1lly,A,273,282,9,YFLFAYAIL,0
1lly,A,283,289,6,SIPNKL,0
1lly,A,290,305,15,GVLALAASVLILFLI,0
1lly,A,324,337,13,LFWLLVANLLILT,0
1lly,A,338,350,12,IGSQPVEHPFII,0
1lly,A,351,367,16,GQMASLSYFTILLILF,0
4xp5,A,35,57,22,FLLSVIGFAVDLANVWRFPYLC,0
4xp5,A,58,60,2,KN,0
4xp5,A,61,84,23,GGAFLVPYGIMLAVGGIPLFYME,0
4xp5,A,110,136,26,YAVVLIAFYVDFYYNVIIAWSLRFFF,0
4xp5,A,137,210,73,SFTNSLPWTSCNNIWNTPNCRPFEGHVEGFQS,0
4xp5,A,211,218,7,ASEYFNR,0
4xp5,A,219,235,16,ILELNRSEGIHDLGAI,0
4xp5,A,236,255,19,WDMALCLLIVYLICYFSLW,0
4xp5,A,261,281,20,GKVVWFTALFPYAVLLILLI,0
4xp5,A,282,288,6,GLTLPG,0
4xp5,A,289,297,8,FLGIQYYL,0
4xp5,A,298,303,5,PNFSA,0
4xp5,A,304,328,24,YKAEVWVDAATQVFFSLGPGFGVL,0
4xp5,A,345,363,18,LLTSFINSATSFIAGFVI,0
4xp5,A,364,391,27,SVLGYMAHTLGVRIEDVATEGPGLVFV,0
4xp5,A,392,399,7,YPAAIAT,0
4xp5,A,400,408,8,PASTFWAL,0
4xp5,A,409,430,21,FFMMLATLGLDSSFGGSEAII,0
4xp5,A,446,464,18,FVAGLFSLYFVVGLASCT,0
4xp5,A,465,467,2,GG,0
4xp5,A,468,492,24,YFFHLLDRYAAGYSILVAVFFEAI,0
4xp5,A,522,545,23,WRFVAPIFLLFITVYGLIGYEPL,0
4xp5,A,546,554,8,YADYVYPS,0
4xp5,A,555,573,18,ANALGWCIAGSSVVMIPA,0
4xpt,A,35,57,22,FLLSVIGFAVDLANVWRFPYLC,0
4xpt,A,58,62,4,KNGG,0
4xpt,A,63,82,19,AFLVPYGIMLAVGGIPLFY,0
4xpt,A,113,133,20,VLIAFYVGFYYNVIIAWSLR,0
4xpt,A,134,237,103,FFASFTNSLPWTSCNNIWNTPNCRPFEVGHVEGFQSAASEYFNRYILELNRSEGIHDLGAIKW,0
4xpt,A,238,255,17,MALCLLIVYLICYFSLW,0
4xpt,A,261,280,19,GKVVWFTALFPYAVLLILL,0
4xpt,A,281,301,20,RGLTLPGSFLGIQYYLTPNF,0
4xpt,A,302,328,26,AIYKAEVWVDAATQVFFSLGPGFGVL,0
4xpt,A,345,362,17,LLTSFINSATSFIAGFV,0
4xpt,A,363,384,21,FSVLGYMAHTLGVRIEDVATE,0
4xpt,A,385,390,5,PGLVF,0
4xpt,A,391,409,18,VYPAAIATMPASTFWALI,0
4xpt,A,410,429,19,FMMLATLGLDSSFGGMEAI,0
4xpt,A,449,464,15,GLFSLYFVVGLASCT,0
4xpt,A,465,467,2,GG,0
4xpt,A,468,489,21,YFFHLLDRYAAGYSILVAVFF,0
4xpt,A,517,524,7,YWQVCWR,0
4xpt,A,526,545,19,APIFLLFITVYGLIGYEPL,0
4xpt,A,546,554,8,YADYVYPS,0
4xpt,A,555,570,15,ANALGWCIAGSSVVM,0
4zit,C,12,26,14,WVIAIIIMLAGGLA,0
4zit,C,27,342,315,LKLPVAQYPTIAPPAVTISASYPGADAKTVQDTVTQVIEQNMNGIDNLMYMSSNSDSTGTVQITLTFESGTDADIAQVQVQNKLQLAMPLLPQEVQQQGVSVEKSSSSFLMVVGVINTDGTMTQEDISDYVAANMKDAISRTSGVGDVQLFGSQYAMRIWMNPNELNKFQLTPVDVITAIKAQNAQVAAGQLGGTPPVKGQQLNASIIAQTRLTSTEEFGKILLKVNQDGSRVLLRDVAKIELGGENYDIIAEFNGQPASGLGIKLATGANALDTAAAIRAELAKMEPFFPSGLKIVYPYDTTPFVKISIHEVVK,0
4zit,C,343,357,14,LVEAIILVFLVMYL,0
4zit,C,366,383,17,IPTIAVPVVLLGTFAVL,0
4zit,C,384,397,13,AFGFSINTLTMFG,0
4zit,C,398,410,12,VLAIGLLVDDAI,0
4zit,C,443,455,12,GIAMVLSAVFVP,0
4zit,C,456,470,14,AFFGGSTGAIYRQF,0
4zit,C,471,488,17,ITIVSAMALSVLVALIL,0
4zit,C,515,534,19,FNRMFEKSTHHYTDSVGGI,0
4zit,C,541,555,14,LVLYLIIVVGMAYL,0
4zit,C,556,877,321,VRLPSSFLPDEDQGVFMTMVQLPAGATQERTQKVLNEVTHYYLTKEKNNVESVFAVNGFGFAGRGQNTGIAFVSLKDWADRPGEENKVEAITMRATRAFSQIKDAMVFAFNLPAIVELGTATGFDFELIDQAGLGHEKLTQARNQLLAEAAKHPDMLTSVRPNGLEDTPQFKIDIDQEKAQALGVSINDINTTLGAAWGGSYVNDFIDRGRVKKVYVMSEAKYRMLPDDIGDWYVRAADGQMVPFSAFSSSRWEYGSPRLERYNGLPSMEILGQAAPGKSTGEAMELMEQLASKLPTGVGYDWTGMSYQERLSGNQAPSLY,0
4zit,C,878,891,13,ISLIVVFLCLAAL,0
4zit,C,898,916,18,FSVMLVVPLGVIGALLAA,0
4zit,C,917,929,12,FRGLTNDVYFQV,0
4zit,C,930,943,13,LLTTIGLSAKNAI,0
4zit,C,976,991,15,MTSLAFILGVMPLVI,0
4zit,C,992,1004,12,TGAGSGAQNAVG,0
4zit,C,1005,1019,14,GVMGGMVTATVLAI,0
4zit,C,1020,1030,10,FVPVFFVVVR,0
4zjo,C,12,28,16,WVIAIIIMLAGGLAIL,0
4zjo,C,29,340,311,LPVAQYPTIAPPAVTISASYPGADAKTVQDTVTQVIEQNMNGIDNLMYMSSNSDSTGTVQITLTFESGTDADIAQVQVQNKLQLAMPLLPQEVQQQGVSVEKSSSSFLMVVGVINTDGTMTQEDISDYVAANMKDAISRTSGVGDVQLFGSQYAMRIWMNPNELNKFQLTPVDVITAIKAQNAQVAAGQLGGTPPVKGQQLNASIIAQTRLTSTEEFGKILLKVNQDGSRVLLRDVAKIELGGENYDIIAEFNGQPASGLGIKLATGANALDTAAAIRAELAKMEPFFPSGLKIVYPYDTTPFVKISIHEV,0
4zjo,C,341,357,16,KTLVEAIILVFLVMYL,0
4zjo,C,366,386,20,IPTIAVPVVLLGTFAVLAAF,0
4zjo,C,387,394,7,FSINTLT,0
4zjo,C,395,410,15,FGMVLAIGLLVDDAI,0
4zjo,C,443,458,15,GIAMVLSAVFVPMAF,0
4zjo,C,459,467,8,GGSTGAIY,0
4zjo,C,468,485,17,QFSITIVSAMALSVLVA,0
4zjo,C,515,536,21,FNRMFEKSTHHYTDSVGGILR,0
4zjo,C,542,558,16,VLYLIIVVGMAYLFVR,0
4zjo,C,559,873,314,PSSFLPDEDQGVFMTMVQLPAGATQERTQKVLNEVTHYYLTKEKNNVESVFAVNGAGAAGAGQNTGIAFVSLKDWADRPGEENKVEAITMRATRAFSQIKDAMVFAFNLPAIVELGTATGFDFELIDQAGLGHEKLTQARNQLLAEAAKHPDMLTSVRPNGLEDTPQFKIDIDQEKAQALGVSINDINTTLGAAWGGSYVNDFIDRGRVKKVYVMSEAKYRMLPDDIGDWYVRAADGQMVPFSAFSSSRWEYGSPRLERYNGLPSMEILGQAAPGKSTGEAMELMEQLASKLPTGVGYDWTGMSYQERLSGNQA,0
4zjo,C,874,891,17,SLYAISLIVVFLCLAAL,0
4zjo,C,898,919,21,FSVMLVVPLGVIGALLAATFR,0
4zjo,C,920,926,6,LTNDVY,0
4zjo,C,927,943,16,QVGLLTTIGLSAKNAI,0
4zjo,C,976,992,16,MTSLAFILGVMPLVIS,0
4zjo,C,993,1000,7,GAGSGAQ,0
4zjo,C,1001,1018,17,AVGTGVMGGMVTATVLA,0
4zjo,C,1019,1030,11,FFVPVFFVVVR,0
4hwl,A,-12,4,16,LELLPTAVEGVSQAQI,0
4hwl,A,5,8,3,GRP,0
4hwl,A,9,31,22,WIWLALGTALMGLGTLYFLVKG,0
4hwl,A,43,67,24,AITTLVPAIAFTMYLSMLLGYGLT,0
4hwl,A,68,78,10,VPFGGEQNPI,0
4hwl,A,79,98,19,WARYADWLFTTPLLLLDLA,0
4hwl,A,106,128,22,TILALVGADGIMIGTGLVGALT,0
4hwl,A,129,133,4,VYSY,0
4hwl,A,134,157,23,FVWWAISTAAMLYILYVLFFGFT,0
4hwl,A,171,195,24,KVLRNVTVVLWSAYPVVWLIGSEG,0
4hwl,A,196,201,5,GIVPL,0
4hwl,A,202,225,23,IETLLFMVLDVSAKVGFGLILLR,0
4hwl,A,232,249,17,AEAPEPSAGDGAAATSD,0
5iou,D,1,27,26,RPTEACCYLKISLIILFYSRAYAQKH,0
5iou,D,28,363,335,NMDIAVILVGTTEEVAIKDVHEKDDFHHLPVTPRVELVTMQESDPKSIITRICDLMSDKKVQGVVFGDDTDQEAIAQILDFISVQTLTPILGIHGGSSMIMADKEEASMFFQFGPSIEQQASVMLNIMEEYDWYIFSIVTTYFPGYQDFENKVRSTIENSFVGWELEEVIHLDMSLDDIDSKIQNQLKKLQSPVILLYCTKEEATYIFEVAHSVGLTGYGFTWIVPSLVAGDTDTVPDEFPTGLISVSYDEWDYDLPARVRDGIAIITTAASTMLSEHNSIPQSKSSCNNIQESRVYEAHMLKRYLINVTFEGRDLSFSEDGYQMHPKLVIILLN,0
5iou,D,365,550,185,RKWERVGKYKDRSLKMWPVFDLYPNSEEHKDEHLSIVTLEEAPFVIVEDVDPLSGTCMRNTVPCRKQIRPENRTEEGGNYIKRCCKGFCIDILKKIAKTVKFTYDLYLVTNGKHGKKINGVWNGMIGEVVTKRAYMAVGSLTINEERSEVVDFSVPFIETGISVMVSRSNGTVSPSAFLEPFSAD,0
5iou,D,551,571,20,WVMMFVMLLIVSAVAVFVFE,0
5iou,D,584,606,22,IGKAIWLLWGLVFNNSLPVQNP,0
5iou,D,608,626,18,TTSKIMVSVWAFFAVIFL,0
5iou,D,627,803,176,SYTANLAAFMIQRRYVDQVSGLSDKKFQRPNDFSPAFRFGTVPNGSTERNIRNNYLEMHSYMVKFNQRSVQDALLSLKSGKLDAFIYDAAVLNYMAGRDEGCKLVTIGSGKVFATTGYGIAIQKDSGWKRQVDLAILQLFGDGEMEELEALWLTGICHNEKNEVMSSQLDIDNMAG,0
5iou,D,804,821,17,FYMLAAAMALSLITFIM,0
1nw0,B,1,4,3,VKQ,0
1nw0,B,23,42,19,SSILVFFGVAAFAHLLVWI,0
1nw0,B,43,47,4,RPWV,0
1nw0,B,48,54,6,GPNGYS,0
2kwx,D,25,48,23,LAVAASIIGILHLILWILDRLFF,0
2kwx,D,50,59,9,IYRFFEHGL,0
3ar6,A,54,74,20,QFEDLLVRILLLAACISFVL,0
3ar6,A,75,89,14,WFEEGEETITAFVE,0
3ar6,A,90,111,21,FVILLILIANAIVGVWQERNA,0
3ar6,A,253,276,23,EFGEQLSKVISLICVAVWLINIG,0
3ar6,A,277,295,18,FNDPVHGGSWIRGAIYYF,0
3ar6,A,296,318,22,IAVALAVAAIPEGLPAVITTCL,0
3ar6,A,758,783,25,FIRYLISSNVGEVVCIFLTAALGLP,0
3ar6,A,784,785,1,A,0
3ar6,A,786,809,23,IPVQLLWVNLVTDGLPATALGFN,0
3ar6,A,833,854,21,FRYMAIGGYVGAATVGAAAWW,0
3ar6,A,855,897,42,MYAEDGPGVTYHQLTHFMQCTEDHPHFEGLDCEIFEAPEPMT,0
3ar6,A,898,917,19,ALSVLVTIEMCNALNSLSE,0
3ar6,A,927,950,23,VNIWLLGSICLSMSLHFLILYVD,0
3ar6,A,951,964,13,LPMIFKLKALDLT,0
3ar6,A,965,987,22,WLMVLKISLPVIGLDEILKFIA,0
4cjz,C,17,27,10,WKGLRAAWIN,0
4cjz,C,28,30,2,AA,0
4cjz,C,31,47,16,RQEGVAVLLAVVIACW,0
4cjz,C,53,69,16,TRVLLISSVMLVMIVE,0
4cjz,C,70,99,29,LNSAIEAVVDRIGSEYHELSGRAKDLGSA,0
4cjz,C,100,116,16,VLIAIIDAVITWCILL,0
5br5,C,5,9,4,GRPE,0
5br5,C,10,33,23,IWLALGTALMGLGTLYFLVKGMG,0
5br5,C,41,62,21,FYAITTLVPAIAFTMYLSMLL,0
5br5,C,63,72,9,YGLTMVPFG,0
5br5,C,75,78,3,NPI,0
5br5,C,79,100,21,WARYADWLFTTPLLLLDLALL,0
5br5,C,106,128,22,TILALVGADGIMIGTGLVGALT,0
5br5,C,129,133,4,VYSY,0
5br5,C,134,156,22,FVWWAISTAAMLYILYVLFFGF,0
5br5,C,171,192,21,KVLRNVTVVLWSAYPVVWLIG,0
5br5,C,193,202,9,EGAGIVPLN,0
5br5,C,203,226,23,ETLLFMVLDVSAKVGFGLILLRS,0
1kg9,C,1,4,3,AQI,0
1kg9,C,5,10,5,GRPEW,0
1kg9,C,11,31,20,WLALGTALMGLGTLYFLVKG,0
1kg9,C,44,62,18,ITTLVPAIAFTMYLSMLL,0
1kg9,C,63,79,16,YGLTMVPFGGEQNPIY,0
1kg9,C,80,97,17,ARYADWLFTTPLLLLDL,0
1kg9,C,108,127,19,LALVGADGIMIGTGLVGAL,0
1kg9,C,128,133,5,KVYSY,0
1kg9,C,134,153,19,FVWWAISTAAMLYILYVLF,0
1kg9,C,157,162,5,SKAES,0
1kg9,C,174,192,18,RNVTVVLWSAYPVVWLIG,0
1kg9,C,193,203,10,EGAGIVPLNI,0
1kg9,C,204,224,20,TLLFMVLDVSAKVGFGLILL,0
2ndj,A,49,78,29,LPGRDDNSYMYILFVMFLFAVTVGSLILG,0
2ndj,A,79,103,24,TRSRKVDKRSDPYHVYIKNRVSMI,0
3j5r,D,433,454,21,FYFNFFVYCLYMIIFTAAAYY,0
3j5r,D,455,473,18,PVEGLPPYKLKNTVGDYF,0
3j5r,D,474,497,23,VTGEILSVSGGVYFFFRGIQYFL,0
3j5r,D,503,507,4,KSLF,0
3j5r,D,511,532,21,SEILFFVQSLFMLVSVVLYFS,0
3j5r,D,533,536,3,RKE,0
3j5r,D,537,557,20,VASMVFSLAMGWTNMLYYTR,0
3j5r,D,566,598,32,VMIEKMILRDLCRFMFVYLVFLFGFSTAVVTL,0
3j5r,D,599,630,31,EDGKYNSL,0
3j5r,D,631,648,17,STCLELFKFTIGMGDLE,0
3j5r,D,649,657,8,TENYDFKA,0
3j5r,D,658,682,24,FIILLLAYVILTYILLLNMLIALM,0
3j5r,D,689,710,21,AQESKNIWKLQRAITILDTEK,0
4hyg,A,1,3,2,QI,0
4hyg,A,11,27,16,MPLMLLFVQIIAIVLV,0
4hyg,A,28,37,9,PMQAAGLVA,0
4hyg,A,38,40,2,EN,0
4hyg,A,41,44,3,SSV,0
4hyg,A,45,61,16,NPLIFIGMLLAFTLVL,0
4hyg,A,76,92,16,IGFALFMTFLYIFGAL,0
4hyg,A,93,104,11,LLALGPTTAAA,0
4hyg,A,105,119,14,GTLIGAVAVTALLY,0
4hyg,A,126,145,19,IDILGVLISAGVASIFGIS,0
4hyg,A,146,148,2,EP,0
4hyg,A,149,164,15,PVLVLLVLLAVYDAI,0
4hyg,A,180,211,31,ETKAPIMVVVPKRADYSFRKEGLNISEGEER,0
4hyg,A,215,230,15,MGMGDLIMPSILVVS,0
4hyg,A,231,234,3,HVF,0
4hyg,A,235,243,8,DAPAVLWT,0
4hyg,A,244,248,4,SAPT,0
4hyg,A,249,262,13,GAMVGSLVGLAVL,0
4hyg,A,275,289,14,PPLNGGAILGFLVG,0
4hyg,A,290,293,3,ALA,0
4hyg,A,294,301,7,SFSWLPF,0
4dop,I,-6,0,6,HHHHHH,0
4dop,I,2,12,10,EWIIRRSVAN,0
4dop,I,13,15,2,FL,0
4dop,I,16,32,16,LMGALFLSIWGTWTII,0
4dop,I,339,356,17,GKLLEEFIVVAVVCALF,0
4dop,I,357,363,6,WHVRSA,0
4dop,I,364,384,20,VAIISLPLGLCIAFIVMHFQ,0
4dop,I,393,409,16,GGIAIAVGAMVDAAIV,0
4dop,I,410,450,40,IENAHKRLEEWQHQHPDATLDNKTRWQVITDASVEVGPAL,0
4dop,I,451,466,15,ISLLIITLSFIPIFT,0
4dop,I,478,497,19,AFTKTYAMAGAALLAIVVI,0
4dop,I,498,504,6,ILMGYW,0
4dop,I,505,516,11,RGKIPPESSNP,0
4dop,I,517,518,1,N,0
4dop,I,519,532,13,FLIRVYHPLLLKV,0
4dop,I,533,539,6,HWPKTT,0
4dop,I,540,555,15,LVAALSVLTVLWPLN,0
4dop,I,873,890,17,LMVPMTLMIIFVLLYLA,0
4dop,I,891,897,6,RRVGEA,0
4dop,I,898,918,20,LIISSVPFALVGGIWLLWWM,0
4dop,I,927,943,16,TGFIALAGVAAEFGVV,0
4dop,I,944,984,40,LMYLRHAIEAVPSLNNPQTFSEQKLDEALYHGAVLRVRPK,0
4dop,I,985,1000,15,MTVAVIIAGLLPILW,0
4dop,I,1010,1028,18,RIAAPMIGGMITAPLLSL,0
4dop,I,1029,1043,14,IIPAAYKLMWLHRH,0
4dop,I,1044,1047,3,VRK,0
5kxi,E,1,218,217,DTEERLVEHLLDPSRYNKLIRPATNGSELVTVQLMVSLAQLISVHEREQIMTTNVWLTQEWEDYRLTWKPEEFDNMKKVRLPSKHIWLPDVVLYNNADGMYEVSFYSNAVVSYDGSIFWLPPAIYKSACKIEVKHFPFDQQNCTMKFRSWTYDRTEIDLVLKSEVASLDDFTPSGEWDIVALPGRRNENPDDSTYVDITYDFIIRRKPLFYTINLII,0
5kxi,E,219,231,12,CVLITSLAILVF,0
5kxi,E,241,252,11,TLCISVLLALT,0
5kxi,E,253,275,22,FLLLISKIVPPTSLDVPLVGKY,0
5kxi,E,276,291,15,MFTMVLVTFSIVTSV,0
5kxi,E,354,368,14,WIFVFVCVFGTIGM,0
5kxi,E,369,373,4,LQPL,0
4j72,B,-5,13,18,PAVPRMLYQLALLLKDYW,0
4j72,B,14,24,10,AFNVLKYITF,0
4j72,B,25,41,16,SFTAVLIAFFLTLVLS,0
4j72,B,49,69,20,KIQRLFGGYVREYTPESHEV,0
4j72,B,78,93,15,IVILIVVTLSTLLLM,0
4j72,B,94,100,6,WDIKYT,0
4j72,B,101,117,16,VVLLSFLSFGTIGFWD,0
4j72,B,122,125,3,KNK,0
4j72,B,131,145,14,TKFLLQVLSASLIS,0
4j72,B,146,175,29,LIYYWADIDTILYFPFFKELYVDLGVLYL,0
4j72,B,176,193,17,FAVFVIVGSANAVNLTD,0
4j72,B,199,213,14,IGPAMTTATALGVV,0
4j72,B,214,237,23,YAVGHSKIAQYLNIPYVPYAGEL,0
4j72,B,238,253,15,VFCFALVGAGLGFLW,0
4j72,B,264,280,16,DVGSLSIGASLATVAL,0
4j72,B,281,284,3,TKS,0
4j72,B,285,304,19,FIFAVAAGVFVFETISVIL,0
4j72,B,312,333,21,GGKRLFKRAPFHHHLELNGLP,0
4j72,B,340,355,15,MWIISILLAIIAISM,0
4j72,B,356,357,1,K,0
4j72,B,358,359,1,R,0
3jcu,z,8,24,16,VFALIATSSILLISVP,0
3jcu,z,25,39,14,VFASPDGWSSNKNI,0
3jcu,z,40,55,15,FSGTSLWLGLVFLVG,0
4dnt,I,-6,0,6,HHHHHH,0
4dnt,I,2,12,10,EWIIRRSVAN,0
4dnt,I,13,15,2,FL,0
4dnt,I,16,32,16,LMGALFLSIWGTWTII,0
4dnt,I,339,355,16,GKLLEEFIVVAVVCAL,0
4dnt,I,356,363,7,LWHVRSA,0
4dnt,I,364,384,20,VAIISLPLGLCIAFIVMHFQ,0
4dnt,I,393,408,15,GGIAIAVGAMVAAAI,0
4dnt,I,409,450,41,MIENAHKRLEEWQHQHPDATLDNKTRWQVITDASVEVGPAL,0
4dnt,I,451,466,15,ISLLIITLSFIPIFT,0
4dnt,I,478,497,19,AFTKTYAMAGAALLAIVVI,0
4dnt,I,498,504,6,ILMGYW,0
4dnt,I,505,516,11,RGKIPPESSNP,0
4dnt,I,517,518,1,N,0
4dnt,I,519,532,13,FLIRVYHPLLLKV,0
4dnt,I,533,539,6,HWPKTT,0
4dnt,I,540,555,15,LVAALSVLTVLWPLN,0
4dnt,I,873,890,17,LMVPMTLMIIFVLLYLA,0
4dnt,I,891,897,6,RRVGEA,0
4dnt,I,898,918,20,LIISSVPFALVGGIWLLWWM,0
4dnt,I,927,943,16,TGFIALAGVAAEFGVV,0
4dnt,I,944,984,40,LMYLRHAIEAVPSLNNPQTFSEQKLDEALYHGAVLRVRPK,0
4dnt,I,985,1000,15,MTVAVIIAGLLPILW,0
4dnt,I,1010,1028,18,RIAAPMIGGMITAPLLSL,0
4dnt,I,1029,1043,14,IIPAAYKLMWLHRH,0
4dnt,I,1044,1047,3,VRK,0
4z3p,A,33,53,20,RMALPMFVGMLTQVTYAIAD,0
4z3p,A,54,59,5,FWLSH,0
4z3p,A,66,74,8,IIAGVGLV,0
4z3p,A,75,94,19,PVGMGLFAIANGIQIGMGS,0
4z3p,A,116,134,18,IIALFFAIVITVLGYVYA,0
4z3p,A,135,154,19,PLLRSLGATKSIIGYATEF,0
4z3p,A,155,176,21,YYSLLTVFSIMLIGVMMGLFQ,0
4z3p,A,182,202,20,VIMKASLLGALVNIMLDPIM,0
4z3p,A,203,211,8,FVFDFGVK,0
4z3p,A,212,231,19,VALASFLAQLSMVAYFIYT,0
4z3p,A,257,277,20,SVGMAQMLMQLIIAVGIVIY,0
4z3p,A,278,295,17,FFIVRLDVNAMAAFTLT,0
4z3p,A,296,314,18,RIDYFIITPMLAIATALL,0
4z3p,A,334,355,21,AAVALAFSIVLVLAVMHIVLA,0
4z3p,A,356,375,19,WMYPLFTRVVAVSDYAVLQ,0
4z3p,A,376,397,21,RIMALALPFVAISLLASEYYQ,0
4z3p,A,402,424,22,WYSVLLTLMRHVFISVPVVYLL,0
4z3p,A,425,434,9,IVLEMRITG,0
4z3p,A,435,453,18,YFGAMSGTFVAALLAWRL,0
4tkr,A,-27,2,29,DYKDDDDKHHHHHHHHHHENLYFQSYVMQ,0
4tkr,A,3,9,6,KRLIIL,0
4tkr,A,10,29,19,ECAIFAAVAMVLSFIPLDI,0
4tkr,A,34,46,12,ISLGMIPMYVIA,0
4tkr,A,47,51,4,RRGF,0
4tkr,A,52,71,19,AAGFAGLLWGLLHFLTGKA,0
4tkr,A,78,95,17,AIIEYILAFSFIAFSGV,0
4tkr,A,96,116,20,SKQVRSNLAANQLKKAIEWA,0
4tkr,A,117,135,18,GTMIIGGVARYFWHYVAG,0
4tkr,A,154,175,21,VMNGASCLGTVLVSGIIISIL,0
4tkr,A,176,185,9,KTSPKLFLP,0
2i5n,M,1,51,50,DYQTIYTQIQARGPHITVSGEWGDNDRVGKPFYSYWLGKIGDAQIGPIYL,0
2i5n,M,52,70,18,ASGIAAFAFGSTAILIIL,0
2i5n,M,81,87,6,LQFFRQ,0
2i5n,M,116,132,16,GLFMTLSLGSWWIRVY,0
2i5n,M,133,143,10,RARALGLGTH,0
2i5n,M,144,162,18,AWNFAAAIFFVLCIGCIH,0
2i5n,M,177,190,13,WPHIDWLTAFSIR,0
2i5n,M,198,218,20,WHGFSIGFAYGCGLLFAAHG,0
2i5n,M,219,266,47,TILAVARFGGDREIEQITDRGTAVERAALFWRWTIGFNATIESVHRW,0
2i5n,M,267,284,17,WFFSLMVMVSASVGILL,0
2i5n,M,292,298,6,YLWCVK,0
2yfy,A,49,56,7,WELVIEQ,0
2yfy,A,57,75,18,EDLLVRILLLAACISFVL,0
2yfy,A,76,88,12,WFEEGEETITAF,0
2yfy,A,89,104,15,EPFVILLILIANAIV,0
2yfy,A,257,276,19,EQLSKVISLICVAVWLINI,0
2yfy,A,277,295,18,HFNDPVHGGSWIRGAIYY,0
2yfy,A,296,314,18,KIAVALAVAAIPEGLPAV,0
2yfy,A,761,781,20,RYLISSNVGEVVCIFLTAAL,0
2yfy,A,782,786,4,LPEA,0
2yfy,A,787,807,20,IPVQLLWVNLVTDGLPATAL,0
2yfy,A,834,851,17,FRYMAIGGYVGAATVGA,0
2yfy,A,852,900,48,AWWFMYAEDGPGVTYHQLTHFMQCTEDHPHFEGLDCEIFEAPEPMTMA,0
2yfy,A,901,916,15,SVLVTIEMCNALNSL,0
2yfy,A,922,947,25,MRMPPWVNIWLLGSICLSMSLHFLI,0
2yfy,A,948,950,2,YV,0
2yfy,A,951,957,6,PLPMIF,0
2yfy,A,958,970,12,LKALDLTQWLMV,0
2yfy,A,971,987,16,KISLPVIGLDEILKFI,0
2n02,A,1,6,5,PESWV,0
2n02,A,7,28,21,AVGLTLVPSLGGFMGAYFVRG,0
2n02,A,41,64,23,WHPPRWTLAPIWGTLYSAMGYGS,0
2n02,A,65,81,16,IVWKELGGFTEDAMVP,0
2n02,A,82,102,20,GLYTGQLALNWAWPPIFFGA,0
2n02,A,107,128,21,ALADLLLVSGVATATTLAWHR,0
2n02,A,129,133,4,SPPA,0
2n02,A,134,153,19,RLLYPYLAWLAFTTVLNYY,0
1kg8,C,1,4,3,AQI,0
1kg8,C,5,10,5,GRPEW,0
1kg8,C,11,32,21,WLALGTALMGLGTLYFLVKGM,0
1kg8,C,42,62,20,YAITTLVPAIAFTMYLSMLL,0
1kg8,C,63,79,16,YGLTMVPFGGEQNPIY,0
1kg8,C,80,98,18,ARYADWLFTTPLLLLDLA,0
1kg8,C,107,127,20,ILALVGADGIMIGTGLVGAL,0
1kg8,C,128,133,5,KVYSY,0
1kg8,C,134,155,21,FVWWAISTAAMLYILYVLFFG,0
1kg8,C,156,166,10,TSKAESMRPE,0
1kg8,C,173,192,19,LRNVTVVLWSAYPVVWLIG,0
1kg8,C,193,203,10,EGAGIVPLNI,0
1kg8,C,204,225,21,TLLFMVLDVSAKVGFGLILLR,0
4ja4,A,1,8,7,NTQYNSS,0
4ja4,A,12,33,21,ITLVATLGGLLFGYDTAVISG,0
4ja4,A,34,58,24,VESLNTVFVAPQNLSESAANSLLG,0
4ja4,A,59,75,16,CVASALIGCIIGGALG,0
4ja4,A,86,105,19,SLKIAAVLFFISGVGSAWP,0
4ja4,A,106,126,20,LGFTSINPDNTVPVYLAGYV,0
4ja4,A,127,148,21,EFVIYRIIGGIGVGLASMLSP,0
4ja4,A,165,182,17,FNQFAIIFGQLLVYCVN,0
4ja4,A,183,202,19,FIARSGDASWLNTDGWRYM,0
4ja4,A,203,220,17,ASECIPALLFLMLLYTV,0
4ja4,A,229,232,3,RGK,0
4ja4,A,264,271,7,KTGGRLL,0
4ja4,A,280,300,20,GVMLSIFQQFVGINVVLYYA,0
4ja4,A,301,303,2,EV,0
4ja4,A,304,314,10,KTLGASTDIA,0
4ja4,A,315,317,2,LQ,0
4ja4,A,318,336,18,IIVGVINLTFTVLAIMTV,0
4ja4,A,343,361,18,LQIIGALGMAIGMFSLGT,0
4ja4,A,362,372,10,FYTQAPGIVA,0
4ja4,A,373,392,19,LSMLFYVAAFAMSWGPVCW,0
4ja4,A,410,429,19,AVAAQWLANYFVSWTFPMM,0
4ja4,A,430,434,4,KNSW,0
4ja4,A,435,440,5,VAHFH,0
4ja4,A,441,443,2,GF,0
4ja4,A,444,462,18,YWIYGCMGVLAALFMWKF,0
4ja4,A,480,485,5,ETKKT,0
3ar7,A,49,55,6,ELVIEQ,0
3ar7,A,57,77,20,DLLVRILLLAACISFVLAWF,0
3ar7,A,78,86,8,EGEETITA,0
3ar7,A,87,104,17,VEPFVILLILIANAIVG,0
3ar7,A,260,279,19,KVISLICVAVWLINIGHFN,0
3ar7,A,280,292,12,PVHGGSWIRGAI,0
3ar7,A,293,314,21,YFKIAVALAVAAIPEGLPAVI,0
3ar7,A,761,783,22,YLISSNVGEVVCIFLTAALGLP,0
3ar7,A,784,785,1,A,0
3ar7,A,786,807,21,IPVQLLWVNLVTDGLPATALG,0
3ar7,A,835,852,17,YMAIGGYVGAATVGAAA,0
3ar7,A,853,897,44,WFMYAEDGPGVTYHQLTHFMQCTEDHPHFEGLDCEIFEAPEPMT,0
3ar7,A,898,916,18,ALSVLVTIEMCNALNSLS,0
3ar7,A,931,950,19,LLGSICLSMSLHFLILYVD,0
3ar7,A,951,967,16,LPMIFKLKALDLTQWL,0
3ar7,A,968,987,19,VLKISLPVIGLDEILKFIA,0
1rh5,C,1,20,19,SKREETGLATSAGLIRYMD,0
1rh5,C,21,32,11,TFSKIRVKPEH,0
1rh5,C,33,50,17,IGVTVAFVIIEAILTYG,0
2w0f,F,1,22,21,PPMLSGLLARLVKLLLGRHGS,0
2w0f,F,26,50,24,RAAGAATVLLVIVLLAGSYLAVLA,0
2w0f,F,51,62,11,RGAPGAQLITY,0
2w0f,F,63,79,16,RALWWSVETATTVGYG,0
2w0f,F,80,86,6,LYPVTL,0
2w0f,F,87,111,24,GRCVAVVVMVAGITSFGLVTAALA,0
4zj8,A,26,44,18,YEDEFLRYLWRDYLYPKQ,0
4zj8,A,45,69,24,EWVLIAAYVAVFVVALVGNTLVCL,0
4zj8,A,85,108,23,VNLSLADVLVTAICLPASLLVDI,0
4zj8,A,109,117,8,ESWLFGHA,0
4zj8,A,118,141,23,CKVIPYLQAVSVSVAVLTLSFIA,0
4zj8,A,163,183,20,SILGIWAVSLAIMVPQAAVM,0
4zj8,A,184,210,26,CSSVLPELANRTRLFSVCDERWADDL,0
4zj8,A,211,234,23,PKIYHSCFFIVTYLAPLGLMAMA,0
4zj8,A,302,324,22,VLLVFALCYLPISVLNILKRVF,0
4zj8,A,325,335,10,MFRQASDREA,0
4zj8,A,336,358,22,YACFTFSHWLVYANSAANPIIY,0
4zj8,A,363,371,8,KFREQFKA,0
2ez0,B,1,17,16,KTDTPSLETPQAARLR,0
2ez0,B,37,61,24,MAAVVGTLVGLAAVAFDKGVAWLQ,0
2ez0,B,62,83,21,QRMGALVHTADNYPLLLTVAF,0
2ez0,B,84,97,13,CSAVLAMFGYFLV,0
2ez0,B,128,142,14,PVKFFGGLGTLGGG,0
2ez0,B,144,159,15,LGRQGPTVQIGGNIG,0
2ez0,B,180,204,24,GAAAGLAAAFNAPLAGILFIIEEM,0
2ez0,B,216,232,16,AVFIGVIMSTIMYRIF,0
2ez0,B,233,252,19,HEVALIDVGKLSDAPLNTL,0
2ez0,B,253,277,24,LYLILGIIFGIFGPIFNKWVLGMQ,0
2ez0,B,290,305,15,WVLMGGAIGGLCGLL,0
2ez0,B,306,316,10,FVAPATSGGG,0
2ez0,B,317,325,8,NLIPIATA,0
2ez0,B,326,336,10,NFSMGMLVFI,0
2ez0,B,337,351,14,VARVITTLLCFSSG,0
2ez0,B,353,368,15,GGIFAPMLALGTVLG,0
2ez0,B,369,391,22,AFGMVAVELFPQYHLEAGTFAI,0
2ez0,B,392,415,23,GMGALLAASIRAPLTGIILVLEM,0
2ez0,B,416,421,5,DNYQL,0
2ez0,B,422,439,17,LPMIITGLGATLLAQFT,0
2ez0,B,459,473,14,QLARSKAASASENT,0
2w1b,C,11,27,16,AWVIAIIIMLAGGLAI,0
2w1b,C,28,340,312,KLPVAQYPTIAPPAVTISASYPGADAKTVQDTVTQVIEQNMNGIDNLMYMSSNSDSTGTVQITLTFESGTDADIAQVQVQNKLQLAMPLLPQEVQQQGVSVEKSSSSFLMVVGVINTDGTMTQEDISDYVAANMKDAISRTSGVGDVQLFGSQYAMRIWMNPNELNKFQLTPVDVITAIKAQNAQVAAGQLGGTPPVKGQQLNASIIAQTRLTSTEEFGKILLKVNQDGSRVLLRDVAKIELGGENYDIIAEFNGQPASGLGIKLATGANALDTAAAIRAELAKMEPFFPSGLKIVYPYDTTPFVKISIHEV,0
2w1b,C,341,357,16,KTLVEAIILVFLVMYL,0
2w1b,C,366,386,20,IPTIAVPVVLLGTFAVLAAF,0
2w1b,C,387,394,7,FSINTLT,0
2w1b,C,395,410,15,FGMVLAIGLLVDDAI,0
2w1b,C,443,457,14,GIAMVLSAVFVPMA,0
2w1b,C,458,470,12,FGGSTGAIYRQF,0
2w1b,C,471,489,18,ITIVSAMALSVLVALILT,0
2w1b,C,514,534,20,WFNRMFEKSTHHYTDSVGGI,0
2w1b,C,543,558,15,LYLIIVVGMAYLFVR,0
2w1b,C,559,874,315,PSSFLPDEDQGVFMTMVQLPAGATQERTQKVLNEVTHYYLTKEKNNVESVFAVNGFGFAGRGQNTGIAFVSLKDWADRPGEENKVEAITMRATRAFSQIKDAMVFAFNLPAIVELGTATGFDFELIDQAGLGHEKLTQARNQLLAEAAKHPDMLTSVRPNGLEDTPQFKIDIDQEKAQALGVSINDINTTLGAAWGGSYVNDFIDRGRVKKVYVMSEAKYRMLPDDIGDWYVRAADGQMVPFSAFSSSRWEYGSPRLERYNGLPSMEILGQAAPGKSTGEAMELMEQLASKLPTGVGYDWTGMSYQERLSGNQAP,0
2w1b,C,875,890,15,LYAISLIVVFLCLAA,0
2w1b,C,899,919,20,SVMLVVPLGVIGALLAATFR,0
2w1b,C,920,927,7,LTNDVYF,0
2w1b,C,928,943,15,VGLLTTIGLSAKNAI,0
2w1b,C,976,992,16,MTSLAFILGVMPLVIS,0
2w1b,C,993,1001,8,GAGSGAQN,0
2w1b,C,1002,1018,16,VGTGVMGGMVTATVLA,0
2w1b,C,1019,1030,11,FFVPVFFVVVR,0
2w1b,C,1034,1049,15,RKNEDIEHSHTVDHH,0
4xpb,A,35,57,22,FLLSVIGFAVDLANVWRFPYLC,0
4xpb,A,58,62,4,KNGG,0
4xpb,A,63,82,19,AFLVPYGIMLAVGGIPLFY,0
4xpb,A,113,133,20,VLIAFYVGFYYNVIIAWSLR,0
4xpb,A,134,237,103,FFASFTNSLPWTSCNNIWNTPNCRPFESQGFQSAASEYFNRYILELNRSEGIHDLGAIKW,0
4xpb,A,238,255,17,MALCLLIVYLICYFSLW,0
4xpb,A,261,280,19,GKVVWFTALFPYAVLLILL,0
4xpb,A,281,303,22,RGLTLPGSFLGIQYYLTPNFSA,0
4xpb,A,304,328,24,YKAEVWVDAATQVFFSLGPGFGVL,0
4xpb,A,346,362,16,LTSFINSATSFIAGFV,0
4xpb,A,363,408,45,FSVLGYMAHTLGVRIEDVATEGPGLVFVVYPAAIATMPASTFWAL,0
4xpb,A,409,429,20,FFMMLATLGLDSSFGGMEAI,0
4xpb,A,449,464,15,GLFSLYFVVGLASCT,0
4xpb,A,465,467,2,GG,0
4xpb,A,468,489,21,YFFHLLDRYAAGYSILVAVFF,0
4xpb,A,517,524,7,YWQVCWR,0
4xpb,A,526,545,19,APIFLLFITVYGLIGYEPL,0
4xpb,A,546,553,7,YADYVYP,0
4xpb,A,554,570,16,WANALGWCIAGSSVVM,0
1ntk,K,1,21,20,LTRFLGPRYRQLARNWVPTA,0
1ntk,K,22,38,16,LWGAVGAVGLVWATDW,0
1ntk,K,54,56,2,DD,0
2exy,B,1,17,16,KTDTPSLETPQAARLR,0
2exy,B,37,61,24,MAAVVGTLVGLAAVAFDKGVAWLQ,0
2exy,B,62,80,18,QRMGALVHTADNYPLLLT,0
2exy,B,81,97,16,AFLCSAVLAMFGYFLV,0
2exy,B,128,142,14,PVKFFGGLGTLGGG,0
2exy,B,144,159,15,LGRQGPTVQIGGNIG,0
2exy,B,180,204,24,GAAAGLAAAFNAPLAGILFIIEEM,0
2exy,B,216,232,16,AVFIGVIMSTIMYRIF,0
2exy,B,233,252,19,HEVALIDVGKLSDAPLNTL,0
2exy,B,253,277,24,LYLILGIIFGIFGPIFNKWVLGMQ,0
2exy,B,278,284,6,LLHRVH,0
2exy,B,290,305,15,WVLMGGAIGGLCGLL,0
2exy,B,306,317,11,FVAPATSGGGF,0
2exy,B,318,325,7,LIPIATA,0
2exy,B,326,336,10,NFSMGMLVFI,0
2exy,B,337,351,14,VARVITTLLCFSSG,0
2exy,B,353,368,15,GGIFAPMLALGTVLG,0
2exy,B,369,391,22,AFGMVAVELFPQYHLEAGTFAI,0
2exy,B,392,415,23,GMGALLAASIRAPLTGIILVLEM,0
2exy,B,416,421,5,DNYQL,0
2exy,B,422,439,17,LPMIITGLGATLLAQFT,0
2exy,B,459,473,14,QLARSKAASASENT,0
3j9p,C,446,663,217,KSPLHFAASYGRINTCQRLLQDISDTRLLNEGDLHGMTPLHLAAKNGHDKVVQLLLKKGALFLSDHNGWTALHHASMGGYTQTMKVILDTNLKCTDRLDEDGNTALHFAAREGHAKAVALLLSHNADIVLNKQQASFLHLALHNKRKEVVLTIIRSKRWDECLKIFSHNSPGNKCPITEMIEYLPECMKVLLDFCMLHSTEDKSCRDYYIEYNFKYL,0
3j9p,C,680,719,39,EPLTALNAMVQNNRIELLNHPVCKEYLLMKWLAYGFRAH,0
3j9p,C,720,740,20,MNLGSYCLGLIPMTILVVNI,0
3j9p,C,769,785,16,IKTCMILVFLSSIFGY,0
3j9p,C,804,824,20,NVLEWIIYTTGIIFVLPLFV,0
3j9p,C,831,852,21,WQCGAIAVYFYWMNFLLYLQR,0
3j9p,C,853,859,6,ENCGIF,0
3j9p,C,860,892,32,VMLEVILKTLLRSTVVFIFLLLAFGLSFYILL,0
3j9p,C,901,922,21,LLSIIQTFSMMLGDINYRESF,0
3j9p,C,934,961,27,VLSFAQLVSFTIFVPIVLMNLLIGLAV,0
3j9p,C,962,970,8,DIADVQKH,0
3j9p,C,971,987,16,SLKRIAMQVELHTSLE,0
3j9p,C,988,1006,18,KLPLWFLRKVDQKSTIVY,0
3j9p,C,1031,1078,47,EIPNADKSLEMEILKQKYRLKDLTFLLEKQHELIKLIIQKMEIISET,0
4fxz,B,1,4,3,EVK,0
4fxz,B,14,35,21,ILAMAGNAVGLGNFLRFPVQA,0
4fxz,B,36,41,5,ENGGG,0
4fxz,B,42,63,21,FMIPYIIAFLLVGIPLMWIEW,0
4fxz,B,89,124,35,AKILGVFGLWIPLVVAIYYVYIESWTLGFAIKFLV,0
4fxz,B,125,131,6,LVPEPP,0
4fxz,B,132,134,2,,0
4fxz,B,135,166,31,DPDSILRPFKEFLYSYIGVPKGDEPILKPSL,0
4fxz,B,167,185,18,AYIVFLITMFINVSILIR,0
4fxz,B,191,214,23,ERFAKIAMPTLFILAVFLVIRVF,0
4fxz,B,215,222,7,LETPNGT,0
4fxz,B,223,231,8,ADGLNFLW,0
4fxz,B,232,241,9,PDFEKLKDP,0
4fxz,B,242,265,23,VWIAAVGQIFATLSLGFGAIITY,0
4fxz,B,278,298,20,GLTAATLNEKAEVILGGSIS,0
4fxz,B,299,307,8,PAAVAFFG,0
4fxz,B,308,317,9,ANAVAIAKA,0
4fxz,B,318,325,7,AFNLGFI,0
4fxz,B,326,331,5,LPAIF,0
4fxz,B,332,339,7,QTAGGTF,0
4fxz,B,340,367,27,GFLWFFLLFFAGLTSSIAIMQPMIAFL,0
4fxz,B,377,396,19,AVLWTAAIVFFSAHLVMFL,0
4fxz,B,397,399,2,KS,0
4fxz,B,400,425,25,DEMDFWAGTIGVVFFGLTELIIFFW,0
4fxz,B,429,437,8,DKAWEEIN,0
4fxz,B,445,472,27,RIYYYVMRYITPAFLAVLLVVWAREYI,0
4fxz,B,473,483,10,KIMEETHWTV,0
4fxz,B,484,502,18,ITRFYIIGLFLFLTFLVF,0
4fxz,B,602,604,2,SA,0
3te1,E,-2,0,2,GR,0
3te1,E,2,22,20,KETLDKLTNAAINKINLLNT,0
3te1,E,23,27,4,KVKY,0
3te1,E,28,48,20,VSSAFAGLYVGIGILLIFTI,0
3te1,E,62,79,17,VMGLSFAIALSLVIMTG,0
3te1,E,81,91,10,LFAGNNMVMS,0
3te1,E,92,104,12,GMLNKGVSIKDT,0
3te1,E,105,129,24,KIWAYSWVGNLIGALVLGIIFVGT,0
3te1,E,136,149,13,VAEFFANTAASKA,0
3te1,E,154,174,20,ALFFRGILCNILVCVSVLCS,0
3te1,E,175,180,5,RTNSD,0
3te1,E,181,198,17,AKIIMIFLCLFAFITSG,0
3te1,E,200,214,14,HSVANMTIYSVSLF,0
3te1,E,224,249,25,GAIYNLVAVTLGNIVGGALFMGLGT,0
3te1,E,250,256,6,ILGKEK,0
3te1,E,257,265,8,NAAAENLY,0
4xp4,A,31,53,22,GKVDFLLSVIGFAVDLANVWRF,0
4xp4,A,54,65,11,YLCYKNGGGAF,0
4xp4,A,66,89,23,VPYGIMLAVGGIPLFYMELALGQ,0
4xp4,A,109,132,23,GYAVVLIAFYVDFYYNVIIAWSL,0
4xp4,A,133,237,104,FFFASFTNSLPWTSCNNIWNTPNCRPFEGHVEGFQSAASEYFNRYILELNRSEGIHDLGAIKW,0
4xp4,A,238,258,20,MALCLLIVYLICYFSLWKGI,0
4xp4,A,260,277,17,SGKVVWFTALFPYAVLL,0
4xp4,A,278,307,29,LLIRGLTLPGSFLGIQYYLTPNFSAIYKA,0
4xp4,A,308,335,27,VWVDAATQVFFSLGPGFGVLLAYASYN,0
4xp4,A,340,359,19,VYKDALLTSFINSATSFIA,0
4xp4,A,360,411,51,FVIFSVLGYMAHTLGVRIEDVATEGPGLVFVVYPAAIATMPASTFWALIFF,0
4xp4,A,412,433,21,MLATLGLDSSFGGSEAIITAL,0
4xp4,A,445,464,19,LFVAGLFSLYFVVGLASCT,0
4xp4,A,465,469,4,GGFY,0
4xp4,A,470,496,26,FHLLDRYAAGYSILVAVFFEAIAVSW,0
4xp4,A,500,511,11,NRFSEDIRDMI,0
4xp4,A,516,545,29,RYWQVCWRFVAPIFLLFITVYGLIGYEPL,0
4xp4,A,546,553,7,YADYVYP,0
4xp4,A,554,574,20,WANALGWCIAGSSVVMIPAV,0
4x32,C,12,28,16,LALGTALMGLGTLYFL,0
4x32,C,29,46,17,KGMGVSDPDAKKFYAIT,0
4x32,C,47,61,14,LVPAIAFTMYLSML,0
4x32,C,80,94,14,ARYADWLFTTPLLL,0
4x32,C,95,110,15,DLALLVDADQGTILA,0
4x32,C,111,126,15,VGADGIMIGTGLVGA,0
4x32,C,135,150,15,VWWAISTAAMLYILY,0
4x32,C,151,156,5,LFFGF,0
4x32,C,163,177,14,RPEVASTFKVLRNV,0
4x32,C,178,192,14,VVLWSAYPVVWLIG,0
4x32,C,204,220,16,TLLFMVLDVSAKVGFG,0
4x32,C,221,232,11,ILLRSRAIFGE,0
3hb3,B,-28,0,28,MAIATKRRGVAAVMSLGVATMTAVPALA,0
3hb3,B,1,34,33,DVLGDLPVIGKPVNGGMNFQPASSPLAHDQQWL,0
3hb3,B,35,55,20,HFVLYIITAVTIFVCLLLLI,0
3hb3,B,78,97,19,VIWTLVPVLILVAIGAFSL,0
3hb3,B,98,252,154,ILFRSQEMPNDPDLVIKAIGHQWYWSYEYPNDGVAFDALMLEKEALADAGYSEDEYLLATDNPVVVPVGKKVLVQVTATDVIHAWTIPAFAVKQDAVPGRIAQLWFSVDQEGVYFGQCSELCGINHAYMPIVVKAVSQEKYEAWLAGAKEEFAA,0
3hb3,B,253,269,16,ASDYLPASPVKLASAE,0
2wsw,C,15,29,14,FPPLIIVGILCWLT,0
2wsw,C,30,32,2,RD,0
2wsw,C,33,46,13,DASNEVINAVFSY,0
2wsw,C,47,64,17,TNVWGWAFEWYMVIMFG,0
2wsw,C,96,109,13,ASCTSAAVLFWGS,0
2wsw,C,110,133,23,EIYYYISSPPFGMEGYSAPAKEI,0
2wsw,C,134,150,16,LAYSLFHWGPLPWATY,0
2wsw,C,192,216,24,DNFYLVALILAMGTSLGLATPLVT,0
2wsw,C,217,223,6,CIQYLF,0
2wsw,C,224,232,8,IPHTLQLD,0
2wsw,C,233,248,15,IIISCWILLNAICVA,0
2wsw,C,255,278,23,KIASDVRTYLSFLMLGWVFIVGG,0
2wsw,C,279,296,17,SFIVNYFTDSVGTLLMY,0
2wsw,C,297,313,16,PRMLFYTDPIGKGGFP,0
2wsw,C,314,331,17,AWTVFYWAWWVIYAIQM,0
2wsw,C,353,369,16,GLTAGTWLIWTILGGN,0
2wsw,C,370,389,19,LQLIDQNILNIPQLIDQYG,0
2wsw,C,390,399,9,PRAIIETWA,0
2wsw,C,400,406,6,LPLSTA,0
2wsw,C,407,431,24,MWGFFILCFIATVTLINACSYTLA,0
2wsw,C,447,463,16,VRIGWSVLVGIIGIIL,0
2wsw,C,464,471,7,ALGGLKP,0
2wsw,C,472,488,16,QTAIIAGGCPLFFVNI,0
5kc4,A,8,28,20,FVGIFSALATLVMFLEFPIF,0
5kc4,A,29,34,5,QASFL,0
5kc4,A,35,48,13,YDPSEIPALIVSF,0
5kc4,A,52,71,19,GVGMFVVLVKDILFFLMKS,0
5kc4,A,72,76,4,DPVG,0
5kc4,A,77,94,17,AMNAVLGMSFVGIAGLI,0
5kc4,A,106,123,17,GMIVATLFATAFALGLN,0
5kc4,A,124,143,19,LIVPLYFEAPFELYLKFFP,0
5kc4,A,144,162,18,ILAFNLVKFGIDSVVTFF,0
4qnz,A,90,91,1,E,0
4qnz,A,92,108,16,AGPVTWVMMIACVVVF,0
4qnz,A,116,123,7,QEVMLWL,0
4qnz,A,136,145,9,RYFTHALMH,0
4qnz,A,149,166,17,HILFNLLWWWYLGGAVE,0
4qnz,A,167,171,4,RLGS,0
4qnz,A,172,189,17,KLIVITLISALLSGYVQ,0
4qnz,A,199,213,14,LSGVVYALMGYVWL,0
4qnz,A,214,225,11,GERDPQSGIYL,0
4qnz,A,226,242,16,RGLIIFALIWIVAGWF,0
4qnz,A,251,267,16,GAHIAGLAVGLAMAFV,0
4qnz,A,268,271,3,SLN,0
5k47,D,221,242,21,RELVTYLLFLIVLCILTYGMM,0
5k47,D,243,297,54,SNVYYYTRMMSQLFLDTPVSKTEKTNFKTLSSMEDFWKFTEGSLLDGLYWKMQP,0
5k47,D,304,469,165,NRSFIFYENLLLGVPRIRQLRVRNGSCSIPQDLRDEIKECYDVYSVSSEDRAPFGPRNGTAWIYTSEKDLNGSSHWGIIATYSGAGYYLDLSRTREETAAQVASLKKNVWLDRGTRATFIDFSVYNANINLFCVVRLLVEFPATGGVIPSWQFQPLKLIRYVTTF,0
5k47,D,470,496,26,FFLAACEIIFCFFIFYYVVEEILEIR,0
5k47,D,503,528,25,RSFWNCLDVVIVVLSVVAIGINIYR,0
5k47,D,529,556,27,SNVEVLLQFLEDQNTFPNFEHLAYWQI,0
5k47,D,557,578,21,FNNIAAVTVFFVWIKLFKFIN,0
5k47,D,581,593,12,TMSQLSTTMSRC,0
5k47,D,594,620,26,KDLFGFAIMFFIIFLAYAQLAYLVFG,0
5k47,D,621,628,7,QVDDFST,0
5k47,D,629,646,17,QECIFTQFRIILGDINF,0
5k47,D,647,652,5,EIEEA,0
5k47,D,654,681,27,VLGPIYFTTFVFFMFFILLNMFLAIIN,0
4xe5,G,5,15,10,PFYYDYETVR,0
4xe5,G,16,32,16,GGLIFAALAFIVGLVI,0
3dtr,H,1,10,9,VGVTAFGNF,0
3dtr,H,13,32,19,SLAIYSFWIFLAGLIYYLQ,0
3dtr,H,33,250,217,ENMREGYPLENEDGTPAANQGPFPLPKPKTFILPHGRGTLTVPGPESEDRPIALARTAVSEGFPHAPTGDPMKDGVGPASWVARRDLPELDGHGHNKIKPMKAAAGFHVSAGKNPIGLPVRGCDLEIAGKVVDIWVDIPEQMARFLEVELKDGSTRLLPMQMVKVQSNRVHVNALSSDLFAGIPTIKSPTEVTLLEEDKICGYVAGGLMYAAPKRKS,0
3dtr,H,251,260,9,VAAMLAEYA,0
4ogq,P,2,22,20,AIVAYIGFLALFTGIAAGLL,0
4ogq,P,23,31,8,GLRSAKIL,0
3vi0,C,-12,4,16,LELLPTAVEGVSQAQI,0
3vi0,C,5,9,4,GRPE,0
3vi0,C,10,30,20,IWLALGTALMGLGTLYFLVK,0
3vi0,C,44,62,18,ITTLVPAIAFTMYLSMLL,0
3vi0,C,63,78,15,YGLTMVPFGGEQNPI,0
3vi0,C,79,96,17,WARYADWLFTTPLALLD,0
3vi0,C,109,128,19,ALVGADGIMIGTGLVGALT,0
3vi0,C,129,133,4,VYSY,0
3vi0,C,134,153,19,FVWWAISTAAMLYILYVLF,0
3vi0,C,175,192,17,NVTVVLWSAYPVVWLIG,0
3vi0,C,193,202,9,EGAGIVPLN,0
3vi0,C,203,222,19,ETLLFMVLDVSAKVGFGLI,0
3vi0,C,232,249,17,AEAPEPSAGDGAAATSD,0
1ih5,D,1,8,7,ASEFKKK,0
1ih5,D,12,32,20,AVVAEFLATTLFVFISIGSA,0
1ih5,D,33,47,14,GFKYPVGNNQTAVQ,0
1ih5,D,48,65,17,NVKVSLAFGLSIATLAQ,0
1ih5,D,73,86,13,HLNPAVTLGLLLS,0
1ih5,D,95,114,19,MYIIAQCVGAIVATAILSG,0
1ih5,D,115,139,24,TSSLTGNSLGRNDLADGVNSGQGL,0
1ih5,D,140,156,16,IEIIGTLQLVLCVLAT,0
1ih5,D,168,185,17,PLAIGLSVALGHLLAID,0
1ih5,D,186,188,2,TG,0
1ih5,D,189,201,12,GINPARSFGSAV,0
1ih5,D,202,209,7,THNFSNH,0
1ih5,D,210,229,19,IFWVGPFIGGALAVLIYDF,0
1ih5,D,233,269,36,RSSDLTDRVKVWTSGQVEEYDLDADDINSRVEMKPK,0
1kp1,A,1,47,46,LSTSRSRFIRNTNESGEEVTTFFDYDYGAPCHKFDVKQIGAQLLPP,0
1kp1,A,48,69,21,YSLVFIFGFVGNMLVVLILIN,0
1kp1,A,77,99,22,DIYLLNLAISDLLFLITLPLWA,0
1kp1,A,100,114,14,SAANEWVFGNAMCK,0
1kp1,A,115,136,21,FTGLYHIGYFGGIFFIILLTI,0
1kp1,A,158,177,19,VTSVITWLVAVFASVPGII,0
1kp1,A,178,200,22,TKCQKEDSVYVCGPYFPRGWNN,0
1kp1,A,201,223,22,HTIMRNILGLVLPLLIMVICYS,0
1kp1,A,245,265,20,FTIMIVYFLFWTPYNIVILL,0
1kp1,A,266,297,31,TFQEFFGLSNCESTSQLDQATQVTETLGMTH,0
1kp1,A,298,317,19,CINPIIYAFVGEKFRRYLS,0
1kp1,A,318,328,10,FFRKHITKRF,0
3f7v,F,21,28,7,SALQWRA,0
3f7v,F,33,50,17,VLLVIVLLAGSYLAVLA,0
3f7v,F,51,62,11,RGAPGAQLITY,0
3f7v,F,63,79,16,RALWWSVETATTVGYG,0
3f7v,F,80,86,6,LYPVTL,0
3f7v,F,87,107,20,GRCVAVVVMVAGITSFGLVT,0
3f7v,F,119,124,5,QQQGQ,0
5b0w,D,18,20,2,VT,0
5b0w,D,21,29,8,RELFEFVL,0
5b0w,D,30,36,6,DPLLAS,0
5b0w,D,37,57,20,LYINIALAGLSILLFVFMTR,0
5b0w,D,66,87,21,IAVSTILVPVVSIASYTGLAS,0
5b0w,D,88,120,32,LTISVLEMPAGHFAEGSSVMLGGEEVDGVVTM,0
5b0w,D,121,141,20,GRYLTWALSTPMILLALGLL,0
5b0w,D,147,168,21,KLFTAITFDIAMCVTGLAAAL,0
5b0w,D,169,174,5,TSSHL,0
5b0w,D,175,199,24,RWFWYAISCACFIVVLYILLVEWA,0
5b0w,D,211,232,21,STLKLLTVVMWLGYPIVWALG,0
5b0w,D,233,243,10,EGVAVLPVGY,0
5b0w,D,244,268,24,SWAYSALDIVAKYIFAFLLLNYLT,0
4jtc,B,-18,31,49,AHHHHHHHHHHGLVPRGSMTVATGDPVDEAAALPGHPQDTYDPEADHES,0
4jtc,B,32,163,131,ERVVINISGLRFETQLKTLAQFPETLLGDPKKRMRYFDPLRNEYFFDRNRPSFDAILYYYQSGGRLRRPVNVPLDIFSEEIRFYELGEEAMEMFREDEGYIKEEERPLPENEFQRQVWLLFEYPESSGPAR,0
4jtc,B,164,188,24,IAIVSVMVILISIVSFCLETLPIF,0
4jtc,B,207,217,10,STIGYQQSTS,0
4jtc,B,219,242,23,DPFFIVETLCIIWFSFEFLVRFF,0
4jtc,B,243,251,8,CPSKAGFF,0
4jtc,B,252,277,25,NIMNIIDIVAIIPYYVTIFLTESNK,0
4jtc,B,285,307,22,RRVVQIFRIMRILRIFKLSRHS,0
4jtc,B,308,319,11,GLQILGQTLKA,0
4jtc,B,321,348,27,RELGLLIFFLFIGVILFSSAVYFAEAD,0
4jtc,B,353,370,17,FPSIPDAFWWAVVSMTT,0
4jtc,B,381,402,21,GGKIVGSLCAIAGVLTIALPV,0
4jtc,B,403,414,11,VIVSNFNYFYH,0
4jtc,B,415,417,2,ET,0
4jtc,B,418,495,77,GEEQAQYLQVTSSPKIPSSPDLKKSRSASTISKSDYMEIQEGVNNSNEDFREENLKTANSTLANTNYVNITKMLTDV,0
4h9l,H,1,10,9,VGVTAFGNF,0
4h9l,H,12,28,16,ASLAIYSFWIFLAGLI,0
4h9l,H,29,248,219,YLQTENMREGYPLENEDGTPAANQGPFPLPKPKTFILPHGRGTLTVPGPESEDRPIALARTAVSEGFPHAPTGDPMKDGVGPASWVARRDLPELDGHGHNKIKPMKAAAGFHVSAGKNPIGLPVRGCDLEIAGKVVDIWVDIPEQMARFLEVELKDGSTRLLPMQMVKVQSNRVHVNALSSDLFAGIPTIKSPTEVTLLEEDKICGYVAGGLMYAAPKR,0
4h9l,H,249,260,11,SVVAAMLAEYA,0
3qbg,D,1,17,16,TETLPPVTESAVALQA,0
3qbg,D,18,20,2,VT,0
3qbg,D,21,28,7,RELFEFV,0
3qbg,D,29,36,7,NDPLLAS,0
3qbg,D,37,57,20,LYINIALAGLSILLFVFMTR,0
3qbg,D,66,87,21,IAVSTILVPVVSIASYTGLAS,0
3qbg,D,88,120,32,LTISVLEMPAGHFAEGSSVMLGGEEVDGVVTM,0
3qbg,D,121,141,20,GRYLTWALSTPMILLALGLL,0
3qbg,D,147,168,21,KLFTAITFDIAMCVTGLAAAL,0
3qbg,D,169,175,6,TSSHLM,0
3qbg,D,176,199,23,WFWYAISCACFIVVLYILLVEWA,0
3qbg,D,211,232,21,STLKLLTVVMWLGYPIVWALG,0
3qbg,D,233,243,10,EGVAVLPVGY,0
3qbg,D,244,267,23,SWAYSALDIVAKYIFAFLLLNYL,0
3qbg,D,278,291,13,LDVPSASGAPADD,0
2nrf,C,96,114,18,TWVMMIACVVVFIAMQIL,0
2nrf,C,115,123,8,DQEVMLWL,0
2nrf,C,124,139,15,WPFDPTLKFEFWRYF,0
2nrf,C,140,163,23,HALMHFSLMHILFNLLWWWYLGG,0
2nrf,C,174,191,17,IVITLISALLSGYVQQK,0
2nrf,C,192,197,5,SGPWF,0
2nrf,C,198,213,15,GLSGVVYALMGYVWL,0
2nrf,C,226,247,21,RGLIIFALIWIVAGWFDLFGM,0
2nrf,C,249,267,18,ANGAHIAGLAVGLAMAFV,0
5iwr,D,327,349,22,FCVLGAIYVLYIICFTMCCVYR,0
5iwr,D,350,382,32,LKPRITNRTNPRDNTLLQQKLLQEAYVTPKDD,0
5iwr,D,383,408,25,RLVGELVSIVGAVIILLVEIPDIFR,0
5iwr,D,422,443,21,PFHVIIVTYAFMVLVTMVMRL,0
5iwr,D,444,448,4,NSDG,0
5iwr,D,449,470,21,VVPMSFALVLGWCNVMYFARG,0
5iwr,D,486,511,25,GDLMRFCWQMAVVILGFASAFYIIF,0
5iwr,D,512,524,12,TEDPDELGHFYD,0
5iwr,D,525,544,19,PMALFSTFELFLTIIDGPA,0
5iwr,D,545,551,6,YDVDLP,0
5iwr,D,552,576,24,MYSITYAAFAIIATLLMLNLLIAM,0
5iwr,D,584,605,21,AHERDELWRAQVVATTVMLER,0
5iva,B,63,71,8,QQRTVSYT,0
5iva,B,72,74,2,SA,0
5iva,B,75,83,8,GAEFELTN,0
5iva,B,105,112,7,KVYVHDE,0
5iva,B,113,114,1,N,0
5iva,B,115,129,14,IGSDQEAAQLRSEM,0
2ypt,A,19,37,18,FGAVLLFSWTVYLWETFL,0
2ypt,A,38,79,41,QRQRRIYKTTTHVPPELGQIMDSETFEKSRLYQLDKSTFSF,0
2ypt,A,80,102,22,SGLYSETEGTLILLFGGIPYLW,0
2ypt,A,108,115,7,CGYAGFG,0
2ypt,A,120,141,21,TQSLVFLLLATLFSALAGLPW,0
2ypt,A,142,167,25,LYNTFVIEEKHGFNQQTLGFFMKDA,0
2ypt,A,168,189,21,KKFVVTQCILLPVSSLLLYII,0
2ypt,A,196,215,19,FIYAWLFTLVVSLVLVTIY,0
2ypt,A,216,271,55,DYIAPLFDKFTPLPEGKLKEEIEVMAKSIDFPLTKVYVVEGSKRSSHSNAYFYGF,0
2ypt,A,272,274,2,KN,0
2ypt,A,275,285,10,RIVLFDTLLE,0
2ypt,A,286,321,35,YSVLNKDIQEDSGMEPRNEEEGNSEEIKAKVKNKK,0
2ypt,A,322,346,24,GCKNEEVLAVLGHALGHWKLGHTV,0
2ypt,A,347,367,20,NIIISQMNSFLCFFLFAVLI,0
2ypt,A,384,410,26,LIGLLIIFQFIFSPYNEVLSFCLTVL,0
2ypt,A,411,449,38,RRFEFQADAFAKKLGKAKDLYSALIKLNKDNLGFPVSD,0
2ypt,A,450,455,5,LFSMW,0
2ypt,A,456,472,16,YSHPPLLERLQALKTM,0
2ypt,A,473,482,9,QHAENLYFQ,0
3qak,A,-14,2,16,YKDDDDAMGQPVGAPP,0
3qak,A,7,25,18,VYITVELAIAVLAILGNV,0
3qak,A,26,48,22,VCWAVWLNSNLQNVTNYFVVSL,0
3qak,A,49,67,18,AADIAVGVLAIPFAITIS,0
3qak,A,76,96,20,CLFIACFVLVLTQSSIFSLL,0
3qak,A,97,126,29,IAIDRYIAIRIPLRYNGLVTGTRAKGIIA,0
3qak,A,127,145,18,CWVLSFAIGLTPMLGWNN,0
3qak,A,149,157,8,KEGKNHSQ,0
3qak,A,172,194,22,PMNYMVYFNFFACVLVPLLLML,0
3qak,A,195,237,42,VYLRIFLAARRQLNIFEMLRIDEGLRLKIYKDTEGYYTIGIGHLLTKSPSLNAAKSELDKAIGRNTNGVITKDEAEKLFNQDVDAAVRGILRNAKLKPVYDSLDAVRRAALINMVFQMGETGVAGFTNSLRMLQQKRWDEAAVNLAKSRWYNQTPNRAKRVITTFRTGTWDAYRSTLQKEVHAAKSLAI,0
3qak,A,238,259,21,VGLFALCWLPLHIINCFTFFC,0
3qak,A,266,286,20,LWLMYLAIVLSHTNSVVNPF,0
3qak,A,287,292,5,YAYRI,0
3qak,A,293,303,10,EFRQTFRKII,0
3qak,A,304,308,4,SHVL,0
3qak,A,309,326,17,QQEPFKAHHHHHHHHHH,0
3syo,D,50,54,4,AKRK,0
3syo,D,70,75,5,NVRET,0
3syo,D,80,116,36,DIFTTLVDLKWRFNLLIFVMVYTVTWLFFGMIWWLI,0
3syo,D,117,121,4,YIRG,0
3syo,D,122,133,11,MDHIEDPSWTP,0
3syo,D,134,144,10,VTNLNGFVSA,0
3syo,D,145,157,12,LFSIETETTIGY,0
3syo,D,158,167,9,YRVITDKCP,0
3syo,D,168,197,29,GIILLLIQSVLGSIVNAFMVGCMFVKISQ,0
3syo,D,198,204,6,KKRAET,0
3syo,D,382,389,7,SLEVLFQ,0
4f4s,T,13,33,20,ISTIGLLGAGIGIAIVFAAL,0
4f4s,T,34,48,14,NGVSRNPSIKDTVF,0
4f4s,T,49,71,22,MAILGFALSEATGLFCLMVSFL,0
4mrr,B,1,8,7,PPETATN,0
4mrr,B,16,27,11,WQTLKRFLPYL,0
4mrr,B,34,58,24,LRRRVVGAILMVLLGKATTLALPF,0
4mrr,B,59,85,26,YKKAVDAMTLGGGAQPALTVALAFVL,0
4mrr,B,86,108,22,YALGRFSGVLFDNLRNIVFERV,0
4mrr,B,155,177,22,YFLLFNIAPTVIELTAVIVIFW,0
4mrr,B,178,182,4,NFGL,0
4mrr,B,183,206,23,LVTATILAVIAYVWTTRTITEWR,0
4mrr,B,263,284,21,SLGLLNIAQALIVNLLMAGAM,0
4mrr,B,285,303,18,WTVYGWSQGKLTVGDLVF,0
4mrr,B,304,325,21,NTYLTQLFRPLDMLGMVYRTI,0
4mrr,B,607,614,7,EHHHHHH,0
3uty,A,1,4,3,AQI,0
3uty,A,10,32,22,IWLALGTALMGLGTLYFLVKGM,0
3uty,A,33,41,8,VSDPDAKK,0
3uty,A,42,66,24,YAIATLVAAIAFTMYLSMLLGYGL,0
3uty,A,79,99,20,WARYADWLFTTPLLLLDLAL,0
3uty,A,100,103,3,VDA,0
3uty,A,104,127,23,QGTILALVGADGIMIGTGLVGAL,0
3uty,A,134,157,23,FVWWAISTAAMLYILYVLFFGFT,0
3uty,A,158,170,12,KAESMRPEVAST,0
3uty,A,171,195,24,KVLRNVTVVLWSAYPVVWLIGSEG,0
3uty,A,202,225,23,IETLLFMVLDVSAKVGFGLILLR,0
3uty,A,226,231,5,RAIFG,0
3uty,A,232,249,17,AEAPEPSAGDGAAATSD,0
2zbd,A,61,77,16,RILLLAACISFVLAWF,0
2zbd,A,78,85,7,EGEETIT,0
2zbd,A,86,102,16,FVEPFVILLILIANAI,0
2zbd,A,257,274,17,QLSKVISLICVAVWLIN,0
2zbd,A,275,295,20,GHFNDPVHGGSWIRGAIYYF,0
2zbd,A,296,311,15,IAVALAVAAIPEGLP,0
2zbd,A,761,777,16,YLISSNVGEVVCIFLT,0
2zbd,A,778,787,9,ALGLPEALI,0
2zbd,A,788,806,18,VQLLWVNLVTDGLPATAL,0
2zbd,A,832,851,19,FFRYMAIGGYVGAATVGAA,0
2zbd,A,852,898,46,WWFMYAEDGPGVTYHQLTHFMQCTEDHPHFEGLDCEIFEAPEPMTM,0
2zbd,A,899,916,17,LSVLVTIEMCNALNSLS,0
2zbd,A,933,950,17,GSICLSMSLHFLILYVD,0
2zbd,A,951,956,5,LPMIF,0
2zbd,A,957,967,10,LKALDLTQWL,0
2zbd,A,968,988,20,VLKISLPVIGLDEILKFIAR,0
5jdq,A,8,27,19,FLLGLILLYYGSDWFVLGS,0
5jdq,A,28,39,11,RIARHFNVSNF,0
5jdq,A,40,57,17,IGATVMAIGTSLPEILT,0
5jdq,A,74,93,19,IGSCICNIGLVLGLSAIIS,0
5jdq,A,94,104,10,IIVDKNLQKN,0
5jdq,A,105,120,15,LVYLLFVIFAAVIGI,0
5jdq,A,126,142,16,DGVVLLILFIIYLRWT,0
5jdq,A,143,151,8,KNGSAEIE,0
5jdq,A,157,165,8,NPSVVFSL,0
5jdq,A,166,183,17,LLIIGLIGVLVGAELFV,0
5jdq,A,207,222,15,GTSLPELMVSLAAAK,0
5jdq,A,223,228,5,NLGGM,0
5jdq,A,229,247,18,LGNVIGSNIADIGGALAV,0
5jdq,A,259,275,16,QMAVLVIMSLLLYLFA,0
5jdq,A,276,280,4,YSKI,0
5jdq,A,281,296,15,RWQGILFLALYIIAI,0
1x0s,C,1,4,3,AQI,0
1x0s,C,5,11,6,GRPEWI,0
1x0s,C,12,29,17,LALGTALMGLGTLYFLV,0
1x0s,C,45,61,16,TTLVPAIAFTMYLSML,0
1x0s,C,62,79,17,GYGLTMVPFGGEQNPIY,0
1x0s,C,80,95,15,ARYADWLFTTPLLLL,0
1x0s,C,110,126,16,LVGADGIMIGTGLVGA,0
1x0s,C,127,134,7,TKVYSYR,0
1x0s,C,135,153,18,VWWAISTAAMLYILYVLF,0
1x0s,C,175,192,17,NVTVVLWSAYPVVWLIG,0
1x0s,C,193,203,10,EGAGIVPLNI,0
1x0s,C,204,222,18,TLLFMVLDVSAKVGFGLI,0
1x0s,C,232,248,16,AEAPEPSAGDGAAATS,0
5jdf,A,5,24,19,VGYFLLGLILLYYGSDWFV,0
5jdf,A,25,39,14,GSERIARHFNVSNF,0
5jdf,A,40,58,18,IGATVMAIGTSLPEILTS,0
5jdf,A,72,92,20,NAIGSCICNIGLVLGLSAII,0
5jdf,A,93,103,10,PIIVDKNLQK,0
5jdf,A,104,120,16,ILVYLLFVIFAAVIGI,0
5jdf,A,127,143,16,GVVLLILFIIYLRWTV,0
5jdf,A,144,148,4,NGSA,0
5jdf,A,156,165,9,NNPSVVFSL,0
5jdf,A,166,186,20,LLIIGLIGVLVGAELFVDGA,0
5jdf,A,205,222,17,AFGTSLPELMVSLAAAK,0
5jdf,A,223,228,5,NLGGM,0
5jdf,A,229,247,18,LGNVIGSNIADIGGALAV,0
5jdf,A,259,275,16,QMAVLVIMSLLLYLFA,0
5jdf,A,276,280,4,YSKI,0
5jdf,A,281,299,18,RWQGILFLALYIIAIASL,0
5m7k,D,13,33,20,QLVWYAQWLVIWTVVLLYLR,0
5m7k,D,34,45,11,EDRREGYPLVE,0
5m7k,D,61,258,197,LPYPKTFVLPHGGTVTVPRRRPETRELKLAQTDGFEGAPLQPTGNPLVDAVGPASYAERAEVVDATVDGKAKIVPLRVATDFSIAEGDVDPRGLPVVAADGVEAGTVTDLWVDRSEHYFRYLELSVAGSARTALIPLGFCDVKKDKIVVTSILSEQFANVPRLQSRDQITLREEDKVSAYYAGGLLYATPERAESLL,0
4phz,G,1,15,14,SSTTSAAAGAAAEV,0
4phz,G,16,24,8,SVVDLRGM,0
4phz,G,25,39,14,IGLVLLNVFYLIVR,0
4phz,G,65,79,14,LWTEIPLELVSGLG,0
4phz,G,80,111,31,AGYLWKTRDRNVDAVTPREEMRRLVVLVQWL,0
4phz,G,112,126,14,VYGIAIYWGASFFT,0
4phz,G,148,162,14,EFYMSYPIYSVIAV,0
4phz,G,163,184,21,AFFYAKTRIPYFAHGYSLAFL,0
4phz,G,185,196,11,VAIGPFMIIPN,0
4phz,G,197,225,28,GLNEWGHTFWFMEELFVAPLHWGFVFFG,0
4phz,G,226,256,30,MALGVFGVVLQILMRIHALVGKEGVKLLTE,0
3wmn,0,0,6,6,AEQKSL,0
3wmn,0,7,28,21,GLTDDEAKEFHAIFMQSMYAW,0
3wmn,0,29,41,12,GLVVIAHLLAWL,0
3n8g,A,1,54,53,EAAHSKSTEECLAYFGVSETTGLTPDQVKRHLEKYGHNELPAEEGKSLWELVI,0
3n8g,A,55,78,23,QFEDLLVRILLLAACISFVLAWF,0
3n8g,A,86,104,18,AFVEPFVILLILIANAIV,0
3n8g,A,105,256,151,VWQERNAENAIEALKEYEPEMGKVYRADRKSVQRIKARDIVPGDIVEVAVGDKVPADIRILSIKSTTLRVDQSILTGESVSVIKHTEPVPDPRAVNQDKKNMLFSGTNIAAGKALGIVATTGVSTEIGKIRDQMAATEQDKTPLQQKLDEF,0
3n8g,A,257,275,18,EQLSKVISLICVAVWLIN,0
3n8g,A,294,313,19,YFKIAVALAVAAIPEGLPA,0
3n8g,A,314,759,445,ITTCLALGTRRMAKKNAIVRSLPSVETLGCTSVICSDKTGTLTTNQMSVCKMFIIDKVDGDFCSLNEFSITGSTYAPEGEVLKNDKPIRSGQFDGLVELATICALCNDSSLDFNETKGVYEKVGEATETALTTLVEKMNVFNTEVRNLSKVERANACNSVIRQLMKKEFTLEFSRDRKSMSVYCSPAKSSRAAVGNKMFVKGAPEGVIDRCNYVRVGTTRVPMTGPVKEKILSVIKEWGTGRDTLRCLALATRDTPPKREEMVLDDSSRFMEYETDLTFVGVVGMLDPPRKEVMGSIQLCRDAGIRVIMITGDNKGTAIAICRRIGIFGENEEVADRAYTGREFDDLPLAEQREACRRACCFARVEPSHKSKIVEYLQSYDEITAMTGDGVNDAPALKKAEIGIAMGSGTAVAKTASEMVLADDNFSTIVAAVEEGRAIYNNMKQ,0
3n8g,A,760,781,21,IRYLISSNVGEVVCIFLTAAL,0
3n8g,A,787,807,20,IPVQLLWVNLVTDGLPATAL,0
3n8g,A,808,831,23,FNPPDLDIMDRPPRSPKEPLISG,0
3n8g,A,832,852,20,LFFRYMAIGGYVGAATVGAA,0
3n8g,A,898,916,18,MALSVLVTIEMCNALNSL,0
3n8g,A,917,931,14,ENQSLMRMPPWVNI,0
3n8g,A,932,950,18,LLGSICLSMSLHFLILYV,0
3n8g,A,951,957,6,PLPMIF,0
3n8g,A,964,987,23,TQWLMVLKISLPVIGLDEILKFI,0
3n8g,A,988,994,6,RNYLEG,0
4ux2,B,38,58,20,WISLYYVAFYVVMSGIFALC,0
4ux2,B,59,88,29,YVLMRTIDPYTPDYQDQLKSPGVTLRPDV,0
4ux2,B,125,154,29,EGSINCTSEKYFFQESFLAPNHTKFSCKF,0
4ux2,B,175,194,19,KPCFIIKMNRIVKFLPGNS,0
4ux2,B,209,213,4,GPPL,0
4ux2,B,224,243,19,SLHYFPYYGKKAQPHYSNP,0
4ux2,B,248,290,42,LLNVPRNRDVVIVCKILAEHVSFDNPHDPYEGKVEFKLKIQK,0
5jki,A,2,20,18,KPVSLFLFFLILAAAIHT,0
5jki,A,21,35,14,AVQSADEAISKAAV,0
5jki,A,36,44,8,IRQPWLNE,0
5jki,A,45,71,26,MTGITHLGASSFLLPLIVIIGAGMFF,0
5jki,A,77,99,22,GLLMLLVFGTDRLLNKVLKEWI,0
5jki,A,100,116,16,RVRPDFAPLVHESSFS,0
5jki,A,117,137,20,PSGHSMNAACVYPVIAYFLV,0
5jki,A,149,167,18,VYIIAGVIAVLVGISRVY,0
5jki,A,168,171,3,GVH,0
5jki,A,172,193,21,VTDVLGGFSLGLLLFFLVKGF,0
4pgu,A,-2,5,7,NAMQATV,0
4pgu,A,6,16,10,ESKQSIMQRI,0
4pgu,A,17,38,21,TVFVFTLLIATVGLFIGQFVP,0
4pgu,A,42,61,19,LPLSILEVAMIILAFWMRR,0
4pgu,A,62,67,5,KAVGY,0
4pgu,A,68,86,18,FVYTFAFVSGITLFPIVS,0
4pgu,A,96,116,20,VLEAFGSTFVIFAVLGTIGA,0
4pgu,A,117,122,5,MKKDL,0
4pgu,A,123,144,21,FLWSFLLVAVLALAVVGIFNI,0
4pgu,A,156,174,18,SVIGTIVFSLYILYDLNQ,0
4pgu,A,175,186,11,KHRHITEDLIP,0
4pgu,A,187,207,20,MALSLYLDFINLFINLLRFF,0
4pgu,A,213,214,1,D,0
3w5b,A,-5,-3,2,DN,0
3w5b,A,48,70,22,LWELVIEQFEDLLVRILLLAAC,0
3w5b,A,71,90,19,SFVLAWFEEGEETITAFVE,0
3w5b,A,91,108,17,FVILLILIANAIVGVWQ,0
3w5b,A,257,274,17,EQLSKVISLICVAVWLI,0
3w5b,A,275,295,20,IGHFNDPVHGGSWIRGAIYY,0
3w5b,A,296,311,15,KIAVALAVAAIPEGL,0
3w5b,A,761,781,20,RYLISSNVGEVVCIFLTAAL,0
3w5b,A,782,785,3,LPE,0
3w5b,A,786,807,21,LIPVQLLWVNLVTDGLPATAL,0
3w5b,A,832,852,20,LFFRYMAIGGYVGAATVGAA,0
3w5b,A,853,897,44,WWFMYAEDGPGVTYHQLTHFMQCTEDHPHFEGLDCEIFEAPEPM,0
3w5b,A,898,916,18,MALSVLVTIEMCNALNSL,0
3w5b,A,931,950,19,WLLGSICLSMSLHFLILYV,0
3w5b,A,951,964,13,PLPMIFKLKALDL,0
3w5b,A,965,987,22,QWLMVLKISLPVIGLDEILKFI,0
4ltr,D,137,149,12,PSSPSLLRAIPG,0
4ltr,D,152,171,19,IALLLLVIFYVFAVMGTKL,0
4ltr,D,172,182,10,AQSFPEWFGT,0
4ltr,D,183,204,21,GASMYTLFQVMTLESWSMGIA,0
4ltr,D,205,212,7,PVIEAYP,0
4ltr,D,213,233,20,AWIYFVSFILVSSFTVLNLF,0
4ltr,D,286,288,2,KR,0
4pd8,C,-5,1,6,PAVPRM,0
4pd8,C,5,21,16,SCCGMAVLLGIAVLLS,0
4pd8,C,22,29,7,NRKAINL,0
4pd8,C,30,47,17,TVGGAFAIQFSLGAFIL,0
4pd8,C,50,78,28,WGQELLRGFSDAVSNVINYGNDGTSFLF,0
4pd8,C,103,118,15,TLIFFSALISVLYYL,0
4pd8,C,120,136,16,MQWVIRILGGGLQKAL,0
4pd8,C,137,175,38,TSRAESMSAAANIFVGQTEAPLVVRPFVPKMTQSELFA,0
4pd8,C,176,192,16,MCGGLASIAGGVLAGY,0
4pd8,C,202,220,18,VAASFMAAPGGLLFAKLM,0
4pd8,C,221,229,8,PETEKPQD,0
4pd8,C,230,240,10,EDITLDGGDD,0
4pd8,C,242,274,32,ANVIDAAAGGASAGLQLALNVGAMLIAFIGLI,0
4pd8,C,275,286,11,LINGMLGGIGG,0
4pd8,C,359,379,20,SFALCGFANLSSIAILLGGL,0
4pd8,C,380,394,14,SLAPKRRGDIARMG,0
4pd8,C,395,414,19,KAVIAGTLSNLMAATIAGF,0
4pd8,C,417,418,1,F,0
5an8,D,393,411,18,NFLCYLVYMLIFTAVAYH,0
5an8,D,412,415,3,PAL,0
5an8,D,427,431,4,GNSM,0
5an8,D,432,452,20,LLGHILILLGGVYLLLGQLW,0
5an8,D,470,490,20,EILFLLQALLTVLSQVLCFL,0
5an8,D,491,494,3,IEW,0
5an8,D,495,514,19,LPLLVSSLVLGWLNLLYYT,0
5an8,D,521,535,14,IYSVMIQKVILRDL,0
5an8,D,536,556,20,RFLLVYLVFLFGFAVALVSL,0
5an8,D,557,559,2,RE,0
5an8,D,586,591,5,PYRSI,0
5an8,D,592,609,17,DASLELFKFTIGMGELA,0
5an8,D,610,618,8,QEQLRFRG,0
5an8,D,619,639,20,VLLLLLAYVLLTYVLLLNML,0
3kdp,H,32,47,15,FAALAFIVGLIILLS,0
3kdp,H,48,49,1,R,0
2hfe,J,87,111,24,GRLVAVVVMVAGITSFGLVTAALA,0
2hfe,J,112,122,10,WFVGREQERR,0
2amk,A,70,93,23,AFLTGFLALVTIIGNILVIVAFK,0
2amk,A,94,103,9,NKQLKTVNN,0
2amk,A,104,128,24,FLLSLACADLIIGVISMNLFTTYI,0
2amk,A,139,162,23,CDLWLSIDYVASNASVMNLLVIS,0
2amk,A,163,184,21,DRYFSITRPLTYRAKRTTKRA,0
2amk,A,185,210,25,VMIGLAWVISFVLWAPAILFWQYFV,0
2amk,A,227,250,23,PTITFGTAIAAFYMPVTIMTILY,0
2amk,A,251,262,11,RIYKETEKRTK,0
2amk,A,263,477,214,LAGLQASGTEAEAENFVHPTGSSRSCSSYELQQQGVKRSSRRKYGRCHFWFTTKSWKPSAEQMDQDHSSSDSWNNNDAAASLENSASSDEEDIGSETRAIYSIVLKLPGHSSILNSTKLPSSDNLQVSNEDLGTVDVERNAHKLQAQKSMGDGDNCQKDFTKLPIQLESAVDTGKTSDTNSSADKTTATLPLSFKEATLAKRFALKTRSQITKR,0
2amk,A,478,491,13,RMSLIKEKKAAQT,0
2amk,A,492,516,24,SAILLAFIITWTPYNIMVLVNTFC,0
2amk,A,524,546,22,WNLGYWLCYINSTVNPVCYALC,0
2amk,A,548,558,10,TFRTTFKTLL,0
2amk,A,559,560,1,C,0
5hew,E,11,210,199,VDVSVSIFINKIYGVNDLEQTYKVDGYIVAQWTGKPRKTPGDKPLIVENTQIERWINNGLWVPALEFINVVGSPDTGNKRLMLFPDGRVIYNARFLGSFSNDMDFRLFPFDRQQFVLELEPFSYNNQQLRFSDIQVYTENIDNEEIDEWWIRGKASTHISDIRYDHLSSVQPNQNEFSRITVRIDAVRNPSYYLWSFIL,0
5hew,E,211,222,11,LGLIIAASWSV,0
5hew,E,233,246,13,TSFTLMLTVVAYA,0
5hew,E,247,265,18,YTSNILPRLPYTTVIDQM,0
5hew,E,266,279,13,IAGYGSIFAAILL,0
5hew,E,303,315,12,FPLGFLAIGCVL,0
5hew,E,316,317,1,I,0
5xat,A,11,19,8,SKGVSDLL,0
5xat,A,20,31,11,FKIFGMPLPLY,0
5xat,A,32,44,12,FALITLLLSHFY,0
5xat,A,47,69,22,PTDIVGGFAIMFIIGAIFGEIG,0
5xat,A,70,80,10,RLPIFNKYIG,0
5xat,A,81,94,13,APVMIFLVAAYFV,0
5xat,A,115,127,12,FLNLFIAVLITG,0
5xat,A,128,141,13,ILSVNRRLLLKSL,0
5xat,A,142,162,20,GYIPTILMGIVGASIFGIAI,0
5xat,A,217,230,13,IANIFAIVFAAVL,0
5xat,A,231,249,18,IIGKKHTWLSGEGELVRK,0
5xat,A,250,257,7,SFKVEED,0
5xat,A,258,269,11,KTGQITHRETA,0
5xat,A,270,286,16,GLVLSTTCFLLAYVVA,0
5xat,A,299,311,12,YFAWMVLIVAAL,0
5xat,A,312,335,23,ASGLCSPEIKAGAKRLSDFFSKQ,0
5xat,A,336,349,13,LWVLMVGVGVCYT,0
5xat,A,364,381,17,IAAIIVIGAVLGAAIGG,0
5xat,A,382,391,9,LMGFFPIES,0
5xat,A,392,414,22,ITAGLCMANRGGSGDLEVLSAC,0
5xat,A,415,419,4,RMNL,0
5xat,A,420,434,14,SYAQISSRLGGGIV,0
5xat,A,446,448,2,PR,0
3b9y,C,43,60,17,SINILAMLLVGFGFLMV,0
3b9y,C,61,68,7,VRRYGFS,0
3b9y,C,69,88,19,TTGTYLVVATGLPLYILLR,0
3b9y,C,105,123,18,IYAEFAVATGLIAMGAVL,0
3b9y,C,124,128,4,RLRV,0
3b9y,C,129,150,21,QYALLALFIVPVYLLNEWLVL,0
3b9y,C,163,183,20,AGSIAIHAFGAYFGLGVSIA,0
3b9y,C,184,202,18,TTAAQRAQPIESDATSDR,0
3b9y,C,203,221,18,SMLGSMVLWLFWPSFATA,0
3b9y,C,233,250,17,NTLLALCGATLATYFLS,0
3b9y,C,251,260,9,LFHKGKASI,0
3b9y,C,261,278,17,DMANAALAGGVAIGSVC,0
3b9y,C,284,301,17,GAFVIGLLGGAISVVGF,0
3b9y,C,302,316,14,FIQPMLESKAKTID,0
3b9y,C,317,338,21,CGVHNLHGLPGLLGGFSAILI,0
3b9y,C,347,371,24,TGIGITLALALIGGVIAGALIKLT,0
3b9y,C,372,418,46,TTKQAYEDSHEFIHLAGPEDEHKAERLVLEAKTEIQGLKNRIDAAV,0
4prc,H,13,32,19,QLVWYAQWLVIWTVVLLYL,0
4prc,H,33,258,225,REDRREGYPLVEPLGLVKLAPEDGQVYELPYPKTFVLPHGGTVTVPRRRPETRELKLAQTDGFEGAPLQPTGNPLVDAVGPASYAERAEVVDATVDGKAKIVPLRVATDFSIAEGDVDPRGLPVVAADGVEAGTVTDLWVDRSEHYFRYLELSVAGSARTALIPLGFCDVKKDKIVVTSILSEQFANVPRLQSRDQITLREEDKVSAYYAGGLLYATPERAESLL,0
1m0k,C,-12,4,16,LELLPTAVEGVSQAQI,0
1m0k,C,5,11,6,GRPEWI,0
1m0k,C,12,30,18,LALGTALMGLGTLYFLVK,0
1m0k,C,44,61,17,ITTLVPAIAFTMYLSML,0
1m0k,C,62,79,17,GYGLTMVPFGGEQNPIY,0
1m0k,C,80,97,17,ARYADWLFTTPLLLLDL,0
1m0k,C,109,126,17,ALVGADGIMIGTGLVGA,0
1m0k,C,127,134,7,TKVYSYR,0
1m0k,C,135,153,18,VWWAISTAAMLYILYVLF,0
1m0k,C,157,161,4,SKAE,0
1m0k,C,175,192,17,NVTVVLWSAYPVVWLIG,0
1m0k,C,193,203,10,EGAGIVPLNI,0
1m0k,C,204,222,18,TLLFMVLDVSAKVGFGLI,0
1m0k,C,232,249,17,AEAPEPSAGDGAAATSD,0
2voy,L,790,804,14,QLLWVNLVTDGLPA,0
5fil,W,10,12,2,TP,0
5fil,W,13,26,13,ILGLPLVTLIVLF,0
5fil,W,77,89,12,FIGSTNLLGLLP,0
5fil,W,90,95,5,SFTPT,0
5fil,W,96,110,14,QLSMNLGMAIPLWA,0
5fil,W,150,171,21,IQPMALAVRLTANITAGHLLI,0
5fil,W,172,193,21,LIGGATLALMSISTTTALITF,0
5fil,W,194,212,18,ILILLTILEFAVAMIQAY,0
4r0c,B,20,35,15,PTLLFVWFCLLLLPL,0
4r0c,B,36,72,36,AVLGALDVTATHPLTDETITAHSLLDADGLRYLFTT,0
4r0c,B,73,97,24,VGNFTGFAPLGVVLVAMLGLGVAE,0
4r0c,B,101,109,8,LSVSLASL,0
4r0c,B,119,131,12,FTVAFAGVLSSL,0
4r0c,B,166,190,24,SGGFSANLLVGPVDATLAGLSTEA,0
4r0c,B,191,200,9,HIIDPDRTV,0
4r0c,B,201,220,19,ATGNYWFIIASTFLVTGLV,0
4r0c,B,255,270,15,TGLTLAILLAGLALL,0
4r0c,B,271,291,20,LPNDAPLRHPDTGSVLGSPF,0
4r0c,B,292,310,18,HGLVVIVALIAGICGAVY,0
4r0c,B,324,351,27,TAMEVTMASMAGYLVLMFFAAQFVAWF,0
4r0c,B,352,355,3,YSQ,0
4r0c,B,356,370,14,GLLLAVKGAAWLGA,0
4r0c,B,371,376,5,TVPKV,0
4r0c,B,377,393,16,LLLLFVVLTALINLMI,0
4r0c,B,395,408,13,ASAKWSILAPVFI,0
4r0c,B,409,418,9,MLMLLGISP,0
4r0c,B,419,433,14,ASQAAYRVGDSSTN,0
4r0c,B,470,485,15,TLLLGWSVLLGVWIG,0
4r0c,B,486,489,3,GWP,0
4r0c,B,490,492,2,GP,0
2hjf,F,22,24,2,AL,0
2hjf,F,25,50,25,WRAAGAATVLLVIVLLAGSYLAVLA,0
2hjf,F,63,79,16,RALWWSVETATTVGYG,0
2hjf,F,87,113,26,GRCVAVVVMVAGITSFGLVTAALATW,0
2hjf,F,114,124,10,VGREQERRGH,0
4kka,B,16,17,1,R,0
4kka,B,37,61,24,MAAVVGTLVGLAAVAFDKGVAWLQ,0
4kka,B,62,83,21,QRMGALVHTADNYPLLLTVAF,0
4kka,B,84,97,13,CSAVLAMFGYFLV,0
4kka,B,128,142,14,PVKFFGGLGTLGGG,0
4kka,B,144,156,12,LGRAGPTVQIGG,0
4kka,B,180,204,24,GAAAGLAAAFNAPLAGILFIIEEM,0
4kka,B,216,232,16,AVFIGVIMSTIMYRIF,0
4kka,B,233,252,19,HEVALIDVGKLSDAPLNTL,0
4kka,B,253,277,24,LYLILGIIFGIFGPIFNKWVLGMQ,0
4kka,B,290,305,15,WVLMGGAIGGLCGLL,0
4kka,B,306,337,31,FVAPATSGGGFNLIPIATAGNFSMGMLVFIF,0
4kka,B,338,351,13,ARVITTLLCFSSG,0
4kka,B,353,368,15,GGIFAPMLALGTVLG,0
4kka,B,369,392,23,AFGMVAVELFPQYHLEAGTFAIA,0
4kka,B,393,415,22,MGALLAASIRAPLTGIILVLEM,0
4kka,B,416,422,6,DNYQLI,0
4kka,B,423,439,16,PMIITGLGATLLAQFT,0
4kka,B,459,461,2,QK,0
4rfs,T,17,26,9,RLDPRAKLM,0
4rfs,T,27,41,14,SFCYIIVVFLANNI,0
4rfs,T,43,57,14,YAILIAFTVGAILS,0
4rfs,T,58,63,5,KISLG,0
4rfs,T,64,69,5,FLKGI,0
4rfs,T,70,89,19,PLLWLIVFTVVLQLLFSPA,0
4rfs,T,104,124,20,DGLINAGYIFVRFLLIIMMS,0
4rfs,T,125,238,113,LLTLSTQPLDIATGLASLMKPLRWVKVPVDTLAMMLSIALRFVPTLMDEATKIMNAQRARGVDFGEGGLFKQAKSLIPLMVPLFMSAFNRAEDLSTAMEARGYQDSEHRSQYR,0
4rfs,T,245,247,2,DT,0
4rfs,T,248,263,15,TWLLFLLGFVAILIF,0
2ac6,A,1,31,30,ALNSSAEDGIKRIQDDCPKAGRHSYIFVMI,0
2ac6,A,32,54,22,TLYSIIFVVGIFGNSLVVIVIY,0
2ac6,A,64,86,22,VFLLNLALADLCFLLTLPLWAV,0
2ac6,A,87,101,14,TAMEYRWPFGNHLC,0
2ac6,A,102,124,22,IASASVSFNLYASVFLLTCLSI,0
2ac6,A,147,168,21,TCIIIWLMAGLASLPAVIHRN,0
2ac6,A,169,194,25,YFIENTNITVCAFHYESRNSTLPIG,0
2ac6,A,195,216,21,GLTKNILGFLFPFLIILTSYT,0
2ac6,A,241,263,22,IMAIVLFFFFSWVPHQIFTFLD,0
2ac6,A,264,286,22,LIQLGVIHDCKISDIVDTAMPI,0
2ac6,A,287,305,18,ICIAYFNNCLNPLFYGFL,0
2ac6,A,309,314,5,KKYFL,0
5a6u,G,7,8,1,V,0
5a6u,G,10,19,9,SRQFVKDSI,0
5a6u,G,20,36,16,LVKRCTKPDRKEFQKI,0
5a6u,G,37,51,14,MATAIGFAIMGFIG,0
3b5z,B,1,9,8,HNDKDLST,0
3b5z,B,10,31,21,QTFRRLWPTIAPFKAGLIVAG,0
3b5z,B,32,47,15,ALILNAASDTFMLSL,0
3b5z,B,64,82,18,LWMPLVVIGLMILRGITS,0
3b5z,B,83,146,63,ISSYCISWVSGKVVMTMRRRLFGHMMGMPVAFFDKQSTGTLLSRITYDSEQVASSSSGALITV,0
3b5z,B,147,162,15,REGASIIGLFIMMFY,0
3b5z,B,168,182,14,IILVVLAPIVSIAI,0
3b5z,B,183,248,65,VVSKRFRSISKNMQNTMGQVTTSAEQMLKGHKEVLIFGGQEVETKRFDKVSNKMRLQGMKMVSAS,0
3b5z,B,249,263,14,ISDPIIQLIASLAL,0
3b5z,B,290,303,13,MIALMRPLKSLTN,0
3b5z,B,304,581,277,NAQFQRGMAACQTLFAILDSEQEKDEGKRVIDRATGDLEFRNVTFTYPGREVPALRNINLKIPAGKTVALVGRSGSGKSTIASLITRFYDIDEGHILMDGHDLREYTLASLRNQVALVSQNVHLFNDTVANNIAYARTEEYSREQIEEAARMAYAMDFINKMDNGLDTIIGENGVLLSGGQRQRIAIARALLRDSPILILDEATSALDTESERAIQAALDELQKNRTSLVIAHRLSTIEQADEIVVVEDGIIVERGTHSELLAQHGVYAQLHKMQFG,0
3rfm,A,1,6,5,PIMGS,0
3rfm,A,8,29,21,YITVELAIAVLAILGNVLVCW,0
3rfm,A,44,68,24,VVSLAAADILVGVLAIPFAITIST,0
3rfm,A,69,74,5,FCAAC,0
3rfm,A,75,100,25,GCLFIACFVLVLAQSSIFSLLAIAI,0
3rfm,A,122,144,22,GIIAICWVLSFAIGLTPMLGWN,0
3rfm,A,145,149,4,CGQP,0
3rfm,A,150,157,7,EGKNHSQ,0
3rfm,A,158,171,13,CGEGQVACLFEDV,0
3rfm,A,172,198,26,PMNYMVYFNFFACVLVPLLLMLGVYL,0
3rfm,A,236,259,23,IIAGLFALCWLPLHIINCFTFFC,0
3rfm,A,260,264,4,DCSH,0
3rfm,A,265,288,23,PLWLMYLAIVLAHTNSVVNPFIY,0
3rfm,A,293,304,11,EFRQTFRKIIR,0
3rfm,A,306,329,23,VLRQQEPFKAAAAHHHHHHHHHH,0
2zw3,F,25,50,25,TVLFIFRIMILVVAAKEVWGDEQAD,0
2zw3,F,51,65,14,VCNTLQPGCKNVCY,0
2zw3,F,66,89,23,HYFPISHIRLWALQLIFVSTPAL,0
2zw3,F,110,124,14,IKSEFKDIEEIKTQ,0
2zw3,F,140,159,19,FFRVIFEAAFMYVFYVMYD,0
2zw3,F,160,182,22,FSMQRLVKCNAWPCPNTVDCFV,0
2zw3,F,183,208,25,RPTEKTVFTVFMIAVSGICILLNVT,0
2zw3,F,218,226,8,SGKSKKPV,0
2xov,A,94,113,19,PVTWVMMIACVVVFIAMQI,0
2xov,A,114,115,1,G,0
2xov,A,116,123,7,QEVMLWL,0
2xov,A,124,136,12,WPFDPTLKFEFW,0
2xov,A,137,143,6,YFTHAL,0
2xov,A,144,166,22,HFSLMHILFNLLWWWYLGGAVE,0
2xov,A,172,190,18,KLIVITLISALLSGYVQQ,0
2xov,A,191,197,6,FSGPWF,0
2xov,A,198,214,16,GLSGVVYALMGYVWLR,0
2xov,A,226,245,19,RGLIIFALIWIVAGWFDLF,0
2xov,A,247,268,21,SMANGAHIAGLAVGLAMAFVD,0
4kjr,D,5,19,14,FILVAAGVPLSVIG,0
4kjr,D,20,29,9,LMHWPSAVL,0
4kjr,D,30,45,15,AVYCVTIIALASYMG,0
4kjr,D,55,57,2,GP,0
4kjr,D,63,79,16,NATFGNAVELIISMFA,0
4kjr,D,80,87,7,KEGLTGI,0
4kjr,D,88,106,18,LASLTGSVLGNLLLVAGL,0
4kjr,D,130,146,16,LLIFAIIVAFVIPEVF,0
4kjr,D,147,157,10,VGMGNASKLN,0
4kjr,D,158,172,14,SIGISIIMILLYVA,0
4kjr,D,178,199,21,VTHRGVYQPNNAAQTEEEEEP,0
4kjr,D,208,224,16,VLFAATIVVAYISENL,0
4kjr,D,225,234,9,HTFHSVAEQ,0
4kjr,D,235,241,6,GWSELF,0
4kjr,D,242,257,15,GVIIVAIVGNAAEHA,0
4kjr,D,276,295,19,GSTLQIAMFVAPVLVICSI,0
4kjr,D,296,302,6,FPTSMP,0
4kjr,D,303,322,19,VFTLPELVAMVSAVLLMIA,0
4kjr,D,335,349,14,TLLAAYVIMAIGFF,0
4kjr,D,350,351,1,L,0
2v60,A,1,2,1,S,0
2v60,A,3,108,105,KCDVVVVGGGISGMAAAKLLHDSGLNVVVLEARDRVGGRTYTLRNQKVKYVDLGGSYVGPTQNRILRLAKELGLETYKVNEVERLIHHVKGKSYPFRGPFPPVWN,0
2v60,A,109,126,17,ITYLDHNNFWRTMDDMG,0
2v60,A,127,485,358,EIPSDAPWKAPLAEEWDNMTMKELLDKLCWTESAKQLATLFVNLCVTAETHEVSALWFLWYVKQCGGTTRIISTTNGGQERKFVGGSGQVSERIMDLLGDRVKLERPVIYIDQTRENVLVETLNHEMYEAKYVISAIPPTLGMKIHFNPPLPMMRNQMITRVPLGSVIKCIVYYKEPFWRKKDYCGTMIIDGEEAPVAYTLDDTKPEGNYAAIMGFILAHKARKLARLTKEERLKKLCELYAKVLGSLEALEPVHYEEKNWCEEQYSGGCYTTYFPPGILTQYGRVLRQPVDRIYFAGTETATHWSGYMEGAVEAGERAAREILHAMGKIPEDEIWQSEPESVDVPAQPITTTFLERH,0
2v60,A,486,498,12,PSVPGLLRLIGL,0
2v60,A,502,520,18,SATALGFLAHKRGLLVRV,0
5cxv,A,20,24,4,GPWQ,0
5cxv,A,25,48,23,AFIGITTGLLSLATVTGNLLVLI,0
5cxv,A,64,87,23,LSLACADLIIGTFSMNLYTTYLL,0
5cxv,A,88,93,5,GHWAL,0
5cxv,A,94,120,26,TLACDLWLALDYVASQASVMNLLLIS,0
5cxv,A,147,168,21,LAWLVSFVLWAPAILFWQYLV,0
5cxv,A,169,178,9,ERTVLAGQC,0
5cxv,A,179,208,29,IQFLSQPIITFGTAMAAFYLPVTVMCTLY,0
5cxv,A,367,391,24,SAILLAFILTWTPYNIMVLVSTFC,0
5cxv,A,392,398,6,DCVPET,0
5cxv,A,399,420,21,WELGYWLCYVNSTINPMCYAL,0
1s51,E,5,9,4,GRPE,0
1s51,E,10,33,23,IWLALGTALMGLGSLYFLVKGMG,0
1s51,E,41,62,21,FYAITTLVPAIAFTMYLSMLL,0
1s51,E,63,79,16,YGLTMVPFGGEQNPIY,0
1s51,E,80,99,19,ARYADWLFTTPLLLLDLAL,0
1s51,E,106,127,21,TILALVGADGIMIGTGLVGAL,0
1s51,E,128,133,5,KVYSY,0
1s51,E,134,157,23,FVWWAISTAAMLYILYVLFFGFT,0
1s51,E,171,192,21,KVLRNVTVVLWSAYPVVWLIG,0
1s51,E,193,202,9,EGAGIVPLN,0
1s51,E,203,225,22,ETLLFMVLDVSAKVGFGLILLR,0
4ire,E,1,4,3,QDM,0
4ire,E,5,194,189,SPPPPIADEPLTVNTGIYLIECYSLDDKAETFKVNAFLSLSWKDRRLAFDPVRSGVRVKTYEPEAIWIPEIRFVNVENARDADVVNISVSPDGTVQYLERFSARVLSPLDFRRYPFDSQTLHIYLIVRSVDTRNIVLAVDLEKVGKNDDVFLTGWDIESFTAVVKPANFALQNRLESKLDYQLRISRQY,0
4ire,E,195,218,23,SYIPNIILPMLFILFISWTAFWS,0
4ire,E,222,244,22,ANVTLVVSTLIAHIAFNILVET,0
4ire,E,245,251,6,LPKTPY,0
4ire,E,252,275,23,TYTGAIIFMIYLFYFVAVIEVTV,0
4ire,E,295,316,21,RIAFPVVFLLANIILAFLFFG,0
3egw,F,5,28,23,MFFFDIYPYIAGAVFLIGSWLRY,0
3egw,F,29,47,18,YGQYTWRAASSQMLDRKG,0
3egw,F,48,73,25,NLASNLFHIGILGIFVGHFFGMLTP,0
3egw,F,87,114,27,KMAMFAGGASGVLCLIGGVLLLKRRLF,0
3egw,F,116,121,5,RVRAT,0
3egw,F,122,124,2,TG,0
3egw,F,125,145,20,DILILSLLVIQCALGLLTIP,0
3egw,F,183,204,21,FRLHLVLGMTLFLLFPFSRLI,0
3egw,F,205,225,20,IWSVPVEYLTRKYQLVRARH,0
4ub8,z,1,7,6,TILFQL,0
4ub8,z,8,25,17,LAALVILSFVMVIGVPV,0
4ub8,z,40,55,15,FLGSGLWIALVLVVG,0
4ub8,z,56,62,6,LNFFVV,0
4ytn,D,28,57,29,SAAVTGAAPPQFDPIAAEKGFKPLHSHGT,0
4ytn,D,58,79,21,FKIERYFAAAMVPLIPAAYFI,0
4ytn,D,84,108,24,DLCLALALTLHVHWGVWGVVNDYG,0
4ytn,D,109,116,7,PFVLGDT,0
4ytn,D,117,138,21,AAAVRVGAYIFTACLLAGLLY,0
4ytn,D,146,154,8,TRAFEMVW,0
5vb2,D,1983,1994,11,DYKDDDDKGSL,0
5vb2,D,2015,2033,18,KFIIYLIVLNGITMGLET,0
5vb2,D,2034,2044,10,KTFMQSFGVY,0
5vb2,D,2045,2064,19,TLFNQIVITIFTIEIILRI,0
5vb2,D,2076,2091,15,SLFDFFVVAISLVPT,0
5vb2,D,2092,2095,3,SGF,0
5vb2,D,2096,2113,17,ILRVLRVLRLFRLVTAV,0
5vb2,D,2131,2151,20,SVIALMTLFFYIFAIMATQL,0
5vb2,D,2152,2163,11,GERFPEWFGTL,0
5vb2,D,2164,2180,16,ESFYTLFQVMTLESWS,0
5vb2,D,2181,2193,12,GIVRPLMEVYPY,0
5vb2,D,2194,2213,19,WVFFIPFIFVVFFVMINLY,0
5vb2,D,2263,2267,4,SLKN,0
4umv,A,1,125,124,STPDNHGKKAPQFAAFKPLTTVQNANDCCCDGACSSSPTLSENVSGTRYSWKVSGMDCAACARKVENAVRQLAGVNQVQVLFATEKLVVDADNDIRAQVESAVQKAGYSLRDEQAADEPQASRL,0
4umv,A,126,130,4,ENLP,0
4umv,A,131,146,15,ITLIVMMAISWGLEQ,0
4umv,A,152,173,21,QLAFIATTLVGLYPIARQALR,0
4umv,A,174,180,6,IKSGSY,0
4umv,A,181,198,17,AIETLMSVAAIGALFIG,0
4umv,A,200,212,12,AEAAMVLLLFLI,0
4umv,A,213,350,137,ERLEGWAASRARQGVSALMALKPETATRLRNGEREEVAINSLRPGDVIEVAAGGRLPADGKLLSPFASFDESALTGESIPVERATGDKVPAGATSVDRLVTLEVLSEPGASAIDRILKLIEEAEERRAPIERFIDRF,0
4umv,A,351,366,15,RIYTPAIMAVALLVT,0
4umv,A,385,399,14,TLLLIGCPCALVIS,0
4umv,A,400,684,284,PAAITSGLAAAARRGALIKGGAALEQLGRVTQVAFDKTGTLTVGKPRVTAIHPATGISESELLTLAAAVEQGATHPLAQAIVREAQVAELAIPTAESQRALVGSGIEAQVNGERVLICAAGKHPADAFAGLINELESAGQTVVLVVRNDDVLGIIALQDTLRADAATAISELNALGVKGVILTGDNPRAAAAIAGELGLEFKAGLLPEDKVKAVTKLNQHAPLAMVGDGINDAPAMKAAAIGIAMGSGTDVALETADAALTHNHLRGLVQMIELARATHANIRQ,0
4umv,A,685,700,15,ITIALGLKGIFLVTT,0
4umv,A,708,723,15,LAVLADTGATVLVTA,0
4umv,A,724,730,6,ALRLLR,0
4umv,A,731,732,1,R,0
5xap,A,29,34,5,PNPWT,0
5xap,A,35,50,15,LLLLLTLLGSLLYIW,0
5xap,A,300,315,15,IAALVGIGLVFVMLF,0
5xap,A,316,324,8,YYGLWFGL,0
5xap,A,325,343,18,GALGLLFSSIIILGILGG,0
5xap,A,353,367,14,AGLVLTIGAAVDGN,0
5xap,A,368,399,31,ISFERIKEELARGKGIKNAIGAGYEHSTAAI,0
5xap,A,400,415,15,DVNASHLLSALALYN,0
5xap,A,425,443,18,VTLIIGVIASTFSNLVFA,0
5xap,A,444,477,33,WFMQWLAQRRPNMSAPQWIKHTHFDFMKPAKVI,0
5xap,A,478,493,15,TLSVLLALAGAALVA,0
5xap,A,603,617,14,LLGLGLILVYVGFR,0
5xap,A,618,623,5,DFIMG,0
5xap,A,624,644,20,GSIIAAIHDVAIAMGLFSLL,0
5xap,A,654,668,14,ALLTLIGYSLNDSI,0
5xap,A,669,702,33,VSDRIRENMKTMRGHSYREIVNAAINQTLSRTV,0
5xap,A,703,718,15,TSVSTMLPLISLLIF,0
5xap,A,725,741,16,FSLILLVGILVGTYSS,0
5xap,A,742,760,18,YIVAPLVVYFEEWRDKNR,0
1jb0,X,7,12,5,TYAFR,0
1jb0,X,13,30,17,FWAVLLLAINFLVAAYY,0
2vl0,E,1,10,9,PADNAADAR,0
2vl0,E,11,209,198,VDVSVSIFINKIYGVNTLEQTYKVDGYIVAQWTGKPRKTPGDKPLIVENTQIERWINNGLWVPALEFINVVGSPDTGNKRLMLFPDGRVIYNARFLGSFSNDMDFRLFPFDRQQFVLELEPFSYNNQQLRFSDIQVYTENIDNEEIDEWWIRKASTHISDIRYDHLSSVQPNQNEFSRITVRIDAVRNPSYYLWSFIL,0
2vl0,E,210,224,14,LGLIIAASWSVFWL,0
2vl0,E,229,244,15,RLQTSFTLMLTVVAY,0
2vl0,E,245,264,19,FYTSNILPRLPYTTVIDQM,0
2vl0,E,265,281,16,IAGYGSIFAAILLIIF,0
2vl0,E,299,313,14,RLAFPLGFLAIGCV,0
2vl0,E,314,316,2,VI,0
2vl0,E,317,321,4,GITL,0
4gp4,C,1,3,2,EE,0
4gp4,C,4,6,2,PK,0
4gp4,C,7,24,17,ALAVILVLTLTILVFWL,0
3nym,A,-2,-1,1,N,0
3nym,A,52,72,20,EFKEDLKNFLDYMEVCQLAL,0
3nym,A,73,78,5,DKNFK,0
3nym,A,79,99,20,ASNSLFMAMIYAGNLSLIFD,0
3nym,A,124,125,1,E,0
2qks,E,1,2,1,S,0
2qks,E,22,28,6,GSETSR,0
2qks,E,31,39,8,DLFTTLVD,0
2qks,E,42,67,25,RWFFVSLAVLFLLLNTAFATLYMLG,0
2qks,E,68,79,11,APIANQFPAGF,0
2qks,E,80,96,16,GAFFFSVETLATVGYG,0
2qks,E,97,103,6,MHPQTV,0
2qks,E,104,128,24,AHWIATLEIFVGMSSIALATGCAF,0
2qks,E,312,321,9,LMSSPLVPR,0
2x5v,L,1,31,30,LLSFERKYRVRGGTLIGGDLFDFWVGPYFV,0
2x5v,L,32,51,19,FFGVSAIFFIFLGVSLIGY,0
2x5v,L,89,105,16,TVCALGAFISWMLREV,0
2x5v,L,106,115,9,ISRKLGIGW,0
2x5v,L,116,134,18,VPLAFCVPIFMFCVLQVF,0
2x5v,L,152,162,10,HLDWVNNFGY,0
2x5v,L,172,190,18,HMSSVSFLFVNAMALGLH,0
2x5v,L,191,229,38,GLILSVANPGDGDKVKTAEHENQYFRDVVGYSIGALSI,0
2x5v,L,230,247,17,RLGLFLASNIFLTGAFG,0
2hg3,H,1,10,9,VGVTAFGNF,0
2hg3,H,11,15,4,LASL,0
2hg3,H,16,32,16,IYSFWIFLAGLIYYLQ,0
2hg3,H,251,260,9,VAAMLAEYA,0
4k0e,C,1,3,2,IE,0
4k0e,C,5,11,6,VTLCFN,0
4k0e,C,15,31,16,VALVFAMVALYGWYAW,0
4k0e,C,32,241,209,QLPLEAYPDIADTTSQVVTQVNGLAAEEVEQQITIPLEREIMGVPGMHVMRSKSTFGLSLITVVFKDGAEDYWSRQRLQERINGVSLPYGAQPSLDPLTSPIGEIYRYTLVSKTRDLRELSELQFWKVIPRLKQVAGVVDVANFGGLTTQFMLEFDPVMLSKYNISLNQITQAISENNANAGGSILNRGEQGLVVRGVGLIRNLDDLGN,0
4k0e,C,242,256,14,VVTQKNGVPVLVKD,0
4k0e,C,257,335,78,GRVVLGNPQRHGILGMDRNPDTIQGITLLLKNENPSVVMEGVHAAVRDLNDNILPKDVKVVPYIDRSNLVDATVHTVG,0
4k0e,C,336,352,16,TLMEGMFLVSLVLLLF,0
4k0e,C,357,380,23,AAIIVAVTIPLSLLMAFILMHHF,0
4k0e,C,381,389,8,IPANLLSL,0
4k0e,C,390,402,12,AIDFGIIVDGAI,0
4k0e,C,414,422,8,DAEKELHG,0
4k0e,C,437,452,15,FGMIVIITAYLPLFA,0
4k0e,C,453,464,11,QRIEYKLFSPM,0
4k0e,C,465,483,18,FAVGFALFGALLVALLLI,0
4k0e,C,488,502,14,WAYRKPRKVFHNPA,0
4k0e,C,504,513,9,WLAPRYESV,0
4k0e,C,526,541,15,IAVATLVGVMILGAT,0
4k0e,C,542,692,150,GRDFLPYLDEGSIWLQVTLPPGISLEKAGQMADNLRAATMEFPEVEHVVTQVGRNDEGTDPFSPSHIETAVTLHPYSTWTSGRDKQQLIEAMATRFRDLPGTQVGFSQPMIDGVLDKLAGAHSDLVVKVYGNDFAETRQVATAITRLLKT,0
4k0e,C,693,694,1,P,0
4k0e,C,695,723,28,AQDVIIDQEPPLPQVRIDVDRAAAARLG,0
4k0e,C,724,728,4,NVAD,0
4k0e,C,729,773,44,MALIQTGIGGSPVTQVFVEDRSYNVVARFIGSSRNDPEAIGNLT,0
4k0e,C,774,782,8,TAANGAHV,0
4k0e,C,783,791,8,LAQVAHIR,0
4k0e,C,792,793,1,A,0
4k0e,C,794,859,65,GETTITREMNKRHLTVRLNLRGRDLSTFLEEARMRIDKEVPYDRTHIQVAWGGQFENQQRAQARL,0
4k0e,C,860,875,15,VILPMVLALMFVLLF,0
4k0e,C,878,881,3,KNL,0
4k0e,C,885,905,20,LILMAVPLATLGGLVALHLR,0
4k0e,C,906,913,7,MTLNVSS,0
4k0e,C,914,929,15,VGFIALFGVAVLNAI,0
4k0e,C,938,947,9,RDTSGVSLK,0
4k0e,C,962,977,15,MTATVAALGLIPAAL,0
4k0e,C,978,979,1,H,0
4k0e,C,981,987,6,GSDVQR,0
4k0e,C,988,1004,16,LATVVVGGLITATALT,0
4k0e,C,1018,1045,27,AAKQVREEPPVQFGPTSEGDLHHHHHH,0
5h2p,C,4,11,7,TGRPEWI,0
5h2p,C,12,28,16,LALGTALMGLGTLYFL,0
5h2p,C,47,61,14,LVPAIAFTMYLSML,0
5h2p,C,62,79,17,GYGLTMVPFGGEQNPIY,0
5h2p,C,80,94,14,ARYADWLFTTPLLL,0
5h2p,C,111,126,15,VGADGIMIGTGLVGA,0
5h2p,C,127,134,7,TKVYSYR,0
5h2p,C,135,150,15,VWWAISTAAMLYILY,0
5h2p,C,178,192,14,VVLWSAYPVVWLIG,0
5h2p,C,193,203,10,EGAGIVPLNI,0
5h2p,C,204,220,16,TLLFMVLDVSAKVGFG,0
4u9n,B,271,277,6,VYSEAG,0
4u9n,B,278,305,27,VALWLARVRWLVILILTGMVTSSILQG,0
4u9n,B,307,312,5,SVLEA,0
4u9n,B,317,338,21,FYVPVLLGTGGNTGNQSATLI,0
4u9n,B,339,352,13,RALATRDLDLRDW,0
4u9n,B,353,381,28,RVFLKEMGVGLLLGLTLSFLLVGKVYWD,0
4u9n,B,388,412,24,VVGVSLVLIVFFANLVGAMLPFLL,0
4u9n,B,413,421,8,RLGVDPAL,0
4u9n,B,422,443,21,SNPLVATLSDVTGLLIYLSVA,0
5h35,E,4,22,18,LELLNIIGIIAFTISGSL,0
5h35,E,23,31,8,GTNKGLDI,0
5h35,E,32,52,20,GVVTLGVITSYAGGIIADIL,0
5h35,E,59,77,18,ILKELNYLLLSVGISIFV,0
5h35,E,78,93,15,YFYKWLQTNPIKMII,0
5h35,E,94,112,18,ISDAVGLSTFATLGASLA,0
5h35,E,120,140,20,SVGLIAAIVGTGGGVIRDVL,0
5h35,E,141,150,9,NEIPMVLTK,0
5h35,E,151,167,16,IYATAALLSGFIYYFT,0
5h35,E,175,190,15,LFVAFLGSFLLRILS,0
5h35,E,191,195,4,KYNF,0
3uza,A,1,6,5,PIMGS,0
3uza,A,10,29,19,TVELAIAVLAILGNVLVCW,0
3uza,A,30,43,13,VWLNSNLQNVTNY,0
3uza,A,44,63,19,VVSLAAADILVGVLAIPFA,0
3uza,A,83,100,17,VLVLAQSSIFSLLAIAI,0
3uza,A,101,121,20,RYIAIAIPLRYNGLVTGTRA,0
3uza,A,122,138,16,GIIAICWVLSFAIGLT,0
3uza,A,150,157,7,EGKNHSQ,0
3uza,A,177,198,21,VYFNFFACVLVPLLLMLGVYL,0
3uza,A,199,235,36,IFAAARRQLKQMESQPLPGERARSTLQKEVHAAKSA,0
3uza,A,236,252,16,IIAGLFALCWLPLHII,0
3uza,A,273,289,16,IVLAHTNSVVNPFIYA,0
3uza,A,290,292,2,RI,0
3uza,A,293,304,11,EFRQTFRKIIR,0
3uza,A,306,329,23,VLRQQEPFKAAAAHHHHHHHHHH,0
3gd8,D,32,37,5,AFWKA,0
3gd8,D,38,55,17,TAEFLAMLIFVLLSLGS,0
3gd8,D,72,89,17,ISLCFGLSIATMVQCFG,0
3gd8,D,90,92,2,IS,0
3gd8,D,93,106,13,GHINPAVTVAMVC,0
3gd8,D,107,115,8,RKISIAKS,0
3gd8,D,116,133,17,FYIAAQCLGAIIGAGIL,0
3gd8,D,158,177,19,GLLVELIITFQLVFTIFAS,0
3gd8,D,178,187,9,DSKRTDVTG,0
3gd8,D,188,205,17,IALAIGFSVAIGHLFAI,0
3gd8,D,209,223,14,ASMNPARSFGPAVI,0
3gd8,D,231,248,17,IYWVGPIIGAVLAGGLY,0
3gd8,D,249,254,5,YVFCP,0
4p1a,C,1,5,4,GLYR,0
4p1a,C,13,30,17,QKILIGLILGAIVGLIL,0
4p1a,C,31,42,11,HYGYAHAVHTY,0
4p1a,C,43,67,24,KPFGDLFVRLLCMLVMPIVFASLV,0
4p1a,C,94,110,16,FAVTLGIIMARLFNPG,0
4p1a,C,111,130,19,GIHLAVGGQQFQPHQAPPL,0
4p1a,C,131,140,9,HILLDIVPT,0
4p1a,C,141,150,9,PFGALANGQ,0
4p1a,C,151,161,10,LPTIFFAIIL,0
4p1a,C,174,197,23,KVRKSAETLLDAINGLAEAMYKI,0
4p1a,C,198,218,20,NGVMQYAPIGVFALIAYVMA,0
4p1a,C,219,222,3,QGV,0
4p1a,C,223,242,19,VVGELAKVTAAVYVGLTLQ,0
4p1a,C,312,328,16,GTALYQGVATFFIANA,0
4p1a,C,329,333,4,GSHL,0
4p1a,C,334,350,16,VGQQLTIVLTAVLASI,0
4p1a,C,357,375,18,AGAIMLCMVLHSVGLPLT,0
4p1a,C,376,379,3,PNV,0
4p1a,C,380,397,17,AAYAMILGIDAILDMGR,0
4p1a,C,419,422,3,VPR,0
4p2z,F,126,130,4,SHMG,0
4p2z,F,135,153,18,ALLTVVFYIAAVMATNLY,0
4p2z,F,154,163,9,ATFPEWFGD,0
4p2z,F,164,186,22,SKSLYTLFQVMTLESWSMGIVR,0
4p2z,F,187,193,6,VMNVHP,0
4p2z,F,194,214,20,AWVFFIPFIMLTAFTVLNLA,0
4p2z,F,222,274,52,AITKEQEEEAKTGHHQEPISQTLLHLGDRLDRIEKQLAQNNELLQRQQPQKK,0
4uxw,C,17,27,10,WKGLRAAWIN,0
4uxw,C,28,32,4,AAFR,0
4uxw,C,33,47,14,EGVAVLLAVVIACW,0
4uxw,C,53,68,15,TRVLLISSVMLVMIV,0
4uxw,C,69,101,32,LLNSAIEAVVDRIGSEYHELSGRAKDLGSAAV,0
4uxw,C,102,116,14,IAIIDAVITWCILL,0
2d2c,U,-1,0,1,E,0
2d2c,U,1,3,2,DV,0
2d2c,U,4,22,18,GWVALLVVFTWSIAMVVW,0
5c76,D,22,38,16,FSVFVSFIETFAISLV,0
5c76,D,39,77,38,PFITLASDFSYFDRNKYLISLKEYLNIPVFEIIVYFGV,0
5c76,D,78,93,15,LIVFYVFRALLNAYY,0
5c76,D,155,168,13,EIFVVLLLYALML,0
5c76,D,169,174,5,INYKI,0
5c76,D,175,189,14,LFLSIFMVLNAFIL,0
5c76,D,260,273,13,IYLEGIGFCVLVF,0
5c76,D,274,293,19,VVFLVLKNESDISGILSTI,0
5c76,D,294,307,13,IFVLALYRLMPSA,0
4ksc,A,1,32,31,ELEEDLKGRADKNFSKMGKKSKKEKKEKKPA,0
4ksc,A,43,68,25,WLDRLYMLVGTLAAIIHGVALPLMM,0
4ksc,A,69,117,48,IFGDMTDSFASVGNVSKNSTNMSEADKRAMFAKLEEEMTTYAYYYTGI,0
4ksc,A,118,137,19,AGVLIVAYIQVSFWCLAAG,0
4ksc,A,183,204,21,DKIGMFFQAMATFFGGFIIGF,0
4ksc,A,205,208,3,RGW,0
4ksc,A,209,228,19,LTLVILAISPVLGLSAGIW,0
4ksc,A,292,312,20,ISMGAAFLLIYASYALAFWY,0
4ksc,A,313,329,16,TSLVISKEYSIGQVLT,0
4ksc,A,330,348,18,FFSVLIGAFSVGQASPNI,0
4ksc,A,627,683,56,GNEIELGNEACKSKDEIDNLDMSSKDSGSSLIRRRSTRKSICGPHDQDRKLSTKEA,0
4ksc,A,695,703,8,ILKLNSTE,0
4ksc,A,708,729,21,VGIFCAIINGGLQPAFSVIFS,0
4ksc,A,730,751,21,VVGVFTNGGPPETQRQNSNLF,0
4ksc,A,752,772,20,LLFLILGIISFITFFLQGFT,0
4ksc,A,829,847,18,AVIFQNIANLGTGIIISL,0
4ksc,A,848,854,6,YGWQLT,0
4ksc,A,855,875,20,LLLAIVPIIAIAGVVEMKML,0
4ksc,A,928,952,24,KKAHVFGITFSFTQAMMYFSYAAC,0
4ksc,A,953,971,18,RFGAYLVTQQLMTFENVL,0
4ksc,A,972,990,18,VFSAIVFGAMAVGQVSSF,0
4ksc,A,1272,1284,12,AKRSLEHHHHHH,0
2mmu,A,31,53,22,WFVSLFIGLMLIGLIWLMVFQL,0
2mmu,A,71,91,20,PWNYAIAFAFMITGLLLTMR,0
2mmu,A,92,95,3,HLE,0
5ax1,A,14,36,22,AQWVVFAVMALAAIVFSIAVQF,0
5ax1,A,37,42,5,PLPLR,0
5ax1,A,43,66,23,TYYVNIAICTIAATAYYAMAVNG,0
5ax1,A,83,104,21,YARYIDWVFTTPLLLLDLVLL,0
5ax1,A,105,109,4,NMPA,0
5ax1,A,110,132,22,MIAWIMGADIAMIAFGIIGAFT,0
5ax1,A,137,160,23,WFYFVVGCIMLAVLAWGMINPIF,0
5ax1,A,161,171,10,EELQKHKEYT,0
5ax1,A,172,197,25,AYTTLLIYLIVLWVIYPIVWGLGAG,0
5ax1,A,207,230,23,IAMGILDLLAKPLYAIGVLITVE,0
5ax1,A,231,236,5,VYGKL,0
1fbk,C,1,3,2,AQ,0
1fbk,C,4,9,5,TGRPE,0
1fbk,C,10,32,22,IWLALGTALMGLGTLYFLVKGM,0
1fbk,C,43,62,19,AITTLVPAIAFTMYLSMLL,0
1fbk,C,63,78,15,YGLTMVPFGGEQNPI,0
1fbk,C,79,98,19,WARYADWLFTTPLLLLGLA,0
1fbk,C,108,128,20,LALVGADGIMIGTGLVGALT,0
1fbk,C,129,133,4,VYSY,0
1fbk,C,134,154,20,FVWWAISTAAMLYILYVLFF,0
1fbk,C,174,192,18,RNVTVVLWSAYPVVWLIG,0
1fbk,C,193,203,10,EGAGIVPLNI,0
1fbk,C,204,224,20,TLLFMVLDVSAKVGLGLILL,0
1fbk,C,229,248,19,FGEAEAPEPSAGDGAAATS,0
4esl,C,1,3,2,EE,0
4esl,C,4,6,2,PK,0
4esl,C,7,25,18,ALAVILVLTLTILVFWLG,0
3uu8,E,-3,4,7,SAAAQDM,0
3uu8,E,5,198,193,SPPPPIADEPLTVNTGIYLIESYSLDDCAETFKVNAFLSLSWKDRRLAFDPVRSGVRVKTYEPEAIWIPEIRFVNVENARDADVVDISVSPDGTVQYLERFSARVLSPLDFRRYPFDSQTLHIYLIVRSVDTRNIVLAVDLEKVGKNDDVFLTGWDIESFTAVVKPANFALEDRLESKLDYQLRISRQYFSYI,0
3uu8,E,199,218,19,NIILPMLFILFISWTAFWS,0
3uu8,E,222,241,19,ANVTLVVSTLIAHIAFNIL,0
3uu8,E,242,255,13,ETNLPCTPYMTYT,0
3uu8,E,256,275,19,AIIFMIYLFYFVAVIEVTV,0
3uu8,E,292,313,21,RASRIAFPVVFLLANIILAFL,0
3uu8,E,314,315,1,F,0
3uu8,E,316,317,1,F,0
4uu1,A,54,76,22,EQFEDLLVRILLLAACISFVLA,0
4uu1,A,77,88,11,FEEGEETITAF,0
4uu1,A,89,107,18,EPFVILLILIANAIVGVW,0
4uu1,A,257,277,20,EQLSKVISLICVAVWLINIG,0
4uu1,A,278,292,14,FNDPVHGGSWIRGA,0
4uu1,A,293,317,24,YYFKIAVALAVAAIPEGLPAVITT,0
4uu1,A,760,783,23,IRYLISSNVGEVVCIFLTAALGL,0
4uu1,A,784,785,1,E,0
4uu1,A,786,807,21,LIPVQLLWVNLVTDGLPATAL,0
4uu1,A,834,853,19,FRYMAIGGYVGAATVGAAA,0
4uu1,A,854,897,43,WFMYAEDGPGVTYHQLTHFMQCTEDHPHFEGLDCEIFEAPEPM,0
4uu1,A,898,916,18,MALSVLVTIEMCNALNSL,0
4uu1,A,927,950,23,WVNIWLLGSICLSMSLHFLILYV,0
4uu1,A,951,957,6,PLPMIF,0
4uu1,A,958,966,8,LKALDLTQ,0
4uu1,A,967,987,20,LMVLKISLPVIGLDEILKFI,0
4bv0,A,46,51,5,PGSGP,0
4bv0,A,60,87,27,IYSKVLVTAIYLALFVVGTVGNGVTLF,0
4bv0,A,88,92,4,LARK,0
4bv0,A,93,99,6,SLQSLQ,0
4bv0,A,100,106,6,RVDYYL,0
4bv0,A,107,132,25,SLALSDLLILLFALPVDVYNFIWVH,0
4bv0,A,136,161,25,FGDAGCKGYYFLREACTYATALNVV,0
4bv0,A,162,174,12,LSVELYLAIRHP,0
4bv0,A,175,179,4,KHKT,0
4bv0,A,180,190,10,MSRSRTKKFI,0
4bv0,A,191,210,19,AIWLASALLAIPMLFTVGL,0
4bv0,A,226,255,29,PIVDTATLKVVIQLNTFMSFLFPMLVASI,0
4bv0,A,256,269,13,NTVIARRLTVMVH,0
4bv0,A,270,280,10,AAEQGRVCTE,0
4bv0,A,297,311,14,GRVQALRRGVLVLR,0
4bv0,A,312,334,22,MVIAFVVCWLPYHVRRLMFVYI,0
4bv0,A,346,368,22,YHYFYMLSNALVYVSAAINPIL,0
4bv0,A,369,387,18,NLVSANFRQVFLSTLACL,0
4bv0,A,388,399,11,PGTRELEVLFQ,0
1q90,Q,68,78,10,EPAIVQIGWA,0
1q90,Q,79,94,15,TCVMFSFSLSLVVWG,0
5j0z,E,5,198,193,SPPPPIADEPLTVNTGIYLIECYSLDDKAETFKVNAFLSLSWKDRRLAFDPVRSGVRVKTYEPEAIWIPEIRFVNVENARDADVVDISVSPDGTVQYLERFSARVLSPLDFRRYPFDSQTLHIYLIVRSVDTRNIVLAVDLEKVGKNDDVFLTGWDIESFTAVVKPANFALEDRLESKLDYQLRISRQYFSYI,0
5j0z,E,199,215,16,NIILPMLFILFISWTA,0
5j0z,E,226,240,14,LVVSTLIAHIAFNI,0
5j0z,E,241,255,14,VETNLPKTPYMTYT,0
5j0z,E,256,272,16,AIIFMIYLFYFVAVIE,0
5j0z,E,296,313,17,IAFPVVFLLANIILAFL,0
5j0z,E,314,315,1,F,0
4nab,A,1,46,45,EAAHSKSTEECLAYFGVSETTGLTPDQVKRHLEKYGHNELPAEEG,0
4nab,A,54,71,17,EQFEDLLVRILLLAACI,0
4nab,A,72,89,17,FVLAWFEEGEETITAFV,0
4nab,A,90,106,16,PFVILLILIANAIVGV,0
4nab,A,123,240,117,PEMGKVYRADRKSVQRIKARDIVPGDIVEVAVGDKVPADIRILSIKSTTLRVDQSILTGESVSVIKHTEPVPDPRAVNQDKKNMLFSGTNIAAGKALGIVATTGVSTEIGKIRDQMA,0
4nab,A,258,274,16,QLSKVISLICVAVWLI,0
4nab,A,275,295,20,IGHFNDPVHGGSWIRGAIYY,0
4nab,A,296,310,14,KIAVALAVAAIPQG,0
4nab,A,762,778,16,YLISSNVGEVVCIFLT,0
4nab,A,779,786,7,ALGLPEA,0
4nab,A,787,805,18,IPVQLLWVNLVTDGLPAT,0
4nab,A,832,851,19,LFFRYMAIGGYVGAATVGA,0
4nab,A,852,898,46,AWWFMYAEDGPGVTYHQLTHFMQCTEDHPHFEGLDCEIFEAPEPMT,0
4nab,A,899,915,16,ALSVLVTIEMCNALNS,0
4nab,A,934,950,16,GSICLSMSLHFLILYV,0
4nab,A,951,956,5,PLPMI,0
4nab,A,957,967,10,KLKALDLTQW,0
4nab,A,968,987,19,MVLKISLPVIGLDEILKFI,0
4nab,A,995,1000,5,GLVPR,0
2z55,F,1,15,14,AGFDLLNDGRPETL,0
2z55,F,16,36,20,LGIGTLLMLIGTFYFIARGW,0
2z55,F,47,66,19,AITILVPGIASAAYLAMFF,0
2z55,F,67,84,17,IGVTEVELASGTVLDIY,0
2z55,F,85,103,18,ARYADWLFTTPLLLLDLA,0
2z55,F,112,132,20,IGTLIGVDALMIVTGLIGAL,0
2z55,F,133,138,5,KTPLA,0
2z55,F,139,159,20,YTWWLFSTIAFLFVLYYLLT,0
2z55,F,178,197,19,LTALVAVLWTAYPILWIVG,0
2z55,F,198,208,10,EGAGVVGLGI,0
2z55,F,209,230,21,TLAFMVLDVTAKVGFGFVLLR,0
2z55,F,243,253,10,SAGADASAAD,0
2aui,A,93,113,20,GRVAMIGFAASLLGEALTGK,0
2aui,A,114,130,16,ILAQLNLETGIPIYEA,0
2aui,A,131,149,18,PLLLFFILFTLLGAIGAL,0
2aui,A,194,217,23,LFVGRLAQLGIAFSLIGEIITGK,0
2aui,A,218,229,11,ALAQLNIETGI,0
2aui,A,230,247,17,IQDIEPLVLLNVAFFFF,0
5jeq,B,1,14,13,IVKRPVSASLARA,0
5jeq,B,15,37,22,FYIVLLSILSTGIALLTLASSL,0
5jeq,B,143,165,22,ERKMLLVVAISLAGGIGIFTLV,0
5jeq,B,166,192,26,FTLRRIRHQVVAPLNQLVTASQRIEH,0
5jeq,B,194,195,1,F,0
5jeq,B,198,230,32,PLDTNLPNELGLLAKTFNQMSSELHKLYRSLE,0
5djq,N,1,8,7,FVDNVVL,0
5djq,N,9,27,18,GVVTVGLMVAFLAGFGYF,0
1qov,H,1,10,9,VGVTAFGNF,0
1qov,H,11,12,1,L,0
1qov,H,13,32,19,SLAIYSFWIFLAGLIYYLQ,0
1qov,H,251,260,9,VAAMLAEYA,0
1aij,H,1,10,9,VGVTAFQNF,0
1aij,H,13,29,16,SLAIYSFWIFLAGLIY,0
1aij,H,30,256,226,LQTENMREGYPLENEDGTPAANQGPFPLPKPKTFILPHGRGTLTVPGPESEDRPIALARTAVSEGFPHAPTGDPMKDGVGPASWVARRDLPELDGHGHNKIKPMKAAAGFHVSAGKNPIGLPVRGCDLEIAGKVVDIWVDIPEQMARFLEVELKDGSTRLLPMQMVKVQSNRVHVNALSSDLFAGIPTIKSPTEVTLLEEDKICGYVAGGLMYAAPKRKSVVAAML,0
1aij,H,257,260,3,EYA,0
3rqw,E,1,10,9,PADNAADAR,0
3rqw,E,11,210,199,VDVSVSIFINKIYGVNTLEQTYKVDGYIVAQWTGKPRKTPGDKPLIVENTQIERWINNGLWVPALEFINVVGSPDTGNKRLMLFPDGRVIYNARFLGSFSNDMDFRLFPFDRQQFVLELEPFSYNNQQLRFSDIQVYTENIDNEEIDEWWIRGKASTHISDIRYDHLSSVQPNQNEFSRITVRIDAVRNPSYYLWSFIL,0
3rqw,E,211,225,14,LGLIIAASWSVFWL,0
3rqw,E,230,245,15,RLQTSFTLMLTVVAY,0
3rqw,E,246,265,19,FYTSNILPRLPYTTVIDQM,0
3rqw,E,266,282,16,IAGYGSIFAAILLIIF,0
3rqw,E,298,315,17,RCRLAFPLGFLAIGCVL,0
3rqw,E,316,317,1,I,0
3rqw,E,318,322,4,GITL,0
4bwb,A,46,51,5,PGSGP,0
4bwb,A,52,61,9,SDLDVNTDI,0
4bwb,A,62,83,21,SKVLVTAIYLALFVVGTVGNG,0
4bwb,A,91,95,4,KKSL,0
4bwb,A,110,131,21,LSDLLILLFALPVDLYNFIWV,0
4bwb,A,132,135,3,HPW,0
4bwb,A,136,161,25,FGDAGCKGYYFLREACTYATALNVV,0
4bwb,A,193,210,17,WLASALLAIPMLFTMGL,0
4bwb,A,211,232,21,NLSGDGTHPGGLVCTPIVDTA,0
4bwb,A,233,254,21,LRVVIQLNTFMSFLFPMLVAS,0
4bwb,A,269,279,10,QAAEQGRVCT,0
4bwb,A,313,333,20,VIAFVVCWLPYHVRRLMFVY,0
4bwb,A,334,346,12,SDEQWTTALFDF,0
4bwb,A,347,365,18,HYFYMLSNALVYVSAAIN,0
4bwb,A,375,387,12,FRQVFLSTLACL,0
4bwb,A,389,399,10,GTRELEVLFQ,0
2m6b,A,224,243,19,IQLYIPSLLIVILSWISFW,0
2m6b,A,244,249,5,NLDAA,0
2m6b,A,250,269,19,ARVGLGITTVLTLTTQSSG,0
2m6b,A,282,303,21,IDIWLAVCLLFVFSALLEYAA,0
2m6b,A,304,397,93,NFVSRQREFGGGGFIQRAKKIDK,0
2m6b,A,398,420,22,SRIGFPLAFLIFNLFYWIIYKI,0
5jef,B,3,12,9,KRPVSASLA,0
5jef,B,13,35,22,AFFYIVLLSILSTGIALLTLAS,0
5jef,B,147,170,23,LLVVAISLAGGIGIFTLVFFTLR,0
5jef,B,171,195,24,IRHQVVAPLNQLVTASQRIEHGQF,0
5jef,B,198,226,28,PLDTNLPNELGLLAKTFNQMSSELHKLY,0
5kli,G,9,14,5,TRRDF,0
5kli,G,15,31,16,YYATAGAGAVATGAAV,0
2itd,F,1,21,20,APMLSGLLARLVKLLLGRHG,0
2itd,F,22,25,3,ALH,0
2itd,F,26,50,24,RAAGAATVLLVIVLLAGSYLAVLA,0
2itd,F,63,78,15,RALWWSVETATTVGY,0
2itd,F,87,111,24,GRCVAVVVMVAGITSFGLVTAALA,0
2itd,F,112,124,12,WFVGREQERRGH,0
3fb8,G,21,25,4,SALQ,0
3fb8,G,26,29,3,RAA,0
3fb8,G,30,50,20,AATVLLVIVLLAGSYLAVLA,0
3fb8,G,63,78,15,RALWWSVETATTVGY,0
3fb8,G,87,107,20,GRCVAVVVMVAGITSFGLVT,0
3fb8,G,108,112,4,ALAT,0
3fb8,G,113,124,11,FVGQEQQQQGQ,0
3f4i,B,1,4,3,EVK,0
3f4i,B,13,32,19,LILAMAGNAVGLGNFLRFP,0
3f4i,B,33,43,10,QAAENGGGAF,0
3f4i,B,44,63,19,IPYIIAFLLVGIPLMWIEW,0
3f4i,B,90,124,34,KILGVFGLWIPLVVAIYYVYIESWTLGFAIKFLV,0
3f4i,B,125,132,7,LVPEPPP,0
3f4i,B,133,134,1,A,0
3f4i,B,135,166,31,DPDSILRPFKEFLYSYIGVPKGDEPILKPSL,0
3f4i,B,167,184,17,AYIVFLITMFINVSILI,0
3f4i,B,191,212,21,ERFAKIAMPTLFILAVFLVIR,0
3f4i,B,213,222,9,FLLETPNGT,0
3f4i,B,223,230,7,ADGLNFL,0
3f4i,B,231,241,10,TPDFEKLKDP,0
3f4i,B,242,265,23,VWIAAVGQIFFTLSLGFGAIITY,0
3f4i,B,278,297,19,GLTAATLNEKAEVILGGSI,0
3f4i,B,298,325,27,IPAAVAFFGVANAVAIAKAGAFNLGFI,0
3f4i,B,326,331,5,LPAIF,0
3f4i,B,332,339,7,QTAGGTF,0
3f4i,B,340,367,27,GFLWFFLLFFAGLTSSIAIMQPMIAFL,0
3f4i,B,378,396,18,VLWTAAIVFFSAHLVMFL,0
3f4i,B,397,399,2,KS,0
3f4i,B,400,426,26,DEMDFWAGTIGVVFFGLTELIIFFWI,0
3f4i,B,429,437,8,DKAWEEIN,0
3f4i,B,445,469,24,RIYYYVMRYITPAFLAVLLVVWAR,0
3f4i,B,470,471,1,Y,0
3f4i,B,472,477,5,PKIME,0
3f4i,B,478,483,5,THWTV,0
3f4i,B,484,502,18,ITRFYIIGLFLFLTFLVF,0
3f4i,B,602,604,2,PR,0
4v1g,I,18,40,22,LIMGGGAIGAGIGDGIAGNALI,0
4v1g,I,41,53,12,GIARQPEAQGRL,0
4v1g,I,54,76,22,TPFFITVGLVEAAYFINLAFMA,0
5ebm,F,1,23,22,APMLSGLLARLVKLLLGRHGSA,0
5ebm,F,29,50,21,GAATVLLVIVLLAGSYLAVLA,0
5ebm,F,51,62,11,RGAPGAQLITY,0
5ebm,F,63,79,16,RALWWSVETATGVGYG,0
5ebm,F,80,86,6,LYPVTL,0
5ebm,F,87,108,21,GRLVAVVVMVAGITSFGLVTA,0
1kqg,I,2,12,10,KSKMIVRTKF,0
1kqg,I,13,33,20,DRACHWTVVICFFLVALSGI,0
1kqg,I,58,77,19,FFGIAIFVALMFMFVRFVH,0
1kqg,I,78,82,4,NIPD,0
1kqg,I,83,90,7,KDIPWLL,0
1kqg,I,91,111,20,IVEVLKGNEHKVADVGKYNA,0
1kqg,I,112,131,19,QKMMFWSIMSMIFVLLVTG,0
1kqg,I,155,175,20,AAAGIILIHAILIHMYMAFW,0
1kqg,I,176,178,2,KG,0
1kqg,I,179,184,5,IKGMI,0
1kqg,I,185,217,32,GKVSRRWAKKHHPRWYREIEKAEAKKESEEGI,0
4zp2,A,9,19,10,RLGRQALLFP,0
4zp2,A,20,40,20,CLVLYEFSTYIGNDMIQPGM,0
4zp2,A,55,72,17,TSMTAYLAGGMFLQWLL,0
4zp2,A,73,83,10,PLSDRIGRRP,0
4zp2,A,84,102,18,MLAGVVWFIVTCLAILLA,0
4zp2,A,107,126,19,FTLLRFLQGISLCFIGAVG,0
4zp2,A,127,143,16,AAIRESFEEAVCIKIT,0
4zp2,A,144,164,20,LMANVALIAPLLGPLVGAAW,0
4zp2,A,171,189,18,GMFVLFAALAAISFFGLQ,0
4zp2,A,190,204,14,AMPETATRIGEKLS,0
4zp2,A,205,215,10,KELGRDYKLV,0
4zp2,A,216,222,6,KNGRFV,0
4zp2,A,223,242,19,GALALGFVSLPLLAWIAQS,0
4zp2,A,259,277,18,LQVPIFGALIAGNLLLAR,0
4zp2,A,278,286,8,TSRRTVRS,0
4zp2,A,287,305,18,IIMGGWPIMIGLLVAAAA,0
4zp2,A,315,335,20,MTAGLSIYAFGIGLANAGLV,0
4zp2,A,336,350,14,LTLFASDMSKGTVS,0
4zp2,A,351,369,18,AMGMLQMLIFTVGIEISK,0
4zp2,A,380,398,18,NLFNLVNGILWLSLMVIF,0
4zp2,A,399,400,1,K,0
4mrv,B,1,8,7,PPETATN,0
4mrv,B,16,27,11,WQTLKRFLPYL,0
4mrv,B,34,58,24,LRRRVVGAILMVLLGKATTLALPF,0
4mrv,B,59,85,26,YKKAVDAMTLGGGAQPALTVALAFVL,0
4mrv,B,86,108,22,YALGRFSGVLFDNLRNIVFERV,0
4mrv,B,156,177,21,FLLFNIAPTVIELTAVIVIFW,0
4mrv,B,178,182,4,NFGL,0
4mrv,B,183,206,23,LVTATILAVIAYVWTTRTITEWR,0
4mrv,B,263,284,21,SLGLLNIAQALIVNLLMAGAM,0
4mrv,B,285,303,18,WTVYGWSQGKLTVGDLVF,0
4mrv,B,304,323,19,NTYLTQLFRPLDMLGMVYR,0
4mrv,B,607,614,7,EHHHHHH,0
3h9v,C,26,31,5,SSKKV,0
3h9v,C,35,55,20,RFTQALVIAYVIGYVFVYNK,0
3h9v,C,56,136,80,YQDTDTVLSSVTTKVKGIALTKTSELGERIWDVADYIIPPQEDGSFFVLTNMIITTNQTQSKCAENPTPASTCTSHRDCK,0
3h9v,C,138,331,193,FNDARGDGVRTGRCVSYSASVKTCEVLSWCPLEKIVDPPNPPLLADAERFTVLIKNNIRYPKFNFNKRNILPNINSSYLTHCVFSRKTDPDCPIFRLGDIVGEAEEDFQIMAVRGGVMGVQIRWDCDLDMPQSWCVPRYTFRRLDNKDPDNNVAPGYNFRFAKYYKNSDGTETRTLIKGYGIRFDVMVFGQAG,0
3h9v,C,332,360,28,FNIIPTLLNIGAGLALLGLVNVICDWIV,0
3h9v,C,362,381,19,FMKRKQHYKEQKYTYVDDF,0
3ag2,Z,16,35,19,IGLSVTFLSFLLPAGWVLY,0
3ag2,Z,36,43,7,LDNYKKS,0
3ag2,Z,44,46,2,AA,0
2npj,C,1,2,1,P,0
2npj,C,18,31,13,LVLFMTIPGIALF,0
2npj,C,32,46,14,GGLIRGKNVLSMLT,0
2npj,C,47,63,16,VTVTFALVCILWVVYG,0
2npj,C,106,118,12,FACITVGLIVGA,0
2npj,C,119,127,8,AERIRFSA,0
2npj,C,128,143,15,LIFVVVWLTLSYIPI,0
2npj,C,163,178,15,GTVVHINAAIAGLVG,0
2npj,C,179,181,2,YL,0
2npj,C,182,194,12,GKRVGFGKEAFK,0
2npj,C,195,202,7,HNLPMVF,0
2npj,C,203,216,13,GTAILYIGWFGFN,0
2npj,C,234,248,14,VVATAAAILGWIFG,0
2npj,C,249,260,11,WALRGKPSLLG,0
2npj,C,261,274,13,CSGAIAGLVGVTP,0
2npj,C,285,299,14,IIGVVAGLAGLWGV,0
2npj,C,300,302,2,ML,0
2npj,C,303,310,7,RLLRVDD,0
2npj,C,311,314,3,CDV,0
2npj,C,315,328,13,GVFGVCGIVGCIM,0
2npj,C,357,377,20,SIAITIVWSGVVAFIGYKLA,0
2npj,C,378,386,8,LTVGLRVP,0
2npj,C,387,424,37,EQEREGLDVNSHGENAYNADQAQQPAQADLEHHHHHH,0
5kc0,A,8,28,20,FVGIFSALATLVMFLEFPIF,0
5kc0,A,29,34,5,QASFL,0
5kc0,A,35,47,12,YDPSEIPALIVS,0
5kc0,A,52,70,18,GVGMFVVLVKDILFFLMK,0
5kc0,A,71,76,5,GDPVG,0
5kc0,A,77,94,17,AMNAVLGMSFVGIAGLI,0
5kc0,A,107,123,16,MIVATLFATAFALGLN,0
5kc0,A,124,142,18,LIVPLYFEAPFELYLKFF,0
5kc0,A,143,161,18,FILAFNLVKFGIDSVVTF,0
4x1h,A,1,39,38,NGTEGPNFYVPFSNKTGVVRSPFEAPQYYLAEPWQFSM,0
4x1h,A,40,65,25,AAYMFLLIMLGFPINFLTLYVTVQH,0
4x1h,A,69,96,27,TPLNYILLNLAVADLFMVFGGFTTTLY,0
4x1h,A,97,112,15,SLHGYFVFGPTGCNL,0
4x1h,A,113,137,24,GFFATLGGEIALWSLVVLAIERYV,0
4x1h,A,151,172,21,HAIMGVAFTWVMALACAAPPL,0
4x1h,A,173,202,29,GWSRYIPEGMQCSCGIDYYTPHEETNNES,0
4x1h,A,203,227,24,VIYMFVVHFIIPLIVIFFCYGQLV,0
4x1h,A,252,274,22,MVIIMVIAFLICWLPYAGVAFY,0
4x1h,A,275,287,12,FTHQGSDFGPIF,0
4x1h,A,288,310,22,TIPAFFAKTSAVYNPVIYIMMN,0
4x1h,A,311,321,10,QFRNCMVTTL,0
4x2s,C,1,5,4,GLYR,0
4x2s,C,13,27,14,QKILIGLILGAIVG,0
4x2s,C,28,43,15,ILGHYGYAHAVHTYV,0
4x2s,C,44,64,20,PFGDLFVRLLKMLVMPIVFA,0
4x2s,C,91,107,16,TSAFAVTLGIIMARLF,0
4x2s,C,108,130,22,PGAGIHLAVGGQQFQPHQAPPL,0
4x2s,C,131,140,9,HILLDIVPT,0
4x2s,C,141,150,9,PFGALANGQ,0
4x2s,C,151,160,9,LPTIFFAII,0
4x2s,C,198,215,17,NGVMQYAPIGVFALIAY,0
4x2s,C,216,225,9,MAEQGVHVV,0
4x2s,C,226,246,20,ELAKVTAAVYVGLTLQILLV,0
4x2s,C,311,325,14,DGTALYQGVATFFI,0
4x2s,C,326,336,10,NALGSHLTVG,0
4x2s,C,337,355,18,QLTIVLTAVLASIGTAGV,0
4x2s,C,357,370,13,AGAIMLAMVLHSV,0
4x2s,C,371,382,11,LPLTDPNVAAA,0
4x2s,C,383,401,18,AMILGIDAILDRGRTMVN,0
4x2s,C,421,422,1,R,0
3dta,H,1,10,9,VGVTAFGNF,0
3dta,H,12,32,20,ASLAIYSFWIFLAGLIYYLQ,0
3dta,H,33,250,217,ENMREGYPLENEDGTPAANQGPFPLPKPKTFILPHGRGTLTVPGPESEDRPIALARTAVSEGFPHAPTGDPMKDGVGPASWVARRDLPELDGHGHNKIKPMKAAAGFHVSAGKNPIGLPVRGCDLEIAGKVVDIWVDIPEQMARFLEVELKDGSTRLLPMQMVKVQSNRVHVNALSSDLFAGIPTIKSPTEVTLLEEDKICGYVAGGLMYAAPKRKS,0
3dta,H,251,260,9,VAAMLAEYA,0
5kbu,D,526,543,17,MCIVFAYIGVSVVLFLV,0
5kbu,D,545,567,22,FSPYEWHTEEFEDGRETQSSES,0
5kbu,D,568,572,4,NEFG,0
5kbu,D,573,586,13,FNSLWFSLGAFMQ,0
5kbu,D,587,592,5,GCDIS,0
5kbu,D,594,614,20,SLSGRIVGGVWWFFTLIIIS,0
5kbu,D,794,813,19,VFYILVGGLGLAMLVALIE,0
5kbu,D,814,817,3,CYK,0
5kbu,D,818,1043,225,RAEAKRMKGTGLFDRGVQMLLTTVGAFAAFSLMTIAVGTDYWLYSRGVCKTKSVSEDETSKKNEEVMTHSGLWRTCCLEGNFKGLCKQIDHFPEDADYEADTAEYFLRAVRASSIFPILSVILLFMGGLCIAASEFYKTRHNIILSAGIFFVSAGLSNIIGIIVYISANAGDPSKSDSKKNSYSYGWSFYFGALSFIIAEMVGVLAVHMFIDRHKQLTGGLVPRG,0
4hbh,H,1,10,9,VGVTAFGNF,0
4hbh,H,12,29,17,ASLAIYSFWIFLAGLIY,0
4hbh,H,30,248,218,LQTENMREGYPLENEDGTPAANQGPFPLPKPKTFILPHGRGTLTVPGPESEDRPIALARTAVSEGFPHAPTGDPMKDGVGPASWVARRDLPELDGHGHNKIKPMKAAAGFHVSAGKNPIGLPVRGCDLEIAGKVVDIWVDIPEQMARFLEVELKDGSTRLLPMQMVKVQSNRVHVNALSSDLFAGIPTIKSPTEVTLLEEDKICGYVAGGLMYAAPKR,0
4hbh,H,249,260,11,SVVAAMLAEYA,0
1y5l,F,5,28,23,MFFFDIYPYIAGAVFLIGSWLRY,0
1y5l,F,29,47,18,YGQYTWRAASSQMLDRKG,0
1y5l,F,48,66,18,NLASNLFHIGILGIFVGY,0
1y5l,F,67,80,13,FGMLTPHWMYEAW,0
1y5l,F,87,114,27,KMAMFAGGASGVLCLIGGVLLLKRRLF,0
1y5l,F,115,124,9,PRVRATTTG,0
1y5l,F,125,145,20,DILILSLLVIQCALGLLTIP,0
1y5l,F,184,204,20,RLHLVLGMTLFLLFPFSRLI,0
1y5l,F,205,225,20,IWSVPVEYLTRKYQLVRARH,0
4q9j,A,35,68,33,LTMFRYAGWLDRLYMLVGTLAAIIHGVALPLMM,0
4q9j,A,69,117,48,IFGDMTDSFASVGQVSKQSTQMSEADKRAMFAKLEEEMTTYAYYYTGI,0
4q9j,A,118,140,22,AGVLIVAYIQVSFWCLAAGRQI,0
4q9j,A,180,204,24,GIGDKIGMFFQAMATFFGGFIIGF,0
4q9j,A,205,208,3,RGW,0
4q9j,A,209,232,23,LTLVILAISPVLGLSAGIWAKIL,0
4q9j,A,290,313,23,ANISMGAAFLLIYASYALAFWYG,0
4q9j,A,314,328,14,SLVISKEYSIGQVL,0
4q9j,A,329,352,23,VFFSVLIGAFSVGQASPNIEAFA,0
4q9j,A,695,700,5,ILKLN,0
4q9j,A,706,729,23,FVVGIFCAIINGGLQPAFSVIFS,0
4q9j,A,730,750,20,VVGVFTNGGPPETQRQNSNL,0
4q9j,A,751,773,22,SLLFLILGIISFITFFLQGFTF,0
4q9j,A,828,848,20,LAVIFQNIANLGTGIIISLI,0
4q9j,A,849,854,5,GWQLT,0
4q9j,A,855,879,24,LLLAIVPIIAIAGVVEMKMLSGQA,0
4q9j,A,925,949,24,NAMKKAHVFGITFSFTQAMMYFSY,0
4q9j,A,950,972,22,ACFRFGAYLVTQQLMTFENVLL,0
4q9j,A,973,991,18,FSAIVFGAMAVGQVSSFA,0
3stl,F,26,50,24,RAAGAATVLLVIVLLAGSYLAVLA,0
3stl,F,51,62,11,RGAPGAQLITY,0
3stl,F,63,78,15,RALWWSVETATTVGY,0
3stl,F,79,86,7,DLCPVTL,0
3stl,F,87,111,24,GRLVAVVVMVAGITSFGLVTAALA,0
2ka1,B,164,186,22,FLPSLLLSHLLAIGLGIYIGRR,0
2ka1,B,187,188,1,T,0
3du3,H,1,10,9,VGVTAFGNF,0
3du3,H,12,29,17,ASLAIYSFWIFLAGLIY,0
3du3,H,30,250,220,LQTENMREGYPLENEDGTPAANQGPFPLPKPKTFILPHGRGTLTVPGPESEDRPIALARTAVSEGFPHAPTGDPMKDGVGPASWVARRDLPELDGHGHNKIKPMKAAAGFHVSAGKNPIGLPVRGCDLEIAGKVVDIWVDIPEQMARFLEVELKDGSTRLLPMQMVKVQSNRVHVNALSSDLFAGIPTIKSPTEVTLLEEDKICGYVAGGLMYAAPKRKS,0
3du3,H,251,260,9,VAAMLAEYA,0
5l25,B,1,32,31,EETFVPFEGIKNDLKGRLMCYKQDWTGGFKA,0
5l25,B,33,35,2,FR,0
5l25,B,36,58,22,LAPTTYIFFASAIPVISFGEQL,0
5l25,B,67,83,16,AVQTLASTAICGMIHS,0
5l25,B,84,90,6,IGGQPL,0
5l25,B,91,109,18,ILGVAEPTVIMYTFMFNF,0
5l25,B,124,140,16,SGWVCVWTALMLFVLA,0
5l25,B,141,157,16,CGACSIINRFTRVAGE,0
5l25,B,158,176,18,FGLLIAMLFMQQAIKGLV,0
5l25,B,204,219,15,LVLSFGLLLTGLRSR,0
5l25,B,220,233,13,ARSWRYGTGWLRS,0
5l25,B,234,251,17,IADYGVPLMVLVWTGVS,0
5l25,B,255,290,35,GDVPKGIPRRLFSPNPWSPGAYGNWTVVKEMLDVP,0
5l25,B,292,312,20,YIIGAFIPASMIAVLYYFDH,0
5l25,B,313,324,11,VASQLAQQKEF,0
5l25,B,325,334,9,LRKPSSYHY,0
5l25,B,335,336,1,L,0
5l25,B,337,350,13,LLGFLTLMCGLLG,0
5l25,B,351,353,2,PP,0
5l25,B,354,369,15,NGVIPQSPMHTKSLA,0
5l25,B,369,369,0,LKYQLLRNRLVATARRSIKTNASLGQLYDNMQEAYHHMQTPLVYQQPQGLKELKESTIQATTFTGNLNAPVDETLFDIEKEIDDLLPVEVKEQR,0
5l25,B,465,481,16,SNLLQSTMVGGCVAAM,0
5l25,B,486,488,2,IP,0
5l25,B,489,504,15,SVLWGYFAFMAIESL,0
5l25,B,505,527,22,GNQFWERILLLFTAPSRRFKVL,0
5l25,B,528,529,1,D,0
5l25,B,530,550,20,HATFVETVPFKTIAMFTLFQ,0
5l25,B,551,576,25,TYLLICFGLTWIPIAGVMFPLMIMF,0
5l25,B,577,586,9,IPVRQYLLP,0
5l25,B,587,652,65,FFKGAHLQDLDAAEYEEAPALPFNLAAETEIGSTTSYPGDLEILDEVMTRSRGEFRHTAAALVPR,0
4xpf,A,38,57,19,SVIGFAVDLANVWRFPYLC,0
4xpf,A,58,62,4,KNGG,0
4xpf,A,63,82,19,AFLVPYGIMLAVGGIPLFY,0
4xpf,A,112,133,21,VVLIAFYVGFYYNVIIAWSLR,0
4xpf,A,134,239,105,FFASFTNSLPWTSCNNIWNTPNCRPFESQGFQSAASEYFNRYILELNRSEGIHDLGAIKWDM,0
4xpf,A,240,255,15,LCLLIVYLICYFSLW,0
4xpf,A,261,281,20,GKVVWFTALFPYAVLLILLI,0
4xpf,A,282,288,6,GLTLPG,0
4xpf,A,289,297,8,FLGIQYYL,0
4xpf,A,298,301,3,PNF,0
4xpf,A,302,328,26,AIYKAEVWVDAATQVFFSLGPGFGVL,0
4xpf,A,346,362,16,LTSFINSATSFIAGFV,0
4xpf,A,363,408,45,FSVLGYMAHTLGVRIEDVATEGPGLVFVVYPAAIATMPASTFWAL,0
4xpf,A,409,430,21,FFMMLATLGLDSSFGGMEAII,0
4xpf,A,447,463,16,VAGLFSLYFVVGLASC,0
4xpf,A,464,470,6,QGGFYF,0
4xpf,A,471,491,20,HLLDRYAAGYSILVAVFFEA,0
4xpf,A,517,524,7,YWQVCWR,0
4xpf,A,526,542,16,APIFLLFITVYGLIGY,0
4xpf,A,543,554,11,PLTYADYVYPS,0
4xpf,A,555,573,18,ANALGWCIAGSSVVMIPA,0
1e14,H,1,10,9,VGVTAFGNF,0
1e14,H,12,29,17,ASLAIYSFWIFLAGLIY,0
1e14,H,251,260,9,VAAMLAEYA,0
1bac,A,1,8,7,QITGRPE,0
1bac,A,9,12,3,IWL,0
1bac,A,13,32,19,LGTALMGLGTLYFLVKGMG,0
1bac,A,33,37,4,SDPD,0
1bac,A,44,60,16,TTLVPAIAFTMYLSML,0
1bac,A,61,62,1,G,0
1bac,A,63,73,10,GLTMVPFGGE,0
1bac,A,74,80,6,NPIYWA,0
1bac,A,81,98,17,YADWLFTTPLLLLDLAL,0
1bac,A,101,105,4,ADQG,0
1bac,A,107,123,16,LALVGADGIMIGTGLV,0
1bac,A,124,127,3,ALT,0
1bac,A,128,136,8,VYSYRFVW,0
1bac,A,138,153,15,ISTAAMLYILYVLFF,0
1bac,A,158,165,7,AESMRPE,0
1bac,A,174,190,16,NVTVVLWSAYPVVWLI,0
1bac,A,192,201,9,EGAGIVPLN,0
1bac,A,202,205,3,ETL,0
1bac,A,206,223,17,FMVLDVSAKVGFGLILL,0
1bac,A,226,248,22,AIFGEAEAPEPSAGDGAAATS,0
1llk,A,15,34,19,WPIFGAAAALLTTSGLIMW,0
1llk,A,35,39,4,HYSS,0
1llk,A,40,59,19,TLLTMGLLSMLLVMLQWWR,0
1llk,A,79,99,20,RYGMILFITSEAFFFLGFFW,0
1llk,A,100,127,27,FFHSSLAPTPELGGQWPPTGVKPLNPL,0
1llk,A,128,149,21,VPLLNTAILLASGVTVTWAHH,0
1llk,A,159,181,22,IHALTLTILLGFYFTALQAMEY,0
1llk,A,182,198,16,EASFSIADSVYGSTFF,0
1llk,A,199,221,22,ATGFHGLHVIIGSSFLTVCLLR,0
1llk,A,234,257,23,FEAAAWYWHFVDIIWLFLYMSMY,0
1llk,A,258,261,3,WGS,0
5lri,H,11,14,3,LAS,0
5lri,H,15,29,14,AIYSFWIFLAGLIY,0
3zk1,K,11,33,22,GCSAVGAGLAMIAGLGPGIGEG,0
3zk1,K,34,61,27,AAGKAVESVARQPEARGSIISTMILGQ,0
3zk1,K,62,85,23,VAESTGIYSLVIALILLYANPFL,0
5kuk,D,62,68,6,PQRYIA,0
5kuk,D,70,76,6,FTTCVD,0
5kuk,D,78,104,26,WRYMLLLFSLAFLVSWLLFGLIFWLI,0
5kuk,D,105,130,25,LIHGDLENPGGDDTFKPCVLQVNGF,0
5kuk,D,131,147,16,AAFLFSIETQTTIGYG,0
5kuk,D,148,155,7,RCVTEEC,0
5kuk,D,156,184,28,LAVFMVVVQSIVGCIIDSFMIGAIMAKM,0
1r2c,H,1,12,11,YHGALAQHLDI,0
1r2c,H,13,32,19,QLVWYAQWLVIWTVVLLYL,0
3tet,E,18,20,2,AK,0
3tet,E,25,45,20,VLFVLTILTLISGTIFYSTV,0
3tet,E,46,50,4,GLRP,0
3tet,E,51,67,16,DALYFSVVTLTTVGFG,0
3tet,E,68,74,6,FSPQTD,0
3tet,E,75,99,24,GKIFTILYIFIGIGLVFGFIHKLA,0
3tet,E,103,111,8,LPSILSNL,0
2ls2,A,4,21,17,GEMAGAFVAVFLLAMFY,0
2ls2,A,22,25,3,GLK,0
3j9t,a,19,35,16,AIIFTSLGAAYGTAKS,0
3j9t,a,36,55,19,VGICATCVLRPDLLFKNIV,0
3j9t,a,56,72,16,VIMAGIIAIYGLVVSV,0
3j9t,a,96,112,16,VGLSGLAAGFAIGIVG,0
3j9t,a,113,130,17,AGVRGSSQQPRLFVGMI,0
3j9t,a,131,147,16,ILIFAEVLGLYGLIVA,0
3tdp,E,1,2,1,H,0
3tdp,E,3,22,19,ETLDKLTNAAINKINLLNT,0
3tdp,E,23,24,1,K,0
3tdp,E,25,46,21,KYLVSSAFAGLYVGIGILLIF,0
3tdp,E,63,79,16,MGLSFAIALSLVIMTG,0
3tdp,E,81,92,11,LFTGNNMVMSA,0
3tdp,E,93,104,11,MLNKGVSIKDT,0
3tdp,E,105,129,24,KIWAYSWVGNLIGALVLGIIFVGT,0
3tdp,E,136,149,13,VAEFFANTAASKA,0
3tdp,E,154,177,23,ALFFRGILCNILVCVSVLCSFRT,0
3tdp,E,178,179,1,S,0
3tdp,E,180,198,18,TAKIIMIFLCLFAFITSG,0
3tdp,E,200,211,11,HSVANMTIYSV,0
3tdp,E,227,252,25,YNLVAVTLGNIVGGALFMGLGTYIL,0
3tdp,E,253,256,3,KEK,0
1ucq,C,1,4,3,AQI,0
1ucq,C,5,9,4,GRPE,0
1ucq,C,10,32,22,IWLALGTALMGLGTLYFLVKGM,0
1ucq,C,43,62,19,AITTLVPAIAFTMYLSMLL,0
1ucq,C,63,79,16,YGLTMVPFGGEQNPIY,0
1ucq,C,80,97,17,ARYADWLFTTPLLLLDL,0
1ucq,C,108,128,20,LALVGADGIMIGTGLVGALT,0
1ucq,C,129,133,4,VYSY,0
1ucq,C,134,154,20,FVWWAISTAAMLYILYVLFF,0
1ucq,C,174,192,18,RNVTVVLWSAYPVVWLIG,0
1ucq,C,193,203,10,EGAGIVPLNI,0
1ucq,C,204,224,20,TLLFMVLDVSAKVGFGLILL,0
1ucq,C,232,249,17,AEAPEPSAGDGAAATSD,0
5kyh,A,4,26,22,IATLLLILIAVAAAVLLYTWVS,0
5kyh,A,27,134,107,LSANVAGTQVTGKSLTLIQATWARPATNVGTTISKDSFDRSKAVLILSFQPPAQVLQGGQAITIDAIDVLYQGRVVCHYDSFPMTADDKYHIGQTIGGLTAFGLVFW,0
5kyh,A,196,303,107,FDDQYPFATILAGTWEVNYVSTNYVETNFRNTSAVIKFDRFVNTHYSPDTQNNNGVPIFDVASASQSNFAVVIWCPNVNPNVMQSVDVKMVFSDGSTWEASVPLSIT,0
4z34,A,29,36,7,IAFFYNR,0
4z34,A,49,71,22,KLVMGLGITVCIFIMLANLLVM,0
4z34,A,72,88,16,AIYVNRRFHFPIYYLM,0
4z34,A,89,110,21,NLAAADFFAGLAYFYLMFNTG,0
4z34,A,117,141,24,VSTWLLRQGLIDTSLTASVANLLA,0
4z34,A,142,168,26,AIERHITVFRMQLHTRMSNRRVVVVI,0
4z34,A,169,189,20,VIWTMAIVMGAIPSVGWNCI,0
4z34,A,196,223,27,NMAPLYSDSYLVFWAIFNLVTFVVMVV,0
4z34,A,224,1043,819,YAHIFGYVADLEDNWETLNDNLKVIEKADNAAQVKDALTKMRAAALDAQKA,0
4z34,A,1058,261,-797,KDFRHGFDILVGQIDDALKLANEGKVKEAQAAAEQLKTTRNAYIQKYLRNRDTMMSLLKTVV,0
4z34,A,262,285,23,VLGAFIICWTPGLVLLLLDVCCP,0
4z34,A,288,310,22,VLAYEKFFLLLAEFNSAMNPII,0
4z34,A,311,315,4,SYRD,0
4z34,A,316,326,10,EMSATFRQIL,0
4chw,D,1,6,5,SVLPF,0
4chw,D,7,12,5,RIYAP,0
4chw,D,13,29,16,NAVLAAPGLLAVAALT,0
4chw,D,41,60,19,AALLAVIWGAYLLQLAATL,0
4chw,D,61,74,13,KRRAGVVRDRTPK,0
4chw,D,75,92,17,AIDVLAVLVPLAAFLLD,0
4chw,D,98,112,14,LYCAVWLLKPLRDS,0
4chw,D,114,125,11,FPVLGRVLANE,0
4chw,D,126,129,3,RNL,0
4chw,D,130,147,17,GVTTLFGVVLFAVALAA,0
4chw,D,166,177,11,WWAVVTLSTTG,0
4chw,D,188,210,22,RVLAGAVMMSGIGIFGLWAGIL,0
4chw,D,211,349,138,TGFYQEVRRGDFVRNWQLVAAVPLFQKLGPAVLVEIVRALRARTVPAGAVICRIGEPGDRMFFVVEGSVSVATPNPVELGPGAFFGEMALISGEPRSATVSAATTVSLLSLHSADFQMLCSSSPEIAEIFRKTALERR,0
4chw,D,350,361,11,AAASAHHHHHH,0
4aps,A,1,10,9,EDKGKTFFG,0
4aps,A,11,17,6,PLGLST,0
4aps,A,18,34,16,FMTEMWERFSYYGMRA,0
4aps,A,59,74,15,MAIYASMVYLSGTIG,0
4aps,A,75,87,12,FVADRIIGARPA,0
4aps,A,88,101,13,FWGGVLIMLGHIV,0
4aps,A,113,127,14,SIILIIIGTGFLKP,0
4aps,A,128,151,23,VSTLVGTLYDEHDRRRDAGFSIF,0
4aps,A,152,166,14,FGINLGAFIAPLIV,0
4aps,A,180,195,15,LAAIGMFIGLLVYYF,0
4aps,A,196,224,28,GKKTLDPHYLRPTDPLAPEEVKPLLVKV,0
4aps,A,225,241,16,LAVAGFIAIIVVMNLV,0
4aps,A,249,263,14,INLLTIVAIAIPVF,0
4aps,A,264,269,5,FAWMI,0
4aps,A,270,281,11,SVKVTSTEHLR,0
4aps,A,282,287,5,VSYIP,0
4aps,A,288,304,16,FIAAVLFWAIEEQGSV,0
4aps,A,325,339,14,SLNPLFIMLYTPFF,0
4aps,A,340,349,9,WLWTAWKKN,0
4aps,A,350,352,2,PS,0
4aps,A,353,357,4,PTKF,0
4aps,A,358,370,12,VGLMFAGLSFLL,0
4aps,A,391,404,13,SWALVILGEMLIS,0
4aps,A,405,428,23,VGLSVTTKLAPKAFNSQMMSMWF,0
4aps,A,429,442,13,SSSVGSALNAQLV,0
4aps,A,456,470,14,FGLGSVVLGIVLVF,0
4aps,A,472,491,19,KRIQGLMQGVEGSENLYFQ,0
3ar3,A,54,74,20,QFEDLLVRILLLAACISFVL,0
3ar3,A,75,88,13,WFEEGEETITAFV,0
3ar3,A,89,111,22,PFVILLILIANAIVGVWQERNA,0
3ar3,A,253,277,24,EFGEQLSKVISLICVAVWLINIGH,0
3ar3,A,278,295,17,NDPVHGGSWIRGAIYYF,0
3ar3,A,296,318,22,IAVALAVAAIPEGLPAVITTCL,0
3ar3,A,760,783,23,RYLISSNVGEVVCIFLTAALGLP,0
3ar3,A,784,785,1,A,0
3ar3,A,786,809,23,IPVQLLWVNLVTDGLPATALGFN,0
3ar3,A,833,854,21,FRYMAIGGYVGAATVGAAAWW,0
3ar3,A,855,896,41,MYAEDGPGVTYHQLTHFMQCTEDHPHFEGLDCEIFEAPEPM,0
3ar3,A,897,916,19,MALSVLVTIEMCNALNSLS,0
3ar3,A,927,950,23,VNIWLLGSICLSMSLHFLILYVD,0
3ar3,A,952,957,5,PMIFK,0
3ar3,A,958,964,6,KALDLT,0
3ar3,A,965,987,22,WLMVLKISLPVIGLDEILKFIA,0
1kfy,P,13,38,25,WGLFGAGGMWSAIIAPVMILLVGIL,0
1kfy,P,39,61,22,PLGLFPGDALSYERVLAFAQSF,0
1kfy,P,62,83,21,GRVFLFLMIVLPLWCGLHRMH,0
1kfy,P,94,116,22,AGKWVFYGLAAILTVVTLIGVV,0
1kfy,P,117,118,1,I,0
3jcg,E,1,16,15,EEKRLSAKKGLPPGT,0
3jcg,E,17,295,278,VYTGKYREDFEIEVMNYSIEEFREFKTTDVESVLPFRDSSTPTWINITGIHRTDVVQRVGEFFGIHPLVLEDILNVHQRPKVEFFENYVFIVLKMFTYDKNLHELESEQVSLILTKNCVLMFQEKIGDVFDPVRERIRYNRGIIRKKRADYLLYSLIDALVDDYFVLLEKIDDEIDVLEEEVLERPEKETVQRTHQLKRNLVELRKTIWPLREVLSSLYRDVPPLIEKETVPYFRDVYDHTIQIADTVETFRDIVSGLLDVYLSSVSNKTNEVMKVLT,0
3jcg,E,296,310,14,IATIFMPLTFIAGI,0
3jcg,E,331,343,12,AVMGVIAVIMVV,0
3jcg,E,344,347,3,FKK,0
3jcg,E,348,351,3,KWL,0
5bqj,J,13,33,20,ISTIGLLGAGIGIAIVFAAL,0
5bqj,J,34,48,14,NGVSRNPSIKDTVF,0
5bqj,J,49,71,22,MAILGFALSEATGLFCLMVSFL,0
2kyv,E,3,17,14,VQYLTRSAIRRAST,0
2kyv,E,31,49,18,FINFCLILICLLLICIIV,0
2kyv,E,50,52,2,LL,0
3jcf,E,3,293,290,KRLSAKKGLPPGTLVYTGKYREDFEIEVMNYSIEEFREFKTTDVESVLPFRDSSTPTWINITGIHRTDVVQRVGEFFGIHPLVLEDILNVHQRPKVEFFENYVFIVLKMFTYDKNLHELESEQVSLILTKNCVLMFQEKIGDVFDPVRERIRYNRGIIRKKRADYLLYSLIDALVDDYFVLLEKIDDEIDVLEEEVLERPEKETVQRTHQLKRNLVELRKTIWPLREVLSSLYRDVPPLIEKETVPYFRDVYDHTIQIADTVETFRDIVSGLLDVYLSSVSNKTNEVMKV,0
3jcf,E,294,315,21,TIIATIFMPLTFIAGIYGMNF,0
3jcf,E,326,346,20,YPVVLAVMGVIAVIMVVYFK,0
3jcf,E,347,351,4,KKWL,0
6prc,H,16,33,17,WYAQWLVIWTVVLLYLR,0
6prc,H,34,258,224,EDRREGYPLVEPLGLVKLAPEDGQVYELPYPKTFVLPHGGTVTVPRRRPETRELKLAQTDGFEGAPLQPTGNPLVDAVGPASYAERAEVVDATVDGKAKIVPLRVATDFSIAEGDVDPRGLPVVAADGVEAGTVTDLWVDRSEHYFRYLELSVAGSARTALIPLGFCDVKKDKIVVTSILSEQFANVPRLQSRDQITLREEDKVSAYYAGGLLYATPERAESLL,0
1ehk,C,2,8,6,EKPKGA,0
1ehk,C,9,23,14,AVILVLTLTILVFW,0
3ar2,A,51,56,5,VIEQF,0
3ar2,A,57,77,20,DLLVRILLLAACISFVLAWF,0
3ar2,A,78,86,8,EGEETITA,0
3ar2,A,87,104,17,VEPFVILLILIANAIVG,0
3ar2,A,257,274,17,QLSKVISLICVAVWLIN,0
3ar2,A,275,293,18,GHFNDPVHGGSWIRGAIY,0
3ar2,A,294,311,17,FKIAVALAVAAIPEGLP,0
3ar2,A,760,780,20,RYLISSNVGEVVCIFLTAAL,0
3ar2,A,781,786,5,LPEAL,0
3ar2,A,787,807,20,PVQLLWVNLVTDGLPATALG,0
3ar2,A,832,851,19,FFRYMAIGGYVGAATVGAA,0
3ar2,A,852,898,46,WWFMYAEDGPGVTYHQLTHFMQCTEDHPHFEGLDCEIFEAPEPMTM,0
3ar2,A,899,916,17,LSVLVTIEMCNALNSLS,0
3ar2,A,932,950,18,LGSICLSMSLHFLILYVD,0
3ar2,A,951,964,13,LPMIFKLKALDLT,0
3ar2,A,965,987,22,WLMVLKISLPVIGLDEILKFIA,0
4hyt,G,1,16,15,AGLSTDDGGSPKGDV,0
4hyt,G,17,28,11,PFYYDYETVRN,0
4hyt,G,29,47,18,GLIFAALAFIVGLIIILS,0
4hyt,G,49,65,16,LRCGGKKHRPINEDEL,0
4z35,A,30,36,6,AFFYNR,0
4z35,A,51,75,24,VMGLGITVCIFIMLANLLVMVAIY,0
4z35,A,76,85,9,NRRFHFPIY,0
4z35,A,86,109,23,LMANLAAADFFAGLAYFYLMFNT,0
4z35,A,121,144,23,LLRQGLIDTSLTASVANLLAIAI,0
4z35,A,145,163,18,RHITVFRMQLHTRMSNRR,0
4z35,A,164,187,23,VVVIVVIWTMAIVMGAIPSVGWN,0
4z35,A,203,226,23,DSYLVFWAIFNLVTFVVMVVLYA,0
4z35,A,227,1043,816,IFGYVADLEDNWETLNDNLKVIEKADNAAQVKDALTKMRAAALDAQKA,0
4z35,A,1058,259,-799,KDFRHGFDILVGQIDDALKLANEGKVKEAQAAAEQLKTTRNAYIQKYLRNRDTMMSLLKT,0
4z35,A,260,284,24,VIVLGAFIICWTPGLVLLLLDVCC,0
4z35,A,288,314,26,VLAYEKFFLLLAEFNSAMNPIIYSYR,0
4z35,A,315,327,12,KEMSATFRQILG,0
4jc9,M,1,52,51,EYQNIFSQVQVRGPADLGMTEDVNLANRSGVGPFSTLLGWFGNAQLGPIYL,0
4jc9,M,53,69,16,SLGVLSLFSGLMWFFT,0
4jc9,M,118,135,17,SFFMFVAVWSWWGRTYL,0
4jc9,M,136,144,8,AQALGMGK,0
4jc9,M,145,163,18,TAWAFLSAIWLWMVLGFI,0
4jc9,M,201,221,20,HGLSIAFLYGSALLFAMHGA,0
4jc9,M,222,267,45,ILAVSRFGGERELEQIADRGTAAERAALFWRWTMGFNATMEGIHR,0
4jc9,M,268,285,17,AIWMAVLVTLTGGIGIL,0
4jc9,M,305,307,2,LN,0
4chv,D,1,6,5,SVLPF,0
4chv,D,7,13,6,RIYAPL,0
4chv,D,14,29,15,AVLAAPGLLAVAALT,0
4chv,D,41,58,17,AALLAVIWGAYLLQLAA,0
4chv,D,59,74,15,LLKRRAGVVRDRTPK,0
4chv,D,75,92,17,AIDVLAVLVPLAAFLLD,0
4chv,D,98,112,14,LYCAVWLLKPLRDS,0
4chv,D,113,114,1,F,0
4chv,D,115,124,9,PVLGRVLAN,0
4chv,D,125,126,1,A,0
4chv,D,127,146,19,NLIGVTTLFGVVLFAVALA,0
4chv,D,167,177,10,WAVVTLSTTG,0
4chv,D,191,211,20,AGAVMMSGIGIFGLWAGILA,0
4chv,D,212,349,137,GFYQEVRRGDFVRNWQLVAAVPLFQKLGPAVLVEIVRALRARTVPAGAVICRIGEPGDRMFFVVEGSVSVATPNPVELGPGAFFGEMALISGEPRSATVSAATTVSLLSLHSADFQMLCSSSPEIAEIFRKTALERR,0
4chv,D,350,361,11,AAASAHHHHHH,0
4hyc,D,1,3,2,QI,0
4hyc,D,11,26,15,MPLMLLFVQIIAIVL,0
4hyc,D,27,37,10,MPMQAAGLVA,0
4hyc,D,38,40,2,EN,0
4hyc,D,41,47,6,SSVANP,0
4hyc,D,48,64,16,IFIGMLLAFTLVLLVL,0
4hyc,D,73,90,17,AAFIGFALFMTFLYIFG,0
4hyc,D,91,105,14,LSLLALGPTTAAAA,0
4hyc,D,106,119,13,TLIGAVAVTALLY,0
4hyc,D,127,143,16,DILGVLISAGVASIFG,0
4hyc,D,144,151,7,SLEPLPV,0
4hyc,D,152,164,12,VLLVLLAVYDAI,0
4hyc,D,180,211,31,ETKAPIMVVVPKRADYSFRKEGLNISEGEER,0
4hyc,D,215,229,14,MGMGDLIMPSILVV,0
4hyc,D,230,234,4,SHVF,0
4hyc,D,235,243,8,DAPAVLWT,0
4hyc,D,244,248,4,SAPT,0
4hyc,D,249,262,13,GAMVGSLVGLAVL,0
4hyc,D,275,289,14,PPLNGGAILGFLVG,0
4hyc,D,290,293,3,ALA,0
4hyc,D,294,301,7,SFSWLPF,0
3j9u,W,14,36,22,IGCASAIIFTSLGAAYGTAKSG,0
3j9u,W,37,55,18,GICATCVLRPDLLFKNIV,0
3j9u,W,56,77,21,VIMAGIIAIYGLVVSVLVCYS,0
3j9u,W,91,112,21,GAGLSVGLSGLAAGFAIGIVG,0
3j9u,W,113,130,17,AGVRGSSQQPRLFVGMI,0
3j9u,W,131,152,21,ILIFAEVLGLYGLIVALLLNS,0
4hts,A,-3,4,7,SVDMPLT,0
4hts,A,8,28,20,ELRYRLIISIIAFLIGSGIA,0
4hts,A,29,32,3,YFA,0
4hts,A,33,46,13,YVFEILAAPILKS,0
4hts,A,47,69,22,PEVELITLSPTEPLFILIKISL,0
4hts,A,70,87,17,VGFIIASPVILYQFWRF,0
4hts,A,104,123,19,LGSILLFMLGALFAYFIVL,0
4hts,A,124,154,30,LALKFLLGLGFTQLLATPYLSVDMYISFVL,0
4hts,A,155,170,15,LVVAFGIAFEMPIVL,0
4hts,A,185,203,18,SFRKYFIVIAFVIGAIIA,0
4hts,A,204,206,2,DV,0
4hts,A,207,223,16,TQVLMAIPLLLLYEIS,0
2ls3,A,5,27,22,TVLHIIQVVISYFLMLIFMTYN,0
2ls3,A,28,29,1,K,0
1ba4,A,27,36,9,KGAIIGLMV,0
1ba4,A,37,40,3,GVV,0
2w1p,D,1,10,9,PDIENQAAD,0
2w1p,D,48,66,18,SGEFVGTFLFLWSAFVIA,0
2w1p,D,67,86,19,IANQAPETPDGGSNPAQLI,0
2w1p,D,87,104,17,ISFGFGFGVMVGVFITY,0
2w1p,D,108,121,13,GNLNPAVTLALVL,0
2w1p,D,131,151,20,LMAFTQIVAGMAAAGAASAM,0
2w1p,D,152,169,17,PGEIAFANALGGGASRT,0
2w1p,D,170,189,19,GLFLEAFGTAILCLTVLML,0
2w1p,D,200,216,16,PFVIGIALLIAHLICI,0
2w1p,D,217,219,2,YT,0
2w1p,D,220,234,14,AGLNPARSFGPAVA,0
2w1p,D,235,242,7,RSFPNYH,0
2w1p,D,243,260,17,IYWLGPILGAFLAYSIW,0
2w1p,D,274,279,5,QDSDA,0
4xp1,A,25,34,9,ERETWSGKV,0
4xp1,A,35,54,19,FLLSVIGFAVDLANVWRFP,0
4xp1,A,64,82,18,FLVPYGIMLAVGGIPLFY,0
4xp1,A,83,112,29,ELALGQHNRKGAITCWGRLVPLFKGIGYA,0
4xp1,A,113,133,20,VLIAFYVDFYYNVIIAWSLR,0
4xp1,A,236,255,19,WDMALCLLIVYLICYFSLW,0
4xp1,A,256,260,4,GIST,0
4xp1,A,261,280,19,GKVVWFTALFPYAVLLILL,0
4xp1,A,305,328,23,KAEVWVDAATQVFFSLGPGFGVL,0
4xp1,A,329,344,15,AYASYNKYHNNVYKD,0
4xp1,A,345,361,16,LLTSFINSATSFIAGF,0
4xp1,A,409,429,20,FFMMLATLGLDSSFGGSEAI,0
4xp1,A,430,448,18,TALSDEFPKIKRNRELFV,0
4xp1,A,449,464,15,GLFSLYFVVGLASCT,0
4xp1,A,468,489,21,YFFHLLDRYAAGYSILVAVFF,0
4xp1,A,490,516,26,AIAVSWIYGTNRFSEDIRDMIGFPPG,0
4xp1,A,517,524,7,YWQVCWR,0
4xp1,A,526,545,19,APIFLLFITVYGLIGYEPL,0
4xp1,A,555,570,15,ANALGWCIAGSSVVM,0
4xp1,A,571,600,29,PAVAIFKLLSTPGSLRQRFTILTTPWRDQ,0
5iof,A,29,49,20,VVALALIPEAIAFSIIAGVD,0
5iof,A,51,68,17,VGLYASFIIALITAFLG,0
5iof,A,75,89,14,AATGAMALLMTGLV,0
5iof,A,90,94,4,DHGI,0
5iof,A,95,114,19,YLFAATVLTGVLQVVFGWA,0
5iof,A,117,122,5,RYLKF,0
5iof,A,128,147,19,VGFVNALAILIFMAQLPQF,0
5iof,A,148,152,4,GANW,0
5iof,A,153,169,16,MYAMVAAGLAIIYLLP,0
5iof,A,176,192,16,SALVAIVVLTVVAVVT,0
5iof,A,193,223,30,ADVKTVGDMGTLPTALPHFQFPQVPLTFET,0
5iof,A,224,242,18,AIIFPVALTLSLVGLLES,0
5iof,A,264,276,12,GQGVANIVTGFF,0
5iof,A,278,287,9,MAGCAMIGQ,0
5iof,A,301,320,19,TFVAGAFLMVLILALQPLL,0
5iof,A,322,341,19,IPMAALVAVMMVVAISTFD,0
5iof,A,358,370,12,MLATVAVTVFTH,0
5iof,A,372,385,13,SLGVLIGVVLSAL,0
1e0p,C,5,11,6,GRPEWI,0
1e0p,C,12,33,21,LALGTALMGLGTLYFLVKGMG,0
1e0p,C,41,62,21,FYAITTLVPAIAFTMYLSMLL,0
1e0p,C,63,79,16,YGLTMVPFGGEQNPIY,0
1e0p,C,80,100,20,ARYADWLFTTPLLLLDLALL,0
1e0p,C,106,127,21,TILALVGADGIMIGTGLVGAL,0
1e0p,C,128,133,5,KVYSY,0
1e0p,C,134,157,23,FVWWAISTAAMLYILYVLFFGFT,0
1e0p,C,171,192,21,KVLRNVTVVLWSAYPVVWLIG,0
1e0p,C,193,203,10,EGAGIVPLNI,0
1e0p,C,204,226,22,TLLFMVLDVSAKVGFGLILLRS,0
3fye,B,26,29,3,QQS,0
3fye,B,30,60,30,EIIGRPQPGGTGFQPSASPVATQIHWLDGF,0
3fye,B,61,80,19,LVIIAAITIFVTLLILYAV,0
3fye,B,99,117,18,LEIAWTIVPIVILVAIGA,0
3fye,B,118,285,167,SLPVLFNQQEIPEADVTVKVTGYQWYWGYEYPDEEISFESYMIGSPATGGDNRMSPEVEQQLIEAGYSRDEFLLATDTAMVVPVNKTVVVQVTGADVIHSWTVPAFGVKQDAVPGRLAQLWFRAEREGIFFGQCSELCGISHAYMPITVKVVSEEAYAAWLEQHHHH,0
3fye,B,286,287,1,H,0
3c02,D,1,7,6,HMLFYK,0
3c02,D,14,31,17,GEFLGTFVLMFLGEGAT,0
3c02,D,32,44,12,NFHTTGLSGDWY,0
3c02,D,45,62,17,LCLGWGLAVFFGILVSA,0
3c02,D,68,79,11,LNLAVSIGLSS,0
3c02,D,88,106,18,PVYFFAQLLGAFVGTSTV,0
3c02,D,107,137,30,GLYHGFISNSKIPQFAWETSRNPSISLTGA,0
3c02,D,138,155,17,FNELILTGILLLVILVV,0
3c02,D,168,185,17,LSSVVGLIILCIGITFG,0
3c02,D,186,189,3,NTG,0
3c02,D,190,203,13,ALNPSRDLGSRFL,0
3c02,D,204,220,16,LIAYGKDTFTKDNFYF,0
3c02,D,221,238,17,VPLVAPCVGSVVFCQFY,0
3c02,D,250,258,8,NEKDGVDL,0
4xpg,A,25,34,9,ERETWSGKV,0
4xpg,A,35,54,19,FLLSVIGFAVDLANVWRFP,0
4xpg,A,64,82,18,FLVPYGIMLAVGGIPLFY,0
4xpg,A,83,112,29,ELALGQHNRKGAITCWGRLVPLFKGIGYA,0
4xpg,A,113,133,20,VLIAFYVGFYYNVIIAWSLR,0
4xpg,A,238,255,17,MALCLLIVYLICYFSLW,0
4xpg,A,256,260,4,GIST,0
4xpg,A,261,280,19,GKVVWFTALFPYAALLILL,0
4xpg,A,305,328,23,KAEVWADAATQVFFSLGPGFGVL,0
4xpg,A,329,344,15,AYASYNKYHNNVYKD,0
4xpg,A,345,360,15,LLTSFINSATSFIAG,0
4xpg,A,410,429,19,FMMLATLGLDSSFGGMEAI,0
4xpg,A,430,448,18,TALSDEFPKIKRNRELFV,0
4xpg,A,449,464,15,GLFSLYFVVGLASCT,0
4xpg,A,468,491,23,YFFHLLDRYAAGYSILVAVFFEA,0
4xpg,A,492,521,29,AVSWIYGTNRFSEDIRDMIGFPPGRYWQV,0
4xpg,A,522,545,23,WRFVAPIFLLFITVYLLIGYEPL,0
4xpg,A,555,571,16,ANALGWCIAGSSVVMI,0
4xpg,A,572,600,28,AVAIFKLLSTPGSLRQRFTILTTPWRDQ,0
3du2,H,1,10,9,VGVTAFGNF,0
3du2,H,16,32,16,IYSFWIFLAGLIYYLQ,0
3du2,H,33,250,217,ENMREGYPLENEDGTPAANQGPFPLPKPKTFILPHGRGTLTVPGPESEDRPIALARTAVSEGFPHAPTGDPMKDGVGPASWVARRDLPELDGHGHNKIKPMKAAAGFHVSAGKNPIGLPVRGCDLEIAGKVVDIWVDIPEQMARFLEVELKDGSTRLLPMQMVKVQSNRVHVNALSSDLFAGIPTIKSPTEVTLLEEDKICGYVAGGLMYAAPKRKS,0
3du2,H,251,260,9,VAAMLAEYA,0
1btt,A,3,21,18,SELLISTAVQGILFALLG,0
2r9h,B,18,36,18,RQLIRQLLERDKTPLAIL,0
2r9h,B,37,61,24,MAAVVGTLVGLAAVAFDKGVAWLQ,0
2r9h,B,81,97,16,AFLCSAVLAMFGYFLV,0
2r9h,B,98,127,29,KYAPEAGGSGIPEIEGALEDQRPVRWWRV,0
2r9h,B,128,142,14,PVKFFGGLGTLGGG,0
2r9h,B,144,159,15,LGREGPTVQIGGNIG,0
2r9h,B,160,179,19,MVLDIFRLKGDEARHTLLA,0
2r9h,B,180,204,24,GAAAGLAAAFNAPLAGILFIIEEM,0
2r9h,B,205,215,10,PCFRYTLISI,0
2r9h,B,216,232,16,AVFIGVIMSTIMYRIF,0
2r9h,B,253,277,24,LYLILGIIFGIFGPIFNKWVLGMQ,0
2r9h,B,278,284,6,LLHRVH,0
2r9h,B,285,289,4,GNIT,0
2r9h,B,290,305,15,WVLMGGAIGGLCGLL,0
2r9h,B,337,351,14,VARVITTLLCFSSG,0
2r9h,B,353,368,15,GGIFAPMLALGTVLG,0
2r9h,B,392,415,23,GMGALLAASIRAPLTGIILVLEM,0
2r9h,B,422,439,17,LPMIITGLGATLLAQFT,0
2r9h,B,440,458,18,GKPLYSAILARTLAKQEA,0
2r9h,B,459,460,1,Q,0
5l24,B,5,20,15,SLLGMAVLIAIAVLL,0
5l24,B,21,30,9,TDRKAINIR,0
5l24,B,31,46,15,VAGAFLIQVALGALV,0
5l24,B,50,77,27,QGRDMLGEASKTISNVIAYGNNGVDFL,0
5l24,B,103,132,29,MIVFFSSLMAVLYYIGVMQLLIKVIGGFL,0
5l24,B,133,143,10,KMLGTSKAES,0
5l24,B,144,159,15,SAAALIFVGQTEAPL,0
5l24,B,160,175,15,VRPYIRRMTESELFA,0
5l24,B,176,191,15,MSGGLASVAGSVLAG,0
5l24,B,203,220,17,AASFMAAPGGLLFAKLL,0
5l24,B,221,228,7,PETERTQ,0
5l24,B,242,274,32,TNVIDAAASGAVTGAQIAIAVGASLLAFVALI,0
5l24,B,275,287,12,MINGIIGGVGGW,0
5l24,B,295,302,7,QAILGWL,0
5l24,B,304,309,5,PLAWV,0
5l24,B,362,375,13,LCGFANLGSIAVL,0
5l24,B,376,394,18,GGLSIMAPKRRKDVARLG,0
5l24,B,395,412,17,KAVVAGSLSNLMSAVIA,0
2wse,4,-50,29,79,ATVTTQASAAIFGPCGLKSRFLGGSSGKLNRGVAFRPVGCSPSASFKVEAKKGEWLPGLASPGYLTGSLPGDNGFDPLG,0
2wse,4,46,59,13,NGRWAMLGVAGML,0
2wse,4,60,90,30,PEVFTSIGIINVPKWYAAGKEEYFASSSTL,0
2wse,4,91,103,12,VIEFILSHYVEI,0
2wse,4,155,170,15,NGRLMLAFLGFIIQH,0
2wse,4,171,195,24,VTGKGPFDNLLQHISDPWHNTIVQ,0
2wse,4,196,200,4,LGGN,0
4q9k,A,43,69,26,WLDRLYMLVGTLAAIIHGVALPLMML,0
4q9k,A,70,114,44,FGDMTDSFASVGQVSKQSTQMSEADKRAMFAKLEEEMTTYAYYY,0
4q9k,A,115,138,23,GIGAGVLIVAYIQVSFWCLAAGR,0
4q9k,A,181,204,23,IGDKIGMFFQAMATFFGGFIIGF,0
4q9k,A,205,210,5,RGWKL,0
4q9k,A,211,232,21,LVILAISPVLGLSAGIWAKIL,0
4q9k,A,286,310,24,KAITANISMGAAFLLIYASYALAF,0
4q9k,A,311,328,17,YGTSLVISKEYSIGQVL,0
4q9k,A,329,352,23,VFFSVLIGAFSVGQASPNIEAFA,0
4q9k,A,695,700,5,ILKLN,0
4q9k,A,704,728,24,PYFVVGIFCAIINGGLQPAFSVIF,0
4q9k,A,729,753,24,KVVGVFTNGGPPETQRQNSNLFSL,0
4q9k,A,754,776,22,FLILGIISFITFFLQGFTFGKA,0
4q9k,A,826,848,22,SRLAVIFQNIANLGTGIIISLI,0
4q9k,A,849,852,3,GWQ,0
4q9k,A,853,876,23,TLLLLAIVPIIAIAGVVEMKMLS,0
4q9k,A,928,952,24,KKAHVFGITFSFTQAMMYFSYAAC,0
4q9k,A,953,971,18,RFGAYLVTQQLMTFENVL,0
4q9k,A,972,991,19,VFSAIVFGAMAVGQVSSFA,0
4tpj,B,1,7,6,TLGTNQ,0
4tpj,B,15,35,20,TVSLIELWERFGYYGMQALI,0
4tpj,B,36,50,14,YFMVQRLGFDDSRA,0
4tpj,B,51,72,21,LVWSACAALIYVSPAIGGWVG,0
4tpj,B,75,97,22,LGTKRTMLLGAGILSVGYALMT,0
4tpj,B,98,105,7,PTENTWF,0
4tpj,B,106,126,20,FSALGVIVVGNGLFKPNAGN,0
4tpj,B,134,136,2,DD,0
4tpj,B,143,162,19,TIYYMAVNVGSTFSMLLTP,0
4tpj,B,163,180,17,IKDYVNAQYGNEFGWHA,0
4tpj,B,181,200,19,FAVCCVGILVGLGNYALMH,0
4tpj,B,215,261,46,NKKSLAIVLALAALSVVASAIILEYEDVARVFVYAAGVAVLGIFFH,0
4tpj,B,262,272,10,IRTSEPSERA,0
4tpj,B,277,299,22,LILTVQTVFFFIFYQQMSTSLA,0
4tpj,B,300,322,22,FALRNVDWDFQVFGTHLWTWSP,0
4tpj,B,323,342,19,QFQALNPIWIMVLSPVLAW,0
4tpj,B,343,355,12,YSWAGRNNKDFS,0
4tpj,B,357,376,19,AKFALGFAVVAIGFFIYGF,0
4tpj,B,377,388,11,GQFAVNGKTSS,0
4tpj,B,389,411,22,VMIWGYASYSLGELLVSGLGLA,0
4tpj,B,417,424,7,PARMGGF,0
4tpj,B,425,444,19,MGAYFVASGISQYLGGVVA,0
4tpj,B,445,465,20,FASVPQDLVDPLQTLPVYTN,0
4tpj,B,466,485,19,FNKLGVAAVVCTIIALAVL,0
4tpj,B,493,523,30,SHHAHSSIENNAAASLRDVKAEQAENLYFQ,0
4csk,D,3,13,10,EFKKKLFWRA,0
4csk,D,14,32,18,VAEFLATTLFVFISIGSA,0
4csk,D,50,68,18,KVSLAFGLSIATLAQSVG,0
4csk,D,69,71,2,IS,0
4csk,D,72,85,13,AHLNPAVTLGLLL,0
4csk,D,86,92,6,CQISIF,0
4csk,D,93,112,19,ALMYIIAQCVGAIVATAIL,0
4csk,D,138,156,18,LGIEIIGTLQLVLCVLAT,0
4csk,D,157,166,9,DRRRRDLGG,0
4csk,D,167,184,17,APLAIGLSVALGHLLAI,0
4csk,D,189,202,13,GINPARSFGSAVI,0
4csk,D,210,227,17,IFWVGPFIGGALAVLIY,0
4csk,D,228,235,7,FILAPRS,0
5l2b,C,7,22,15,LGMAVLIAIAVLLST,0
5l2b,C,23,27,4,RKAI,0
5l2b,C,28,42,14,IRTVAGAFLIQVAL,0
5l2b,C,52,67,15,RDMLGEASKTISNVI,0
5l2b,C,70,77,7,NNGVDFL,0
5l2b,C,103,135,32,MIVFFSSLMAVLYYIGVMQLLIKVIGGFLQKM,0
5l2b,C,137,152,15,TSKAESMSAAASIFV,0
5l2b,C,154,165,11,TEAPLVVRPYI,0
5l2b,C,166,171,5,RMTES,0
5l2b,C,172,184,12,LFAVMSGGLASV,0
5l2b,C,207,222,15,MAAPGGLLFAKLLVP,0
5l2b,C,223,228,5,TERTQ,0
5l2b,C,240,242,2,KP,0
5l2b,C,243,274,31,NVIDAAASGAVTGAQIAIAVGASLLAFVALI,0
5l2b,C,275,287,12,MINGIIGGVGGW,0
5l2b,C,295,310,15,QAILGWLFSPLAWVI,0
5l2b,C,366,384,18,ANLGSIAVLVGGLSIMAP,0
5l2b,C,385,386,1,R,0
5l2b,C,387,408,21,KDVARLGIKAVVAGSLSNLMS,0
5kbt,D,522,543,21,YEIWMCIVFAYIGVSVVLFLV,0
5kbt,D,545,567,22,FSPYEWHTEEFEDGRETQSSES,0
5kbt,D,568,576,8,NEFGIFNS,0
5kbt,D,577,586,9,WFSLGAFMQ,0
5kbt,D,587,592,5,GCDIS,0
5kbt,D,593,595,2,RS,0
5kbt,D,596,617,21,SGRIVGGVWWFFTLIIISSYT,0
5kbt,D,792,812,20,AGVFYILVGGLGLAMLVALI,0
5kbt,D,813,817,4,FCYK,0
5kbt,D,818,1043,225,RAEAKRMKGTGLFDRGVQMLLTTVGAFAAFSLMTIAVGTDYWLYSRGVCKTKSVSEDETSKKNEEVMTHSGLWRTCCLEGNFKGLCKQIDHFPEDADYEADTAEYFLRAVRASSIFPILSVILLFMGGLCIAASEFYKTRHNIILSAGIFFVSAGLSNIIGIIVYISANAGDPSKSDSKKNSYSYGWSFYFGALSFIIAEMVGVLAVHMFIDRHKQLTGGLVPRG,0
2ws3,L,1,10,9,VSNASALGR,0
2ws3,L,11,14,3,GVH,0
2ws3,L,15,35,20,FILVRATAIVLTLYIIYMVG,0
2ws3,L,59,80,21,FTLLALFSILIHAWIGMWQVL,0
2ws3,L,81,88,7,DFVKPLA,0
2ws3,L,89,109,20,RLMLQLVIVVALVVYVIYGF,0
2bhw,C,1,9,8,KSATTKKV,0
2bhw,C,10,63,53,SSGSPWYGPDRVKYLGPFSGESPSYLTGEFPGDYGWDTAGLSADPETFSKNRE,0
2bhw,C,64,82,18,EVIHSRWAMLGALGSVFP,0
2bhw,C,125,142,17,AIWATQVILMGAVEGYR,0
2bhw,C,143,179,36,AGGPLGEVVDPLYPGGSFDPLGLADDPEAFAELKVK,0
2bhw,C,180,199,19,LKNGRLAMFSMFGFFVQAI,0
2bhw,C,207,214,7,NLADHLA,0
5lev,A,8,11,3,MPL,0
5lev,A,12,25,13,INLIVSLLGFVAT,0
5lev,A,60,76,16,ISGAVFLIILFCFIPF,0
5lev,A,77,79,2,FL,0
5lev,A,91,98,7,HHEFVAL,0
5lev,A,99,112,13,GALLAICCMIFLG,0
5lev,A,124,138,14,KLLLPTAASLPLLM,0
5lev,A,139,151,12,YFTNFGNTTIVV,0
5lev,A,162,170,8,LDLGILYY,0
5lev,A,171,187,16,YMGLLAVFCTNAINIL,0
5lev,A,195,209,14,GQSLVISASIIVFN,0
5lev,A,210,224,14,VELEGDCRDDHVFS,0
5lev,A,225,237,12,YFMIPFFFTTLG,0
5lev,A,254,267,13,CYFAGMTFAGVGI,0
5lev,A,268,272,4,GHFS,0
5lev,A,273,291,18,TMLLFFMPQVFNFLYSLP,0
5lev,A,328,339,11,LGTFILKVAES,0
5lev,A,363,371,8,INLLLKVL,0
5lev,A,383,397,14,LLLQILGSAITFSI,0
5lev,A,398,403,5,YQLVR,0
3stz,F,23,25,2,LH,0
3stz,F,26,50,24,RAAGAATVLLVIVLLAGSYLAVLA,0
3stz,F,63,78,15,RALWWSVETATTVGY,0
3stz,F,87,111,24,GRLVAVVVMVAGITSFGLVTAALA,0
3stz,F,112,124,12,WFVGREQERRGH,0
4oj2,C,-2,4,6,HVMWEL,0
4oj2,C,5,10,5,SIAFS,0
4oj2,C,11,30,19,AVFAEFLATLLFVFFGLGS,0
4oj2,C,43,60,17,IAMAFGLGIGTLVQALG,0
4oj2,C,61,62,1,I,0
4oj2,C,63,78,15,GAHINPAVTVACLVG,0
4oj2,C,79,83,4,HVSV,0
4oj2,C,84,104,20,RAAFYVAAQLLGAVAGAALL,0
4oj2,C,129,149,20,AVTVELFLTLQLVLCIFAST,0
4oj2,C,150,158,8,ERRGENPG,0
4oj2,C,159,176,17,PALSIGFSVALGHLLGI,0
4oj2,C,181,193,12,SMNPARSLAPAV,0
4oj2,C,202,219,17,VFWIGPLVGAILGSLLY,0
4oj2,C,220,257,37,YVLFPPAKSLSERLAVLKGLEPDTDWEEREVRRRQAV,0
4oj2,C,258,271,13,LHSPQSLPRGTKA,0
2npk,C,1,2,1,P,0
2npk,C,15,33,18,CTALVLFMTIPGIALFYG,0
2npk,C,34,44,10,LIRGKNVLSM,0
2npk,C,45,64,19,TQVTVTFALVCILWVVYGY,0
2npk,C,102,120,18,FQGSFACITVGLIVGALA,0
2npk,C,121,125,4,RIRF,0
2npk,C,126,147,21,AVLIFVVVWLTLSYIPIAHMV,0
2npk,C,161,180,19,AGGTVVAINAAIAGLVGAY,0
2npk,C,181,186,5,IGKRV,0
2npk,C,187,192,5,FGKEA,0
2npk,C,193,199,6,KPHNLP,0
2npk,C,200,219,19,VFTGTAILYIGWFGFNAGS,0
2npk,C,231,251,20,VNTVVATAAAILGWIFGEWA,0
2npk,C,252,258,6,RGKPSL,0
2npk,C,259,276,17,GACSGAIAGLVGVTPAC,0
2npk,C,282,302,20,GALIIGVVAGLAGLWGVTML,0
2npk,C,303,306,3,RLL,0
2npk,C,307,308,1,V,0
2npk,C,309,312,3,DPC,0
2npk,C,313,332,19,VFGVAGVCGIVGCIMTGIF,0
2npk,C,353,381,28,VQLESIAITIVWSGVVAFIGYKLADLTV,0
2npk,C,382,386,4,LRVP,0
2npk,C,387,424,37,EQEREGLDVNSHGENAYNADQAQQPAQADLEHHHHHH,0
3ag3,Z,17,35,18,GLSVTFLSFLLPAGWVLY,0
3ag3,Z,36,43,7,LDNYKKS,0
3ag3,Z,44,46,2,AA,0
1kqf,I,2,12,10,KSKMIVRTKF,0
1kqf,I,13,33,20,DRACHWTVVICFFLVALSGI,0
1kqf,I,58,77,19,FFGIAIFVALMFMFVRFVH,0
1kqf,I,78,82,4,NIPD,0
1kqf,I,83,90,7,KDIPWLL,0
1kqf,I,91,111,20,IVEVLKGNEHKVADVGKYNA,0
1kqf,I,112,131,19,QKMMFWSIMSMIFVLLVTG,0
1kqf,I,155,175,20,AAAGIILIHAILIHMYMAFW,0
1kqf,I,176,178,2,KG,0
1kqf,I,179,184,5,IKGMI,0
1kqf,I,185,217,32,GKVSRRWAKKHHPRWYREIEKAEAKKESEEGI,0
5ebl,F,22,25,3,ALH,0
5ebl,F,26,50,24,RAAGAATVLLVIVLLAGSYLAVLA,0
5ebl,F,63,79,16,RALWWSVETATGVGYG,0
5ebl,F,87,113,26,GRLVAVVVMVAGITSFGLVTAALATW,0
5ebl,F,114,124,10,VGREQERRGH,0
5b1a,Z,17,37,20,GLSVTFLSFLLPAGWVLYHL,0
5b1a,Z,38,43,5,NYKKS,0
2bg9,E,226,243,17,APCVLISSLVVLVYFLP,0
2bg9,E,244,250,6,QAGGQK,0
2bg9,E,251,268,17,TLSISVLLAQTIFLFLI,0
2bg9,E,289,308,19,MFVSLVIVTNCVIVLNVSL,0
2bg9,E,309,448,139,TPNTHSCVEACNFIAKSTKEQNDSGSENENWVLIGKVIDK,0
2bg9,E,449,466,17,CFWIALLLFSLGTLAIF,0
3zrs,D,1,11,10,TGGMKPPARK,0
3zrs,D,12,26,14,RILNSDGSSNITRL,0
3zrs,D,27,32,5,LEKRG,0
3zrs,D,33,36,3,LDD,0
3zrs,D,37,43,6,YHDLLT,0
3zrs,D,44,46,2,SW,0
3zrs,D,47,68,21,VFITLITGLYLVTNALFALAY,0
3zrs,D,87,98,11,FFSVQTMATIG,0
3zrs,D,109,132,23,NTLVTLEALCGMLGLAVAARLIY,0
3zrs,D,133,277,144,RFTRPTAGVLFSSRMVISDFEGKPTLMMRLANLRIEQIIEADVHLVLVRSEISQEGMVFRRFHDLTLTRSRSPIFSLSWTVMHPIDHHSPIYGETDETLRNSHSEFLVLFTGHHEAFAQNVHARHAYSCDEIIWGGHFVDVFTT,0
3zrs,D,278,280,2,PD,0
3zrs,D,281,300,19,RRALDLGKFHEIAQHHHHH,0
2r6g,G,1,6,5,AMVQP,0
2r6g,G,7,14,7,SQKARLF,0
2r6g,G,15,32,17,THLLLLLFIAAIMFPLL,0
2r6g,G,57,62,5,HWKLA,0
2r6g,G,68,73,5,QADGR,0
2r6g,G,86,107,21,NSVKVAGISAIGIVALSTTCA,0
2r6g,G,108,116,8,AFARMRFP,0
2r6g,G,117,133,16,KATLLKGMLIFQMFPA,0
2r6g,G,136,150,14,LVALYALFDRLGEY,0
2r6g,G,160,178,18,GVIFAYLGGIALHVWTIK,0
2r6g,G,179,198,19,YFETIDSSLEEAAALDGAT,0
2r6g,G,199,205,6,WQAFRL,0
2r6g,G,206,213,7,LLPLSVP,0
2r6g,G,214,229,15,LAVVFILSFIAAITE,0
2r6g,G,269,285,16,SALPITIVFLLAQRWL,0
2r6g,G,286,296,10,NGLTAGGVKG,0
4v1f,I,17,39,22,GLIMGGGAIGAGIGDGIAGNAL,0
4v1f,I,40,54,14,SGIARQPEAQGRLF,0
4v1f,I,55,77,22,PFFITVGLVEAAYFINLAFMAL,0
2k9j,B,685,691,6,ESPKGP,0
2k9j,B,692,714,22,ILVVLLSVMGAILLIGLAALLI,0
5ko2,A,43,69,26,WLDRLYMLVGTLAAIIHGVALPLMML,0
5ko2,A,70,114,44,FGDMTDSFASVGNVSKNSTNMSEADKRAMFAKLEEEMTTYAYYY,0
5ko2,A,115,138,23,GIGAGVLIVAYIQVSFWCLAAGR,0
5ko2,A,181,204,23,IGDKIGMFFQAMATFFGGFIIGF,0
5ko2,A,205,210,5,RGWKL,0
5ko2,A,211,232,21,LVILAISPVLGLSAGIWAKIL,0
5ko2,A,288,310,22,ITANISMGAAFLLIYASYALAF,0
5ko2,A,311,329,18,YGTSLVISKEYSIGQVLT,0
5ko2,A,330,352,22,FFSVLIGAFSVGQASPNIEAFA,0
5ko2,A,693,698,5,WRILK,0
5ko2,A,704,728,24,PYFVVGIFCAIINGGLQPAFSVIF,0
5ko2,A,729,752,23,KVVGVFTNGGPPETQRQNSNLFS,0
5ko2,A,753,776,23,LFLILGIISFITFFLQGFTFGKA,0
5ko2,A,824,847,23,TGSRLAVIFQNIANLGTGIIISL,0
5ko2,A,848,854,6,YGWQLT,0
5ko2,A,855,878,23,LLLAIVPIIAIAGVVEMKMLSGQ,0
5ko2,A,927,952,25,MKKAHVFGITFSFTQAMMYFSYAAC,0
5ko2,A,953,972,19,RFGAYLVTQQLMTFENVLL,0
5ko2,A,973,995,22,FSAIVFGAMAVGQVSSFAPDYA,0
4fc4,E,1,2,1,F,0
4fc4,E,3,22,19,DTINKCAANAARIARLSAN,0
4fc4,E,23,25,2,PL,0
4fc4,E,26,50,24,FWVSSAMAGAYVGLGIILIFTLGN,0
4fc4,E,57,76,19,PLVMGATFGIALTLVIIAG,0
4fc4,E,78,88,10,LFTGHTMFLT,0
4fc4,E,89,101,12,GVKAGTISHGQM,0
4fc4,E,102,131,29,AILPQTWLGNLVGSVFVALLYSWGGGSLL,0
4fc4,E,142,174,32,LAKTTAPATVLFFKGALCNWLVCLAIWMAIRT,0
4fc4,E,176,194,18,TAKFLAIWWCLLAFIASG,0
4fc4,E,196,211,15,HSVANMTLFALSWFG,0
4fc4,E,219,245,26,AGIGHNLLWVTLGNTLSGVVFMGLGY,0
4fc4,E,246,250,4,YATP,0
4fc4,E,251,261,10,SELEHHHHHH,0
3mp7,B,0,6,6,AELQER,0
3mp7,B,7,28,21,RHFWKESRRAFLVTKKPNWA,0
3mp7,B,29,34,5,YKRAA,0
3mp7,B,35,55,20,ITGLGIILIGLIGMLIRIVG,0
5u1l,C,21,33,12,SSTNYGTIKWIF,0
5u1l,C,36,49,13,VFSYISFALISDK,0
5u1l,C,50,329,279,YQKKEPLISSVHTKVKGIAEVKAEILENGMKKMVSGVFDTADYTFPLQGNSFFVMTNFIKTEGQQQGLCPDFPTARTICSSDRGCKKGRMDPQSKGIQTGRCVVYKERLKTCEVSAWCPIEEVKDAPRPALLNSAENFTVLIKNNIDFPGHNYTTRNILPGVNITCTFHKTQNPQCPIFRLGDIFQETGDSFSDVAIQGGIMGIEIYWDCNLDGWFHHCRPKYSFRRLDDKTTSESLYPGYNFRYAKYYKENNVEKRTLIKVFGIRFDILVFGTGGKFN,0
5u1l,C,330,344,14,IQLAVYIGSVISYF,0
5u1l,C,351,362,11,DILINTYSASS,0
1waz,A,27,40,13,VILLGVVGLSALT,0
1waz,A,41,48,7,YLDYVLL,0
1waz,A,49,64,15,ALAIFIGLTIYAIQR,0
2m59,B,101,106,5,KTNLE,0
2m59,B,107,129,22,IILVGTAVIAMFFWLLLVIILR,0
1f88,C,1,36,35,NGTEGPNFYVPFSNKTGVVRSPFEAPQYYLAEPWQ,0
1f88,C,37,64,27,SMLAAYMFLLIMLGFPINFLTLYVTVQ,0
1f88,C,73,99,26,YILLNLAVADLFMVFGGFTTTLYTSL,0
1f88,C,100,108,8,GYFVFGPT,0
1f88,C,109,133,24,CNLEGFFATLGGEIALWSLVVLAI,0
1f88,C,154,176,22,MGVAFTWVMALACAAPPLVGWS,0
1f88,C,177,198,21,YIPEGMQCSCGIDYYTPHEET,0
1f88,C,199,223,24,NESFVIYMFVVHFIIPLIVIFFCY,0
1f88,C,236,239,3,QQE,0
1f88,C,254,279,25,IIMVIAFLICWLPYAGVAFYIFTHQ,0
1f88,C,280,285,5,SDFGP,0
1f88,C,286,308,22,FMTIPAFFAKTSAVYNPVIYIM,0
1f88,C,311,321,10,QFRNCMVTTL,0
1f88,C,328,333,5,GDDEA,0
2maw,A,1,3,2,,0
2maw,A,8,30,22,YGLNLLIPCVLISALALLVFLL,0
2maw,A,31,35,4,ADSG,0
2maw,A,36,57,21,KISLGITVLLSLTVFMLLVAE,0
2maw,A,68,90,22,IAQYFASTMIIVGLSVVVTVIV,0
2maw,A,91,107,16,QYHHHDPDGGEGGGEG,0
2maw,A,108,130,22,DRLCLMAFSVFTIICTIGILMS,0
2m7g,A,4,27,23,ELLIVVAIIGILAAIAIPQFSAY,0
2m7g,A,28,61,33,VKAYNSAASSDLRNLKTALESAFADDQTYPPES,0
4yay,A,1002,31,-971,LEDNWETLNDNLKVIEKADNAAQVKDALTKMRAAALDAQKATPPKLEDKSPDSPEMKDFRHGFDILVGQIDDALKLANEGKVKEAQAAAEQLKTTRNAYIQKYLILNSSDCPKAGRHNYIFVMI,0
4yay,A,32,57,25,TLYSIIFVVGIFGNSLVVIVIYFYM,0
4yay,A,63,85,22,SVFLLNLALADLCFLLTLPLWA,0
4yay,A,86,102,16,YTAMEYRWPFGNYLCK,0
4yay,A,103,127,24,ASASVSFNLYASVFLLTCLSIDRY,0
4yay,A,144,165,21,AKVTCIIIWLLAGLASLPAII,0
4yay,A,166,172,6,RNVFFI,0
4yay,A,177,185,8,TVCAFHYE,0
4yay,A,190,193,3,LPI,0
4yay,A,194,220,26,LGLTKNILGFLFPFLIILTSYTLIWK,0
4yay,A,238,261,23,FKIIMAIVLFFFFSWIPHQIFTF,0
4yay,A,262,285,23,DVLIQLGIIRDCRIADIVDTAMP,0
4yay,A,286,307,21,TICIAYFNNCLNPLFYGFLGK,0
4yay,A,308,316,8,FKRYFLQL,0
3gjd,B,1,4,3,EVK,0
3gjd,B,13,32,19,LILAMAGNAVGLGNFLRFP,0
3gjd,B,33,43,10,QAAENGGGAF,0
3gjd,B,44,63,19,IPYIIAFLLVGIPLMWIEW,0
3gjd,B,90,124,34,KILGVFGLWIPLVVAIYYVYIESWTLGFAIKFLV,0
3gjd,B,125,132,7,LVPEPPP,0
3gjd,B,133,134,1,A,0
3gjd,B,135,166,31,DPDSILRPFKEFLYSYIGVPKGDEPILKPSL,0
3gjd,B,167,185,18,AYIVFLITMFINVSILIR,0
3gjd,B,191,212,21,ERFAKIAMPTLFILAVFLVIR,0
3gjd,B,213,222,9,FLLETPNGT,0
3gjd,B,223,230,7,ADGLNFL,0
3gjd,B,231,243,12,TPDFEKLKDPGV,0
3gjd,B,244,266,22,IAAVGQIFFTLSLGFGAIITYA,0
3gjd,B,277,297,20,SGLTAATLNEKAEVILGGSI,0
3gjd,B,298,325,27,IPAAVAFFGVANAVAIAKAGAFNLGFI,0
3gjd,B,326,332,6,LPAIFS,0
3gjd,B,333,339,6,TAGGTF,0
3gjd,B,340,367,27,GFLWFFLLFFAGLTSSIAIMQPMIAFL,0
3gjd,B,378,396,18,VLWTAAIVFFSAHLVMFL,0
3gjd,B,397,399,2,KS,0
3gjd,B,400,426,26,DEMDFWAGTIGVVFFGLTELIIFFWI,0
3gjd,B,429,437,8,DKAWEEIN,0
3gjd,B,445,469,24,RIYYYVMRYITPAFLAVLLVVWAR,0
3gjd,B,470,471,1,Y,0
3gjd,B,472,477,5,PKIME,0
3gjd,B,478,483,5,THWTV,0
3gjd,B,484,502,18,ITRFYIIGLFLFLTFLVF,0
4bw5,B,66,72,6,GLQTVM,0
4bw5,B,73,77,4,WKTV,0
4bw5,B,78,98,20,AIFVVVVVYLVTGGLVFRAL,0
4bw5,B,149,154,5,SSNNS,0
4bw5,B,160,176,16,SAFFFAGTVITTIGYG,0
4bw5,B,185,208,23,KIFCILYAIFGIPLFGFLLAGIG,0
4bw5,B,209,228,19,QLGTIFGKSIARVEKVFRK,0
4bw5,B,229,242,13,QVSQTKIRVISTI,0
4bw5,B,243,263,20,FILAGCIVFVTIPAVIFKYI,0
4bw5,B,269,285,16,ESIYFVVVTLTTVGFG,0
4bw5,B,299,324,25,WYKPLVWFWILVGLAYFAAVLSMIG,0
4bw5,B,325,331,6,WLRVLS,0
4bw5,B,333,347,14,TKEEVGEAENLYFQ,0
5avz,G,4,24,20,GPDNDERFTYDYYRLRVVGL,0
5avz,G,25,40,15,VAAVLCVIGIIILLA,0
4uu0,A,49,54,5,WELVI,0
4uu0,A,55,74,19,QFEDLLVRILLLAACISFV,0
4uu0,A,75,89,14,AWFEEGEETITAFV,0
4uu0,A,90,107,17,PFVILLILIANAIVGVW,0
4uu0,A,257,276,19,EQLSKVISLICVAVWLINI,0
4uu0,A,277,295,18,HFNDPVHGGSWIRGAIYY,0
4uu0,A,296,317,21,KIAVALAVAAIPEGLPAVITT,0
4uu0,A,760,781,21,IRYLISSNVGEVVCIFLTAAL,0
4uu0,A,782,785,3,LPE,0
4uu0,A,786,807,21,LIPVQLLWVNLVTDGLPATAL,0
4uu0,A,834,851,17,FRYMAIGGYVGAATVGA,0
4uu0,A,852,898,46,AWWFMYAEDGPGVTYHQLTHFMQCTEDHPHFEGLDCEIFEAPEPMT,0
4uu0,A,899,916,17,ALSVLVTIEMCNALNSL,0
4uu0,A,927,947,20,WVNIWLLGSICLSMSLHFLI,0
4uu0,A,948,950,2,YV,0
4uu0,A,951,957,6,PLPMIF,0
4uu0,A,958,967,9,LKALDLTQW,0
4uu0,A,968,987,19,MVLKISLPVIGLDEILKFI,0
1f4z,C,5,10,5,GRPEW,0
1f4z,C,11,32,21,WLALGTALMGLGTLYFLVKGM,0
1f4z,C,41,62,21,FYAITTLVPAIAFTMYLSMLL,0
1f4z,C,63,79,16,YGLTMVPFGGEQNPIY,0
1f4z,C,80,99,19,ARYADWLFTTPLLLLDLAL,0
1f4z,C,106,127,21,TILALVGADGIMIGTGLVGAL,0
1f4z,C,128,133,5,KVYSY,0
1f4z,C,134,156,22,FVWWAISTAAMLYILYVLFFGF,0
1f4z,C,157,161,4,SKAE,0
1f4z,C,172,192,20,VLRNVTVVLWSAYPVVWLIG,0
1f4z,C,193,203,10,EGAGIVPLNI,0
1f4z,C,204,225,21,TLLFMVLDVSAKVGFGLILLR,0
5m87,A,31,37,6,WKTLLA,0
5m87,A,41,55,14,GALVAVGYMDPGNW,0
5m87,A,56,69,13,TSITGGQNFQYLL,0
5m87,A,70,85,15,SIIVISSLLAMLLQN,0
5m87,A,98,105,7,AQAIRAR,0
5m87,A,113,137,24,FWILTELAIMATDIAEVIGAAIAL,0
5m87,A,138,146,8,LLFKIPIF,0
5m87,A,147,162,15,AVVITVLDVFLLLLL,0
5m87,A,170,187,17,EALVVCLIFVILFVFLY,0
5m87,A,188,195,7,IILSQPA,0
5m87,A,196,202,6,HQVAKG,0
5m87,A,203,222,19,IPSWASVQTSPKIGGQTPL,0
5m87,A,223,241,18,ASLGIIGATIMPHNLFLH,0
5m87,A,268,284,16,SNIQLSLAMVVNALLL,0
5m87,A,285,331,46,MGVAVFKSGAVQDPSFFGLYQALSNPDMVSNPVLAEAARSGVLSTL,0
5m87,A,332,351,19,AVALLASGQNSTITGTITG,0
5m87,A,366,382,16,LRRLVTRLIAIIPVVV,0
5m87,A,383,402,19,VAITSHQGSLDEHQALNNL,0
5m87,A,403,419,16,NNSQVFLALALPFSIV,0
5m87,A,444,465,21,GWLTVIILTLLNLISISSQIA,0
5m87,A,466,479,13,FFGDNPSSQDLLL,0
5m87,A,480,497,17,QVISIGIILAMIGLLIW,0
5ax0,A,13,35,22,DAQWVVFAVMALAAIVFSIAVQ,0
5ax0,A,36,42,6,RPLPLR,0
5ax0,A,43,66,23,TYYVNIAICTIAATAYYAMAVNG,0
5ax0,A,83,103,20,YARYIDWVFTTPLLLLDLVL,0
5ax0,A,104,109,5,TNMPA,0
5ax0,A,110,132,22,MIAWIMGADIAMIAFGIIGAFT,0
5ax0,A,137,159,22,WFYFVVGCIMLAVLAWGMINPI,0
5ax0,A,160,173,13,KEELQKHKEYTGA,0
5ax0,A,174,197,23,TTLLIYLIVLWVIYPIVWGLGAG,0
5ax0,A,205,228,23,EIIAMGILDLLAKPLYAIGVLIT,0
5ax0,A,229,235,6,EVVYGK,0
1a11,A,1,4,3,SEK,0
1a11,A,5,22,17,STAISVLLAQAVFLLLT,0
4ksb,A,1,32,31,ELEEDLKGRADKNFSKMGKKSKKEKKEKKPA,0
4ksb,A,44,68,24,LDRLYMLVGTLAAIIHGVALPLMM,0
4ksb,A,69,117,48,IFGDMTDSFASVGNVSKNSTNMSEADKRAMFAKLEEEMTTYAYYYTGI,0
4ksb,A,118,136,18,AGVLIVAYIQVSFWCLAA,0
4ksb,A,183,204,21,DKIGMFFQAMATFFGGFIIGF,0
4ksb,A,205,208,3,RGW,0
4ksb,A,209,228,19,LTLVILAISPVLGLSAGIW,0
4ksb,A,292,312,20,ISMGAAFLLIYASYALAFWY,0
4ksb,A,313,329,16,TSLVISKEYSIGQVLT,0
4ksb,A,330,348,18,FFSVLIGAFSVGQASPNI,0
4ksb,A,627,683,56,GNEIELGNEACKSKDEIDNLDMSSKDSGSSLIRRRSTRKSICGPHDQDRKLSTKEA,0
4ksb,A,695,703,8,ILKLNSTE,0
4ksb,A,708,729,21,VGIFCAIINGGLQPAFSVIFS,0
4ksb,A,730,751,21,VVGVFTNGGPPETQRQNSNLF,0
4ksb,A,752,772,20,LLFLILGIISFITFFLQGFT,0
4ksb,A,828,847,19,LAVIFQNIANLGTGIIISL,0
4ksb,A,848,854,6,YGWQLT,0
4ksb,A,855,875,20,LLLAIVPIIAIAGVVEMKML,0
4ksb,A,929,952,23,KAHVFGITFSFTQAMMYFSYAAC,0
4ksb,A,953,971,18,RFGAYLVTQQLMTFENVL,0
4ksb,A,972,991,19,VFSAIVFGAMAVGQVSSFA,0
4ksb,A,1272,1284,12,AKRSLEHHHHHH,0
5m8a,A,31,37,6,WKTLLA,0
5m8a,A,41,58,17,GALVAVGYMDPGNWSTS,0
5m8a,A,59,67,8,TGGQNFQY,0
5m8a,A,68,85,17,LLSIIVISSLLAMLLQN,0
5m8a,A,98,104,6,AQAIRA,0
5m8a,A,113,137,24,FWILTELAIMATDIAAVIGAAIAL,0
5m8a,A,138,146,8,LLFKIPIF,0
5m8a,A,147,163,16,AVVITVLDVFLLLLLN,0
5m8a,A,170,190,20,EALVVCLIFVILFVFLYQII,0
5m8a,A,191,195,4,SQPA,0
5m8a,A,196,202,6,HQVAKG,0
5m8a,A,203,222,19,IPSWASVQTSPKIGGQTPL,0
5m8a,A,223,241,18,ASLGIIGATIMPHNLFLH,0
5m8a,A,269,285,16,NIQLSLAMVVNALLLI,0
5m8a,A,286,300,14,GVAVFKSGAVQDPS,0
5m8a,A,301,308,7,FGLYQAL,0
5m8a,A,309,331,22,NPDMVSNPVLAEAARSGVLSTL,0
5m8a,A,332,351,19,AVALLASGQNSTITGTITG,0
5m8a,A,366,382,16,LRRLVTRLIAIIPVVV,0
5m8a,A,383,402,19,VAITSHQGSLDEHQALNNL,0
5m8a,A,403,419,16,NNSQVFLALALPFSIV,0
5m8a,A,444,465,21,GWLTVIILTLLNLISISSQIA,0
5m8a,A,466,479,13,FFGDNPSSQDLLL,0
5m8a,A,480,497,17,QVISIGIILAMIGLLIW,0
3w4t,A,1,3,2,SE,0
3w4t,A,7,13,6,GVQLLR,0
3w4t,A,24,44,20,IAMMIGMSVQTLYNLADGIW,0
3w4t,A,45,59,14,SGLGPESLAAVGLF,0
3w4t,A,60,78,18,PVFMGIIALAAGLGVGTS,0
3w4t,A,101,119,18,ILSLILGVTITITMLPAI,0
3w4t,A,120,138,18,SLFRSMGAKGEAVELAIE,0
3w4t,A,139,161,22,ARVLLAGAFIIVFNNVGNGILR,0
3w4t,A,167,188,21,RAMLAMVLGSGLNIVLDPIFI,0
3w4t,A,189,196,7,TLGFGVV,0
3w4t,A,197,215,18,AAYATLLSMVVTSLFIAY,0
3w4t,A,243,263,20,RVGLPSSLSQLSMSIAMFFL,0
3w4t,A,264,280,16,SVAITAGGENGVAVFT,0
3w4t,A,281,301,20,AWRITMLGIVPILGMAAATT,0
3w4t,A,324,346,22,KIAFMIELAVVAFIMLFAPQVA,0
3w4t,A,347,351,4,LFTY,0
3w4t,A,352,356,4,ESAQ,0
3w4t,A,357,365,8,IKGDLISA,0
3w4t,A,366,387,21,RTLPVFLVLTPFGMMTSAMFQ,0
3w4t,A,392,414,22,EKSLILTIFRTLVMQVGFAYIF,0
3w4t,A,415,424,9,HYTTLGLRG,0
3w4t,A,425,445,20,WIGIVIGNMVAAIVGFLWGR,0
3w4t,A,455,461,6,ATGGKR,0
4wav,A,12,16,4,VEGE,0
4wav,A,17,39,22,IWLALGTIGMLLGMLYFIADGL,0
4wav,A,48,69,21,FYVITILIPAIAAASYLSMFF,0
4wav,A,70,87,17,FGLTEVSLANGRVVDVY,0
4wav,A,88,108,20,ARYANWLFTTPLLLLDIGLL,0
4wav,A,112,134,22,QRDIGALVGIDAFMIVTGLVAT,0
4wav,A,135,143,8,TKVVVARY,0
4wav,A,144,165,21,FWTISTISMVFLLYYLVAVFG,0
4wav,A,180,200,20,ALRNIILVTWAIYPVAWLVG,0
4wav,A,201,210,9,EGLALTGLY,0
4wav,A,211,233,22,ETLLFMVLDLVAKVGFGFILLR,0
1mps,H,1,10,9,VGVTAFGNF,0
1mps,H,12,31,19,ASLAIYSFWIFLAGLIYYL,0
1mps,H,251,260,9,VAAMLAEYA,0
3rko,J,8,21,13,GLIAILATLRVIT,0
3rko,J,22,28,6,TNPVHA,0
3rko,J,29,42,13,LYLIISLLAISGV,0
3rko,J,52,67,15,ALEIIVYAGAIMVLF,0
3rko,J,68,93,25,FVVMMLNLGGSEIEQERQWLKPQVW,0
3rko,J,94,106,12,GPAILSAIMLVV,0
3rko,J,126,133,7,KAVGITL,0
3rko,J,142,155,13,LASMLLLAGLVVA,0
3rko,J,156,168,12,HVGREERAGEVL,0
3rko,J,169,184,15,NRKDDSAKRKTEEHA,0
2oau,G,-19,26,45,GSSHHHHHHSSGLVPRGSHMEDLNVVDSINGAGSWLVANQALLLS,0
2oau,G,27,30,3,AVN,0
2oau,G,31,52,21,VAALAIIIVGLIIARMISNAV,0
2oau,G,71,90,19,LVRYGIIAFTLIAALGRVG,0
2oau,G,92,104,12,TASVIAVLGAAG,0
2oau,G,105,127,22,AVGLALQGSLSNLAAGVLLVMF,0
2oau,G,281,286,5,EDKAA,0
2mxb,A,15,38,23,LILTLSLILVLISLLLTVLALLS,0
2mxb,A,39,49,10,RRTLQQKIWP,0
4bor,E,-16,0,16,VLTLLLIICLALEVRS,0
4bor,E,165,171,6,VVEWIH,0
4bor,E,221,243,22,IINIIAPCVLISSLVVLVYFLP,0
4bor,E,244,250,6,QAGGQK,0
4bor,E,251,273,22,TLSISVLLAQTIFLFLIAQKVP,0
4bor,E,284,308,24,YLIFVMFVSLVIVTNCVIVLNVSL,0
4bor,E,309,314,5,TPNTH,0
4bor,E,315,413,98,LSEKIKHLFLEFLPKYLGMHLEPSEETPEKPQPRRRSSFGIMIKAEEYILKKPRSELMFEEQKDRHGLKRVNKMTSDIDIGTTVDLYKDLANFAPEIK,0
4bor,E,414,448,34,CVEACNFIAKSTKEQNDSGSENENWVLIGKVIDK,0
4bor,E,449,473,24,CFWIALLLFSLGTLAIFLTGHLNQ,0
4bor,E,477,488,11,PFPGDPRKYVP,0
4umw,A,1,123,122,STPDNHGKKAPQFAAFKPLTTVQNANDCCCDGACSSSPTLSENVSGTRYSWKVSGMDCAACARKVENAVRQLAGVNQVQVLFATEKLVVDADNDIRAQVESAVQKAGYSLRDEQAADEPQAS,0
4umw,A,130,145,15,LITLIVMMAISWGLE,0
4umw,A,146,151,5,FNHPF,0
4umw,A,152,176,24,QLAFIATTLVGLYPIARQALRLIK,0
4umw,A,180,198,18,FAIETLMSVAAIGALFIG,0
4umw,A,200,213,13,AEAAMVLLLFLIG,0
4umw,A,224,227,3,RQG,0
4umw,A,351,366,15,RIYTPAIMAVALLVT,0
4umw,A,367,384,17,VPPLLFAASWQEWIYKG,0
4umw,A,385,399,14,TLLLIGCPCALVIS,0
4umw,A,685,701,16,ITIALGLKGIFLVTTL,0
4umw,A,702,705,3,GMT,0
4umw,A,706,724,18,LWLAVLADTGATVLVTAN,0
4umw,A,731,732,1,R,0
2dqs,A,54,73,19,QFEDLLVRILLLAACISFV,0
2dqs,A,74,89,15,AWFEEGEETITAFVE,0
2dqs,A,90,111,21,FVILLILIANAIVGVWQERNA,0
2dqs,A,254,276,22,FGEQLSKVISLICVAVWLINIG,0
2dqs,A,277,295,18,FNDPVHGGSWIRGAIYYF,0
2dqs,A,296,318,22,IAVALAVAAIPEGLPAVITTCL,0
2dqs,A,760,781,21,RYLISSNVGEVVCIFLTAALG,0
2dqs,A,782,785,3,PEA,0
2dqs,A,786,808,22,IPVQLLWVNLVTDGLPATALGF,0
2dqs,A,833,852,19,FRYMAIGGYVGAATVGAAA,0
2dqs,A,853,897,44,WFMYAEDGPGVTYHQLTHFMQCTEDHPHFEGLDCEIFEAPEPMT,0
2dqs,A,898,916,18,ALSVLVTIEMCNALNSLS,0
2dqs,A,927,948,21,VNIWLLGSICLSMSLHFLILY,0
2dqs,A,949,966,17,DPLPMIFKLKALDLTQW,0
2dqs,A,967,987,20,MVLKISLPVIGLDEILKFIA,0
5h2f,z,8,25,17,LAALVILSFVMVIGVPV,0
5h2f,z,26,39,13,YASPQDWDRSKQL,0
5h2f,z,40,54,14,FLGSGLWIALVLVV,0
5ctg,C,11,28,17,AGLAGNIFALALFLSPV,0
5ctg,C,29,45,16,TFKRILKAKSTERFDG,0
5ctg,C,46,63,17,PYLFSLLNCLICLWYGL,0
5ctg,C,71,92,21,LVATVNGIGAVFQLAYICLFI,0
5ctg,C,93,103,10,YADSRKTRMK,0
5ctg,C,104,122,18,IGLLVLVVCGFALVSHAS,0
5ctg,C,134,154,20,VGAVSMASLISMFASPLAVM,0
5ctg,C,155,166,11,VVIRSESVEFM,0
5ctg,C,167,186,19,FYLSLSTFLMSASFALYGL,0
5ctg,C,191,213,22,FIYFPNGLGLILGAMQLALYAY,0
5ctg,C,214,217,3,SSN,0
4gp5,C,1,3,2,EE,0
4gp5,C,10,27,17,VILVLTLTILVFWLGVY,0
4gp5,C,28,34,6,VFFARG,0
2vl1,A,254,263,9,TVHGVGAHA,0
2vl1,A,264,268,4,TTPW,0
2vl1,A,269,288,19,LRKDALLMSSKMIVAASEI,0
2vl1,A,299,318,19,IIDAKPYSVNIIPGEVSFT,0
2vl1,A,336,349,13,AAEFDRLIKINDG,0
2vl1,A,350,356,6,ALSYES,0
2hhk,H,1,10,9,VGVTAFGNF,0
2hhk,H,12,29,17,ASLAIYSFWIFLAGLIY,0
2hhk,H,252,260,8,AAMLAEYA,0
2fec,B,1,17,16,KTDTPSLETPQAARLR,0
2fec,B,37,61,24,MAAVVGTLVGLAAVAFDKGVAWLQ,0
2fec,B,62,80,18,QRMGALVHTADNYPLLLT,0
2fec,B,81,98,17,AFLCSAVLAMFGYFLVR,0
2fec,B,128,142,14,PVKFFGGLGTLGGG,0
2fec,B,144,159,15,LGREGPTVQIGGNIG,0
2fec,B,180,204,24,GAAAGLAAAFNAPLAGILFIIEQM,0
2fec,B,216,233,17,AVFIGVIMSTIMYRIFN,0
2fec,B,234,252,18,EVALIDVGKLSDAPLNTL,0
2fec,B,253,277,24,LYLILGIIFGIFGPIFNKWVLGMQ,0
2fec,B,278,284,6,LLHRVH,0
2fec,B,290,305,15,WVLMGGAIGGLCGLL,0
2fec,B,306,334,28,FVAPATSGGGFNLIPIATAGNFSMGMLV,0
2fec,B,335,351,16,IFVARVITTLLCFSSG,0
2fec,B,353,368,15,GGIFAPMLALGTVLG,0
2fec,B,369,390,21,AFGMVAVELFPQYHLEAGTFA,0
2fec,B,391,415,24,AGMGALLAASIRAPLTGIILVLEM,0
2fec,B,416,421,5,DNYQL,0
2fec,B,422,439,17,LPMIITGLGATLLAQFT,0
2fec,B,461,465,4,ARSK,0
2ff9,A,64,84,20,LALIVLLIVVGNVLVIVAIA,0
2ff9,A,85,93,8,TPRLQTLT,0
2ff9,A,94,116,22,LFIMSLASADLVMGLLVVPFGA,0
2ff9,A,133,154,21,WTSVDVLCVTASIETLCVIAL,0
2ff9,A,155,170,15,RYLAITLPFRYQSLL,0
2ff9,A,172,175,3,ARA,0
2ff9,A,176,196,20,ALVCTVWAISALVSFLPILM,0
2ff9,A,224,244,20,AIASSVVSFYVPLCIMAFVY,0
2ff9,A,245,282,37,RVFREAQKQVKKIDSCERRFLTGPPRPPSPAPSPSPG,0
2ff9,A,283,300,17,PRPADSLANGRSSKRRP,0
2ff9,A,301,302,1,R,0
2ff9,A,303,313,10,VALREQKALK,0
2ff9,A,314,333,19,LGIIMGVFTLCWLPFFLAN,0
2ff9,A,351,368,17,NWLGYANSAFNPIIYCR,0
2ff9,A,370,380,10,DFRKAFQRLL,0
2ff9,A,381,384,3,CAR,0
5a6g,B,253,267,14,ICTLLCLVFTGTCG,0
5a6g,B,268,283,15,QHLERAGEKLSLFKS,0
5a6g,B,284,295,11,YFCIVTFSTVG,0
5a6g,B,296,307,11,GDVTPKIWPSQ,0
5a6g,B,308,322,14,LVVIMICVALVVLP,0
4kjw,B,16,17,1,R,0
4kjw,B,37,61,24,MAAVVGTLVGLAAVAFDKGVAWLQ,0
4kjw,B,62,83,21,QRMGALVHTADNYPLLLTVAF,0
4kjw,B,84,97,13,CSAVLAMFGYFLV,0
4kjw,B,129,142,13,VKFFGGLGTLGGG,0
4kjw,B,144,156,12,LGREGPTVQIGG,0
4kjw,B,180,204,24,GAAAGLAAAFNAPLAGILFIIEEM,0
4kjw,B,216,232,16,AVFIGVIMSTIMYRIF,0
4kjw,B,233,252,19,HEVALIDVGKLSDAPLNTL,0
4kjw,B,253,277,24,LYLILGIIFGIFGPIFNKWVLGMQ,0
4kjw,B,290,305,15,WVLMGGAIGGLCGLL,0
4kjw,B,306,337,31,FVAPATSGGGFNLIPIATAGNFSMGMLVFIF,0
4kjw,B,338,351,13,ARVITTLLCFSSG,0
4kjw,B,353,368,15,GGIFAPMLALGTVLG,0
4kjw,B,369,392,23,AFGMVAVELFPQYHLEAGTFAIA,0
4kjw,B,393,415,22,MGALLAASIRAPLTGIILVLEM,0
4kjw,B,416,422,6,DNYQLI,0
4kjw,B,423,439,16,PMIITGLGATLLAQFT,0
4kjw,B,459,461,2,QK,0
4ntb,C,0,7,7,HKDEVAL,0
4ntb,C,8,27,19,ATVTLVGVLLQAYFSLQVI,0
4ntb,C,52,71,19,QVNCSEYFPLFLATLWVAG,0
4ntb,C,72,78,6,FFHEGA,0
4ntb,C,79,97,18,ALCGLFYLFARLRYFQGY,0
4ntb,C,104,124,20,LTPLYASARALWLLVAMAAL,0
4ntb,C,125,141,16,LLVHFLPGTLRTALFR,0
4ntb,C,142,145,3,LQM,0
1c0v,A,1,7,6,ENLNMD,0
1c0v,A,8,33,25,LYMAAAVMMGLAAIGAAIGIGILGG,0
1c0v,A,54,77,23,IVMGLVDAIPMIAVGLGLYVMFA,0
1c0v,A,78,79,1,A,0
3b60,B,1,9,8,HNDKDLST,0
3b60,B,11,21,10,TFRRLWPTIA,0
3b60,B,22,27,5,FKAGL,0
3b60,B,28,44,16,VAGIALILNAASDTFM,0
3b60,B,69,89,20,VVIGLMILRGITSYISSYCI,0
3b60,B,90,141,51,WVSGKVVMTMRRRLFGHMMGMPVAFFDKQSTGTLLSRITYDSEQVASSSSG,0
3b60,B,142,162,20,LITVVREGASIIGLFIMMFY,0
3b60,B,168,185,17,IILVVLAPIVSIAIRVV,0
3b60,B,186,248,62,KRFRSISKNMQNTMGQVTTSAEQMLKGHKEVLIFGGQEVETKRFDKVSNKMRLQGMKMVSAS,0
3b60,B,249,265,16,ISDPIIQLIASLALAF,0
3b60,B,291,305,14,IALMRPLKSLTNVN,0
3b60,B,306,581,275,QFQRGMAACQTLFAILDSEQEKDEGKRVIDRATGDLEFRNVTFTYPGREVPALRNINLKIPAGKTVALVGRSGSGKSTIASLITRFYDIDEGHILMDGHDLREYTLASLRNQVALVSQNVHLFNDTVANNIAYARTEEYSREQIEEAARMAYAMDFINKMDNGLDTIIGENGVLLSGGQRQRIAIARALLRDSPILILDEATSALDTESERAIQAALDELQKNRTSLVIAHRLSTIEQADEIVVVEDGIIVERGTHSELLAQHGVYAQLHKMQFG,0
2f2b,D,8,25,17,IAEFIGTFILVFFGAGS,0
2f2b,D,26,55,29,AVTLMIASGGTSPNPFNIGIGLLGGLGDW,0
2f2b,D,56,74,18,AIGLAFGFAIAASIYALG,0
2f2b,D,79,91,12,HINPAVTIGLWS,0
2f2b,D,101,118,17,PYIIAQLLGAAFGSFIF,0
2f2b,D,119,146,27,QCAGIGAATVGGLGATAPFPGISYWQA,0
2f2b,D,147,164,17,LAEVVGTFLLMITIMGI,0
2f2b,D,175,191,16,GIIIGLTVAGIITTLG,0
2f2b,D,192,194,2,IS,0
2f2b,D,195,209,14,SSLNPARTFGPYLN,0
2f2b,D,210,222,12,MIFAGTDLWNYY,0
2f2b,D,223,240,17,IYVIGPIVGAVLAALTY,0
5a63,D,2,62,60,LERVSNEEKLNLCRKYYLGGFAFLPFLWLVNIFWFFREAFLVPAYTEQSQIKGYVWRSAV,0
5a63,D,63,78,15,FLFWVIVLTSWITIF,0
5v5s,L,1,10,9,PNFFIDRPI,0
5v5s,L,11,28,17,AWVIAIIIMLAGGLAIL,0
5v5s,L,342,358,16,TLVEAIILVFLVMYLF,0
5v5s,L,359,366,7,QNFRATL,0
5v5s,L,367,386,19,PTIAVPVVLLGTFAVLAAF,0
5v5s,L,396,412,16,GMVLAIGLLVDDAIVV,0
5v5s,L,413,441,28,ENVERVMAEEGLPPKEATRKSMGQIQGA,0
5v5s,L,442,458,16,VGIAMVLSAVFVPMAF,0
5v5s,L,469,489,20,FSITIVSAMALSVLVALILT,0
5v5s,L,490,510,20,ALCATMLKPIAKGDHGEGKK,0
5v5s,L,511,541,30,FFGWFNRMFEKSTHHYTDSVGGILRSTGRY,0
5v5s,L,542,559,17,VLYLIIVVGMAYLFVRL,0
5v5s,L,874,891,17,SLYAISLIVVFLCLAAL,0
5v5s,L,892,898,6,ESWSIP,0
5v5s,L,899,919,20,SVMLVVPLGVIGALLAATFR,0
5v5s,L,927,943,16,QVGLLTTIGLSAKNAI,0
5v5s,L,944,975,31,IVEFAKDLMDKEGKGLIEATLDAVRMRLRPI,0
5v5s,L,976,992,16,MTSLAFILGVMPLVIS,0
5v5s,L,1001,1019,18,AVGTGVMGGMVTATVLAI,0
5v5s,L,1021,1033,12,VPVFFVVVRRRF,0
5v5s,L,1034,1037,3,RKN,0
2v5z,A,1,2,1,S,0
2v5z,A,3,108,105,KCDVVVVGGGISGMAAAKLLHDSGLNVVVLEARDRVGGRTYTLRNQKVKYVDLGGSYVGPTQNRILRLAKELGLETYKVNEVERLIHHVKGKSYPFRGPFPPVWN,0
2v5z,A,109,126,17,ITYLDHNNFWRTMDDMG,0
2v5z,A,127,485,358,EIPSDAPWKAPLAEEWDNMTMKELLDKLCWTESAKQLATLFVNLCVTAETHEVSALWFLWYVKQCGGTTRIISTTNGGQERKFVGGSGQVSERIMDLLGDRVKLERPVIYIDQTRENVLVETLNHEMYEAKYVISAIPPTLGMKIHFNPPLPMMRNQMITRVPLGSVIKCIVYYKEPFWRKKDYCGTMIIDGEEAPVAYTLDDTKPEGNYAAIMGFILAHKARKLARLTKEERLKKLCELYAKVLGSLEALEPVHYEEKNWCEEQYSGGCYTTYFPPGILTQYGRVLRQPVDRIYFAGTETATHWSGYMEGAVEAGERAAREILHAMGKIPEDEIWQSEPESVDVPAQPITTTFLERH,0
2v5z,A,486,498,12,PSVPGLLRLIGL,0
2v5z,A,502,520,18,SATALGFLAHKRGLLVRV,0
1s52,A,5,8,3,GRP,0
1s52,A,9,30,21,WIWLALGTALMGLGVLYFLVK,0
1s52,A,43,67,24,AITTLVPAIAFTMYLSMLLGYGLT,0
1s52,A,68,78,10,VPFGGEQNPI,0
1s52,A,79,99,20,WARYADWLFTTPLLLLDLAL,0
1s52,A,106,128,22,TILALVGADGIMIGTGLVGALT,0
1s52,A,129,133,4,VYSY,0
1s52,A,134,158,24,FVWWAISTAAMLYILYVLFFGFTS,0
1s52,A,171,195,24,KVLRNVTVVLWSAYPVVWLIGSEG,0
1s52,A,196,201,5,GIVPL,0
1s52,A,202,224,22,IETLLFMVLDVSAKVGFGLILL,0
4eeb,E,22,25,3,SHM,0
4eeb,E,293,311,18,LTIIATIFMPLTFIAGIY,0
4eeb,E,312,315,3,MNF,0
4eeb,E,316,325,9,YMPELRWKW,0
4eeb,E,326,328,2,YP,0
4eeb,E,329,346,17,VLAVMGVIAVIMVVYFK,0
4eeb,E,350,351,1,L,0
4ytm,D,56,79,23,TLFKIERYFAAAMVPLIPAAYFI,0
4ytm,D,80,83,3,GRE,0
4ytm,D,84,108,24,DLCLALALTLHVHWGVWGVVNDYG,0
4ytm,D,117,139,22,AAAVRVGAYIFTACLLAGLLYF,0
4ytm,D,140,145,5,EHDVG,0
4ytm,D,146,154,8,TRAFEMVW,0
4ytm,D,155,156,1,L,0
2x5u,M,1,51,50,DYQTIYTQIQARGPHITVSGEWGDNDRVGKPFYSYWLGKIGDAQIGPIYL,0
2x5u,M,52,71,19,ASGIAAFAFGSTAILIILF,0
2x5u,M,81,87,6,LQFFRQ,0
2x5u,M,115,132,17,AGLFMTLSLGSWWIRVY,0
2x5u,M,133,143,10,RARALGLGTH,0
2x5u,M,144,162,18,AWNFAAAIFFVLCIGCIH,0
2x5u,M,177,190,13,WPHIDWLTAFSIR,0
2x5u,M,198,219,21,WHGFSIGFAYGCGLLFAAHGA,0
2x5u,M,220,263,43,ILAVARFGGDREIEQITDRGTAVERAALFWRWTIGFNATIESV,0
2x5u,M,264,284,20,RWGWFFSLMVMVSASVGILL,0
2x5u,M,292,298,6,YLWCVK,0
5dsg,A,34,54,20,IATVTGSLSLVTVVGNILVM,0
5dsg,A,55,73,18,SIKVNRQLQTVNNYFLFS,0
5dsg,A,74,93,19,ACADLIIGAFSMNLYTVYI,0
5dsg,A,104,124,20,CDLWLALDYVVSNASVMNLL,0
5dsg,A,125,153,28,ISFDRYFCVTKPLTYPARRTTKMAGLMI,0
5dsg,A,154,175,21,AAWVLSFVLWAPAILFWQFVV,0
5dsg,A,191,212,21,NPAVTFGTAIAAFYLPVVIMT,0
5dsg,A,213,1011,798,LYIHISLASRSRVNIFEMLRIDE,0
5dsg,A,1019,1117,98,AEKLFNQDVDAAVRGILRNAKLKPVYDSLDAVRRAALINMVFQMGETGVAGFTNSLRMLQQKRWDEAAVNLAKSRWYNQTPNRAKRVITTFRTGTWDA,0
5dsg,A,396,404,8,KVTRTIFA,0
5dsg,A,405,427,22,LLAFILTWTPYNVMVLVNTFCQ,0
5dsg,A,434,452,18,WSIGYWLCYVNSTINPAC,0
5dsg,A,453,457,4,ALCN,0
5dsg,A,458,468,10,TFKKTFRHLL,0
5dsg,A,469,470,1,C,0
5fjg,A,-2,14,16,NSMKNIESLFDYSAGQ,0
5fjg,A,15,38,23,EFIDHLLTMGVGVHFAALIFFLV,0
5fjg,A,50,74,24,TALSCIVMVSAGLILNSQAVMWTD,0
5fjg,A,75,89,14,YAYVDGSYQLQDLT,0
5fjg,A,90,112,22,SNGYRYVNWMATIPCLLLQLLI,0
5fjg,A,121,144,23,FSTATWLILAAWGMIITGYVGQL,0
5fjg,A,145,153,8,EVDDIAQL,0
5fjg,A,154,177,23,IWGAVSTAFFVVMNWIVGTKIFK,0
5fjg,A,190,210,20,TKVFWLMMFAWTLYPIAYLV,0
5fjg,A,211,219,8,AFMNNADG,0
5fjg,A,220,243,23,VLRQLLFTIADISSKVIYGLMIT,0
1vry,A,-3,-1,2,PA,0
1vry,A,0,20,20,VGLGITTVLTLTTQSSGSRA,0
1vry,A,27,50,23,VKAIDIWLAVCLLFVFSALLEYA,0
1vry,A,51,57,6,VNFVSR,0
1vry,A,58,72,14,KKKHRLLEHHHHHH,0
5xas,B,11,15,4,SKGV,0
5xas,B,16,28,12,DLLGFKIFGMPL,0
5xas,B,29,41,12,LYAFALITLLLS,0
5xas,B,51,72,21,VGGFAIMFIIGAIFGEIGKRL,0
5xas,B,73,78,5,IFNKY,0
5xas,B,79,92,13,GGAPVMIFLVAAY,0
5xas,B,115,126,11,FLNLFIAVLIT,0
5xas,B,127,149,22,AILSVNRRLLLKSLLGYIPTIL,0
5xas,B,150,166,16,GIVGASIFGIAIGLVF,0
5xas,B,174,197,23,MLYVLPIMGGGNGAGAVPLSEIY,0
5xas,B,209,223,14,STAIAILTIANIFA,0
5xas,B,224,238,14,VFAAVLDIIGKKHT,0
5xas,B,239,262,23,LSGEGELVRKASFKVEEDEKTGQ,0
5xas,B,263,272,9,THRETAVGL,0
5xas,B,273,288,15,LSTTCFLLAYVVAKK,0
5xas,B,297,310,13,IHYFAWMVLIVAA,0
5xas,B,311,332,21,NASGLCSPEIKAGAKRLSDFF,0
5xas,B,333,346,13,KQLLWVLMVGVGV,0
5xas,B,358,373,15,TFANVVIAAIIVIGA,0
5xas,B,374,430,56,LGAAIGGWLMGFFPIESAITAGLCMANRGGSGDLEVLSACNRMNLISYAQISSRLG,0
5xas,B,431,442,11,GIVLVIASIVF,0
5xas,B,447,448,1,R,0
4bog,E,-16,0,16,VLTLLLIICLALEVRS,0
4bog,E,165,171,6,VVEWIH,0
4bog,E,221,243,22,IINIIAPCVLISSLVVLVYFLP,0
4bog,E,244,250,6,QAGGQK,0
4bog,E,251,273,22,TLSISVLLAQTIFLFLIAQKVP,0
4bog,E,284,308,24,YLIFVMFVSLVIVTNCVIVLNVSL,0
4bog,E,309,314,5,TPNTH,0
4bog,E,315,413,98,LSEKIKHLFLEFLPKYLGMHLEPSEETPEKPQPRRRSSFGIMIKAEEYILKKPRSELMFEEQKDRHGLKRVNKMTSDIDIGTTVDLYKDLANFAPEIK,0
4bog,E,414,448,34,CVEACNFIAKSTKEQNDSGSENENWVLIGKVIDK,0
4bog,E,449,473,24,CFWIALLLFSLGTLAIFLTGHLNQ,0
4bog,E,477,488,11,PFPGDPRKYVP,0
5h36,C,4,6,2,VT,0
5h36,C,7,25,18,LLDWFGLCIFTVTGALVA,0
5h36,C,31,53,22,IAGFVLLGAVTGVGGGTIRDLV,0
5h36,C,54,65,11,GRTPVFWVEEP,0
5h36,C,66,82,16,YVLACLGVAVFTFFFA,0
5h36,C,92,109,17,LWLDAVGLSLFAVTGAE,0
5h36,C,110,118,8,ALQTGAGP,0
5h36,C,119,140,21,IAIAMGVATATFGGILRDLLG,0
5h36,C,151,166,15,YITAALLGAAAFVAL,0
5h36,C,167,174,7,AFGAPRE,0
5h36,C,175,191,16,ALGAGFAAAFLSRAAG,0
1m0l,C,-12,4,16,LELLPTAVEGVSQAQI,0
1m0l,C,5,12,7,GRPEWIW,0
1m0l,C,13,29,16,ALGTALMGLGTLYFLV,0
1m0l,C,45,59,14,TTLVPAIAFTMYLS,0
1m0l,C,60,81,21,LLGYGLTMVPFGGEQNPIYWA,0
1m0l,C,82,96,14,YADWLFTTPLLLLD,0
1m0l,C,110,124,14,LVGADGIMIGTGLV,0
1m0l,C,125,136,11,ALTKVYSYRFV,0
1m0l,C,137,152,15,WAISTAAMLYILYVL,0
1m0l,C,157,161,4,SKAE,0
1m0l,C,175,190,15,NVTVVLWSAYPVVWL,0
1m0l,C,191,205,14,GSEGAGIVPLNIET,0
1m0l,C,206,222,16,LFMVLDVSAKVGFGLI,0
1m0l,C,232,249,17,AEAPEPSAGDGAAATSD,0
3ny8,A,-7,31,38,YKDDDDAMGQPGNGSAFLLAPNRSHAPDHDVTQQRDEV,0
3ny8,A,36,57,21,GIVMSLIVLAIVFGNVLVITA,0
3ny8,A,58,69,11,AKFERLQTVTN,0
3ny8,A,70,91,21,FITSLACADLVMGLAVVPFGA,0
3ny8,A,109,129,20,TSIDVLCVTASIWTLCVIAV,0
3ny8,A,130,149,19,RYFAITSPFKYQSLLTKNK,0
3ny8,A,150,168,18,RVIILMVWIVSGLTSFLP,0
3ny8,A,201,220,19,ASSIVSFYVPLVIMVFVYS,0
3ny8,A,221,274,53,VFQEAKRQLNIFEMLRIDEGLRLKIYKDTEGYYTIGIGHLLTKSPSLNAAKSELDKAIGRNTNGVITKDEAEKLFNQDVDAAVRGILRNAKLKPVYDSLDAVRRAALINMVFQMGETGVAGFTNSLRMLQQKRWDEAAVNLAKSRWYNQTPNRAKRVITTFRTGTWDAYKFCLKEHKALKT,0
3ny8,A,275,295,20,GIIMGTFTLCWLPFFIVNIV,0
3ny8,A,310,327,17,LNWIGYVNSGFNPLIYC,0
3ny8,A,328,329,1,S,0
3ny8,A,330,340,10,DFRIAFQELL,0
3ny8,A,341,342,1,L,0
3ny8,A,343,354,11,RSSLKHHHHHH,0
5heg,E,202,215,13,PMLFILFISWTAF,0
5heg,E,216,222,6,STSYEA,0
5heg,E,223,238,15,VTLVVSTLIAHIAFN,0
5heg,E,258,273,15,FMIYLFYFVAVIEVT,0
5heg,E,274,293,19,QHYLKVESQPARAASITRA,0
5heg,E,294,309,15,RIAFPVVFLLANIIL,0
5fik,W,10,13,3,TPV,0
5fik,W,14,29,15,LGLPLVTLIVLFPSL,0
5fik,W,75,89,14,ILFIGSTNLLGLLP,0
5fik,W,90,95,5,SFTPT,0
5fik,W,96,114,18,QLSMNLGMAIPLWAGAVI,0
5fik,W,143,168,25,IETISLFIQPMALAVRLTANITAGH,0
5fik,W,169,193,24,LIHLIGGATLALMSISTTTALITF,0
5fik,W,194,215,21,ILILLTILEFAVAMIQAYVFT,0
2a95,B,1,40,39,NGTEGPNFYVPFSNKTGVVRSPFEAPQYYLAEPWQFSML,0
2a95,B,41,65,24,AYMFLLIMLGFPINFLTLYVTVQH,0
2a95,B,72,95,23,NYILLNLAVADLFMVFGGFTTTL,0
2a95,B,96,109,13,TSLHGYFVFGPTG,0
2a95,B,110,136,26,NLEGFFATLGGEIALWSLVVLAIERY,0
2a95,B,141,148,7,PMSNFRF,0
2a95,B,153,178,25,IMGVAFTWVMALACAAPPLVGWSRY,0
2a95,B,179,201,22,PEGMQCSCGIDYYTPHEETNNE,0
2a95,B,202,226,24,FVIYMFVVHFIIPLIVIFFCYGQL,0
2a95,B,227,243,16,FTVKEAAAQQQESATT,0
2a95,B,250,274,24,TRMVIIMVIAFLICWLPYAGVAFY,0
2a95,B,275,289,14,FTHQGSDFGPIFMT,0
2a95,B,290,311,21,PAFFAKTSAVYNPVIYIMMNK,0
2a95,B,312,321,9,FRNCMVTTL,0
1vrn,M,55,71,16,IAAFAFGSTAILIILF,0
1vrn,M,72,80,8,MAAEVHFD,0
1vrn,M,81,87,6,LQFFRQ,0
1vrn,M,88,114,26,FWLGLYPPKAQYGMGIPPLHDGGWWL,0
1vrn,M,115,131,16,AGLFMTLSLGSWWIRV,0
1vrn,M,145,162,17,WNFAAAIFFVLCIGCIH,0
1vrn,M,163,176,13,TLVGSWSEGVPFG,0
1vrn,M,177,190,13,WPHIDWLTAFSIR,0
1vrn,M,191,197,6,GNFYYC,0
1vrn,M,198,216,18,WHGFSIGFAYGCGLLFAA,0
1vrn,M,267,284,17,WFFSLMVMVSASVGILL,0
1vrn,M,285,291,6,GTFVDN,0
1vrn,M,292,298,6,YLWCVK,0
1vrn,M,299,323,24,GAAPDYPAYLPATPDPASLPGAPK,0
5jjj,D,24,38,14,VFIFVGALTVLFGA,0
5jjj,D,39,64,25,AYGEVTAAAATGDAAAVQEAAVSAI,0
5jjj,D,65,80,15,GLIILLGINLGLVAA,0
1zrt,R,1,10,9,SHAEDNAGT,0
1zrt,R,15,35,20,YHATAATGVVVTGAAVWPLI,0
1zrt,R,36,191,155,QMNASADVKAMASIFVDVSAVEVGTQLTVKWRGKPVFIRRRDEKDIELARSVPLGALRDTSAENANKPGAEATDENRTLPAFDGTNTGEWLVMLGVCTHLGCVPMGDKSGDFGGWFCPCHGSHYDSAGRIRKGPAPRNLDIPVAAFVDETTIKLG,0
5d3m,D,27,41,14,TFYFIIMIFLANNW,0
5d3m,D,43,57,14,YLVISIFGLAYVFA,0
5d3m,D,63,69,6,VFWDGV,0
5d3m,D,74,87,13,MIVFTSLLQTFFM,0
5d3m,D,88,105,17,GGKVYWHWWIFTLSSEG,0
5d3m,D,106,122,16,INGLYVFIRFAMIILV,0
5d3m,D,141,146,5,MLTPL,0
5d3m,D,246,260,14,IPVAYCLLLTILMI,0
5d3m,D,261,264,3,TRK,0
4lwy,M,1,47,46,EYQNIFTQVQVRGPADLGMTEDVNLANRSGVGPFSTLLGWFGNAQL,0
4lwy,M,48,69,21,PIYLGSLGVLSLFSGLMWFFT,0
4lwy,M,82,88,6,AVFLRD,0
4lwy,M,119,138,19,FFMFVAVWSWWGRTYLRAQ,0
4lwy,M,139,143,4,LGMG,0
4lwy,M,144,159,15,HTAWAFLSAIWLWMV,0
4lwy,M,179,192,13,FSHLDWTNNFSLV,0
4lwy,M,202,224,22,GLSIAFLYGSALLFAMHGATIL,0
4lwy,M,225,264,39,VSRFGGERELEQIADRGTAAERAALFWRWTMGFNATMEG,0
4lwy,M,265,283,18,HRWAIWMAVLVTLTGGIG,0
4pgr,A,-2,5,7,NAMQATV,0
4pgr,A,6,17,11,ESKQSIMQRIL,0
4pgr,A,18,38,20,VFVFTLLIATVGLFIGQFVP,0
4pgr,A,42,61,19,LPLSILEVAMIILAFWMRR,0
4pgr,A,62,67,5,KAVGY,0
4pgr,A,68,86,18,FVYTFAFVSGITLFPIVS,0
4pgr,A,95,116,21,VVLEAFGSTFVIFAVLGTIGA,0
4pgr,A,117,122,5,MKKDL,0
4pgr,A,123,142,19,FLWSFLLVAVLALAVVGIF,0
4pgr,A,156,173,17,SVIGTIVFSLYILYDLN,0
4pgr,A,174,186,12,IKHRHITEDLIP,0
4pgr,A,187,207,20,MALSLYLDFINLFINLLRFF,0
4pgr,A,213,214,1,D,0
1jv6,A,1,8,7,AQITGRP,0
1jv6,A,12,32,20,LALGTALMGLGTLYFLVKGM,0
1jv6,A,33,41,8,VSDPDAKK,0
1jv6,A,42,61,19,YAITTLVPAIAFTMYLSML,0
1jv6,A,64,77,13,GLTMVPFGGEQNP,0
1jv6,A,82,100,18,YASWLFTTPLLLLDLALL,0
1jv6,A,101,103,2,DA,0
1jv6,A,104,123,19,QGTILALVGADGIMIGTGL,0
1jv6,A,138,157,19,AISTAAMLYILYVLFFGFT,0
1jv6,A,158,170,12,KAESMRPEVAST,0
1jv6,A,171,189,18,KVLRNVTVVLWSAYPVVW,0
1jv6,A,206,225,19,LFMVLDVSAKVGLGLILLR,0
1jv6,A,226,230,4,RAIF,0
1jv6,A,231,249,18,EAEAPEPSAGDGAAATSD,0
1vgo,F,1,4,3,AGF,0
1vgo,F,15,37,22,WLGIGTLLMLIGTFYFIARGWG,0
1vgo,F,38,44,6,TDKEAR,0
1vgo,F,45,66,21,YYAITILVPGIASAAYLAMFF,0
1vgo,F,84,105,21,YARYADWLFTTPLLLLDLALL,0
1vgo,F,106,110,4,KVDR,0
1vgo,F,111,132,21,TIGTLIGVDALMIVTGLIGAL,0
1vgo,F,139,162,23,YTWWLFSTIAFLFVLYYLLTSLR,0
1vgo,F,163,175,12,AAAKRSEEVRST,0
1vgo,F,176,197,21,NTLTALVAVLWTAYPILWIVG,0
1vgo,F,209,231,22,TLAFMVLDVTAKVGFGFVLLRS,0
1vgo,F,232,237,5,AILGE,0
1vgo,F,238,253,15,EAPEPSAGADASAAD,0
5cbh,E,6,19,13,MFKRFFGAVRTSW,0
5cbh,E,20,27,7,DPSTRGA,0
5cbh,E,28,45,17,LSLAIIVTAATIFYTLA,0
5cbh,E,51,67,16,DSLFYAVSVGLPMGNG,0
5cbh,E,75,96,21,SKIFTLVYAILVVGLFVTVGG,0
5cbh,E,97,103,6,LASAIV,0
5cbh,E,104,106,2,NN,0
4p3j,C,1,5,4,GLYR,0
4p3j,C,14,30,16,KILIGLILGAIVGLIL,0
4p3j,C,31,42,11,HYGYAHAVHTY,0
4p3j,C,43,64,21,KPFGDLFVRLLCMLVMPIVFA,0
4p3j,C,94,110,16,FAVTLGIIMARLFNPG,0
4p3j,C,111,130,19,GIHLAVGGQQFQPHQAPPL,0
4p3j,C,131,140,9,HILLDIVPT,0
4p3j,C,141,150,9,PFGALANGQ,0
4p3j,C,151,161,10,LPTIFFAIIL,0
4p3j,C,174,200,26,KVRKSAETLLDAINGLAEAMYKIVNG,0
4p3j,C,201,217,16,MQYAPIGVFALIAYVM,0
4p3j,C,218,222,4,EQGV,0
4p3j,C,223,242,19,VVGELAKVTAAVYVGLTLQ,0
4p3j,C,312,327,15,GTALYQGVATFFIAN,0
4p3j,C,328,333,5,LGSHL,0
4p3j,C,334,350,16,VGQQLTIVLTAVLASI,0
4p3j,C,357,375,18,AGAIMLCMVLHSVGLPLT,0
4p3j,C,376,379,3,PNV,0
4p3j,C,380,397,17,AAYAMILGIDAILDMGR,0
4p3j,C,417,422,5,TLVPR,0
1f6g,D,28,47,19,AGAATVLLVIVLLAGSYLA,0
1f6g,D,48,64,16,LAERGAPGAQLITYPA,0
1f6g,D,65,78,13,LWWSVETATTVGY,0
1f6g,D,79,85,6,DLYPVT,0
1f6g,D,86,111,25,WGRCVAVVVMVAGITSFGLVTAALA,0
2df9,A,3,28,25,YVINIIVPCVLISGLVLLAYFLPAQ,0
2df9,A,29,36,7,GGQKCTV,0
2df9,A,37,59,22,INVLLAQTVFLFLIAQKIPETS,0
2df9,A,67,91,24,FLIFVMVVATLIVMNCVIVLNVSQ,0
2df9,A,92,93,1,T,0
3waj,A,1,14,13,QNAESWFKKYWHL,0
3waj,A,16,25,9,LVIAALISV,0
3waj,A,26,83,57,LRILNPWNSVFTWTVRLGGNDPWYYYRLIENTIHNFPHRIWFDPFTYYPYGSYTHFG,0
3waj,A,84,96,12,FLVYLGSIAGII,0
3waj,A,97,115,18,SATSGESLRAVLAFIPAI,0
3waj,A,116,134,18,GVLAILPVYLLTREVFDK,0
3waj,A,136,147,11,AVIAAFLIAIV,0
3waj,A,148,164,16,GQFLQRSILGFNDHHI,0
3waj,A,165,184,19,EAFWQVSALGTFLLAYNRW,0
3waj,A,189,192,3,SHN,0
3waj,A,195,214,19,RQMAYPVIAGITIGLYVLS,0
3waj,A,215,217,2,GA,0
3waj,A,218,235,17,FIIAPIILAFMFFAFVL,0
3waj,A,246,263,17,SLVAVVTFAVSALIYLP,0
3waj,A,264,278,14,AFNYPGFSTIFYSP,0
3waj,A,279,297,18,QLLVLLGSAVIAAAFYQI,0
3waj,A,318,333,15,AVIVLTALIMGLFFV,0
3waj,A,334,373,39,SPDFARNLLSVVRVVQPKGGALTIAEVYPFFFTHNGEFT,0
3waj,A,374,375,1,T,0
3waj,A,376,381,5,AVLHF,0
3waj,A,382,400,18,ALFFFGMAGILYSAYRFL,0
3waj,A,405,422,17,PEMALLIWAIAMFIALW,0
3waj,A,423,429,6,QNRFAY,0
3waj,A,430,451,21,FAAVSAVYSALALSVVFDKLH,0
3waj,A,452,468,16,YRALENAIGARNKLSY,0
3waj,A,470,486,16,VAFALLIALAAIYPTY,0
3waj,A,487,868,381,LADAQSSYAGGPNKQWYDALTWMRENTPDGEKYDEYYLQLYPTPQSNKEPFSYPFETYGVISWWDYGHWIEAVAHRMPIANPFQAGIGNKYNNVPGASSFFTAENESYAEFVAEKLNVKYVVSDIEMETGKYYAMAVWAEGDLPLAEKYYGGYFYYSPTGTFGYANSQWDIPLNSIIIPLRIPSELYYSTMEAKLHLFDGSGLSHYRMIYESDYPAEWKSYSSQVNLNNESQVLQTALYEAVMRARYGVSPTMGTQEVLYKYAYTQLYEKKMGIPVKIAPSGYVKIFERVKGAVVTGKVSANVTEVSVNATIKTNQNRTFEYWQTVEVKNGTYTVVLPYSHNSDYPVKPITPYHIKAGNVVKEITIYESQVQNGEIIQLDL,0
3waj,A,869,875,6,LALVPR,0
4y7k,E,24,46,22,MGIASTALIKSFVDNIIMPIIT,0
4y7k,E,47,66,19,FVPGGGWETATVELGPIVI,0
4y7k,E,67,85,18,WGAFLGELVNFIIIAFAV,0
5avx,G,4,23,19,GPDNDERFTYDYYRLRVVG,0
5avx,G,24,40,16,IVAAVLCVIGIIILLA,0
2m67,A,1,17,16,KDPKTLLRVSIIGTTL,0
2m67,A,18,38,20,ALSSFTPVLVILLGVVGLSA,0
2m67,A,43,64,21,DYVLLPALAIFIGLTIYAIQR,0
2m67,A,65,81,16,RQADASSTPKFNGVKK,0
3wo7,A,25,26,1,Q,0
3wo7,A,27,31,4,PITS,0
3wo7,A,32,40,8,SEGIWNHF,0
3wo7,A,42,55,13,YPMSWLITTVANL,0
3wo7,A,56,65,9,NGSYGLSII,0
3wo7,A,66,90,24,VTILIRLALLPLTLKQQKSMRAMQ,0
3wo7,A,93,104,11,PEMEAIQKKYK,0
3wo7,A,111,127,16,KVQQEMQKELLGLYQK,0
3wo7,A,131,148,17,PMAGCLPLFIQLPILMA,0
3wo7,A,149,178,29,YFAIMRTEEIRYHTFLWFDLGQPDYILPF,0
3wo7,A,179,194,15,AGITTYFQFKMTMSH,0
3wo7,A,195,216,21,QQMQKTNPSDSDNPMANMMQM,0
3wo7,A,218,231,13,KVMLYVMPVMIII,0
3wo7,A,232,243,11,GLSLPSALSLY,0
3wo7,A,244,262,18,VIGNIFMIIQTYFIVVKA,0
3wo7,A,273,278,5,NLYFQ,0
4rp8,C,16,29,13,TNAPLLLGIVTCL,0
4rp8,C,30,45,15,YILLRKSVSVIIKGT,0
4rp8,C,46,65,19,KTIIGFMLLQAGSGILTST,0
4rp8,C,106,121,15,AVLLALALNICYVLL,0
4rp8,C,122,129,7,RITGIRT,0
4rp8,C,130,144,14,MLTGHIMFQQAGLI,0
4rp8,C,161,177,16,TAILVSLYWGITSNMM,0
4rp8,C,178,185,7,KPTQEVT,0
4rp8,C,186,192,6,GCGFSI,0
4rp8,C,193,203,10,HQQQFASWIA,0
4rp8,C,204,209,5,KVAPF,0
4rp8,C,210,223,13,GKKEESVEDLKLP,0
4rp8,C,224,230,6,WLNIFH,0
4rp8,C,231,233,2,NI,0
4rp8,C,234,249,15,STAIVMTIFFGAILL,0
4rp8,C,253,260,7,DTVQAMA,0
4rp8,C,265,291,26,TVYILQTGFSFAVAIFIITQGVRMFV,0
4rp8,C,292,304,12,ELSEAFNGISQR,0
4rp8,C,305,310,5,IPGAV,0
4rp8,C,311,320,9,AIDCAAIYS,0
4rp8,C,321,326,5,APNAV,0
4rp8,C,327,343,16,WGFMWGTIGQLIAVGI,0
4rp8,C,356,368,12,FIPMFFSNATIG,0
4rp8,C,369,380,11,FANHFGGWRAA,0
4rp8,C,381,395,14,KICLVMGMIEIFGC,0
4rp8,C,409,421,12,MADWSILAPPMM,0
4rp8,C,431,444,13,MAVIIVIALAYMF,0
4rp8,C,445,456,11,AGRALRAEEDA,0
5m7l,D,1,12,11,YHGALAQHLDI,0
5m7l,D,13,29,16,QLVWYAQWLVIWTVVL,0
3f4j,B,1,4,3,EVK,0
3f4j,B,13,32,19,LILAMAGNAVGLGNFLRFP,0
3f4j,B,33,43,10,QAAENGGGAF,0
3f4j,B,44,63,19,IPYIIAFLLVGIPLMWIEW,0
3f4j,B,90,124,34,KILGVFGLWIPLVVAIYYVYIESWTLGFAIKFLV,0
3f4j,B,125,132,7,LVPEPPP,0
3f4j,B,133,134,1,A,0
3f4j,B,135,166,31,DPDSILRPFKEFLYSYIGVPKGDEPILKPSL,0
3f4j,B,167,185,18,AYIVFLITMFINVSILIR,0
3f4j,B,191,212,21,ERFAKIAMPTLFILAVFLVIR,0
3f4j,B,213,222,9,FLLETPNGT,0
3f4j,B,223,230,7,ADGLNFL,0
3f4j,B,231,243,12,TPDFEKLKDPGV,0
3f4j,B,244,265,21,IAAVGQIFFTLSLGFGAIITY,0
3f4j,B,277,297,20,SGLTAATLNEKAEVILGGSI,0
3f4j,B,298,325,27,IPAAVAFFGVANAVAIAKAGAFNLGFI,0
3f4j,B,326,331,5,LPAIF,0
3f4j,B,332,339,7,QTAGGTF,0
3f4j,B,340,367,27,GFLWFFLLFFAGLTSSIAIMQPMIAFL,0
3f4j,B,378,396,18,VLWTAAIVFFSAHLVMFL,0
3f4j,B,397,399,2,KS,0
3f4j,B,400,426,26,DEMDFWAGTIGVVFFGLTELIIFFWI,0
3f4j,B,429,437,8,DKAWEEIN,0
3f4j,B,445,469,24,RIYYYVMRYITPAFLAVLLVVWAR,0
3f4j,B,470,471,1,Y,0
3f4j,B,472,478,6,PKIMEE,0
3f4j,B,479,483,4,HWTV,0
3f4j,B,484,502,18,ITRFYIIGLFLFLTFLVF,0
3f4j,B,602,604,2,PR,0
5gxb,A,6,9,3,TNF,0
5gxb,A,10,28,18,MFGLFFFFYFFIMGAYFP,0
5gxb,A,50,67,17,AISLFSLLFQPLFGLLS,0
5gxb,A,68,74,6,KLGLRK,0
5gxb,A,75,90,15,LLWIITGMLVMFAPF,0
5gxb,A,109,130,21,GGIYLGFCFNAGAPAVEAFIE,0
5gxb,A,131,140,9,VSRRSNFEF,0
5gxb,A,141,157,16,RARMFGCVGWALCASI,0
5gxb,A,170,187,17,WLGSGCALILAVLLFFA,0
5gxb,A,188,190,2,TD,0
5gxb,A,207,209,2,FS,0
5gxb,A,210,217,7,KLALELF,0
5gxb,A,218,223,5,QPKLW,0
5gxb,A,224,243,19,LSLYVIGVSCTYDVFDQQF,0
5gxb,A,263,279,16,VTTMGELLNASIMFFA,0
5gxb,A,280,291,11,LIINRIGGKNA,0
5gxb,A,292,309,17,LLAGTIMSVRIIGSSFA,0
5gxb,A,314,333,19,VVILKTLHMFEVPFLLVGC,0
5gxb,A,334,347,13,KYITSQFEVRFSA,0
5gxb,A,348,369,21,IYLVCFCFFKQLAMIFMSVLA,0
5gxb,A,381,396,15,YLVLGLVALGFTLIS,0
5gxb,A,397,408,11,FTLSGPGPLSL,0
4jtd,B,-18,31,49,AHHHHHHHHHHGLVPRGSMTVATGDPVDEAAALPGHPQDTYDPEADHES,0
4jtd,B,32,163,131,ERVVINISGLRFETQLKTLAQFPETLLGDPKKRMRYFDPLRNEYFFDRNRPSFDAILYYYQSGGRLRRPVNVPLDIFSEEIRFYELGEEAMEMFREDEGYIKEEERPLPENEFQRQVWLLFEYPESSGPAR,0
4jtd,B,164,181,17,IAIVSVMVILISIVSFC,0
4jtd,B,225,242,17,ETLCIIWFSFEFLVRFF,0
4jtd,B,243,254,11,CPSKAGFFTNI,0
4jtd,B,255,271,16,NIIDIVAIIPYYVTIF,0
4jtd,B,292,307,15,RIMRILRIFKLSRHS,0
4jtd,B,308,318,10,GLQILGQTLK,0
4jtd,B,319,321,2,SM,0
4jtd,B,322,342,20,ELGLLIFFLFIGVILFSSAV,0
4jtd,B,362,372,10,WAVVSMTTVG,0
4jtd,B,385,402,17,VGSLCAIAGVLTIALPV,0
4jtd,B,403,414,11,VIVSNFNYFYH,0
4jtd,B,415,417,2,ET,0
4jtd,B,418,495,77,GEEQAQYLQVTSSPKIPSSPDLKKSRSASTISKSDYMEIQEGVNNSNEDFREENLKTANSTLANTNYVNITKMLTDV,0
3q7k,E,1,28,27,KADNPFDLLLPAAMAKVAEEAGVYKAT,0
3q7k,E,29,35,6,HPLKTF,0
3q7k,E,36,57,21,LAITAGVFISIAFVFYITATT,0
3q7k,E,64,83,19,GMAKLIGGICFSLGLILCV,0
3q7k,E,84,99,15,CGADLFTSTVLIVVA,0
3q7k,E,100,107,7,ASGRITW,0
3q7k,E,108,114,6,QLAKNW,0
3q7k,E,115,141,26,NVYFGNLIGALLFVLLMWLSGEYMTA,0
3q7k,E,149,179,30,LQTADHKMHHTFIEAVCLGILANLMVCLAV,0
3q7k,E,180,192,12,MSYSGRSLMDKA,0
3q7k,E,193,206,13,IMVLPVAMFVASG,0
3q7k,E,208,226,18,HSIANMFMIPMGIVIRDF,0
3q7k,E,229,234,5,EFWTA,0
3q7k,E,245,268,23,TVMSFITDNLIPVTIGNIIGGGL,0
3q7k,E,269,293,24,VGLTYWVIYLRGNEHHLEHHHHHH,0
1kpw,A,1,55,54,AQQWSLQRLAGRHPQDSYEDSTQSSIFTYTNSNSTRGPFEGPNYHIAPRWVYHL,0
1kpw,A,56,81,25,SVWMIFVVIASVFTNGLVLAATMKF,0
1kpw,A,85,111,26,HPLNWILVNLAVADLAETVIASTISV,0
1kpw,A,112,128,16,NQVYGYFVLGHPMCVL,0
1kpw,A,129,153,24,GYTVSLCGITGLWSLAIISWERWM,0
1kpw,A,165,186,21,AKLAIVGIAFSWIWAAVWTAP,0
1kpw,A,187,221,34,IFGWSRYWPHGLKTSCGPDVFSGSSYPGVQSYMI,0
1kpw,A,222,244,22,LMVTCCITPLSIIVLCYLQVWL,0
1kpw,A,266,289,23,TRMVVVMVLAFCFCWGPYAFFAC,0
1kpw,A,290,306,16,AAANPGYPFHPLMAAL,0
1kpw,A,307,326,19,AFFAKSATIYNPVIYVFMN,0
1kpw,A,327,336,9,QFRNCILQL,0
4f4c,A,1,3,2,LR,0
4f4c,A,4,7,3,GSL,0
4f4c,A,8,21,13,QSLRTLDSFSLAP,0
4f4c,A,23,34,11,VLKTAIKTVED,0
4f4c,A,35,51,16,EGDNIDSNGEIKITRD,0
4f4c,A,52,54,2,KE,0
4f4c,A,55,69,14,VVNKVSIPQLYRYT,0
4f4c,A,70,95,25,TLEKLLLFIGTLVAVITGAGLPLMS,0
4f4c,A,143,164,21,AMTVGMWAAGQITVTCYLYVA,0
4f4c,A,165,209,44,QMNNRLRREFVKSILRQEISWFDTNHSGTLATKLFDNLERVKEG,0
4f4c,A,210,232,22,GDKIGMAFQYLSQFITGFIVAF,0
4f4c,A,239,261,22,LVMLAVTPIQALCGFAIAKSMS,0
4f4c,A,262,312,50,FAIRETLRYAKAGKVVEETISSIRTVVSLNGLRYELERYSTAVEEAKKAG,0
4f4c,A,313,337,24,LKGLFLGISFGAMQASNFISFALA,0
4f4c,A,359,379,20,SSVMMGSMALGLAGPQLAVL,0
4f4c,A,380,665,285,TAQGAASGIYEVLDRKPVIDSSSKAGRKDMKIKGDITVENVHFTYPSRPDVPILRGMNLRVNAGQTVALVGSSGCGKSTIISLLLRYYDVLKGKITIDGVDVRDINLEFLRKNVAVVSQEPALFNCTIEENISLGKEGITREEMVAACKMANAEKFIKTLPNGYNTLVGDRGTQLSGGQKQRIAIARALVRNPKILLLDEATSALDAESEGIVQQALDKAAKGRTTIIIAHRLSTIRNADLIISCKNGQVVEVGDHRALMAQQGLYYDLVTAQTFTDAVDSAAEG,0
4f4c,A,666,715,49,FSRENSVARQTSEHEGLSRQASEMDDIMNRVRSSTIGSITNGPVIDEKE,0
4f4c,A,716,721,5,RIGKD,0
4f4c,A,722,728,6,LSRLKQ,0
4f4c,A,729,739,10,LEENNAQKTN,0
4f4c,A,740,772,32,FEILYHARPHALSLFIGMSTATIGGFIYPTYS,0
4f4c,A,801,825,24,VLAAAQGICSFLMTFFMGIASESL,0
4f4c,A,826,867,41,RDLRNKLFRNVLSQHIGFFDSPQNASGKISTRLATDVPNLR,0
4f4c,A,868,889,21,AIDFRFSTVITTLVSMVAGIG,0
4f4c,A,903,923,20,AILPIVAFGQYLRGRRFTGK,0
4f4c,A,924,972,48,VKSASEFADSGKIAIEAIENVRTVQALAREDTFYENFCEKLDIPHKEA,0
4f4c,A,973,994,21,KEAFIQGLSYGCASSVLYLLN,0
4f4c,A,1024,1042,18,TISTSTLGFATSYFPEYA,0
4f4c,A,1043,1306,263,ATFAGGIIFGMLRKISKIDSLSLAGEKKKLYGKVIFKNVRFAYPERPEIEILKGLSFSVEPGQTLALVGPSGCGKSTVVALLERFYDTLGGEIFIDGSEIKTLNPEHTRSQIAIVSQEPTLFDCSIAENIIYGLDPSSVTMAQVEEAARLANIHNFIAELPEGFETRVGDRGTQLSGGQKQRIAIARALVRNPKILLLDEATSALDTESEKVVQEALDRAREGRTCIVIAHRLNTVMNADCIAVVSNGTIIEKGTHTQLMSEK,0
4f4c,A,1307,1321,14,AYYKLTQKQMTEKK,0
2b2f,C,11,28,17,STALVMLMVPGVGFFYA,0
2b2f,C,29,39,10,MVRRKNAVNM,0
2b2f,C,40,62,22,ALSFISLIITVLLWIFYGYSVS,0
2b2f,C,91,108,17,YQMMFAAVTIAILTSAI,0
2b2f,C,109,114,5,ERAKV,0
2b2f,C,115,136,21,SFILLSALWLTFVYAPFAHWL,0
2b2f,C,150,170,20,AGGMVVHISSGFAALAVAMT,0
2b2f,C,171,188,17,GKRAGFEEYSIEPHSIP,0
2b2f,C,189,208,19,TLIGAALLWFGWFGFNGGS,0
2b2f,C,220,240,20,VVTNTSAAVAGFVWMVIGWI,0
2b2f,C,241,246,5,GKPGS,0
2b2f,C,247,264,17,GIVSGAIAGLAAITPAA,0
2b2f,C,270,290,20,GAIVIGLVAGIVCYLAMDFR,0
2b2f,C,291,297,6,KKKIDE,0
2b2f,C,298,319,21,LDAWAIHGIGGLWGSVAVGIL,0
2b2f,C,342,367,25,IAVASTTAYAFLVTLILAKAVDAAV,0
2b2f,C,368,379,11,LRVSSQEEYVG,0
2b2f,C,380,385,5,DLSQH,0
2b2f,C,386,391,5,EVAYT,0
2b2f,C,392,399,7,EHHHHHH,0
3ae9,D,35,38,3,SKA,0
3ae9,D,39,61,22,SLHWTGERVVSVLLLGLLPAAY,0
3ae9,D,69,89,20,YSLAAALTLHGHWGIGQVVT,0
3ae9,D,90,97,7,YVRGDAL,0
3ae9,D,98,118,20,KAAKAGLLALSAFTFAGLCY,0
3ae9,D,126,134,8,CKAVAMLW,0
3ag1,Z,20,36,16,VTFLSFLLPAGWVLYH,0
3ag1,Z,37,43,6,DNYKKS,0
3ag1,Z,44,46,2,AA,0
5u1y,C,21,33,12,SSTNYGTIKWIF,0
5u1y,C,36,49,13,VFSYISFALISDK,0
5u1y,C,50,328,278,YQKKEPLISSVHTKVKGIAEVKAEILENGMKKMVSGVFDTADYTFPLQGNSFFVMTNFIKTEGQQQGLCPDFPTARTICSSDRGCKKGRMDPQSKGIQTGRCVVYKERLKTCEVSAWCPIEEVKDAPRPALLNSAENFTVLIKNNIDFPGHNYTTRNILPGVNITCTFHKTQNPQCPIFRLGDIFQETGDSFSDVAIQGGIMGIEIYWDCNLDGWFHHCRPKYSFRRLDDKTTSESLYPGYNFRYAKYYKENNVEKRTLIKVFGIRFDILVFGTGGKF,0
5u1y,C,329,344,15,VIQLAVYIGSVISYF,0
5u1y,C,351,362,11,DILINTYSASS,0
5kbv,D,524,543,19,IWMCIVFAYIGVSVVLFLV,0
5kbv,D,545,567,22,FSPYEWHTEEFEDGRETQSSES,0
5kbv,D,568,576,8,NEFGIFNS,0
5kbv,D,577,586,9,WFSLGAFMQ,0
5kbv,D,587,592,5,GCDIS,0
5kbv,D,593,596,3,RSL,0
5kbv,D,597,617,20,GRIVGGVWWFFTLIIISSYT,0
5kbv,D,793,812,19,GVFYILVGGLGLAMLVALI,0
5kbv,D,813,817,4,FCYK,0
5kbv,D,818,831,13,RAEAKRMKGLVPR,0
3oe6,B,-9,34,43,YKDDDDAGAPEGISIYTSDNYTEEMGSGDYDSMKEPCFREENA,0
3oe6,B,38,61,23,IFLPTIYSIIFLTGIVGNGLVIL,0
3oe6,B,62,76,14,MGYQKKLRSMTDKY,0
3oe6,B,77,98,21,LHLSVADLLFVITLPFWAVDA,0
3oe6,B,105,129,24,NFLCKAVHVIYTVNLYSSVWILAF,0
3oe6,B,130,156,26,SLDRYLAIVHATNSQRPRKLLAEKVV,0
3oe6,B,157,176,19,VGVWIPALLLTIPDFIFAN,0
3oe6,B,195,217,22,VVVFQFQHIMVGLILPGIVILS,0
3oe6,B,218,226,8,YCIIISKL,0
3oe6,B,227,234,7,HSGSNIF,0
3oe6,B,235,242,7,MLRIDEGLRLKIYKDTEGYYTIGIGHLLTKSPSLNAAKSELDKAIGRNTNGVITKDEAEKLFNQDVDAAVRGILRNAKLKPVYDSLDAVRRAALINMVFQMGETGVAGFTNSLRMLQQKRWDEAAVNLAKSRWYNQTPNRAKRVITTFRTGTWDAYGSKGHQKRKALKTTV,0
3oe6,B,243,267,24,LILAFFACWLPYYIGISIDSFILL,0
3oe6,B,281,303,22,KWISITEALAFFHCCLNPILYA,0
3oe6,B,304,312,8,LGAKFKTS,0
3oe6,B,313,334,21,QHALTSVSRGSSGRPLEVLFQ,0
4tph,B,1,7,6,TLGTNQ,0
4tph,B,8,19,11,SKTHSFMTVSL,0
4tph,B,20,33,13,ELWERFGYYGMQA,0
4tph,B,55,68,13,ACAALIYVSPAIG,0
4tph,B,69,82,13,WVGDKILGTKRTM,0
4tph,B,83,96,13,LGAGILSVGYALM,0
4tph,B,109,122,13,LGVIVVGNGLFKP,0
4tph,B,123,133,10,AGNLVRKIYE,0
4tph,B,134,136,2,DD,0
4tph,B,137,147,10,KIDSAFTIYY,0
4tph,B,148,161,13,AVNVGSTFSMLLT,0
4tph,B,183,196,13,VCCVGILVGLGNY,0
4tph,B,197,220,23,LMHKSLANYGSEPDTRPVNKKSL,0
4tph,B,221,238,17,IVLALAALSVVASAIIL,0
4tph,B,244,260,16,RVFVYAAGVAVLGIFF,0
4tph,B,261,262,1,L,0
4tph,B,263,269,6,RTSEPS,0
4tph,B,270,278,8,RAGLIAAL,0
4tph,B,279,295,16,LTVQTVFFFIFYQQMS,0
4tph,B,325,340,15,QALNPIWIMVLSPVL,0
4tph,B,341,342,1,W,0
4tph,B,343,355,12,YSWAGRNNKDFS,0
4tph,B,356,359,3,AAK,0
4tph,B,360,373,13,ALGFAVVAIGFFI,0
4tph,B,393,406,13,GYASYSLGELLVS,0
4tph,B,407,415,8,LGLAMIAR,0
4tph,B,416,424,8,VPARMGGF,0
4tph,B,425,427,2,MG,0
4tph,B,428,441,13,YFVASGISQYLGG,0
4tph,B,471,484,13,VAAVVCTIIALAV,0
4tph,B,485,492,7,PLMRRLT,0
4tph,B,493,523,30,SHHAHSSIENNAAASLRDVKAEQAENLYFQ,0
3han,A,1,5,4,AQIT,0
3han,A,6,9,3,RPE,0
3han,A,10,32,22,IWLALGTALMGLGTLYFLVKGM,0
3han,A,42,66,24,YAITTLAPAIAFTMYLSMLLGYGL,0
3han,A,67,78,11,MVPFGGEQNPI,0
3han,A,79,99,20,WARYADWLFTTPLLLLDLAL,0
3han,A,104,127,23,QGTILALVGADGIMIGTGLVGAL,0
3han,A,128,134,6,KVYSYR,0
3han,A,135,157,22,VWWAISTAAMLYILYVLFFGFT,0
3han,A,172,195,23,VLRNVTVVLWSAYPVVWLIGSEG,0
3han,A,196,201,5,GIVPL,0
3han,A,202,225,23,IETLLFMVLDVSAKVGFGLILLR,0
3han,A,231,249,18,EAEAPEPSAGDGAAATSD,0
4dw1,C,26,35,9,SSKKVGTLN,0
4dw1,C,38,55,17,QALVIAYVIGYVCVYNK,0
4dw1,C,56,332,276,YQDTDTVLSSVTTKVKGIALTKTSELGERIWDVADYIIPPQEDGSFFVLTNMIITTNQTQSKCAENPTPASTCTSHRDCKRGFNDARGDGVRTGRCVSYSASVKTCEVLSWCPLEKIVDPPNPPLLADAERFTVLIKNNIRYPKFNFNKRNILPNINSSYLTHCVFSRKTDPDCPIFRLGDIVGEAEEDFQIMAVRGGVMGVQIRWDCDLDMPQSWCVPRYTFRRLDNKDPDNNVAPGYNFRFAKYYKNSDGTETRTLIKGYGIRFDVMVFGQAGK,0
4dw1,C,333,349,16,NIIPTLLNIGAGLALL,0
4dw1,C,360,365,5,LTFMK,0
5l26,C,0,7,7,MVVLHSL,0
5l26,C,8,25,17,GMAVLIAIAVLLSTDRK,0
5l26,C,27,42,15,NIRTVAGAFLIQVAL,0
5l26,C,43,49,6,ALVLYV,0
5l26,C,50,78,28,QGRDMLGEASKTISNVIAYGNNGVDFLF,0
5l26,C,79,105,26,GLVSEKMFEVFGGGGFVFALRVLPMI,0
5l26,C,106,140,34,FFSSLMAVLYYIGVMQLLIKVIGGFLQKMLGTSK,0
5l26,C,142,162,20,SMSAAANIFVGQTEAPLVVR,0
5l26,C,172,189,17,LFAVMSGGLASVAGSVL,0
5l26,C,190,205,15,GYVQMGVPLPYLIAA,0
5l26,C,206,222,16,FMAAPGGLLFAKLLVP,0
5l26,C,242,252,10,TNVIDAAASG,0
5l26,C,254,270,16,TGAQIAIAVGASLLAF,0
5l26,C,271,281,10,ALIAMINGII,0
5l26,C,282,285,3,GVG,0
5l26,C,292,294,2,LT,0
5l26,C,295,302,7,QAILGWL,0
5l26,C,304,309,5,PLAWV,0
5l26,C,310,362,52,GVPWSEAGIAGSLIGQKVVINEFVAYSEFVKYLKPEAAVQLSDTTKAIISFA,0
5l26,C,363,382,19,CGFANLGSIAVLVGGLSIM,0
5l26,C,391,408,17,RLGIKAVVAGSLSNLMS,0
5l26,C,409,417,8,VIAGLFTG,0
4xes,A,49,61,12,GPNSDLDVNTDI,0
4xes,A,62,87,25,SKVLVTAIYLALFVVGTVGNSVTLF,0
4xes,A,106,130,24,GSLALSDLLILLLAMPVELYNFIW,0
4xes,A,131,137,6,HHPWAF,0
4xes,A,138,163,25,DAGCRGYYFLRDACTYATALNVASL,0
4xes,A,189,209,20,ISAIWLASALLAIPMLFTMG,0
4xes,A,210,225,15,QNRSADGTHPGGLVC,0
4xes,A,226,255,29,PIVDTATVKVVIQVNTFMSFLFPMLVISI,0
4xes,A,312,334,22,VVIAFVVCWLPYHVRRLMFCYI,0
4xes,A,335,346,11,DEQWTTFLFDF,0
4xes,A,347,370,23,HYFYMLTNALFYASSAINPILYN,0
3duq,H,1,10,9,VGVTAFGNF,0
3duq,H,16,32,16,IYSFWIFLAGLIYYLQ,0
3duq,H,33,250,217,ENMREGYPLENEDGTPAANQGPFPLPKPKTFILPHGRGTLTVPGPESEDRPIALARTAVSEGFPHAPTGDPMKDGVGPASWVARRDLPELDGHGHNKIKPMKAAAGFHVSAGKNPIGLPVRGCDLEIAGKVVDIWVDIPEQMARFLEVELKDGSTRLLPMQMVKVQSNRVHVNALSSDLFAGIPTIKSPTEVTLLEEDKICGYVAGGLMYAAPKRKS,0
3duq,H,251,260,9,VAAMLAEYA,0
2ka2,B,164,187,23,FLPSLLLSHLLAIGLGIYIGRRL,0
3dtu,B,26,28,2,QQ,0
3dtu,B,29,58,29,LEIIGRPQPGGTGFQPSASPVATQIHWLD,0
3dtu,B,59,82,23,FILVIIAAITIFVTLLILYAVWR,0
3dtu,B,98,119,21,PLEIAWTIVPIVILVAIGAFS,0
3dtu,B,120,287,167,PVLFNQQEIPEADVTVKVTGYQWYWGYEYPDEEISFESYMIGSPATGGDNRMSPEVEQQLIEAGYSRDEFLLATDTAMVVPVNKTVVVQVTGADVIHSWTVPAFGVKQDAVPGRLAQLWFRAEREGIFFGQCSELCGISHAYMPITVKVVSEEAYAAWLEQHHHHHH,0
4q9i,A,43,69,26,WLDRLYMLVGTLAAIIHGVALPLMML,0
4q9i,A,70,114,44,FGDMTDSFASVGQVSKQSTQMSEADKRAMFAKLEEEMTTYAYYY,0
4q9i,A,115,138,23,GIGAGVLIVAYIQVSFWCLAAGR,0
4q9i,A,181,204,23,IGDKIGMFFQAMATFFGGFIIGF,0
4q9i,A,205,210,5,RGWKL,0
4q9i,A,211,233,22,LVILAISPVLGLSAGIWAKILS,0
4q9i,A,286,310,24,KAITANISMGAAFLLIYASYALAF,0
4q9i,A,311,328,17,YGTSLVISKEYSIGQVL,0
4q9i,A,329,352,23,VFFSVLIGAFSVGQASPNIEAFA,0
4q9i,A,704,728,24,PYFVVGIFCAIINGGLQPAFSVIF,0
4q9i,A,729,752,23,KVVGVFTNGGPPETQRQNSNLFS,0
4q9i,A,753,776,23,LFLILGIISFITFFLQGFTFGKA,0
4q9i,A,825,848,23,GSRLAVIFQNIANLGTGIIISLI,0
4q9i,A,849,852,3,GWQ,0
4q9i,A,853,876,23,TLLLLAIVPIIAIAGVVEMKMLS,0
4q9i,A,928,952,24,KKAHVFGITFSFTQAMMYFSYAAC,0
4q9i,A,953,972,19,RFGAYLVTQQLMTFENVLL,0
4q9i,A,973,992,19,FSAIVFGAMAVGQVSSFAP,0
1ln6,A,1,39,38,NGTEGPNFYVPFSNKTGVVRSPFEAPQYYLAEPWQFSM,0
1ln6,A,41,63,22,AYMFLLIMLGFPINFLTLYVTV,0
1ln6,A,75,101,26,LLNLAVADLFMVFGGFTTTLYTSLHG,0
1ln6,A,102,105,3,FVF,0
1ln6,A,106,132,26,PTGCNLEGFFATLGGEIALWSLVVLA,0
1ln6,A,154,177,23,MGVAFTWVMALACAAPPLVGWSR,0
1ln6,A,178,199,21,IPEGMQCSCGIDYYTPHEETN,0
1ln6,A,200,222,22,ESFVIYMFVVHFIIPLIVIFFC,0
1ln6,A,257,277,20,VIAFLICWLPYAGVAFYIFT,0
1ln6,A,278,287,9,QGSDFGPIF,0
1ln6,A,288,306,18,TIPAFFAKTSAVYNPVIY,0
4daj,A,56,63,7,DPLGGHT,0
4daj,A,67,90,23,VFIAFLTGFLALVTIIGNILVIV,0
4daj,A,91,105,14,FKVNKQLKTVNNYF,0
4daj,A,106,129,23,LSLACADLIIGVISMNLFTTYII,0
4daj,A,140,163,23,DLWLSIDYVASNASVMNLLVISF,0
4daj,A,164,185,21,RYFSITRPLTYRAKRTTKRAG,0
4daj,A,186,206,20,MIGLAWVISFVLWAPAILFW,0
4daj,A,229,249,20,ITFGTAIAAFYMPVTIMTIL,0
4daj,A,250,259,9,WRIYKETEK,0
4daj,A,1001,1161,160,NIFEMLRIDEGLRLKIYKDTEGYYTIGIGHLLTKSPSLNAAKSELDKAIGRNTNGVITKDEAEKLFNQDVDAAVRGILRNAKLKPVYDSLDAVRRAALINMVFQMGETGVAGFTNSLRMLQQKRWDEAAVNLAKSRWYNQTPNRAKRVITTFRTGTWDAY,0
4daj,A,482,485,3,IKE,0
4daj,A,486,488,2,KA,0
4daj,A,489,492,3,QTL,0
4daj,A,493,516,23,AILLAFIITWTPYNIMVLVNTFC,0
4daj,A,523,543,20,YWNLGYWLCYINSTVNPVCY,0
4daj,A,544,547,3,LCN,0
4daj,A,548,555,7,TFRTTFK,0
4daj,A,557,595,38,LLCQCDKRKRRKQQYQQRQSVIFHKRVPEQALHHHHHH,0
3zk2,K,11,32,21,GCSAVGAGLAMIAGLGPGIGE,0
3zk2,K,33,61,28,YAAGKAVESVARQPEARGSIISTMILGQ,0
3zk2,K,62,84,22,VAESTGIYSLVIALILLYANPF,0
1uaz,F,16,35,19,LWLGIGTLLMLIGTFYFIV,0
1uaz,F,36,51,15,GWGVTDKEAREYYSI,0
1uaz,F,52,69,17,ILVPGIASAAYLSMFFG,0
1uaz,F,85,100,15,YARYADWLFTTPLLL,0
1uaz,F,101,115,14,DLALLAKVDRVSIG,0
1uaz,F,116,134,18,LVGVDALMIVTGLVGALS,0
1uaz,F,139,156,17,RYTWWLFSTICMIVVLY,0
1uaz,F,157,181,24,LATSLRAAAKERGPEVASTFNTLT,0
1uaz,F,182,198,16,LVLVLWTAYPILWIIG,0
1uaz,F,209,227,18,ETLLFMVLDVTAKVGFGF,0
1uaz,F,228,236,8,LLRSRAIL,0
1uaz,F,237,254,17,DTEAPEPSAGAEASAAD,0
3tds,D,-2,-1,1,G,0
3tds,D,0,1,1,A,0
3tds,D,2,22,20,KETLDKLTNAAINKINLLNT,0
3tds,D,23,24,1,K,0
3tds,D,25,46,21,KYLVSSAFAGLYVGIGILLIF,0
3tds,D,63,79,16,MGLSFAIALSLVIMTG,0
3tds,D,81,92,11,LFTGNNMVMSA,0
3tds,D,93,104,11,MLNKGVSIKDT,0
3tds,D,105,129,24,KIWAYSWVGNLIGALVLGIIFVGT,0
3tds,D,136,150,14,VAEFFANTAASKAS,0
3tds,D,154,177,23,ALFFRGILCNILVCVSVLCSFRT,0
3tds,D,178,179,1,S,0
3tds,D,180,197,17,TAKIIMIFLCLFAIITS,0
3tds,D,199,211,12,EHSVANMTIYSV,0
3tds,D,227,252,25,YNLVAVTLGNIVGGALFMGLGTYIL,0
3tds,D,253,256,3,KEK,0
3tds,D,257,265,8,NAAAENLY,0
2p7t,F,22,25,3,ALH,0
2p7t,F,26,50,24,RAAGAATVLLVIVLLAGSYLAVLA,0
2p7t,F,63,79,16,RALWWSVSTATTVGYG,0
2p7t,F,87,113,26,GRCVAVVVMVAGITSFGLVTAALATW,0
2p7t,F,114,124,10,VGREQERRGH,0
4jcz,C,-5,-1,4,HHHH,0
4jcz,C,8,25,17,AAVTLLGVLLQAYFSLQ,0
4jcz,C,26,52,26,ISARRAFRVSPPLTTGPPEFERVYRA,0
4jcz,C,53,71,18,VNCSEYFPLFLATLWVAG,0
4jcz,C,79,96,17,ALCGLVYLFARLRYFQG,0
4jcz,C,97,104,7,ARSAQLR,0
4jcz,C,105,124,19,APLYASARALWLLVALAAL,0
4jcz,C,147,150,3,PWA,0
4dnr,I,-6,0,6,HHHHHH,0
4dnr,I,1,3,2,IE,0
4dnr,I,4,10,6,IIRRSV,0
4dnr,I,11,14,3,NRF,0
4dnr,I,15,31,16,VLMGALFLSIWGTWTI,0
4dnr,I,339,355,16,GKLLEEFIVVAVVCAL,0
4dnr,I,356,360,4,LWHV,0
4dnr,I,361,381,20,SALVAIISLPLGLCIAFIVM,0
4dnr,I,395,410,15,IAIAVGAMVDAAIVM,0
4dnr,I,411,433,22,ENAHKRLEEWQHQHPDATLDNK,0
4dnr,I,434,444,10,RWQVITDASV,0
4dnr,I,445,448,3,VGP,0
4dnr,I,449,466,17,LFISLLIITLSFIPIFT,0
4dnr,I,477,497,20,LAFTKTYAMAGAALLAIVVI,0
4dnr,I,498,504,6,ILMGYW,0
4dnr,I,505,516,11,RGKIPPESSNP,0
4dnr,I,518,532,14,RFLIRVYHPLLLKV,0
4dnr,I,533,540,7,HWPKTTL,0
4dnr,I,541,556,15,VAALSVLTVLWPLNK,0
4dnr,I,873,890,17,LMVPMTLMIIFVLLYLA,0
4dnr,I,891,897,6,RRVGEA,0
4dnr,I,898,918,20,LIISSVPFALVGGIWLLWWM,0
4dnr,I,927,943,16,TGFIALAGVAAEFGVV,0
4dnr,I,944,983,39,LMYLRHAIEAVPSLNNPQTFSEQKLDEALYHGAVLRVRP,0
4dnr,I,984,1000,16,AMTVAVIIAGLLPILW,0
4dnr,I,1013,1028,15,APMIGGMITAPLLSL,0
4dnr,I,1029,1043,14,IIPAAYKLMWLHRH,0
4dnr,I,1044,1047,3,VRK,0
2evu,D,1,4,3,VSL,0
2evu,D,5,25,20,KRCIAEFIGTFILVFFGAGS,0
2evu,D,56,77,21,AIGLAFGFAIAASIYALGNIS,0
2evu,D,79,92,13,HINPAVTIGLWSV,0
2evu,D,93,94,1,K,0
2evu,D,95,118,23,PGREVVPYIIAQLLGAAFGSFIF,0
2evu,D,147,166,19,LAEVVGTFLLMITIMGIAV,0
2evu,D,167,173,6,ERAPKG,0
2evu,D,174,191,17,AGIIIGLTVAGIITTLG,0
2evu,D,195,209,14,SSLNPARTFGPYLN,0
2evu,D,223,243,20,IYVIGPIVGAVLAALTYQYL,0
2evu,D,244,245,1,S,0
4aq5,E,165,171,6,VVEWIH,0
4aq5,E,222,243,21,INIIAPCVLISSLVVLVYFLP,0
4aq5,E,244,250,6,QAGGQK,0
4aq5,E,251,273,22,TLSISVLLAQTIFLFLIAQKVP,0
4aq5,E,285,308,23,LIFVMFVSLVIVTNCVIVLNVSL,0
4aq5,E,309,314,5,TPNTH,0
4aq5,E,315,413,98,LSEKIKHLFLEFLPKYLGMHLEPSEETPEKPQPRRRSSFGIMIKAEEYILKKPRSELMFEEQKDRHGLKRVNKMTSDIDIGTTVDLYKDLANFAPEIK,0
4aq5,E,414,448,34,CVEACNFIAKSTKEQNDSGSENENWVLIGKVIDK,0
4aq5,E,449,473,24,CFWIALLLFSLGTLAIFLTGHLNQ,0
4aq5,E,477,488,11,PFPGDPRKYVP,0
2ic8,A,94,110,16,PVTWVMMIACVVVFIA,0
2ic8,A,111,115,4,QILG,0
2ic8,A,116,123,7,QEVMLWL,0
2ic8,A,124,136,12,WPFDPTLKFEFW,0
2ic8,A,137,143,6,YFTHAL,0
2ic8,A,144,147,3,HFS,0
2ic8,A,148,166,18,MHILFNLLWWWYLGGAVE,0
2ic8,A,172,188,16,KLIVITLISALLSGYV,0
2ic8,A,189,198,9,QKFSGPWFG,0
2ic8,A,199,217,18,LSGVVYALMGYVWLRGER,0
2ic8,A,225,241,16,QRGLIIFALIWIVAGW,0
2ic8,A,242,251,9,DLFGMSMAN,0
2ic8,A,252,268,16,AHIAGLAVGLAMAFVD,0
1bnx,A,4,24,20,YLSDITDVIFIYFAALSPAI,0
1bnx,A,25,34,9,FGGLLGEK,0
5bqi,B,5,15,10,LVMSSPALPA,0
5bqi,B,16,32,16,LLCSTLLVIKMYVVAI,0
5bqi,B,73,90,17,NDMETIYPFLFLGFVYS,0
5bqi,B,91,98,7,LGPNPFV,0
5bqi,B,99,115,16,WMHFLVFLVGRVAHTV,0
5bqi,B,127,146,19,VTYTLAQLPCASMALQILW,0
5bqi,B,147,152,5,AARHL,0
1bok,A,1,33,32,NGTEGPNFYVPFSNKTGVVRSPFEAPQYYLAE,0
1bok,A,37,61,24,SMLAAYMFLLIMLGFPINFLTLYV,0
1bok,A,62,66,4,VQHK,0
1bok,A,67,70,3,LRT,0
1bok,A,71,74,3,LNY,0
1bok,A,75,96,21,LLNLAVADLFMVFGGFTTTLY,0
1bok,A,99,110,11,HGYFVFGPTGC,0
1bok,A,112,130,18,EGFFATLGGEIALWSLVV,0
1bok,A,131,141,10,AIERYVVVCK,0
1bok,A,142,149,7,MSNFRFG,0
1bok,A,150,155,5,NHAIM,0
1bok,A,156,178,22,VAFTWVMALACAAPPLVGWSRY,0
1bok,A,179,199,20,PEGMQCSCGIDYYTPHEETN,0
1bok,A,201,220,19,SFVIYMFVVHFIIPLIVIF,0
1bok,A,221,223,2,CY,0
1bok,A,224,246,22,QLVFTVKEAAAQQQESATTQKA,0
1bok,A,247,253,6,KEVTRM,0
1bok,A,254,277,23,IIMVIAFLICWLPYAGVAFYIFT,0
1bok,A,278,284,6,QGSDFG,0
1bok,A,286,308,22,FMTIPAFFAKTSAVYNPVIYIM,0
1bok,A,309,310,1,N,0
1bok,A,311,348,37,QFRNCMVTTLCCGKNPLGDDEASTTVSKTETSQVAPA,0
1bl1,A,2,9,7,AVKFLTN,0
1bl1,A,10,12,2,TR,0
1bl1,A,13,18,5,REVFD,0
1bl1,A,19,28,9,LGMIYTVGY,0
3s8f,C,1,3,2,EE,0
3s8f,C,4,9,5,PKGAL,0
3s8f,C,10,24,14,VILVLTLTILVFWL,0
2ydv,A,1,2,1,P,0
2ydv,A,3,5,2,MG,0
2ydv,A,6,29,23,SVYITVELAIAVLAILGNVLVCW,0
2ydv,A,44,68,24,VVSAAAADILVGVLAIPFAIAIST,0
2ydv,A,69,76,7,FCAACHG,0
2ydv,A,77,103,26,LFIACFVLVLTASSIFSLLAIAIDRY,0
2ydv,A,120,143,23,AKGIIAICWVLSFAIGLTPMLGW,0
2ydv,A,144,172,28,NCGQPKEGKAHSQGCGEGQVACLFEDVV,0
2ydv,A,173,199,26,MNYMVYFNFFACVLVPLLLMLGVYLR,0
2ydv,A,215,222,7,LPGERAR,0
2ydv,A,233,256,23,SLAIIVGLFALCWLPLHIINCFT,0
2ydv,A,257,265,8,FCPDCSHA,0
2ydv,A,266,290,24,LWLMYLAIVLSHTNSVVNPFIYAY,0
2ydv,A,293,307,14,EFRQTFRKIIRSHV,0
2ydv,A,312,323,11,PFKAAAAENLY,0
2g87,A,39,64,25,AAYMFLLIMLGFPINFLTLYVTVQH,0
2g87,A,65,71,6,KLRTPL,0
2g87,A,72,98,26,YILLNLAVADLFMVFGGFTTTLYTSL,0
2g87,A,109,135,26,NLEGFFATLGGEIALWSLVVLAIERY,0
2g87,A,136,151,15,VVCKPMSNFRFGENH,0
2g87,A,152,176,24,IMGVAFTWVMALACAAPPLVGWSR,0
2g87,A,200,225,25,SFVIYMFVVHFIIPLIVIFFCYGQL,0
2g87,A,226,251,25,FTVKEAAAQQQESATTQKAEKEVTR,0
2g87,A,252,277,25,VIIMVIAFLICWLPYAGVAFYIFTH,0
2g87,A,288,309,21,IPAFFAKTSAVYNPVIYIMMN,0
2g87,A,311,321,10,FRNCMVTTLC,0
2g87,A,322,348,26,GKNPLGDDEASTTVSKTETSQVAPA,0
1psl,E,1,34,33,EKVQYLTRSAIRRASTIEMPQQARQKLQNLFIN,0
1psl,E,35,38,3,CLI,0
1psl,E,39,49,10,ICLLLICIIV,0
4ja3,A,1,7,6,NTQYNS,0
4ja3,A,8,15,7,YIFSITL,0
4ja3,A,16,39,23,ATLGGLLFGYDTAVISGTVESLN,0
4ja3,A,52,75,23,ANSLLGFCVASALIGCIIGGALG,0
4ja3,A,76,87,11,YCSNRFGRRDS,0
4ja3,A,88,106,18,KIAAVLFFISGVGSAWPE,0
4ja3,A,123,147,24,GYVPEFVIYRIIGGIGVGLASMLS,0
4ja3,A,148,165,17,MYIAELAPAHIRGKLVS,0
4ja3,A,166,188,22,NQFAIIFGQLLVYCVNYFIARS,0
4ja3,A,198,218,20,WRYMFASECIPALLFLMLLY,0
4ja3,A,219,264,45,VPESPRWLMSRGKQEQAEGILRKIMGNTLATQAVQEIKHSLDHGR,0
4ja3,A,265,275,10,TGGRLLMFGV,0
4ja3,A,276,279,3,VIV,0
4ja3,A,280,303,23,GVMLSIFQQFVGINVVLYYAPEV,0
4ja3,A,304,309,5,KTLGA,0
4ja3,A,312,336,24,IALLQTIIVGVINLTFTVLAIMTV,0
4ja3,A,337,342,5,KFGRK,0
4ja3,A,343,364,21,LQIIGALGMAIGMFSLGTAFY,0
4ja3,A,370,392,22,VALLSMLFYVAAFAMSWGPVCW,0
4ja3,A,393,397,4,LLSE,0
4ja3,A,398,406,8,FPNAIRGK,0
4ja3,A,407,409,2,LA,0
4ja3,A,410,431,21,AVAAQWLANYFVSWTFPMMDK,0
4ja3,A,434,439,5,LVAHF,0
4ja3,A,442,462,20,FSYWIYGCMGVLAALFMWKF,0
4ja3,A,463,465,2,PE,0
4ja3,A,466,485,19,KGKTLEELEALWEPETKKT,0
3fwl,A,54,65,11,SHMKPRGKRGW,0
3fwl,A,70,86,16,KLAIVFAVLIAIYGVY,0
3fwl,A,87,248,161,DQKIRSRIDGKVWQLPAAVYGRMVNLEPDMTISKNEMVKLLEATQYRQVSKMTRPGEFTVQANSIEMIRRPFDFPDSKEGQVRARLTFDGDHLATIVNMENNRQFGFFRLDPRLITMISSPNGEQRLFVPRSGFPDLLVDTLLATEDRHFYEHDGISLYSI,0
3fwl,A,249,267,18,RAVLANLTAGRTVQGAST,0
3fwl,A,268,284,16,TQQLVKNLFLSSERSY,0
3fwl,A,285,299,14,RKANEAYMALIMDA,0
3fwl,A,300,398,98,YSKDRILELYMNEVYLGQSGDNEIRGFPLASLYYFGRPVEELSLDQQALLVGMVKGASIYNPWRNPKLALERRNLVLRLLQQQQIIDQELYDMLSARP,0
3fwl,A,399,406,7,GVQPRGG,0
3fwl,A,407,799,392,ISPQPAFMQLVRQELQAKLGDKVKDLSGVKIFTTFDSVAQDAAEKAAVEGIPALKKQRKLSDLETAIVVVDRFSGEVRAMVGGSEPQFAGYNRAMQARRSIGSLAKPATYLTALSQPKIYRLNTWIADAPIALRQPNGQVWSPQNDDRRYSESGRVMLVDALTRSMNVPTVNLGMALGLPAVTETWIKLGVPKDQLHPVPAMLLGALNLTPIEVAQAFQTIASGGNRAPLSALRSVIAEDGKVLYQSFPQAERAVPAQAAYLTLWTMQQVVQRGTGRQLGAKYPNLHLAGKTGTTNNNVDTWFAGIDGSTVTITWVGRDNNQPTKLYGASGAMSIYQRYLANQTPTPLNLVPPEDIADMGVDYDGNFVCSGGMRILPVWTSDPQSLCQQSEM,0
3fwl,A,800,804,4,QQPS,0
4j7c,L,-19,14,33,GSSHHHHHHSSGLVPRGSHMTLQKDKVIKWVRF,0
4j7c,L,15,21,6,PPQVLA,0
4j7c,L,22,40,18,GFFLTIIIGAVLLMLPIS,0
4j7c,L,48,65,17,DALFTAASATTVTGLAV,0
4j7c,L,73,91,18,VFGQTVIMGLIQIGGLGF,0
4j7c,L,92,101,9,TFAVLIVMI,0
4j7c,L,103,104,1,K,0
4j7c,L,105,137,32,IGLKERMLVQEALNQPTIGGVIGLVKVLFLFS,0
4j7c,L,138,154,16,SIELIAALILSIRLVP,0
4j7c,L,159,174,15,SGLFASLFHAISAFN,0
4j7c,L,175,180,5,AGFSL,0
4j7c,L,189,207,18,GDPTVNLVITFLFITGGI,0
4j7c,L,208,234,26,FTVLFDVMKNRRFKTFSLHTKLMLTG,0
4j7c,L,235,251,16,LMLNAIAMLTVFILEY,0
4j7c,L,263,278,15,DKLWASYFQAVTPRT,0
4j7c,L,279,284,5,GFNSL,0
4j7c,L,290,306,16,EGTIVFTLLLMFIGAG,0
4j7c,L,307,315,8,ASTASGIK,0
4j7c,L,316,330,14,TTFIVILTSVIAYL,0
4j7c,L,331,355,24,GKKETVIFRRSIKYPIIIKALAVS,0
4j7c,L,356,372,16,TSLFIVFLGIFALTIT,0
4j7c,L,378,395,17,QIVFETFSAFGTVGLTM,0
4j7c,L,404,420,16,GKCIIIVIMFIGRIGP,0
4j7c,L,421,427,6,TFVFSF,0
4j7c,L,428,445,17,KTEQSNIRYPDGEVFTG,0
1boj,A,1,33,32,NGTEGPNFYVPFSNKTGVVRSPFEAPQYYLAE,0
1boj,A,37,61,24,SMLAAYMFLLIMLGFPINFLTLYV,0
1boj,A,62,66,4,VQHK,0
1boj,A,67,70,3,LRT,0
1boj,A,71,74,3,LNY,0
1boj,A,75,96,21,LLNLAVADLFMVFGGFTTTLY,0
1boj,A,99,110,11,HGYFVFGPTGC,0
1boj,A,112,131,19,EGFFATLGGEIALWSLVVL,0
1boj,A,132,141,9,IERYVVVCK,0
1boj,A,142,149,7,MSNFRFG,0
1boj,A,150,154,4,NHAI,0
1boj,A,155,177,22,GVAFTWVMALACAAPPLVGWSR,0
1boj,A,179,199,20,PEGMQCSCGIDYYTPHEETN,0
1boj,A,201,220,19,SFVIYMFVVHFIIPLIVIF,0
1boj,A,221,223,2,CY,0
1boj,A,224,246,22,QLVFTVKEAAAQQQESATTQKA,0
1boj,A,247,253,6,KEVTRM,0
1boj,A,254,277,23,IIMVIAFLICWLPYAGVAFYIFT,0
1boj,A,278,284,6,QGSDFG,0
1boj,A,287,308,21,MTIPAFFAKTSAVYNPVIYIM,0
1boj,A,309,310,1,N,0
1boj,A,311,348,37,QFRNCMVTTLCCGKNPLGDDEASTTVSKTETSQVAPA,0
5ndd,A,1126,1134,8,DEAAVNLA,0
5ndd,A,63,68,5,FSASV,0
5ndd,A,73,98,25,TTVFLPIVYTIVFVVALPSNGMALW,0
5ndd,A,99,113,14,FLFRTKKKAPAVIY,0
5ndd,A,114,136,22,ANLALADLLSVIWFPLKIAYHI,0
5ndd,A,144,168,24,EALCNVLIGFFYANMYCSILFLTC,0
5ndd,A,169,193,24,SVQRAWEIVNPMGHSRKKANIAIG,0
5ndd,A,194,214,20,SLAIWLLILLVTIPLYVVKQ,0
5ndd,A,236,259,23,GDMFNYFLSLAIGVFLFPAFLTA,0
5ndd,A,260,290,30,AYVLMIRALADLEDNWETLNDNLKVIEKADNAAQVKDALTKMRAAALDAQKATPPKLEDKSPDSPEMKDFRHGFDILVGQIDDALKLANEGKVKEAQAAAEQLKTTRNAYIQKYLENSEKKRKRAIKLAV,0
5ndd,A,291,313,22,VAAMYLICFTPSNLLLVVHYFL,0
5ndd,A,322,343,21,YALYIVALCLSTLNSCIDPFV,0
5ndd,A,344,348,4,YFVS,0
5ndd,A,349,358,9,DFRDHAKNA,0
5br2,C,6,9,3,RPE,0
5br2,C,10,32,22,IWLALGTALMGLGTLYFLVKGM,0
5br2,C,40,62,22,KFYAITTLVPAIAFTMYLSMLL,0
5br2,C,63,71,8,YGLTMVPF,0
5br2,C,75,79,4,NPIY,0
5br2,C,80,100,20,ARYADWLFTTPLLLLDLALL,0
5br2,C,106,127,21,TILALVGADGIMIGTGLVGAL,0
5br2,C,128,133,5,KVYSY,0
5br2,C,134,156,22,FVWWAISTAAMLYILYVLFFGF,0
5br2,C,171,192,21,KVLRNVTVVLWSAYPVVWLIG,0
5br2,C,193,202,9,EGAGIVPLN,0
5br2,C,203,226,23,ETLLFMVLDVSAKVGFGLILLRS,0
5bqh,B,5,15,10,LVMSSPALPA,0
5bqh,B,16,34,18,LLCSTLLVIKMYVVAIIT,0
5bqh,B,47,52,5,EDALR,0
5bqh,B,72,90,18,RNDMETIYPFLFLGFVYS,0
5bqh,B,91,98,7,LGPNPFV,0
5bqh,B,99,117,18,WMHFLVFLVGRVAHTVAY,0
5bqh,B,126,146,20,SVTYTLAQLPCASMALQILW,0
5bqh,B,147,152,5,AARHL,0
3s8g,C,1,3,2,EE,0
3s8g,C,4,6,2,PK,0
3s8g,C,7,24,17,ALAVILVLTLTILVFWL,0
4j7t,C,-5,-2,3,HHH,0
4j7t,C,-1,4,5,HHKDE,0
4j7t,C,5,28,23,ALLAAVTLLGVLLQAYFSLQVIS,0
4j7t,C,52,74,22,QVNCSEYFPLFLATLWVAGIFF,0
4j7t,C,76,97,21,GAAALCGLVYLFARLRYFQGY,0
4j7t,C,104,131,27,LAPLYASARALWLLVALAALGLLAHFL,0
4j7t,C,132,142,10,AALRAALLGR,0
4j7t,C,143,146,3,RTL,0
4j7t,C,147,150,3,PWA,0
1umx,M,55,72,17,GVLSLFSGLMWFFTIGI,0
1umx,M,73,81,8,FWYQAGWN,0
1umx,M,82,87,5,AVFLR,0
1umx,M,88,117,29,LFFFSLEPPAPEYGLSFAAPLKEGGLWLI,0
1umx,M,118,133,15,SFFMFVAVWSWWGRT,0
1umx,M,147,163,16,WAFLSAIWLWMVLGFI,0
1umx,M,164,178,14,PILMGSWSEAVPYG,0
1umx,M,179,191,12,FSHLDWTNNFSL,0
1umx,M,192,200,8,HGNLFYNP,0
1umx,M,201,221,20,HGLSIAFLYGSALLFAMHGA,0
1umx,M,269,285,16,IWMAVLVTLTGGIGIL,0
1umx,M,286,302,16,SGTVVDNWYVWGQNHG,0
1umx,M,303,307,4,APLN,0
4z36,A,30,36,6,AFFYNR,0
4z36,A,49,72,23,KLVMGLGITVCIFIMLANLLVMV,0
4z36,A,73,88,15,IYVNRRFHFPIYYLM,0
4z36,A,89,109,20,NLAAADFFAGLAYFYLMFNT,0
4z36,A,120,141,21,WLLRQGLIDTSLTASVANLLA,0
4z36,A,142,166,24,AIERHITVFRMQLHTRMSNRRVVV,0
4z36,A,167,187,20,IVVIWTMAIVMGAIPSVGWN,0
4z36,A,203,222,19,CSYLVFWAIFNLVTFVVMV,0
4z36,A,223,1043,820,LYAHIFGYVADLEDNWETLNDNLKVIEKADNAAQVKDALTKMRAAALDAQKG,0
4z36,A,1058,262,-796,KDFRHGFDILVGQIDDALKLANEGKVKEAQAAAEQLKTTRNAYIQKYLRNRDTMMSLLKTVVI,0
4z36,A,263,284,21,LGAFIICWTPGLVLLLLDCCC,0
4z36,A,288,310,22,VLAYEKFFLLLAEFNSAMNPII,0
4z36,A,311,315,4,SYRD,0
4z36,A,316,326,10,EMSATFRQIL,0
4quv,A,24,40,16,WLVLMIALPPLVYYLW,0
4quv,A,41,55,14,CVTYYQGELVFTSD,0
4quv,A,56,63,7,AAWRRFW,0
4quv,A,64,73,9,HVAPPTWHA,0
4quv,A,74,92,18,GLYAAWFLGQAALQVWAP,0
4quv,A,112,126,14,GIFSFLFTLAVVFG,0
4quv,A,127,145,18,VTMGWLDATVLYDQLGPL,0
4quv,A,146,162,16,TVVNIFTFVFAGFLYF,0
4quv,A,197,214,17,LFCEARPGMIFWLLMNL,0
4quv,A,215,230,15,MAAKQYELHGTVTVP,0
4quv,A,231,249,18,LLVVGFQSFYLIDYFIHE,0
4quv,A,265,283,18,MLCWGDLVWLPFTYTLQA,0
4quv,A,284,295,11,YLVHHTHDLPV,0
4quv,A,296,313,17,GIIAIVALNLAGYAIFR,0
4quv,A,361,376,15,GDLMIALSWCLPAAF,0
4quv,A,377,378,1,S,0
4quv,A,379,393,14,IPYFHIVYFTILLL,0
1ntz,K,1,22,21,LTRFLGPRYRQLARNWVPTAQ,0
1ntz,K,23,38,15,WGAVGAVGLVWATDW,0
1ntz,K,54,56,2,DD,0
3tdr,E,-2,0,2,GR,0
3tdr,E,2,22,20,KETLDKLTNAAINKINLLNT,0
3tdr,E,23,24,1,K,0
3tdr,E,25,45,20,KYLVSSAFAGLYVGIGILLI,0
3tdr,E,64,79,15,GLSFAIALSLVIMTG,0
3tdr,E,81,92,11,LFTGNNMVMSA,0
3tdr,E,93,104,11,MLNKGVSIKDT,0
3tdr,E,105,129,24,KIWAYSWVGNLIGALVLGIIFVGT,0
3tdr,E,136,149,13,VAEFFANTAASKA,0
3tdr,E,154,177,23,ALFFRGILCNILVCVSVLCSFRT,0
3tdr,E,178,179,1,S,0
3tdr,E,180,197,17,TAKIIMIFLCLFAFITS,0
3tdr,E,199,211,12,EHSVANMTIYSV,0
3tdr,E,227,252,25,YNLVAVTLGNIVGGALFMGLGTYIL,0
3tdr,E,253,256,3,KEK,0
3tdr,E,257,265,8,NAAAENLY,0
3j9v,T,14,36,22,IGCASAIIFTSLGAAYGTAKSG,0
3j9v,T,37,55,18,GICATCVLRPDLLFKNIV,0
3j9v,T,56,76,20,VIMAGIIAIYGLVVSVLVCY,0
3j9v,T,90,111,21,LGAGLSVGLSGLAAGFAIGIV,0
3j9v,T,112,130,18,DAGVRGSSQQPRLFVGMI,0
3j9v,T,131,152,21,ILIFAEVLGLYGLIVALLLNS,0
3zkr,E,11,210,199,VDVSVSIFINKIYGVNTLEQTYKVDGYIVAQWTGKPRKTPGDKPLIVENTQIERWINNGLWVPALEFINVVGSPDTGNKRLMLFPDGRVIYNARFLGSFSNDMDFRLFPFDRQQFVLELEPFSYNNQQLRFSDIQVYTENIDNEEIDEWWIRGKASTHISDIRYDHLSSVQPNQNEFSRITVRIDAVRNPSYYLWSFIL,0
3zkr,E,211,225,14,LGLIIAASWSVFWL,0
3zkr,E,230,245,15,RLQTSFTLMLTVVAY,0
3zkr,E,246,265,19,FYTSNILPRLPYTTVIDQM,0
3zkr,E,266,282,16,IAGYGSIFAAILLIIF,0
3zkr,E,300,315,15,RLAFPLGFLAIGCVL,0
3zkr,E,316,317,1,I,0
1ntm,K,1,21,20,LTRFLGPRYRQLARNWVPTA,0
1ntm,K,22,38,16,LWGAVGAVGLVWATDW,0
1ntm,K,52,56,4,KKDD,0
4q9h,A,40,68,28,YAGWLDRLYMLVGTLAAIIHGVALPLMM,0
4q9h,A,69,117,48,IFGDMTDSFASVGQVSKQSTQMSEADKRAMFAKLEEEMTTYAYYYTGI,0
4q9h,A,118,139,21,AGVLIVAYIQVSFWCLAAGRQ,0
4q9h,A,180,204,24,GIGDKIGMFFQAMATFFGGFIIGF,0
4q9h,A,205,208,3,RGW,0
4q9h,A,209,232,23,LTLVILAISPVLGLSAGIWAKIL,0
4q9h,A,289,311,22,TANISMGAAFLLIYASYALAFW,0
4q9h,A,312,330,18,GTSLVISKEYSIGQVLTV,0
4q9h,A,331,352,21,FSVLIGAFSVGQASPNIEAFA,0
4q9h,A,695,700,5,ILKLN,0
4q9h,A,704,728,24,PYFVVGIFCAIINGGLQPAFSVIF,0
4q9h,A,729,752,23,KVVGVFTNGGPPETQRQNSNLFS,0
4q9h,A,753,776,23,LFLILGIISFITFFLQGFTFGKA,0
4q9h,A,824,846,22,TGSRLAVIFQNIANLGTGIIIS,0
4q9h,A,847,857,10,IYGWQLTLLL,0
4q9h,A,858,879,21,AIVPIIAIAGVVEMKMLSGQA,0
4q9h,A,925,949,24,NAMKKAHVFGITFSFTQAMMYFSY,0
4q9h,A,950,973,23,ACFRFGAYLVTQQLMTFENVLLV,0
4q9h,A,974,994,20,SAIVFGAMAVGQVSSFAPDY,0
1uv3,A,23,36,13,WDGPQYHLAPVWA,0
1uv3,A,37,64,27,RLQAAFMGFVFFVGTPLNAIVLVATLH,0
1uv3,A,73,99,26,YILVNVSLGGFLFCIFSVFTVFIASC,0
1uv3,A,100,108,8,GYFLFGRH,0
1uv3,A,109,133,24,CALEAFLGSVAGLVTGWSLAFLAF,0
1uv3,A,154,176,22,MVVLATWIIGIGVSIPPFFGWS,0
1uv3,A,177,198,21,FIPEGLQCSCGPDWYTVGTKY,0
1uv3,A,199,224,25,SEYYTWFLFIFCFIIPLSLICFSYS,0
1uv3,A,254,277,23,VVMVGSFCLCYVPYAALAMYMVN,0
1uv3,A,278,286,8,RNHGLDLR,0
1uv3,A,287,309,22,VTIPAFFSKSSCVYNPIIYCFM,0
1uv3,A,311,321,10,QFRACILEMV,0
1y5n,F,4,28,24,NMFFFDIYPYIAGAVFLIGSWLRY,0
1y5n,F,29,47,18,YGQYTWRAASSQMLDRKG,0
1y5n,F,48,72,24,NLASNLFHIGILGIFVGHFFGMLT,0
1y5n,F,73,80,7,HWMYEAW,0
1y5n,F,87,114,27,KMAMFAGGASGVLCLIGGVLLLKRRLF,0
1y5n,F,115,124,9,PRVRATTTG,0
1y5n,F,125,145,20,DILILSLLVIQCALGLLTIP,0
1y5n,F,183,204,21,FRLHLVLGMTLFLLFPFSRLI,0
1y5n,F,205,225,20,IWSVPVEYLTRKYQLVRARH,0
4hbj,H,1,10,9,VGVTAFGNF,0
4hbj,H,16,32,16,IYSFWIFLAGLIYYLQ,0
4hbj,H,33,249,216,ENMREGYPLENEDGTPAANQGPFPLPKPKTFILPHGRGTLTVPGPESEDRPIALARTAVSEGFPHAPTGDPMKDGVGPASWVARRDLPELDGHGHNKIKPMKAAAGFHVSAGKNPIGLPVRGCDLEIAGKVVDIWVDIPEQMARFLEVELKDGSTRLLPMQMVKVQSNRVHVNALSSDLFAGIPTIKSPTEVTLLEEDKICGYVAGGLMYAAPKRK,0
4hbj,H,250,260,10,VVAAMLAEYA,0
2wsf,4,-50,29,79,ATVTTQASAAIFGPCGLKSRFLGGSSGKLNRGVAFRPVGCSPSASFKVEAKKGEWLPGLASPGYLTGSLPGDNGFDPLG,0
2wsf,4,42,56,14,AELVNGRWAMLGVA,0
2wsf,4,57,92,35,MLLPEVFTSIGIINVPKWYAAGKEEYFASSSTLFV,0
2wsf,4,93,106,13,EFILSHYVEIRRW,0
2wsf,4,150,166,16,EKEIANGRLMLAFLGF,0
2wsf,4,167,195,28,IQHNVTGKGPFDNLLQHISDPWHNTIVQ,0
2wsf,4,196,200,4,LGGN,0
2wqy,D,1,2,1,S,0
2wqy,D,9,28,19,WTSERAVSALLLGLLPAAY,0
2wqy,D,29,34,5,YPGPA,0
2wqy,D,35,56,21,DYSLAAALTLHGHWGLGQVIT,0
2wqy,D,66,85,19,VANTGLYVLSAITFTGLCY,0
2wqy,D,86,92,6,NYYDVG,0
2wqy,D,93,100,7,CKAVAML,0
2wqy,D,101,103,2,SI,0
5l27,C,7,21,14,LGMAVLIAIAVLLS,0
5l27,C,25,27,2,AI,0
5l27,C,28,46,18,IRTVAGAFLIQVALGALV,0
5l27,C,53,78,25,DMLGEASKTISNVIAYGNNGVDFLF,0
5l27,C,103,136,33,MIVFFSSLMAVLYYIGVMQLLIKVIGGFLQKML,0
5l27,C,137,142,5,TSKAE,0
5l27,C,143,162,19,MSAAALIFVGQTEAPLVVR,0
5l27,C,163,172,9,YIRRMTESE,0
5l27,C,173,189,16,FAVMSGGLASVAGSVL,0
5l27,C,204,221,17,ASFMAAPGGLLFAKLLV,0
5l27,C,237,241,4,EDEK,0
5l27,C,242,274,32,TNVIDAAASGAVTGAQIAIAVGASLLAFVALI,0
5l27,C,275,283,8,MINGIIGG,0
5l27,C,295,302,7,QAILGWL,0
5l27,C,305,310,5,LAWVI,0
5l27,C,365,381,16,FANLGSIAVLVGGLSI,0
5l27,C,382,391,9,APKRRKDVA,0
5l27,C,392,411,19,LGIKAVVAGSLSNLMSAVI,0
3hao,C,1,5,4,AQIT,0
3hao,C,6,9,3,RPE,0
3hao,C,10,33,23,IWLALGTALMGLGTLYFLVKGMG,0
3hao,C,41,62,21,FYAITTLVPAIAFTMYLSMLL,0
3hao,C,63,79,16,YGLTMVPFGGEQNPIY,0
3hao,C,80,99,19,ARYADWLFTTPLLALDLAL,0
3hao,C,106,127,21,TILALVGADGIMIGTGLVGAL,0
3hao,C,128,133,5,KVYSY,0
3hao,C,134,157,23,FVWWAISTAAMLYILYVLFFGFT,0
3hao,C,171,192,21,KVLRNVTVVLWSAYPVVWLIG,0
3hao,C,193,203,10,EGAGIVPLNI,0
3hao,C,204,226,22,TLLFMVLDVSAKVGFGLILLRS,0
3hao,C,232,249,17,AEAPEPSAGDGAAATSD,0
4dw0,C,26,31,5,SSKKV,0
4dw0,C,32,36,4,TLNR,0
4dw0,C,37,55,18,TQALVIAYVIGYVFVYNK,0
4dw0,C,334,356,22,IIPTLLNIGAGLALLGLVNVIC,0
4dw0,C,357,361,4,WIVL,0
4dw0,C,362,365,3,FMK,0
2k74,A,2,9,7,RFLNQAS,0
2k74,A,10,13,3,GRG,0
2k74,A,14,35,21,WLLMAFTALALELTALWFQHV,0
2k74,A,41,62,21,VLSIYERAALFGVLGAALIGA,0
2k74,A,63,70,7,APKTPLR,0
2k74,A,71,92,21,VAMVIWLYSAFRGVQLTYEHT,0
2k74,A,141,162,21,MPQWLLGIFIAYLIVAVLVVI,0
2k74,A,163,183,20,QPFKAKKRDLFGRGHHHHHH,0
5l2a,C,7,21,14,LGMAVLIAIAVLLS,0
5l2a,C,22,27,5,DRKAI,0
5l2a,C,28,42,14,IRTVAGAFLIQVAL,0
5l2a,C,52,68,16,RDMLGEASKTISNVIA,0
5l2a,C,71,77,6,NGVDFL,0
5l2a,C,103,118,15,MIVFFSSLMAVLYYI,0
5l2a,C,120,152,32,MQLLIKVIGGFLQKMLGTSKAESMSAAASIFV,0
5l2a,C,154,165,11,TEAPLVVRPYI,0
5l2a,C,166,171,5,RMTES,0
5l2a,C,172,184,12,LFAVMSGGLASV,0
5l2a,C,207,221,14,MAAPGGLLFAKLLV,0
5l2a,C,222,228,6,ETERTQ,0
5l2a,C,240,242,2,KP,0
5l2a,C,243,274,31,NVIDAAASGAVTGAQIAIAVGASLLAFVALI,0
5l2a,C,275,287,12,MINGIIGGVGGW,0
5l2a,C,295,310,15,QAILGWLFSPLAWVI,0
5l2a,C,366,384,18,ANLGSIAVLVGGLSIMAP,0
5l2a,C,385,386,1,R,0
5l2a,C,387,408,21,KDVARLGIKAVVAGSLSNLMS,0
5kbw,A,2,7,5,SIKKI,0
5kbw,A,8,28,20,FVGIFSALATLVMFLEFPIF,0
5kbw,A,35,48,13,YDPSEIPALIVSF,0
5kbw,A,49,51,2,LG,0
5kbw,A,52,71,19,GVGMFVVLVKDILFFLMKS,0
5kbw,A,75,94,19,GIAMNAVLGMSFVGIAGLI,0
5kbw,A,95,105,10,HRNKSRATAI,0
5kbw,A,106,123,17,GMIVATLFATAFALGLN,0
5kbw,A,143,163,20,FILAFNLVKFGIDSVVTFFV,0
5kbw,A,164,171,7,KKVSSIL,0
5uj9,A,215,220,5,LSRIT,0
5uj9,A,225,233,8,GMMVQGYR,0
5uj9,A,330,346,16,FKAVHDLMMFAGPEIL,0
5uj9,A,347,367,20,LLINFVNDKKAPEWQGYFYT,0
5uj9,A,368,382,14,LLFISACLQTLVLH,0
5uj9,A,446,459,13,APLQVILALYLLW,0
5uj9,A,460,464,4,NLGP,0
5uj9,A,465,480,15,VLAGVAVMVLMVPLN,0
5uj9,A,548,564,16,GTFTWVCTPFLVALST,0
5uj9,A,565,583,18,AVYVTVDENNILDAQKAF,0
5uj9,A,584,599,15,SLALFNILRFPLNIL,0
5uj9,A,959,969,10,SVYWDYMKAI,0
5uj9,A,972,992,20,ISFLSIFLFLCNHVASLVSN,0
5uj9,A,993,1019,26,WLSLWTDDPIVNGTQEHTQVRLSVYG,0
5uj9,A,1020,1036,16,LGISQGITVFGYSMAV,0
5uj9,A,1091,1108,17,MFMGSLFNVIGACIIIL,0
5uj9,A,1109,1114,5,ATPMA,0
5uj9,A,1115,1129,14,VIIPPLGLIYFFVQ,0
5uj9,A,1200,1214,14,RLECVGNCIVLFAS,0
5uj9,A,1215,1232,17,FAVISRHSLSAGLVGLS,0
5uj9,A,1233,1247,14,SYSLQVTTYLNWLV,0
4xee,A,50,60,10,PNSDLDVNTD,0
4xee,A,61,86,25,YSKVLVTAIYLALFVVGTVGNSVTL,0
4xee,A,106,131,25,GSLALSDLLILLLAMPVELYNFIWV,0
4xee,A,132,135,3,HPW,0
4xee,A,136,165,29,FGDAGCRGYYFLRDACTYATALNVASLSV,0
4xee,A,189,209,20,ISAIWLASALLAIPMLFTMG,0
4xee,A,210,233,23,QNRSADGTHPGGLVCTPIVDTAT,0
4xee,A,234,259,25,KVVIQVNTFMSFLFPMLVISILNTV,0
4xee,A,309,333,24,LRAVVIAFVVCWLPYHVRRLMFCY,0
4xee,A,334,347,13,SDEQWTTFLFDFY,0
4xee,A,348,370,22,YFYMLTNALFYASSAINPILYN,0
2klu,A,364,373,9,PLVPRGSMA,0
2klu,A,374,397,23,IVLGGVAGLLLFIGLGIFFSVRS,0
4zp0,A,9,19,10,RLGRQALLFP,0
4zp0,A,20,40,20,CLVLYEFSTYIGNDMIQPGM,0
4zp0,A,55,73,18,TSMTAYLAGGMFLQWLLG,0
4zp0,A,74,83,9,LSDRIGRRP,0
4zp0,A,84,102,18,MLAGVVWFIVTCLAILLA,0
4zp0,A,107,126,19,FTLLRFLQGISLCFIGAVG,0
4zp0,A,127,144,17,AAIRESFEEAVCIKITA,0
4zp0,A,145,165,20,MANVALIAPLLGPLVGAAWI,0
4zp0,A,171,190,19,GMFVLFAALAAISFFGLQR,0
4zp0,A,191,204,13,MPETATRIGEKLS,0
4zp0,A,205,216,11,KELGRDYKLVL,0
4zp0,A,217,222,5,NGRFV,0
4zp0,A,223,243,20,GALALGFVSLPLLAWIAQSP,0
4zp0,A,256,275,19,YGLLQVPIFGALIAGNLLL,0
4zp0,A,276,287,11,RLTSRRTVRSL,0
4zp0,A,288,307,19,IMGGWPIMIGLLVAAAATV,0
4zp0,A,314,335,21,WMTAGLSIYAFGIGLANAGLV,0
4zp0,A,336,350,14,LTLFASDMSKGTVS,0
4zp0,A,351,372,21,AMGMLQMLIFTVGIEISKHAW,0
4zp0,A,378,398,20,LFNLFNLVNGILWLSLMVIF,0
4zp0,A,399,400,1,K,0
1bzk,A,3,12,9,YYLSDITDA,0
1bzk,A,13,18,5,SPQVL,0
1bzk,A,19,41,22,AVIFIYFAALSPAITFGGLLGE,0
5u1x,C,21,30,9,SSTNYGTIK,0
5u1x,C,33,48,15,HALVFSYISFALISD,0
5u1x,C,49,329,280,RYQKKEPLISSVHTKVKGIAEVKAEILENGMKKMVSGVFDTADYTFPLQGNSFFVMTNFIKTEGQQQGLCPDFPTARTICSSDRGCKKGRMDPQSKGIQTGRCVVYKERLKTCEVSAWCPIEEVKDAPRPALLNSAENFTVLIKNNIDFPGHNYTTRNILPGVNITCTFHKTQNPQCPIFRLGDIFQETGDSFSDVAIQGGIMGIEIYWDCNLDGWFHHCRPKYSFRRLDDKTTSESLYPGYNFRYAKYYKENNVEKRTLIKVFGIRFDILVFGTGGKFN,0
5u1x,C,330,348,18,IQLAVYIGSVISYFGLAT,0
5u1x,C,352,362,10,ILINTYSASS,0
5b1b,Z,17,36,19,GLSVTFLSFLLPAGWVLYH,0
5b1b,Z,37,43,6,DNYKKS,0
2lj2,A,13,19,6,GTTLVA,0
2lj2,A,20,41,21,SSFTPVLVILLGVVGLSALTG,0
2lj2,A,47,67,20,LPALAIFIGLTIYAIQRKRQ,0
2lj2,A,68,72,4,DASS,0
4xk8,4,95,111,16,LVNGRWAMLGVAGMLL,0
4xk8,4,112,140,28,EVFTSIGIINVPKWYAAGKEEYFASSST,0
4xk8,4,141,154,13,FVIEFILFHYVEI,0
4xk8,4,204,220,16,IANGRLAMLAFLGFII,0
4xk8,4,221,228,7,HNVTGKG,0
4xk8,4,229,238,9,FDNLLQHIS,0
4xk8,4,239,249,10,PWHNTIVQTL,0
5b2n,A,2,17,15,NIESLFDYSAGQFEF,0
5b2n,A,18,41,23,DHLLTMGVGVHFAALIFFLVVSQ,0
5b2n,A,48,70,22,IATALSCIVMVSAGLILNSQAV,0
5b2n,A,71,92,21,WTDAYAYVDGSYQLQDLTFSN,0
5b2n,A,93,114,21,YRYVNWMATIPCLLLQLLIVL,0
5b2n,A,121,143,22,FSTATWLILAAWGMIITGYVGQ,0
5b2n,A,144,152,8,YEVDDIAQ,0
5b2n,A,153,176,23,MIWGAVSTAFFVVMNWIVGTKIF,0
5b2n,A,190,210,20,TKVFWLMMFAWTLYPIAYLV,0
5b2n,A,211,221,10,AFMNNADGVV,0
5b2n,A,222,246,24,RQLLFTIADISSKVIYGLMITYIA,0
5b2n,A,256,263,7,PAQQALG,0
3ae8,D,39,61,22,SLHWTGERVVSVLLLGLLPAAY,0
3ae8,D,62,67,5,NPCSA,0
3ae8,D,68,92,24,DYSLAAALTLHGHWGIGQVVTDYV,0
3ae8,D,97,117,20,QKAAKAGLLALSAFTFAGLC,0
3ae8,D,118,125,7,FNYHDVG,0
3ae8,D,126,134,8,CKAVAMLW,0
3ae8,D,135,136,1,L,0
5iwt,D,327,349,22,FCVLGAIYVLYIICFTMCCVYR,0
5iwt,D,350,382,32,LKPRITNRTNPRDNTLLQQKLLQEAYVTPKDD,0
5iwt,D,383,408,25,RLVGELVSIVGAVIILLVEIPDIFR,0
5iwt,D,422,443,21,PFHVIIVTYAFMVLVTMVMRL,0
5iwt,D,444,448,4,NSDG,0
5iwt,D,449,470,21,VVPMSFALVLGWCNVMYFARG,0
5iwt,D,486,511,25,GDLMRFCWQMAVVILGFASAFYIIF,0
5iwt,D,512,524,12,TEDPDELGHFYD,0
5iwt,D,525,544,19,PMALFSTFELFLTIIDGPA,0
5iwt,D,545,551,6,YDVDLP,0
5iwt,D,552,576,24,MYSITYAAFAIIATLLMLNLLIAM,0
5iwt,D,584,606,22,AHERDELWRAQVVATTVMLERK,0
2b0x,A,17,41,24,FPIVYSIIFVLGVIANGYVLWVFA,0
2b0x,A,42,54,12,LYPCKKFNEIKI,0
2b0x,A,55,78,23,MVNLTMADMLFLITLPLWIVYYQ,0
2b0x,A,89,113,24,CNVAGCLFFINTYCSVAFLGVITY,0
2b0x,A,114,132,18,RFQAVTRPIKTAQANTRK,0
2b0x,A,133,154,21,GISLSLVIWVAIVGAASYFLI,0
2b0x,A,183,206,23,VLIIHIFIVFSFFLVFLIILFCN,0
2b0x,A,207,232,25,VIIRTLLMQPVQQQRNAEVKRRALW,0
2b0x,A,233,256,23,VCTVLAVFIICFVPHHVVQLPWT,0
2b0x,A,273,295,22,AHQVTLCLLSTNCVLDPVIYCF,0
2b0x,A,296,302,6,TKKFRK,0
2b0x,A,303,308,5,LTEKF,0
2b0x,A,309,342,33,SMRSSRKCSRATTDTVTEVVVPFNQIPGNSLKN,0
5lki,E,-679,89,768,NESVKEIPDVLKSQCGFNCLTDISHSSFNEFRQQVSEHLSWSETHDLYHDAQQAQKDNRLYEARILKRANPQLQNAVHLAILAPNAELIGYNNQFSGRASQYVAPGTVSSMFSPAAYLTELYREARNLHASDSVYYLDTRRPDLKSMALSQQNMDIELSTLSLSNELLLESIKTESKLENYTKVMEMLSTFRPSGATPYHDAYENVREVIQLQDPGLEQLNASPAIAGLMHQASLLGINASISPELFNILTEEITEGNAEELYKKNFGNIEPASLAMPEYLKRYYNLSDEELSQFIGKASNFGQQEYSNNQLITPVVNSSDGTVKVYRITREYTTNAYQMDVELFPFGGENYRLDYKFKNFYNASYLSIKLNDKRELVRTEGAPQVNIEYSANITLNTADISQPFEIGLTRVLPSGSWAYAAAKFTVEEYNQYSFLLKLNKAIRLSRATELSPTILEGIVRSVNLQLDINTDVLGKVFLTKYYMQRYAIHAETALILCNAPISQRSYDNQPSQFDRLFNTPLLNGQYFSTGDEEIDLNSGSTGDWRKTILKRAFNIDDVSLFRLLKITDHDNKDGKIKNNLKNLSNLYIGKLLADIHQLTIDELDLLLIAVGEGKTNLSAISDKQLATLIRKLNTITSWLHTQKWSVFQLFIMTSTSYNKTLTPEIKNLLDTVYHGLQGFDKDKADLLHVMAPYIAATLQLSSENVAHSVLLWADKLQPGDGAMTAEKFWDWLNTKYTPGSSEAVETQEHIVQYCQALAQLEMVYHST,0
5lki,E,144,144,0,VNA,0
5lki,E,158,158,0,N,0
5lki,E,161,161,0,EQ,0
5lki,E,163,163,0,AMN,0
5lki,E,178,178,0,H,0
5lki,E,1178,1192,14,KQTGNSKDGYQTET,0
5lki,E,1306,1579,273,AEDYEIPSSVSSRKDYGWGDYYLSMVYNGDIPTINYKAASSDLKIYISPKLRIIHNGYEGQKRNQCNLMNKYGKLGDKFIVYTSLGVNPNNSSNKLMFYPVYQYSGNTSGLNQGRLLFHRDTTYPSKVEAWIPGAKRSLTNQNAAIGDDYATDSLNKPDDLKQYIFMTDSKGTATDVSGPVEINTAISPAKVQIIVKAGGKEQTFTADKDVSIQPSPSFDEMNYQFNALEIDGSGLNFINNSASIDVTFTAFAEDGRKLGYESFSIPVTLKVS,0
5lki,E,1697,1701,4,PLNQ,0
5lki,E,1914,1946,32,TQNAHDSAIVALRQNIPTPAPLSLRSANTLTD,0
5lki,E,2120,2144,24,AAGLTTAVQASRLAGAAADLVPNI,0
5lki,E,2145,2151,6,GFAGGG,0
5lki,E,2152,2173,21,RWGAIAEATGYVMEFSANVMN,0
2iub,E,-11,4,15,GSDKIHHHHHHMEEK,0
2iub,E,294,310,16,TIIATIFMPLTFIAGI,0
2iub,E,311,312,1,G,0
2iub,E,313,326,13,NFEYMPELRWKWG,0
2iub,E,327,331,4,PVVL,0
2iub,E,332,347,15,VMGVIAVIMVVYFKK,0
2iub,E,350,351,1,L,0
4mqx,B,1,17,16,KTDTPSLETPQAARLR,0
4mqx,B,37,61,24,MAAVVGTLVGLAAVAFDKGVAWLQ,0
4mqx,B,62,83,21,QRMGALVHTADNYPLLLTVAF,0
4mqx,B,84,97,13,ASAVLAMFGYFLV,0
4mqx,B,129,142,13,VKFFGGLGTLGGG,0
4mqx,B,144,156,12,LGREGPTVQIGG,0
4mqx,B,181,203,22,AAAGLAAAFNAPLAGILFIIEE,0
4mqx,B,216,232,16,AVFIGVIMSTIMYRIF,0
4mqx,B,233,252,19,HEVALIDVGKLSDAPLNTL,0
4mqx,B,253,277,24,LYLILGIIFGIFGPIFNKWVLGMQ,0
4mqx,B,290,305,15,WVLMGGAIGGLAGLL,0
4mqx,B,306,337,31,FVAPATSGGGFNLIPIATAGNFSMGMLVFIF,0
4mqx,B,338,351,13,ARVITTLLSFSSG,0
4mqx,B,353,368,15,GGIFAPMLALGTVLG,0
4mqx,B,369,391,22,AFGMVAVELFPQYHLEAGTFAI,0
4mqx,B,392,415,23,GMGALLCASIRAPLTGIILVLEM,0
4mqx,B,416,422,6,DNYQLI,0
4mqx,B,423,439,16,PMIITGLGCTLLAQFT,0
4mqx,B,459,465,6,QLARSK,0
4q7c,B,-27,0,27,HHHHHHHHHHSSGVDLGTENLYFQSNA,0
4q7c,B,1,155,154,RLAYVKNHEIYGEKLLGLTLRERIEKTLQRAGFDVRFFDELSLEEAEDYLIILEPVLILERDLLLEGRKILVSDGFTVGYFFGGDFRTVFDGNLQSSIEKYLSLNNLESYEIWAIKLSNDNLKTAEKLLLSSLIKAKRTGLKPAYYDGWIAREI,0
4q7c,B,156,167,11,RKVSLRISRLL,0
4q7c,B,168,178,10,DTSVTPNQIT,0
4q7c,B,179,193,14,FSFFLSLVGSALFL,0
4q7c,B,199,214,15,TLLAGVIIQLHSIID,0
4q7c,B,215,237,22,CDGEIARLKFMESKYGAWLDGV,0
4q7c,B,238,252,14,DRYSDFIIVFSITY,0
4q7c,B,262,277,15,IIGFLAAFASLMIAY,0
4q7c,B,278,296,18,GDKFVAAYMRTYSPEGFA,0
4q7c,B,297,316,19,PITRDFRLLIIFACSVVNL,0
4q7c,B,318,337,19,LALVIIALLGNFEALRRIV,0
4q7c,B,338,341,3,LRS,0
4q7c,B,342,344,2,TN,0
3v2w,A,-17,16,33,KTIIALSYIFCLVFAGAPGPTSVPLVKAHRSSV,0
3v2w,A,17,39,22,DYVNYDIIVRHYNYTGKLNISA,0
3v2w,A,40,46,6,KENSIK,0
3v2w,A,47,50,3,TSV,0
3v2w,A,51,68,17,FILICCFIILENIFVLL,0
3v2w,A,84,101,17,GNLALSDLLAGVAYTAN,0
3v2w,A,102,121,19,LLSGATTYKLTPAQWFLRE,0
3v2w,A,122,138,16,SMFVALSASVFSLLAI,0
3v2w,A,149,155,6,KLHNGS,0
3v2w,A,162,178,16,LISACWVISLILGGLP,0
3v2w,A,179,201,22,MGWNCISALSSCSTVLPLYHKH,0
3v2w,A,202,219,17,ILFCTTVFTLLLLSIVI,0
3v2w,A,260,278,18,VLSVFIACWAPLFILLLL,0
3v2w,A,279,294,15,VGCKVKTCDILFRAE,0
3v2w,A,295,311,16,FLVLAVLNSGTNPIIY,0
3v2w,A,316,323,7,EMRRAFI,0
3v2w,A,326,355,29,GRPLEVLFQGPHHHHHHHHHHDYKDDDDK,0
4ycr,C,14,26,12,GIPLGLAALSLA,0
4ycr,C,27,40,13,FHLENLFPAARMV,0
4ycr,C,41,58,17,DVLGIVASAVWILFILM,0
4ycr,C,67,75,8,EEVRAEYH,0
4ycr,C,84,97,13,LIPITTMLVGDIL,0
4ycr,C,98,104,6,RWNPLI,0
4ycr,C,105,122,17,EVLIWIGTIGQLLFSTL,0
4ycr,C,144,154,10,PAVAANFTSA,0
4ycr,C,156,165,9,LALLGYHDL,0
4ycr,C,166,182,16,YLFFGAGMIAWIIFEP,0
4ycr,C,203,215,12,VLAPAFVCVSAY,0
4ycr,C,216,226,10,SINHGEVDTL,0
4ycr,C,227,243,16,KILWGYGFLQLFFLLR,0
4ycr,C,258,271,13,AFSFGLASMANSA,0
4ycr,C,272,283,11,AFYHGNVLQGV,0
4ycr,C,284,304,20,IFAFVFSNVMIGLLVLMTIY,0
2at9,C,1,5,4,QITG,0
2at9,C,6,12,6,PEWIWL,0
2at9,C,13,29,16,LGTALMGLGTLYFLVK,0
2at9,C,46,60,14,LVPAIAFTMYLSML,0
2at9,C,61,80,19,GYGLTMVPFGGEQNPIYWA,0
2at9,C,81,94,13,YADWLFTTPLLLL,0
2at9,C,111,126,15,GADGIMIGTGLVGAL,0
2at9,C,127,135,8,KVYSYRFV,0
2at9,C,136,150,14,WAISTAAMLYILYV,0
2at9,C,177,190,13,VVLWSAYPVVWLI,0
2at9,C,191,204,13,SEGAGIVPLNIET,0
2at9,C,205,221,16,LFMVLDVSAKVGFGLI,0
2at9,C,228,248,20,FGEAEAPEPSAGDGAAATS,0
4rp9,B,7,29,22,FTVFFNQVMTNAPLLLGIVTCL,0
4rp9,B,46,70,24,KTIIGFMLLQAGSGILTSTFKPVV,0
4rp9,B,71,104,33,KMSEVYGINGAISDTYASMMATIDRMGDAYSWV,0
4rp9,B,105,122,17,YAVLLALALNICYVLLR,0
4rp9,B,128,145,17,TIMLTGHIMFQQAGLIA,0
4rp9,B,146,159,13,TLFIFGYSMWTTI,0
4rp9,B,160,177,17,CTAILVSLYWGITSNMM,0
4rp9,B,178,185,7,KPTQEVT,0
4rp9,B,192,204,12,GHQQQFASWIAY,0
4rp9,B,224,230,6,WLNIFH,0
4rp9,B,233,251,18,VSTAIVMTIFFGAILLSF,0
4rp9,B,253,260,7,DTVQAMA,0
4rp9,B,261,263,2,KV,0
4rp9,B,264,287,23,WTVYILQTGFSFAVAIFIITQGV,0
4rp9,B,288,304,16,MFVAELSEAFNGISQR,0
4rp9,B,311,320,9,AIDCAAIYS,0
4rp9,B,324,343,19,AVVWGFMWGTIGQLIAVGI,0
4rp9,B,344,355,11,VACGSSILIIP,0
4rp9,B,356,371,15,FIPMFFSNATIGVFA,0
4rp9,B,378,395,17,AALKICLVMGMIEIFGC,0
4rp9,B,396,407,11,WAVKLTGMSAW,0
4rp9,B,408,424,16,GMADWSILAPPMMQGF,0
4rp9,B,425,429,4,SIGI,0
4rp9,B,430,444,14,FMAVIIVIALAYMF,0
3wo6,A,25,28,3,QDP,0
3wo6,A,29,40,11,TSESEGIWNHF,0
3wo6,A,42,55,13,YPMSWLITTVANL,0
3wo6,A,56,64,8,NGSYGLSI,0
3wo6,A,65,87,22,IVTILIRLALLPLTLKQQKSMR,0
3wo6,A,88,103,15,MQVIRPEMEAIQKKY,0
3wo6,A,111,128,17,KVQQEMQKELLGLYQKH,0
3wo6,A,132,149,17,MAGCLPLFIQLPILMAF,0
3wo6,A,150,177,27,FAIMRTEEIRYHTFLWFDLGQPDYILP,0
3wo6,A,178,194,16,VAGITTYFQFKMTMSH,0
3wo6,A,195,214,19,QQMQKTNPSDSDNPMANMM,0
3wo6,A,216,233,17,QMKVMLYVMPVMIIIAG,0
3wo6,A,234,240,6,SLPSAL,0
3wo6,A,241,256,15,LYWVIGNIFMIIQTY,0
3wo6,A,257,266,9,IVVKAPPLE,0
3rqu,E,1,10,9,PADNAADAR,0
3rqu,E,11,210,199,VDVSVSIFINKIYGVNTLEQTYKVDGYIVAQWTGKPRKTPGDKPLIVENTQIERWINNGLWVPALEFINVVGSPDTGNKRLMLFPDGRVIYNARFLGSFSNDMDFRLFPFDRQQFVLELEPFSYNNQQLRFSDIQVYTENIDNEEIDEWWIRGKASTHISDIRYDHLSSVQPNQNEFSRITVRIDAVRNPSYYLWSFIL,0
3rqu,E,211,225,14,LGLIIAASWSVFWL,0
3rqu,E,231,245,14,LQTSFTLMLTVVAY,0
3rqu,E,246,265,19,FYTSNILPRLPYTTVIDQM,0
3rqu,E,266,282,16,IAGYGSIFAAILLIIF,0
3rqu,E,299,315,16,CRLAFPLGFLAIGCVL,0
3rqu,E,316,317,1,I,0
3rqu,E,318,322,4,GITL,0
1oed,E,222,244,22,IINIIAPCVLISSLVVLVYFLP,0
1oed,E,245,252,7,QAGGQKC,0
1oed,E,253,273,20,LSISVLLAQTIFLFLIAQKV,0
1oed,E,286,309,23,LIFVMFVSMLIVMNCVIVLNVSL,0
1oed,E,310,311,1,T,0
1oed,E,312,443,131,NTHSLSEKIKHLFLGFLPKYLGMQLEPSEETPEKPQPRRRSSFGIMIKAEEYILKKPRSELMFEEQKDRHGLKRVNKMTSDIDIGTTVDLYKDLANFAPEIKSCVEACNFIAKSTKEQNDSGSENENWVLI,0
1oed,E,444,449,5,KVIDK,0
1oed,E,450,473,23,CFWIALLLFSIGTLAIFLTGHFN,0
1h6i,A,1,8,7,ASEFKKK,0
1h6i,A,9,13,4,FWRA,0
1h6i,A,14,32,18,VAEFLATTLFVFISIGSA,0
1h6i,A,50,68,18,KVSLAFGLSIATLAQSVG,0
1h6i,A,69,71,2,IS,0
1h6i,A,72,86,14,AHLNPAVTLGLLLS,0
1h6i,A,87,93,6,QISIFR,0
1h6i,A,94,114,20,LMYIIAQCVGAIVATAILSG,0
1h6i,A,139,156,17,GIEIIGTLQLVLCVLAT,0
1h6i,A,157,167,10,DRRRRDLGGS,0
1h6i,A,168,184,16,PLAIGLSVALGHLLAI,0
1h6i,A,188,202,14,CGINPARSFGSAVI,0
1h6i,A,210,231,21,IFWVGPFIGGALAVLIYDFIL,0
1h6i,A,232,233,1,P,0
1h6i,A,234,269,35,SSDLTDRVKVWTSGQVEEYDLDADDINSRVEMKPK,0
5tl9,C,5,15,10,LVMSSPALPA,0
5tl9,C,16,32,16,LLCSTLLVIKMYVVAI,0
5tl9,C,73,90,17,NDMETIYPFLFLGFVYS,0
5tl9,C,91,98,7,LGPNPFV,0
5tl9,C,99,115,16,WMHFLVFLVGRVAHTV,0
5tl9,C,127,146,19,VTYTLAQLPCASMALQILW,0
5tl9,C,147,152,5,AARHL,0
2vt4,A,31,39,8,GAELLSQQ,0
2vt4,A,41,63,22,AGMSLLMALVVLLIVAGNVLVI,0
2vt4,A,82,103,21,LACADLVVGLLVVPFGATLVV,0
2vt4,A,104,107,3,GTW,0
2vt4,A,108,133,25,WGSFLCELWTSLDVLCVTASIETLC,0
2vt4,A,163,184,21,TVWAISALVSFLPIMMHWWRD,0
2vt4,A,185,186,1,D,0
2vt4,A,187,194,7,QALKCYQ,0
2vt4,A,195,199,4,PGCC,0
2vt4,A,200,225,25,FVTNRAYAIASSIISFYIPLLIMIF,0
2vt4,A,239,253,14,KIDRASKRKRVMLM,0
2vt4,A,294,316,22,IMGVFTLCWLPFFLVNIVNVFN,0
2vt4,A,317,322,5,DLVPD,0
2vt4,A,323,342,19,LFVAFNWLGYANSAMNPII,0
2vt4,A,347,356,9,DFRKAFKRL,0
2vt4,A,359,373,14,PRKADRRLHHHHHH,0
4y7j,E,7,14,7,KEFLYEY,0
4y7j,E,20,40,20,IAFIMGIASTALIKSFVDNI,0
4y7j,E,41,53,12,MPIITPFVPGGG,0
4y7j,E,56,60,4,ATVE,0
4y7j,E,61,63,2,GP,0
4y7j,E,67,68,1,W,0
4y7j,E,69,89,20,AFLGELVNFIIIAFAVFIIA,0
5avy,G,4,24,20,GPDNDERFTYDYYRLRVVGL,0
5avy,G,25,40,15,VAAVLCVIGIIILLA,0
4wab,B,10,15,5,PALPA,0
4wab,B,16,32,16,LLCSTLLVIKMYVVAI,0
4wab,B,73,90,17,NDMETIYPFLFLGFVYS,0
4wab,B,91,98,7,LGPNPFV,0
4wab,B,99,115,16,WMHFLVFLVGRVAHTV,0
4wab,B,129,146,17,YTLAQLPCASMALQILW,0
4wab,B,147,170,23,AARHFLPAALRAALLGRLRTLRP,0
1dxr,M,1,53,52,DYQTIYTQIQARGPHITVSGEWGDNDRVGKPFYSYWLGKIGDAQIGPIYLGA,0
1dxr,M,54,70,16,GIAAFAFGSTAILIIL,0
1dxr,M,81,87,6,LQFFRQ,0
1dxr,M,116,132,16,GLFMTLSLGSWWIRVY,0
1dxr,M,133,144,11,RARALGLGTHI,0
1dxr,M,145,162,17,WNFAAAIFFVLCIGCIH,0
1dxr,M,177,190,13,WPHIDWLTAFSIR,0
1dxr,M,198,216,18,WHGFSIGFAYGCGLLFAA,0
1dxr,M,217,266,49,GATILAVARFGGDREIEQITDRGTAVERAALFWRWTIGFNATIESVHRW,0
1dxr,M,267,284,17,WFFSLMVMVSASVGILL,0
1dxr,M,292,298,6,YLWCVK,0
3wak,A,1,4,3,QNA,0
3wak,A,8,24,16,KKYWHLSVLVIAALIS,0
3wak,A,25,83,58,KLRILNPWNSVFTWTVRLGGNDPWYYYRLIENTIHNFPHRIWFDPFTYYPYGSYTHFG,0
3wak,A,84,96,12,FLVYLGSIAGII,0
3wak,A,97,117,20,SATSGESLRAVLAFIPAIGG,0
3wak,A,118,134,16,LAILPVYLLTREVFDK,0
3wak,A,136,147,11,AVIAAFLIAIV,0
3wak,A,148,166,18,GQFLQRSILGFNDHHIWE,0
3wak,A,167,181,14,FWQVSALGTFLLAY,0
3wak,A,199,212,13,YPVIAGITIGLYV,0
3wak,A,213,218,5,SWGAG,0
3wak,A,219,232,13,IIAPIILAFMFFA,0
3wak,A,247,262,15,LVAVVTFAVSALIYL,0
3wak,A,263,280,17,FAFNYPGFSTIFYSPFQ,0
3wak,A,281,294,13,LVLLGSAVIAAAF,0
3wak,A,321,335,14,VLTALIMGLFFVIS,0
3wak,A,336,337,1,D,0
3wak,A,338,346,8,ARNLLSVV,0
3wak,A,347,374,27,VVQPKGGALTIAEVYPFFFTHNGEFTL,0
3wak,A,375,381,6,NAVLHF,0
3wak,A,382,397,15,ALFFFGMAGILYSAY,0
3wak,A,407,421,14,MALLIWAIAMFIAL,0
3wak,A,422,430,8,GQNRFAYY,0
3wak,A,431,447,16,AAVSAVYSALALSVVF,0
3wak,A,470,486,16,VAFALLIALAAIYPTY,0
3wak,A,487,868,381,LADAQSSYAGGPNKQWYDALTWMRENTPDGEKYDEYYLQLYPTPQSNKEPFSYPFETYGVISWWDYGHWIEAVAHRMPIANPFQAGIGNKYNNVPGASSFFTAENESYAEFVAEKLNVKYVVSDIEMETGKYYAMAVWAEGDLPLAEKYYGGYFYYSPTGTFGYANSQWDIPLNSIIIPLRIPSELYYSTMEAKLHLFDGSGLSHYRMIYESDYPAEWKSYSSQVNLNNESQVLQTALYEAVMRARYGVSPTMGTQEVLYKYAYTQLYEKKMGIPVKIAPSGYVKIFERVKGAVVTGKVSANVTEVSVNATIKTNQNRTFEYWQTVEVKNGTYTVVLPYSHNSDYPVKPITPYHIKAGNVVKEITIYESQVQNGEIIQLDL,0
3wak,A,869,875,6,LALVPR,0
4w6v,A,19,39,20,LSGLFLSEMWERFSFYGIRP,0
4w6v,A,40,62,22,LILFMAATVFDGGMGLPREQAS,0
4w6v,A,63,83,20,IVGIFAGSMYLAALPGGLLA,0
4w6v,A,90,107,17,RAVWYGSILIALGHLSI,0
4w6v,A,108,119,11,LSAFFGNDLFF,0
4w6v,A,120,140,20,GLVFIVLGTGLFKTCISVMV,0
4w6v,A,155,172,17,SLFYMGINMGSFIAPLL,0
4w6v,A,173,187,14,GWLLRTHGWHWGFG,0
4w6v,A,188,207,19,GGIGMLVALLIFRGFAIPA,0
4w6v,A,233,250,17,WVTAIMAVVVVIIALIS,0
4w6v,A,251,258,7,GVIPINP,0
4w6v,A,259,278,19,MIASLLVYVIAASVTLYFI,0
4w6v,A,298,318,20,ILLVSAAFFWSAFEQKPTSF,0
4w6v,A,319,339,20,LFANDYTDRMVMGFEIPTVW,0
4w6v,A,340,358,18,QSINALFIILLAPVFSWA,0
4w6v,A,372,390,18,TKFVIGILCAAAGFAVMM,0
4w6v,A,391,408,17,AAQHVLSSGGAGVSPLW,0
4w6v,A,409,428,19,VMSILLLTLGELCLSPIGL,0
4w6v,A,444,462,18,GLWFCASSLGNLAAGLIG,0
4w6v,A,463,476,13,HVKADQLDMLPTL,0
4w6v,A,477,494,17,ARCSIALVICAAVLILL,0
3w5d,A,49,54,5,WELVI,0
3w5d,A,55,74,19,QFEDLLVRILLLAACISFV,0
3w5d,A,75,88,13,AWFEEGEETITAF,0
3w5d,A,89,108,19,EPFVILLILIANAIVGVWQ,0
3w5d,A,254,276,22,EFGEQLSKVISLICVAVWLINI,0
3w5d,A,277,295,18,HFNDPVHGGSWIRGAIYY,0
3w5d,A,296,317,21,KIAVALAVAAIPEGLPAVITT,0
3w5d,A,760,781,21,IRYLISSNVGEVVCIFLTAAL,0
3w5d,A,782,785,3,LPE,0
3w5d,A,786,807,21,LIPVQLLWVNLVTDGLPATAL,0
3w5d,A,833,852,19,FFRYMAIGGYVGAATVGAA,0
3w5d,A,853,897,44,WWFMYAEDGPGVTYHQLTHFMQCTEDHPHFEGLDCEIFEAPEPM,0
3w5d,A,898,916,18,MALSVLVTIEMCNALNSL,0
3w5d,A,927,950,23,WVNIWLLGSICLSMSLHFLILYV,0
3w5d,A,952,957,5,LPMIF,0
3w5d,A,958,966,8,LKALDLTQ,0
3w5d,A,967,987,20,LMVLKISLPVIGLDEILKFI,0
2hpy,A,39,63,24,AAYMFLLIMLGFPINFLTLYVTVQ,0
2hpy,A,64,72,8,KKLRTPLN,0
2hpy,A,73,99,26,ILLNLAVADLFMVFGGFTTTLYTSLH,0
2hpy,A,108,133,25,CNLEGFFATLGGEIALWSLVVLAIE,0
2hpy,A,134,153,19,YVVVCKPMSNFRFGENHAI,0
2hpy,A,154,181,27,GVAFTWVMALACAAPPLVGWSRYIPEG,0
2hpy,A,199,225,26,ESFVIYMFVVHFIIPLIVIFFCYGQL,0
2hpy,A,226,251,25,FTVKEAAAQQQESATTQKAEKEVTR,0
2hpy,A,252,277,25,VIIMVIAFLICWLPYAGVAFYIFTH,0
2hpy,A,288,309,21,IPAFFAKTSAVYNPVIYIMMN,0
2hpy,A,311,321,10,FRNCMVTTLC,0
2hpy,A,322,348,26,GKNPLGDDEASTTVSKTETSQVAPA,0
4gd3,B,1,7,6,QQKSDN,0
4gd3,B,8,18,10,VSHYVFEAPV,0
4gd3,B,19,37,18,IWHWLTVLCMAVLMVTGY,0
4gd3,B,63,80,17,FSAGMVFTVVLLMRIYW,0
4gd3,B,81,89,8,FVGNRYSR,0
4gd3,B,90,102,12,LFIVPVWRKSWW,0
4gd3,B,103,115,12,GVWYEIRWYLFL,0
4gd3,B,116,126,10,KRPSADIGHN,0
4gd3,B,127,129,2,IA,0
4gd3,B,130,149,19,AAMFGYFLMSVFMIITGFA,0
4gd3,B,160,173,13,APFRYVVEFFYWT,0
4gd3,B,184,204,20,RLGMWLIGAFVIGHVYMALR,0
4gd3,B,205,210,5,DIMSD,0
4gd3,B,211,235,24,TVISTMVNGYRSHKFGKISNKERS,0
1jv7,A,1,8,7,AQITGRP,0
1jv7,A,9,11,2,WI,0
1jv7,A,12,32,20,LALGTALMGLGTLYFLVKGM,0
1jv7,A,42,61,19,YAITTLVPAIAFTMYLSML,0
1jv7,A,62,63,1,G,0
1jv7,A,64,77,13,GLTMVPFGGEQNP,0
1jv7,A,78,80,2,YW,0
1jv7,A,81,100,19,RYASWLFTTPLLLLDLALL,0
1jv7,A,104,123,19,QGTILALVGADGIMIGTGL,0
1jv7,A,124,137,13,GALTKVYSYRFVW,0
1jv7,A,138,157,19,AISTAAMLYILYVLFFGFT,0
1jv7,A,171,189,18,KVLRNVTVVLWSAYPVVW,0
1jv7,A,190,205,15,IGSEGAGIVPLNIET,0
1jv7,A,206,225,19,LFMVLDVSAKVGFGLILLR,0
1jv7,A,233,249,16,EAPEPSAGDGAAATSD,0
3uzc,A,1,6,5,PIMGS,0
3uzc,A,11,29,18,VELAIAVLAILGNVLVCW,0
3uzc,A,30,44,14,VWLNSNLQNVTNYF,0
3uzc,A,45,63,18,VSLAAADILVGVLAIPFA,0
3uzc,A,83,99,16,VLVLAQSSIFSLLAIA,0
3uzc,A,100,122,22,DRYIAIAIPLRYNGLVTGTRAA,0
3uzc,A,123,138,15,IIAICWVLSFAIGLT,0
3uzc,A,150,157,7,EGKNHSQ,0
3uzc,A,177,196,19,VYFNFFACVLVPLLLMLGV,0
3uzc,A,197,235,38,LRIFAAARRQLKQMESQPLPGERARSTLQKEVHAAKSA,0
3uzc,A,236,252,16,IIAGLFALCWLPLHII,0
3uzc,A,272,288,16,AIVLAHTNSVVNPFIY,0
3uzc,A,289,292,3,YRI,0
3uzc,A,293,304,11,EFRQTFRKIIR,0
3uzc,A,306,329,23,VLRQQEPFKAAAAHHHHHHHHHH,0
4pgs,A,-2,5,7,NAMQATV,0
4pgs,A,18,37,19,VFVFTLLIATVGLFIGQFV,0
4pgs,A,38,41,3,VAL,0
4pgs,A,42,61,19,LPLSILEVAMIILAFWMRR,0
4pgs,A,66,86,20,YAFVYTFAFVSGITLFPIVS,0
4pgs,A,87,94,7,YASIAGA,0
4pgs,A,95,112,17,VVLEAFGSTFVIFAVLG,0
4pgs,A,126,144,18,SFLLVAVLALAVVGIFNI,0
4pgs,A,145,152,7,SPLNSAA,0
4pgs,A,153,171,18,MAYSVIGTIVFSLYILYD,0
4pgs,A,187,210,23,MALSLYLDFINLFINLLRFFGIL,0
4pgs,A,211,212,1,S,0
4pgs,A,213,214,1,D,0
2jiy,M,0,1,1,A,0
2jiy,M,55,74,19,GVLSLFSGLMWFFTIGIWF,0
2jiy,M,75,81,6,YQAGWN,0
2jiy,M,82,87,5,AVFLR,0
2jiy,M,88,114,26,LFFFSLEPPAPEYGLSFAAPLKEGGL,0
2jiy,M,115,133,18,LIASFFMFVAVWSWWGRT,0
2jiy,M,147,168,21,WWFLSAIWLWMVLGFIRPILM,0
2jiy,M,169,178,9,SWSEAVPYG,0
2jiy,M,179,192,13,FSHLDWTNNFSLV,0
2jiy,M,193,196,3,GNL,0
2jiy,M,197,221,24,YNPFHGLSIAFLYGSALLFAMHGA,0
2jiy,M,269,287,18,IWMAVLVTLTGGIGILLS,0
2jiy,M,288,293,5,TVVDN,0
2jiy,M,294,300,6,YVWGQN,0
2jiy,M,301,302,1,G,0
2jiy,M,303,307,4,APLN,0
5fij,W,10,12,2,TP,0
5fij,W,13,26,13,ILGLPLVTLIVLF,0
5fij,W,77,89,12,FIGSTNLLGLLP,0
5fij,W,90,91,1,S,0
5fij,W,92,110,18,TPTTQLSMNLGMAIPLWA,0
5fij,W,150,168,18,IQPMALAVRLTANITAGH,0
5fij,W,169,193,24,LIHLIGGATLALMSISTTTALITF,0
5fij,W,194,212,18,ILILLTILEFAVAMIQAY,0
1mgy,A,1,3,2,AQ,0
1mgy,A,4,12,8,TGRPEWIW,0
1mgy,A,13,31,18,ALGTALMGLGTLYFLVKG,0
1mgy,A,42,60,18,YAITTLVPAIAFTMYLSM,0
1mgy,A,61,64,3,LGY,0
1mgy,A,65,77,12,LTMVPFGGEQNP,0
1mgy,A,78,81,3,YWA,0
1mgy,A,82,100,18,YASWLFTTPLLLLDLALL,0
1mgy,A,104,123,19,QGTILALVGADGIMIGTGL,0
1mgy,A,124,138,14,GALTKVYSYRFVWW,0
1mgy,A,139,157,18,ISTAAMLYILYVLFFGFT,0
1mgy,A,171,189,18,KVLRNVTVVLWSAYPVVW,0
1mgy,A,190,206,16,IGSEGAGIVPLNIETL,0
1mgy,A,207,225,18,FMVLDVSAKVGFGLILLR,0
1mgy,A,233,249,16,EAPEPSAGDGAAATSD,0
4k1c,A,-4,21,25,PSSPMDATTPLLTVANSHPARNPKH,0
4k1c,A,22,24,2,AW,0
4k1c,A,25,34,9,AAVYDLQYI,0
4k1c,A,35,52,17,KASPLNFLLVFVPLGLI,0
4k1c,A,65,86,21,FNFLAIIPLAAILANATEELA,0
4k1c,A,87,92,5,KAGNT,0
4k1c,A,93,112,19,GGLLNATFGNAVELIVSII,0
4k1c,A,123,144,21,ASMLGSLLSNLLLVLGLCFIF,0
4k1c,A,145,159,14,GYNRVQQTFNQTAA,0
4k1c,A,160,176,16,TMSSLLAIACASLLIP,0
4k1c,A,185,190,5,GKEDH,0
4k1c,A,202,219,17,TSIVILIVYVLFLYFQL,0
4k1c,A,220,222,2,SH,0
4k1c,A,223,241,18,ALFEQQEEETDEVMSTIS,0
4k1c,A,242,250,8,NPHHSLSV,0
4k1c,A,251,269,18,SSLVILLGTTVIISFCAD,0
4k1c,A,275,281,6,DNVVES,0
4k1c,A,291,308,17,IVIPIVGNAAEHVTSVL,0
4k1c,A,309,318,9,AMKDKMDLA,0
4k1c,A,319,340,21,GVAIGSSLQVALFVTPFMVLV,0
4k1c,A,357,373,16,ATLFIAVFLSNYLILD,0
4k1c,A,374,376,2,ES,0
4k1c,A,377,394,17,WLEGVMSLAMYILIAMA,0
4k1c,A,402,416,14,TLDSIGNSLGLVPR,0
3ny9,A,-7,31,38,YKDDDDAMGQPGNGSAFLLAPNRSHAPDHDVTQQRDEV,0
3ny9,A,36,59,23,GIVMSLIVLAIVFGNVLVITAIA,0
3ny9,A,60,68,8,FERLQTVT,0
3ny9,A,69,91,22,YFITSLACADLVMGLAVVPFGA,0
3ny9,A,109,130,21,TSIDVLCVTASIWTLCVIAVD,0
3ny9,A,131,148,17,YFAITSPFKYQSLLTKN,0
3ny9,A,149,168,19,ARVIILMVWIVSGLTSFLP,0
3ny9,A,202,221,19,SSIVSFYVPLVIMVFVYSR,0
3ny9,A,222,274,52,FQEAKRQLNIFEMLRIDEGLRLKIYKDTEGYYTIGIGHLLTKSPSLNAAKSELDKAIGRNTNGVITKDEAEKLFNQDVDAAVRGILRNAKLKPVYDSLDAVRRAALINMVFQMGETGVAGFTNSLRMLQQKRWDEAAVNLAKSRWYNQTPNRAKRVITTFRTGTWDAYKFCLKEHKALKT,0
3ny9,A,275,294,19,GIIMGTFTLCWLPFFIVNI,0
3ny9,A,311,327,16,NWIGYVNSGFNPLIYC,0
3ny9,A,328,329,1,S,0
3ny9,A,330,340,10,DFRIAFQELL,0
3ny9,A,341,342,1,L,0
3ny9,A,343,354,11,RSSLKHHHHHH,0
4u9l,B,271,277,6,VYSEAG,0
4u9l,B,278,305,27,VALWLARVRWLVILILTGMVTSSILQG,0
4u9l,B,307,312,5,SVLEA,0
4u9l,B,318,338,20,YVPVLLGTGGNTGNQSATLI,0
4u9l,B,339,352,13,RALATRDLDLRDW,0
4u9l,B,353,381,28,RVFLKEMGVGLLLGLTLSFLLVGKVYWD,0
4u9l,B,388,412,24,VVGVSLVLIVFFANLVGAMLPFLL,0
4u9l,B,413,421,8,RLGVDPAL,0
4u9l,B,422,443,21,SNPLVATLSDVTGLLIYLSVA,0
1m0m,C,-12,4,16,LELLPTAVEGVSQAQI,0
1m0m,C,5,10,5,GRPEW,0
1m0m,C,11,28,17,WLALGTALMGLGTLYFL,0
1m0m,C,47,62,15,LVPAIAFTMYLSMLL,0
1m0m,C,63,79,16,YGLTMVPFGGEQNPIY,0
1m0m,C,80,94,14,ARYADWLFTTPLLL,0
1m0m,C,112,127,15,GADGIMIGTGLVGAL,0
1m0m,C,128,133,5,KVYSY,0
1m0m,C,134,149,15,FVWWAISTAAMLYIL,0
1m0m,C,157,161,4,SKAE,0
1m0m,C,178,192,14,VVLWSAYPVVWLIG,0
1m0m,C,193,203,10,EGAGIVPLNI,0
1m0m,C,204,220,16,TLLFMVLDVSAKVGFG,0
1m0m,C,232,249,17,AEAPEPSAGDGAAATSD,0
4l6v,K,1,47,46,TAIARERGRSKRGIALHRLEYLKENQVFEIIFGEPLSMFNTALLLA,0
4l6v,K,57,73,16,LSVGIIMCLCNVFAFV,0
4l6v,K,74,102,28,GYFAIQKTGKGKDLALPQLASKKTFGLP,0
4l6v,K,103,122,19,LLATMSFGHILGAGMVLGL,0
3k08,E,18,22,4,AKDK,0
3k08,E,26,45,19,LFVLTILTLISGTIFYSTV,0
3k08,E,46,50,4,GLRP,0
3k08,E,51,70,19,DALYFSVVTLTTVGNTPPP,0
3k08,E,71,73,2,TD,0
3k08,E,74,98,24,GKIFTILYIFIGIGLVFGFIHKLA,0
3k08,E,102,110,8,LPSILSNL,0
5xar,B,16,22,6,DLLGFK,0
5xar,B,23,42,19,FGMPLPLYAFALITLLLSH,0
5xar,B,51,73,22,VGGFAIMFIIGAIFGEIGKRLP,0
5xar,B,75,93,18,NKYIGGAPVMIFLVAAYF,0
5xar,B,101,111,10,KEIDAISNVM,0
5xar,B,115,131,16,FLNLFIAVLITGAILS,0
5xar,B,132,133,1,N,0
5xar,B,134,145,11,RLLLKSLLGYI,0
5xar,B,146,166,20,TILMGIVGASIFGIAIGLVF,0
5xar,B,174,196,22,MLYVLPIMGGGNGAGAVPLSEI,0
5xar,B,210,226,16,TAIAILTIANIFAIVF,0
5xar,B,227,237,10,AVLDIIGKKH,0
5xar,B,260,265,5,GQITH,0
5xar,B,266,286,20,ETAVGLVLSTTCFLLAYVVA,0
5xar,B,299,317,18,YFAWMVLIVAALNASGLC,0
5xar,B,318,324,6,PEIKAG,0
5xar,B,325,346,21,KRLSDFFSKQLLWVLMVGVGV,0
5xar,B,358,380,22,TFANVVIAAIIVIGAVLGAAIG,0
5xar,B,381,395,14,WLMGFFPIESAITA,0
5xar,B,396,407,11,LCMANRGGSGD,0
5xar,B,408,424,16,EVLSACNRMNLISYAQ,0
5xar,B,425,441,16,SSRLGGGIVLVIASIV,0
2qju,A,5,15,10,EHWATRLGLI,0
2qju,A,16,35,19,AMAGNAVGLGNFLRFPVQA,0
2qju,A,44,63,19,IPYIIAFLLVGIPLMWIEW,0
2qju,A,64,88,24,MGRYGGAQGHGTTPAIFYLLWRNR,0
2qju,A,89,124,35,AKILGVFGLWIPLVVAIYYVYIESWTLGFAIKFLV,0
2qju,A,133,134,1,A,0
2qju,A,167,184,17,AYIVFLITMFINVSILI,0
2qju,A,185,190,5,GISKG,0
2qju,A,191,214,23,ERFAKIAMPTLFILAVFLVIRVF,0
2qju,A,223,230,7,ADGLNFL,0
2qju,A,242,265,23,VWIAAVGQIFFTLSLGFGAIITY,0
2qju,A,266,277,11,SYVRKDQDIVL,0
2qju,A,278,298,20,GLTAATLNEKAEVILGGSIS,0
2qju,A,309,317,8,NAVAIAKA,0
2qju,A,319,324,5,FNLGF,0
2qju,A,326,331,5,LPAIF,0
2qju,A,340,366,26,GFLWFFLLFFAGLTSSIAIMQPMIAF,0
2qju,A,367,377,10,EDELKLSRKH,0
2qju,A,378,396,18,VLWTAAIVFFSAHLVMFL,0
2qju,A,400,426,26,DEMDFWAGTIGVVFFGLTELIIFFWI,0
2qju,A,427,428,1,G,0
2qju,A,429,437,8,DKAWEEIN,0
2qju,A,438,444,6,GGIIKV,0
2qju,A,445,469,24,RIYYYVMRYITPAFLAVLLVVWAR,0
2qju,A,472,477,5,PKIME,0
2qju,A,484,502,18,ITRFYIIGLFLFLTFLVF,0
2qju,A,503,515,12,AERRRNHESAGT,0
3ehz,E,0,6,6,QDMVSP,0
3ehz,E,198,216,18,NIILPMLFILFISWTAFW,0
3ehz,E,217,220,3,TSY,0
3ehz,E,221,240,19,ANVTLVVSTLIAHIAFNIL,0
3ehz,E,255,274,19,AIIFMIYLFYFVAVIEVTV,0
3ehz,E,275,293,18,HYLKVESQPARAASITRA,0
3ehz,E,294,312,18,RIAFPVVFLLANIILAFL,0
2hj6,H,1,10,9,VGVTAFGNF,0
2hj6,H,11,15,4,LASL,0
2hj6,H,16,32,16,IYSFWIFLAGLIYYLQ,0
2hj6,H,252,260,8,AAMLAEYA,0
5jsi,A,9,29,20,MVATVGMLAGTVFLLASSRE,0
5jsi,A,30,35,5,KPEHR,0
5jsi,A,36,55,19,GVYISALVCGIAWYHYQKM,0
5jsi,A,67,87,20,LRYVDWVLTVPLMFVEVLAV,0
5jsi,A,88,95,7,RKGAAYN,0
5jsi,A,96,117,21,AVRNWGIAATVMIGAGYYGET,0
5jsi,A,124,146,22,YWTGFVIAMATYVWLMRNLQAE,0
5jsi,A,147,156,9,EGLKGDQAV,0
5jsi,A,157,178,21,FENIKNLILVGWIIYPLGYIA,0
5jsi,A,189,211,22,VLYTIADIINKVGLGVLVLQMA,0
5jsi,A,212,216,4,VQSG,0
4nta,C,-1,7,8,HHKDEVAL,0
4nta,C,8,28,20,ATVTLVGVLLQAYFSLQVIS,0
4nta,C,52,71,19,QVNCSEYFPLFLATLWVAG,0
4nta,C,72,78,6,FFHEGA,0
4nta,C,79,97,18,ALCGLFYLFARLRYFQGY,0
4nta,C,104,124,20,LTPLYASARALWLLVAMAAL,0
4nta,C,125,141,16,LLVHFLPGTLRTALFR,0
4nta,C,142,145,3,LQM,0
1s53,E,5,9,4,GRPE,0
1s53,E,10,34,24,IWLALGTALMGLGTLYFLVKGMGV,0
1s53,E,40,62,22,KFYAISTLVPAIAFTMYLSMLL,0
1s53,E,63,79,16,YGLTMVPFGGEQNPIY,0
1s53,E,80,100,20,ARYADWLFTTPLLLLDLALL,0
1s53,E,104,127,23,QGTILALVGADGIMIGTGLVGAL,0
1s53,E,128,133,5,KVYSY,0
1s53,E,134,157,23,FVWWAISTAAMLYILYVLFFGFT,0
1s53,E,171,192,21,KVLRNVTVVLWSAYPVVWLIG,0
1s53,E,193,202,9,EGAGIVPLN,0
1s53,E,203,226,23,ETLLFMVLDVSAKVGFGLILLRS,0
3b61,A,1,3,2,NP,0
3b61,A,4,6,2,IY,0
3b61,A,7,20,13,GGAILAEVIGTTL,0
3b61,A,38,51,13,CYCASFWLLAQTL,0
3b61,A,52,53,1,Y,0
3b61,A,54,66,12,PTGIAYAIWSGV,0
3eff,N,30,48,18,AATVLLVIVLLAGSYLAV,0
3eff,N,49,62,13,AERGAPGAQLITY,0
3eff,N,63,79,16,RALWWSVETATTVGYG,0
3eff,N,80,86,6,LYPVTL,0
3eff,N,87,107,20,GRLVAVVVMVAGITSFGLVT,0
1jo5,A,12,41,29,DEQAQELHSVYMSGLWLFSAVAIVAHLAV,0
1jo5,A,42,48,6,IWRPWF,0
2zt9,Q,2,22,20,AIVAYIGFLALFTGIAAGLL,0
2zt9,Q,23,31,8,GLRSAKIL,0
2q7r,C,1,11,10,DQETVGNVVL,0
2q7r,C,12,29,17,AIVTLISVVQNGFFAHK,0
2q7r,C,58,75,17,NCVDAYPTFLAVLWSAG,0
2q7r,C,76,82,6,LCSQVP,0
2q7r,C,83,99,16,AFAGLMYLFVRQKYFV,0
2q7r,C,113,128,15,FGKRIILFLFLMSVA,0
2q7r,C,129,149,20,IFNYYLIFFFGSDFENYIAT,0
2q7r,C,150,161,11,STTISPLLLIP,0
4u16,A,67,93,26,VFIAFLTGFLALVTIIGNILVIVAFK,0
4u16,A,94,104,10,NKQLKTVNNY,0
4u16,A,105,129,24,LLSLACADLIIGVISMNLFTTYII,0
4u16,A,139,163,24,CDLWLSIDYVASNASVMNLLVISF,0
4u16,A,164,184,20,RYFSITRPLTYRAKRTTKRA,0
4u16,A,185,206,21,VMIGLAWVISFVLWAPAILFW,0
4u16,A,221,251,30,IQFLSEPTITFGTAIAAFYMPVTIMTILYW,0
4u16,A,252,491,239,IYKETEKMNIFEMLRIDEGGGSGGDEAEKLFNQDVDAAVRGILRNAKLKPVYDSLDAVRRAALINMVFQMGETGVAGFTNSLRMLQQKRWDEAAVNLAKSRWYNQTPNRAKRVITTFRTGTWDAYLIKEKKAAQT,0
4u16,A,492,516,24,SAILLAFIITWTPYNIMVLVNTFC,0
4u16,A,523,545,22,YWNLGYWLCYINSTVNPVCYAL,0
4u16,A,546,547,1,N,0
4u1w,D,524,540,16,IWMAIVFAYIGVSVVL,0
4u1w,D,541,543,2,LV,0
4u1w,D,595,596,1,L,0
4u1w,D,597,617,20,ARIVAGVWWFFTLIIISSYT,0
4u1w,D,790,808,18,NVAGVFYILVGGLGLAML,0
4u1w,D,809,816,7,ALIEFAY,0
2q67,D,2,18,16,SFLLTLKRMLRACLRA,0
2q67,D,19,25,6,KDKEFQ,0
2q67,D,26,42,16,LFVLTILTLISGTIFY,0
2q67,D,54,66,12,YFSVVTLTTVGA,0
2q67,D,76,94,18,KIFTILYIFIGIGLVFGF,0
2q67,D,95,103,8,HKLAVNVQ,0
2q67,D,104,114,10,PSILSNLVPR,0
1s3b,A,1,2,1,S,0
1s3b,A,3,108,105,KCDVVVVGGGISGMAAAKLLHDSGLNVVVLEARDRVGGRTYTLRNQKVKYVDLGGSYVGPTQNRILRLAKELGLETYKVNEVERLIHHVKGKSYPFRGPFPPVWN,0
1s3b,A,109,126,17,ITYLDHNNFWRTMDDMG,0
1s3b,A,127,485,358,EIPSDAPWKAPLAEEWDNMTMKELLDKLCWTESAKQLATLFVNLCVTAETHEVSALWFLWYVKQCGGTTRIISTTNGGQERKFVGGSGQVSERIMDLLGDRVKLERPVIYIDQTRENVLVETLNHEMYEAKYVISAIPPTLGMKIHFNPPLPMMRNQMITRVPLGSVIKCIVYYKEPFWRKKDYCGTMIIDGEEAPVAYTLDDTKPEGNYAAIMGFILAHKARKLARLTKEERLKKLCELYAKVLGSLEALEPVHYEEKNWCEEQYSGGCYTTYFPPGILTQYGRVLRQPVDRIYFAGTETATHWSGYMEGAVEAGERAAREILHAMGKIPEDEIWQSEPESVDVPAQPITTTFLERH,0
1s3b,A,486,498,12,PSVPGLLRLIGL,0
1s3b,A,502,520,18,SATALGFLAHKRGLLVRV,0
3klz,E,1,22,21,EHNQFDSLLPPQMAERAAITG,0
3klz,E,23,34,11,GKAKKAAYKSF,0
3klz,E,35,52,17,LAISAGIQIGIAFVFYT,0
3klz,E,68,84,16,LGGLAFSLGLILVVIT,0
3klz,E,85,92,7,GELFTSS,0
3klz,E,93,101,8,LILVAKAS,0
3klz,E,102,113,11,KISWKELVRNW,0
3klz,E,114,134,20,VVYFGNLCGSIILVFIMLAT,0
3klz,E,144,153,9,GLNAMAISQ,0
3klz,E,161,180,19,QAFALGLMCNILVCLAVWM,0
3klz,E,181,188,7,FSARSLT,0
3klz,E,189,205,16,KVMVLILPVAMFVSSG,0
3klz,E,207,218,11,HCIANMFQVPM,0
3klz,E,250,268,18,VNNLIPVTLGNIVGGGVF,0
3klz,E,269,279,10,GMWYWLIYLK,0
4ysx,D,58,78,20,FKIERYFAAAMVPLIPAAYF,0
4ysx,D,79,83,4,HGRE,0
4ysx,D,84,108,24,DLCLALALTLHVHWGVWGVVNDYG,0
4ysx,D,118,140,22,AAVRVGAYIFTACLLAGLLYFN,0
4ysx,D,141,145,4,HDVG,0
4ysx,D,146,155,9,TRAFEMVWE,0
5mrl,A,1,2,1,S,0
5mrl,A,3,490,487,KCDVVVVGGGISGMAAAKLLHDSGLNVVVLEARDRVGGRTYTLRNQKVKYVDLGGSYVGPTQNRILRLAKELGLETYKVNEVERLIHHVKGKSYPFRGPFPPVWNPITYLDHNNFWRTMDDMGREIPSDAPWKAPLAEEWDNMTMKELLDKLCWTESAKQLATLFVNLCVTAETHEVSALWFLWYVKQCGGTTRIISTTNGGQERKFVGGSGQVSERIMDLLGDRVKLERPVIYIDQTRENVLVETLNHEMYEAKYVISAIPPTLGMKIHFNPPLPMMRNQMITRVPLGSVIKCIVYYKEPFWRKKDYCGTMIIDGEEAPVAYTLDDTKPEGNYAAIMGFILAHKARKLARLTKEERLKKLCELYAKVLGSLEALEPVHYEEKNWCEEQYSGGCYTTYFPPGILTQYGRVLRQPVDRIYFAGTETATHWSGYMEGAVEAGERAAREILHAMGKIPEDEIWQSEPESVDVPAQPITTTFLERHLPSVP,0
5mrl,A,491,501,10,LLRLIGLTTI,0
5mrl,A,502,520,18,SATALGFLAHKRGLLVRV,0
1s2q,A,1,2,1,S,0
1s2q,A,3,490,487,KCDVVVVGGGISGMAAAKLLHDSGLNVVVLEARDRVGGRTYTLRNQKVKYVDLGGSYVGPTQNRILRLAKELGLETYKVNEVERLIHHVKGKSYPFRGPFPPVWNPITYLDHNNFWRTMDDMGREIPSDAPWKAPLAEEWDNMTMKELLDKLCWTESAKQLATLFVNLCVTAETHEVSALWFLWYVKQCGGTTRIISTTNGGQERKFVGGSGQVSERIMDLLGDRVKLERPVIYIDQTRENVLVETLNHEMYEAKYVISAIPPTLGMKIHFNPPLPMMRNQMITRVPLGSVIKCIVYYKEPFWRKKDYCGTMIIDGEEAPVAYTLDDTKPEGNYAAIMGFILAHKARKLARLTKEERLKKLCELYAKVLGSLEALEPVHYEEKNWCEEQYSGGCYTTYFPPGILTQYGRVLRQPVDRIYFAGTETATHWSGYMEGAVEAGERAAREILHAMGKIPEDEIWQSEPESVDVPAQPITTTFLERHLPSVP,0
1s2q,A,491,501,10,LLRLIGLTTI,0
1s2q,A,502,520,18,SATALGFLAHKRGLLVRV,0
4px7,A,1,4,3,RSI,0
4px7,A,5,25,20,RRTAVGAALLLVMPVAVWIS,0
4px7,A,33,34,1,Q,0
4px7,A,40,65,25,AFWVTETVTQPWGVITHLILFGWFL,0
4px7,A,66,75,9,CLRFRIKAA,0
4px7,A,76,97,21,VLFAILAAAILVGQGVKSWIK,0
4px7,A,140,143,3,KNI,0
4px7,A,145,154,9,YLRSHWQKE,0
4px7,A,159,179,20,PSGHTMFAASWALLAVGLLW,0
4px7,A,180,183,3,RRR,0
4px7,A,184,203,19,LTIAILLVWATGVMGSRLL,0
4px7,A,207,230,23,WPRDLVVATLISWALVAVATWLA,0
4px7,A,231,240,9,RICGPLTPP,0
4px7,A,242,258,16,ENREIAQREQESLEHH,0
4px7,A,259,262,3,HHH,0
2q6a,D,2,16,14,SFLLTLKRMLRACL,0
2q6a,D,17,25,8,AWKDKEFQ,0
2q6a,D,26,45,19,LFVLTILTLISGTIFYSTV,0
2q6a,D,51,67,16,DALYFSVVTLTTVGEG,0
2q6a,D,75,94,19,GKIFTILYIFIGIGLVFGF,0
2q6a,D,95,103,8,HKLAVNVQ,0
2q6a,D,104,114,10,PSILSNLVPR,0
1t5s,A,1,54,53,EAAHSKSTEECLAYFGVSETTGLTPDQVKRHLEKYGHNELPAEEGKSLWELVI,0
1t5s,A,55,78,23,QFEDLLVRILLLAACISFVLAWF,0
1t5s,A,86,104,18,AFVEPFVILLILIANAIV,0
1t5s,A,105,256,151,VWQERNAENAIEALKEYEPEMGKVYRADRKSVQRIKARDIVPGDIVEVAVGDKVPADIRILSIKSTTLRVDQSILTGESVSVIKHTEPVPDPRAVNQDKKNMLFSGTNIAAGKALGIVATTGVSTEIGKIRDQMAATEQDKTPLQQKLDEF,0
1t5s,A,257,276,19,EQLSKVISLICVAVWLINI,0
1t5s,A,293,313,20,YYFKIAVALAVAAIPEGLPA,0
1t5s,A,314,759,445,ITTCLALGTRRMAKKNAIVRSLPSVETLGCTSVICSDKTGTLTTNQMSVCKMFIIDKVDGDFCSLNEFSITGSTYAPEGEVLKNDKPIRSGQFDGLVELATICALCNDSSLDFNETKGVYEKVGEATETALTTLVEKMNVFNTEVRNLSKVERANACNSVIRQLMKKEFTLEFSRDRKSMSVYCSPAKSSRAAVGNKMFVKGAPEGVIDRCNYVRVGTTRVPMTGPVKEKILSVIKEWGTGRDTLRCLALATRDTPPKREEMVLDDSSRFMEYETDLTFVGVVGMLDPPRKEVMGSIQLCRDAGIRVIMITGDNKGTAIAICRRIGIFGENEEVADRAYTGREFDDLPLAEQREACRRACCFARVEPSHKSKIVEYLQSYDEITAMTGDGVNDAPALKKAEIGIAMGSGTAVAKTASEMVLADDNFSTIVAAVEEGRAIYNNMKQ,0
1t5s,A,760,781,21,IRYLISSNVGEVVCIFLTAAL,0
1t5s,A,786,807,21,LIPVQLLWVNLVTDGLPATAL,0
1t5s,A,808,831,23,FNPPDLDIMDRPPRSPKEPLISG,0
1t5s,A,832,852,20,LFFRYMAIGGYVGAATVGAA,0
1t5s,A,898,916,18,MALSVLVTIEMCNALNSL,0
1t5s,A,917,930,13,ENQSLMRMPPWVN,0
1t5s,A,931,950,19,WLLGSICLSMSLHFLILYV,0
1t5s,A,952,957,5,LPMIF,0
1t5s,A,964,987,23,TQWLMVLKISLPVIGLDEILKFI,0
1t5s,A,988,994,6,RNYLEG,0
2cpb,A,1,20,19,EGDDPAKAAFNSLQASATE,0
2cpb,A,21,43,22,IGYAWAMVVVIVGATIGIKLFK,0
2xfo,A,1,2,1,S,0
2xfo,A,3,108,105,KCDVVVVGGGISGMAAAKLLHDSGLNVVVLEARDRVGGRTYTLRNQKVKYVDLGGSYVGPTQNRILRLAKELGLETYKVNEVERLIHHVKGKSYPFRGPFPPVWN,0
2xfo,A,109,126,17,ITYLDHNNFWRTMDDMG,0
2xfo,A,127,485,358,EIPSDAPWKAPLAEEWDNMTMKELLDKLCWTESAKQLATLFVNLCVTAETHEVSALWFLWYVKQCGGTTRIASTTNGGQERKFVGGSGQVSERIMDLLGDRVKLERPVIYIDQTRENVLVETLNHEMYEAKYVISAIPPTLGMKIHFNPPLPMMRNQMITRVPLGSVIKCIVYYKEPFWRKKDYCGTMIIDGEEAPVAYTLDDTKPEGNYAAIMGFILAHKARKLARLTKEERLKKLCELYAKVLGSLEALEPVHYEEKNWCEEQYSGGCYTTYFPPGILTQYGRVLRQPVDRIYFAGTETATHWSGYMEGAVEAGERAAREILHAMGKIPEDEIWQSEPESVDVPAQPITTTFLERH,0
2xfo,A,486,498,12,PSVPGLLRLIGL,0
2xfo,A,502,520,18,SATALGFLAHKRGLLVRV,0
1jgx,H,1,10,9,VGVTAFGNF,0
1jgx,H,16,32,16,IYSFWIFLAGLIYYLQ,0
1jgx,H,33,250,217,ENMREGYPLENEDGTPAANQGPFPLPKPKTFILPHGRGTLTVPGPESEDRPIALARTAVSEGFPHAPTGDPMKDGVGPASWVARRDLPELDGHGHNKIKPMKAAAGFHVSAGKNPIGLPVRGCDLEIAGKVVDIWVDIPEQMARFLEVELKDGSTRLLPMQMVKVQSNRVHVNALSSDLFAGIPTIKSPTEVTLLEEDKICGYVAGGLMYAAPKRKS,0
1jgx,H,251,260,9,VAAMLAEYA,0
3ukm,B,11,17,6,PSREAS,0
3ukm,B,18,21,3,SAT,0
3ukm,B,22,44,22,FGFLVLGYLLYLVFGAVVFSSV,0
3ukm,B,94,99,5,QASGN,0
3ukm,B,105,121,16,SALFFASTVLSTTGYG,0
3ukm,B,129,157,28,GKAFCIIYSVIGIPFTLLFLTAVVQRIT,0
3ukm,B,158,168,10,HVTRRPVLYF,0
3ukm,B,169,174,5,IRWGF,0
3ukm,B,175,182,7,KQVVAIV,0
3ukm,B,183,206,23,AVLLGFVTVSCFFFIPAAVFSVL,0
3ukm,B,213,229,16,ESFYFCFISLSTIGLG,0
3ukm,B,244,268,24,YKIGITCYLLLGLIAMLVVLETFC,0
3ukm,B,269,270,1,L,0
3ukm,B,271,278,7,ELKKFRK,0
3ukm,B,279,281,2,FY,0
3ukm,B,282,290,8,KKDKDEVD,0
2f95,D,4,26,22,VSRLLLPSRVRHSYTGKMGAVF,0
2f95,D,27,38,11,FVGALTVLFGA,0
2f95,D,39,64,25,AYGEVTAAAATGDAAAVQEAAVSAI,0
2f95,D,65,79,14,GLIILLGINLGLVA,0
2f95,D,80,166,86,TLGGDTAASLSTLAAKASRMGDGDLDVELETRREDEIGDLYAAFDEMRQSVRTSLEDAKNAREDAEQAQKRAEEINTNSHHHHHHH,0
5fl7,T,14,26,12,ASIGLVGAGIGI,0
5fl7,T,27,55,28,IVFAALINGVSRNPALKGQLFTYSILGF,0
5fl7,T,56,68,12,LSEATGLFALMI,0
3kcu,E,1,29,28,KADNPFDLLLPAAMAKVAEEAGVYKATK,0
3kcu,E,36,56,20,LAITAGVFISIAFVFYITAT,0
3kcu,E,57,66,9,GTGTMPFGM,0
3kcu,E,67,85,18,KLVGGICFSLGLILCVVC,0
3kcu,E,114,135,21,LNVYFGNLVGALLFVLLMWLS,0
3kcu,E,136,143,7,EYMTANG,0
3kcu,E,144,155,11,WGLNVLQTADH,0
3kcu,E,156,161,5,VHHTF,0
3kcu,E,162,182,20,EAVCLGILANLMVCLAVWMS,0
3kcu,E,189,219,30,DKAFIMVLPVAMFVASGFEHSIANMFMIPM,0
3kcu,E,220,247,27,IVIRDFASPEFWTAVGSAPENFSHLTV,0
3kcu,E,248,272,24,NFITDNLIPVTIGNIIGGGLLVGL,0
3kcu,E,279,285,6,RENDHH,0
5j9p,F,26,50,24,RAAGAATVLLVIVLLAGSYLAVLA,0
5j9p,F,51,62,11,RGAPGAQLITY,0
5j9p,F,63,78,15,RALWWSVETATTVGY,0
5j9p,F,79,86,7,DLYPVTL,0
5j9p,F,87,111,24,GRLVAVVVMVAGITSFGLVTAALA,0
2c32,D,1,5,4,WELR,0
2c32,D,6,12,6,ASFWRA,0
2c32,D,13,30,17,CAEFFASLFYVFFGLGA,0
2c32,D,43,60,17,VALAFGLALATLVQAVG,0
2c32,D,61,63,2,IS,0
2c32,D,64,77,13,AHVNPAVTFAFLV,0
2c32,D,78,86,8,SQMSLLRA,0
2c32,D,87,104,17,CYMVAQLLGAVAGAAVL,0
2c32,D,129,148,19,ATIVEIFLTLQFVLCIFAT,0
2c32,D,149,158,9,DERRNGRLG,0
2c32,D,159,176,17,VALAVGFSLTLGHLFGM,0
2c32,D,181,194,13,GMNPARSFAPAIL,0
2c32,D,202,219,17,VYWVGPVIGAGLGSLLY,0
2c32,D,220,239,19,FLLFPRLKSVSERLSILKG,0
2c32,D,240,263,23,RPSESNGQPEVTGEPVELKTQAL,0
1xme,C,5,27,22,KGALAVILVLTLTILVFWLGVY,0
1xme,C,28,34,6,VFFARG,0
4gc0,A,1,4,3,NTQ,0
4gc0,A,15,35,20,VATLGGLLFGYDTAVISGTV,0
4gc0,A,36,42,6,SLNTVF,0
4gc0,A,43,55,12,APQNLSESAANS,0
4gc0,A,56,75,19,LGFCVASALIGCIIGGALG,0
4gc0,A,88,105,17,KIAAVLFFISGVGSAWP,0
4gc0,A,106,124,18,LGFTSINPDNTVPVYLAG,0
4gc0,A,125,148,23,VPEFVIYRIIGGIGVGLASMLSP,0
4gc0,A,163,185,22,VSFNQFAIIFGQLLVYCVNYFI,0
4gc0,A,186,197,11,RSGDASWLNTD,0
4gc0,A,198,217,19,WRYMFASECIPALLFLMLL,0
4gc0,A,281,302,21,VMLSIFQQFVGINVVLYYAPE,0
4gc0,A,303,315,12,FKTLGASTDIAL,0
4gc0,A,316,336,20,QTIIVGVINLTFTVLAIMTV,0
4gc0,A,342,363,21,PLQIIGALGMAIGMFSLGTAF,0
4gc0,A,364,371,7,TQAPGIV,0
4gc0,A,372,395,23,LLSMLFYVAAFAMSWGPVCWVLL,0
4gc0,A,410,431,21,AVAAQWLANYFVSWTFPMMDK,0
4gc0,A,432,439,7,SWLVAHF,0
4gc0,A,440,441,1,N,0
4gc0,A,442,460,18,FSYWIYGCMGVLAALFMW,0
4gc0,A,480,491,11,ETKKTQQTATL,0
1zwi,F,22,26,4,ALHW,0
1zwi,F,27,50,23,AAGAATVLLVIVLLAGSYLAVLA,0
1zwi,F,63,79,16,RALWWSVATATTVGYG,0
1zwi,F,87,110,23,GRCVAVVVMVAGITSFGLVTAAL,0
1zwi,F,111,124,13,TWFVGREQERRGA,0
5d7t,D,27,41,14,TFYFIIMIFLANNW,0
5d7t,D,43,59,16,YLVISIFGLAYVFATG,0
5d7t,D,62,72,10,RVFWDGVKPM,0
5d7t,D,73,90,17,WMIVFTSLLQTFFMAGG,0
5d7t,D,91,99,8,VYWHWWIF,0
5d7t,D,100,123,23,LSSEGLINGLYVFIRFAMIILVS,0
5d7t,D,132,146,14,LEIADAMEWMLTPL,0
5d7t,D,246,257,11,IPVAYCLLLTI,0
5d7t,D,258,264,6,ITTRKH,0
5t36,C,6,15,9,VMSSPALPA,0
5t36,C,16,32,16,LLCSTLLVIKMYVVAI,0
5t36,C,73,90,17,NDMETIYPFLFLGFVYS,0
5t36,C,91,97,6,LGPNPF,0
5t36,C,98,115,17,AWMHFLVFLVGRVAHTV,0
5t36,C,129,146,17,YTLAQLPCASMALQILW,0
5t36,C,147,152,5,AARHL,0
2vpz,G,1,15,14,EFYGLPNAQEFWHW,0
2vpz,G,16,36,20,NALHFVLVGLAGGVALLAAL,0
2vpz,G,50,66,16,YALMLIALDLFILWAE,0
2vpz,G,67,88,21,PARFRFTHIWLFLSFHPTSPI,0
2vpz,G,89,105,16,WGAWGLGLGFLTGGLL,0
2vpz,G,115,132,17,AWALLVFSLVALSYPGL,0
2vpz,G,133,146,13,LAVNLNRPLWNGL,0
2vpz,G,147,163,16,AGLFPLTALVLALGLA,0
2vpz,G,175,189,14,RVLAGASLLLALLY,0
2vpz,G,190,206,16,LTLPPEARGHLLEEAG,0
2vpz,G,207,221,14,WYGLFLLLGLGTFW,0
2vpz,G,226,241,15,PWAGLLAAAGLRALL,0
2vpz,G,242,250,8,LAGQWQGL,0
2vpz,G,251,252,1,L,0
3uq5,E,-1,10,11,SAPADNAADAR,0
3uq5,E,11,204,193,VDVSVSIFINKIYGVNTLEQTYKVDGYIVAQWTGKPRKTPGDKPLIVENTQIERWINNGLWVPALEFINVVGSPDTGNKRLMLFPDGRVIYNARFLGSFSNDMDFRLFPFDRQQFVLELEPFSYNNQQLRFSDIQVYTENIDNEEIDEWWIRGKASTHISDIRYDHLSSVQPNQNEFSRITVRIDAVRNPSYY,0
3uq5,E,205,221,16,WSFILPLGLIIAASWS,0
3uq5,E,235,250,15,FTLMATVVAYALYTS,0
3uq5,E,251,261,10,ILPRLPYTTV,0
3uq5,E,262,278,16,DQMIIAGYGSIFAAIL,0
3uq5,E,305,317,12,LGFLAIGCVLVI,0
3uq5,E,318,322,4,GITL,0
3n23,G,30,46,16,LIFAALAFIVGLIIIL,0
1occ,Z,17,36,19,GLSVTFLSFLLPAGWVLYH,0
1occ,Z,37,43,6,DNYKKS,0
1occ,Z,44,46,2,AA,0
4p9o,F,126,130,4,SHMG,0
4p9o,F,132,152,20,SVAALLTVVFYIAAVMATNL,0
4p9o,F,153,163,10,GATFPEWFGD,0
4p9o,F,164,181,17,SKSLYTLFQVMTLESWS,0
4p9o,F,182,191,9,GIVRPVMNV,0
4p9o,F,192,194,2,PN,0
4p9o,F,195,218,23,WVFFIPFIMLTTFTVLNLFIGII,0
4p9o,F,221,274,53,MAITKEQEEEAKTGHHQEPISQTLLHLGDRLDRIEKQLAQNNELLQRQQPQKK,0
3po7,A,1,2,1,S,0
3po7,A,3,108,105,KCDVVVVGGGISGMAAAKLLHDSGLNVVVLEARDRVGGRTYTLRNQKVKYVDLGGSYVGPTQNRILRLAKELGLETYKVNEVERLIHHVKGKSYPFRGPFPPVWN,0
3po7,A,109,126,17,ITYLDHNNFWRTMDDMG,0
3po7,A,127,485,358,EIPSDAPWKAPLAEEWDNMTMKELLDKLCWTESAKQLATLFVNLCVTAETHEVSALWFLWYVKQCGGTTRIISTTNGGQERKFVGGSGQVSERIMDLLGDRVKLERPVIYIDQTRENVLVETLNHEMYEAKYVISAIPPTLGMKIHFNPPLPMMRNQMITRVPLGSVIKCIVYYKEPFWRKKDYCGTMIIDGEEAPVAYTLDDTKPEGNYAAIMGFILAHKARKLARLTKEERLKKLCELYAKVLGSLEALEPVHYEEKNWCEEQYSGGCYTTYFPPGILTQYGRVLRQPVDRIYFAGTETATHWSGYMEGAVEAGERAAREILHAMGKIPEDEIWQSEPESVDVPAQPITTTFLERH,0
3po7,A,486,501,15,PSVPGLLRLIGLTTI,0
3po7,A,502,520,18,SATALGFLAHKRGLLVRV,0
4yeu,E,11,205,194,VDVSVSIFINKIYGVNTLEQTYKVDGYIVAQWTGKPRKTPGDKPLIVENTQIERWINNGLWVPALEFINVVGSPDTGNKRLMLFPDGRVIYNARFLGSFSNDMDFRLFPFDRQQFVLELEPFSYNNQQLRFSDIQVYTENIDNEEIDEWWIRGKASTHISDIRYDHLSSVQPNQNEFSRITVRIDAVRNYFSYI,0
4yeu,E,206,220,14,NIILPMLFILFISW,0
4yeu,E,236,248,12,STLIAHIAFNIL,0
4yeu,E,249,261,12,ETNLPKTPYMTY,0
4yeu,E,262,276,14,GAIIFMIYLFYFVA,0
4yeu,E,307,320,13,VVFLLANIILAFL,0
4yeu,E,321,322,1,F,0
5tis,r,9,23,14,LPVLLAAGWAVRNI,0
5tis,r,24,32,8,PYAVKQVQ,0
5tis,r,33,35,2,LL,0
4g80,T,90,105,15,RGSHHHHHHGENLYF,0
4g80,T,106,118,12,FRVRAVIDHLGM,0
4g80,T,119,140,21,VFGVFLIFLDIILMIIDLSLP,0
4g80,T,146,169,23,QSFYDGMALALSCYFMLDLGLRI,0
4g80,T,170,182,12,AYGPKNFFTNPW,0
4g80,T,183,204,21,VADGLIIVVTFVVTIFYTVLD,0
4g80,T,213,231,18,GLGRLVVLARLLRVVRLA,0
4g80,T,232,236,4,IFYS,0
4g80,T,237,243,6,QQMKAS,0
3usk,B,1,4,3,EVK,0
3usk,B,17,32,15,MAGNAVGLGNFLRFP,0
3usk,B,33,43,10,QAAENGGGAF,0
3usk,B,44,62,18,IPYIIAFLLVGIPLMWIE,0
3usk,B,90,124,34,KILGVFGLWIPLVVAIYYVYIESWTLGFAIKFLV,0
3usk,B,125,131,6,LVPEPP,0
3usk,B,132,134,2,,0
3usk,B,135,166,31,DPDSILRPFKEFLYSYIGVPKGDEPILKPSL,0
3usk,B,167,183,16,AYIVFLITMFINVSIL,0
3usk,B,195,214,19,KIAMPTLFILAVFLVIRVF,0
3usk,B,215,222,7,LETPNGT,0
3usk,B,223,231,8,ADGLNFLW,0
3usk,B,232,243,11,PDFEKLKDPGV,0
3usk,B,244,263,19,IAAVGQIFFTLSLGFGAII,0
3usk,B,280,297,17,TAATLNEKAEVILGGSI,0
3usk,B,298,307,9,IPAAVAFFG,0
3usk,B,308,317,9,ANAVAIAKA,0
3usk,B,319,324,5,FNLGF,0
3usk,B,326,331,5,LPAIF,0
3usk,B,332,339,7,QTAGGTF,0
3usk,B,340,364,24,GFLWFFLLFFAGLTSSIAIMQPMI,0
3usk,B,380,395,15,WTAAIVFFSAHLVMF,0
3usk,B,396,399,3,NKS,0
3usk,B,400,422,22,DEMDFWAGTIGVVFFGLTELII,0
3usk,B,429,437,8,DKAWEEIN,0
3usk,B,451,469,18,MRYITPAFLAVLLVVWAR,0
3usk,B,470,476,6,YIPKIM,0
3usk,B,477,484,7,ETHWTVW,0
3usk,B,485,500,15,TRFYIIGLFLFLTFL,0
3usk,B,602,610,8,SAGTLVPR,0
5ara,W,10,12,2,TP,0
5ara,W,13,27,14,ILGLPLVTLIVLFP,0
5ara,W,75,89,14,ILFIGSTNLLGLLP,0
5ara,W,90,94,4,SFTP,0
5ara,W,95,110,15,TQLSMNLGMAIPLWA,0
5ara,W,144,169,25,ETISLFIQPMALAVRLTANITAGHL,0
5ara,W,170,193,23,IHLIGGATLALMSISTTTALITF,0
5ara,W,194,215,21,ILILLTILEFAVAMIQAYVFT,0
4us4,A,21,39,18,AMGSAVGLGNIWRFSYVT,0
4us4,A,40,44,4,ENGG,0
4us4,A,45,63,18,AFLLVYLGFIALIGIPIV,0
4us4,A,93,120,27,GLMGVAAGFLILSFYGVIAGWILFYLF,0
4us4,A,121,133,12,YITGQLWSAPAE,0
4us4,A,134,144,10,FGGFFEGFIA,0
4us4,A,145,149,4,PTLP,0
4us4,A,150,166,16,FWQALFMIATIWIVAI,0
4us4,A,169,192,23,KGIERSNKILMPLLGVLLIALAI,0
4us4,A,193,215,22,SLTLGGAKEGLAFLFSPDWSAL,0
4us4,A,216,239,23,DPGVYLAAISQAFFTLSLGMGAL,0
4us4,A,256,273,17,VSVAGLDTAFAIIAGIM,0
4us4,A,274,291,17,FPAVFALGLSPSGGPGL,0
4us4,A,292,302,10,FVVLPDIFDS,0
4us4,A,303,308,5,RLGPI,0
4us4,A,309,333,24,GIAFFILLGAAALSSAVSLLEVPV,0
4us4,A,346,363,17,AAITLGVIITLLGIPSS,0
4us4,A,364,380,16,SFGVLGEVTIIPGLNI,0
4us4,A,381,402,21,DSVDFIASSVFLPLGGMIIAL,0
4us4,A,423,430,7,WGKLWIL,0
4us4,A,431,449,18,LRFIAPIAILIVFLSAFQ,0
4ev3,C,1,3,2,EE,0
4ev3,C,10,27,17,VILVLTLTILVFWLGVY,0
4ev3,C,28,34,6,VFFARG,0
3abm,Z,13,33,20,EQAIGLSVTFLSFLLPAGWV,0
3abm,Z,34,43,9,YHLDNYKKS,0
3abm,Z,44,46,2,AA,0
2bcc,J,1,3,2,AP,0
2bcc,J,5,12,7,TARLYSL,0
2bcc,J,13,18,5,FRRTS,0
2bcc,J,19,42,23,FALTIVVGALLFERAFDQGADAI,0
5l8r,L,77,84,7,LVAWYLS,0
5l8r,L,101,115,14,VGLAHGFLLVGPFV,0
5l8r,L,116,130,14,AGPLRNTEIAGQAG,0
5l8r,L,131,144,13,LAAGGLVVILSIC,0
5l8r,L,190,203,13,FGGISGVIWAFFL,0
5l8r,L,204,210,6,YVLDLP,0
2iqm,A,49,73,24,IAITALYSAVCAVGLLGNVLVMFG,0
2iqm,A,74,87,13,VRYTKMKTATNIY,0
2iqm,A,88,108,20,FNLALADALATSTLPFQSAK,0
2iqm,A,120,141,21,CKAVLSIDYYNMFTSIFTLTM,0
2iqm,A,142,167,25,SVDRYIAVCHPVKALDFRTPAKAKL,0
2iqm,A,168,191,23,NICIWVLASGVGVPIMVMAVTRP,0
2iqm,A,209,230,21,DTVTKICVFLFAFVVPILIIT,0
2iqm,A,231,264,33,CYGLMLLRLRSVRLLSGSKEKDRSLRRITRMVL,0
2iqm,A,265,288,23,VVGAFVVCWAPIHIFVIVWTLVD,0
2iqm,A,297,320,23,AALHLCIALGYANSSLNPVLYAF,0
2iqm,A,321,322,1,D,0
2iqm,A,323,333,10,NFKRCFRQLC,0
2iqm,A,334,336,2,KP,0
2irv,C,92,93,1,A,0
2irv,C,94,113,19,PVTWVMMIACVVVFIAMQI,0
2irv,C,133,146,13,EFWRYFTHALMHF,0
2irv,C,148,166,18,MHILFNLLWWWYLGGAVE,0
2irv,C,167,171,4,RLGS,0
2irv,C,172,189,17,KLIVITLISALLSGYVQ,0
2irv,C,198,214,16,GLSGVVYALMGYVWLR,0
2irv,C,215,224,9,ERDPQSGIY,0
2irv,C,225,241,16,QRGLIIFALIWIVAGW,0
2irv,C,244,249,5,FGMSM,0
2irv,C,252,268,16,AHIAGLAVGLAMAFVD,0
2irv,C,269,273,4,LNAR,0
2loo,A,-8,0,8,TSLYKKVG,0
2loo,A,6,19,13,GYAALVTFGSIFG,0
2loo,A,29,46,17,IAGLFVGCLAGYGAYRV,0
2loo,A,47,51,4,NDKR,0
2loo,A,52,66,14,VKVSLFTAFFLATI,0
2loo,A,81,97,16,LVAGLSLMMILRLVLL,0
2loo,A,98,99,1,L,0
4a79,A,1,2,1,S,0
4a79,A,3,108,105,KCDVVVVGGGISGMAAAKLLHDSGLNVVVLEARDRVGGRTYTLRNQKVKYVDLGGSYVGPTQNRILRLAKELGLETYKVNEVERLIHHVKGKSYPFRGPFPPVWN,0
4a79,A,109,126,17,ITYLDHNNFWRTMDDMG,0
4a79,A,127,485,358,EIPSDAPWKAPLAEEWDNMTMKELLDKLCWTESAKQLATLFVNLCVTAETHEVSALWFLWYVKQCGGTTRIISTTNGGQERKFVGGSGQVSERIMDLLGDRVKLERPVIYIDQTRENVLVETLNHEMYEAKYVISAIPPTLGMKIHFNPPLPMMRNQMITRVPLGSVIKCIVYYKEPFWRKKDYCGTMIIDGEEAPVAYTLDDTKPEGNYAAIMGFILAHKARKLARLTKEERLKKLCELYAKVLGSLEALEPVHYEEKNWCEEQYSGGCYTTYFPPGILTQYGRVLRQPVDRIYFAGTETATHWSGYMEGAVEAGERAAREILHAMGKIPEDEIWQSEPESVDVPAQPITTTFLERH,0
4a79,A,486,501,15,PSVPGLLRLIGLTTI,0
4a79,A,502,520,18,SATALGFLAHKRGLLVRV,0
5kkh,C,18,36,18,WLALGTIGMLLGMLYFIA,0
5kkh,C,37,51,14,GLDVQDPRQKEFYV,0
5kkh,C,52,69,17,TILIPAIAAASYLSMFF,0
5kkh,C,88,103,15,ARYADWLFTTPLLLL,0
5kkh,C,104,117,13,IGLLAGASQRDIG,0
5kkh,C,118,136,18,LVGIDAFMIVTGLVATLT,0
5kkh,C,142,160,18,YAFWTISTISMVFLLYYL,0
5kkh,C,161,182,21,AVFGEAVSDADEDTRSTFNAL,0
5kkh,C,183,200,17,NIILVTWAIYPVAWLVG,0
5kkh,C,212,230,18,TLLFMVLDLVAKVGFGFI,0
5kkh,C,231,238,7,LRSRAIM,0
5b6v,C,4,11,7,TGRPEWI,0
5b6v,C,12,28,16,LALGTALMGLGTLYFL,0
5b6v,C,47,61,14,LVPAIAFTMYLSML,0
5b6v,C,62,79,17,GYGLTMVPFGGEQNPIY,0
5b6v,C,80,94,14,ARYADWLFTTPLLL,0
5b6v,C,111,126,15,VGADGIMIGTGLVGA,0
5b6v,C,127,134,7,TKVYSYR,0
5b6v,C,135,150,15,VWWAISTAAMLYILY,0
5b6v,C,178,192,14,VVLWSAYPVVWLIG,0
5b6v,C,193,203,10,EGAGIVPLNI,0
5b6v,C,204,220,16,TLLFMVLDVSAKVGFG,0
5khs,A,23,39,16,SLLIAAFSGVYVARHF,0
5khs,A,40,279,239,INTDISKLVDAEPQWAALSQAVDRAFPQRNGTILAVVEAPAPEFATAAAHALTESLQKQAAAGRIGPVAEPGGGPFFEHNGLLFLSPQQVADTTSQLASARPLVNELAKNPSLTGLATTLSTTLGQPLLTGQVKLPSMAKLLSRSAATVDDVLAGKPAAFSWRALVDNDAARQPARAFVTVQPVVNYGALKAGAQTSDVIRETARALDLEKRYGAVVRLTGEQPLADDEFSSVEDGAAL,0
5khs,A,280,295,15,GVVTLLVVFVILWLA,0
5khs,A,303,325,22,SVLVTLFVGLVVTAALGLAMVG,0
5khs,A,326,331,5,LNMIS,0
5khs,A,332,347,15,AFMVLFVGLGVDFSI,0
5khs,A,382,395,13,TAVAASFFSFIPT,0
5khs,A,396,400,4,YRGV,0
5khs,A,401,418,17,ELGLIAGVGMFVALLTT,0
5khs,A,444,453,9,PVDDYLDRH,0
5khs,A,458,473,15,IGTLAVVIGALPLLA,0
5khs,A,474,719,245,LHFDFNPLHLKDPHSESMSTLLALKDSPEAAVNDVTLLAPSLADADAAAKRLDALPEVGRTTTLSTFIPADQPEKRAAIATAASTLLPALTQPPAPPATDAQRVAALKRASDLLGYAAEDHPGPGAAAAQHLSQSLAKLAAADSATRDRAERAFADTLRIALNQLAALLQPQEITRDTLPPPLVRDWVAPDGKALVQISPKVPKGVDPNDDTMLRHFATAVKAAEPGAIGGPISILHSANTIISA,0
5khs,A,720,734,14,LHAALWSIISITIL,0
5khs,A,749,766,17,VPLLVSGIVTLEMCVVL,0
5khs,A,767,775,8,MSLNFANI,0
5khs,A,776,789,13,ALPLMLGVGVAFK,0
5khs,A,803,809,6,LHSSLT,0
5khs,A,813,827,14,FSAATTATAFGSLW,0
5khs,A,828,837,9,SHHPGTSSM,0
5khs,A,838,855,17,KLLALALTCTLIGAVVF,0
3hkk,C,-5,0,5,HHHHH,0
3hkk,C,9,25,16,AVTLLGVLLQAYFSLQ,0
3hkk,C,26,52,26,ISARRAFRVSPPLTTGPPEFERVYRA,0
3hkk,C,53,71,18,VNCSEYFPLFLATLWVAG,0
3hkk,C,79,95,16,ALCGLVYLFARLRYFQ,0
3hkk,C,96,105,9,YARSAQLRL,0
3hkk,C,106,124,18,PLYASARALWLLVALAAL,0
3hkk,C,125,142,17,LLAHFLPAALRAALLGR,0
3hkk,C,146,150,4,LPWA,0
2prc,H,13,30,17,QLVWYAQWLVIWTVVLL,0
2prc,H,31,258,227,LRREDRREGYPLVEPLGLVKLAPEDGQVYELPYPKTFVLPHGGTVTVPRRRPETRELKLAQTDGFEGAPLQPTGNPLVDAVGPASYAERAEVVDATVDGKAKIVPLRVATDFSIAEGDVDPRGLPVVAADGVEAGTVTDLWVDRSEHYFRYLELSVAGSARTALIPLGFCDVKKDKIVVTSILSEQFANVPRLQSRDQITLREEDKVSAYYAGGLLYATPERAESLL,0
5ekp,D,-3,123,126,QSNATIELSIVIPMYNEEDNLEHLFARLLEVLTPLKITYEIICVNDGSKDKTLKQLIDCYQSNRQIKIVNLSRNFGKEIALSAGIDYAQGNAVIPIDADLQDPPELIHELVDKWREGYDIVYATRR,0
5ekp,D,129,195,66,WVKQFTAKMFYKVIGRMTEIKIPPNTGDFRLMDRKVVNAIKQLPERTRFMKGLFAWVGYRQTFVLF,0
5ekp,D,207,208,1,N,0
5ekp,D,209,223,14,WKLWNFALDGIFSF,0
5ekp,D,224,230,6,LLPLKV,0
5ekp,D,231,252,21,TYLGSIISLLSLAYASFLILK,0
5ekp,D,260,283,23,PGYASLMVAILFLGGVQLISLGV,0
5ekp,D,284,314,30,GEYLGRVYEEVKARPLYLVSDLWGLEYLPL,0
4hfe,E,1,4,3,QDM,0
4hfe,E,5,198,193,SPPPPIADEPLTVNTGIYLIECYSLDDKAETFKVNAFLSLSWKDRRLAFDPVRSGVRVKTYEPEAIWIPEIRFVNVENARDADVVDISVSPDGTVQYLERFSARVLSPLDFRRYPFDSQTLHIYLIVRSVDTRNIVLAVDLEKVGKNDDVFLTGWDIESFTAVVKPANFALEDRLESKLDYQLRISRQYFSYI,0
4hfe,E,199,218,19,NIILPMLFILFISWTAFWS,0
4hfe,E,222,240,18,ANVTLVVSTLIAHIAANI,0
4hfe,E,241,255,14,VETNLPKTPYMTYT,0
4hfe,E,256,275,19,AIIFMIYLFYFVAVIEVTV,0
4hfe,E,292,313,21,RASRIAFPVVFLLANIILAFL,0
4hfe,E,314,315,1,F,0
4hfe,E,316,317,1,F,0
4myc,B,107,132,25,RIRVLIALGLLISAKILNVQVPFFF,0
4myc,B,133,158,25,QTIDSMNIAWDDPTVALPAAIGLTI,0
4myc,B,159,182,23,CYGVARFGSVLFGELRNAVFAKV,0
4myc,B,229,252,23,TAMVFHIIPISFEISVVCGILTY,0
4myc,B,253,256,3,FGA,0
4myc,B,257,280,23,FAAITFSTMLLYSIFTIKTTAWR,0
4myc,B,334,358,24,VSQSLAFLNSGQNLIFTTALTAMM,0
4myc,B,359,376,17,MGCTGVIGGNLTVGDLV,0
4myc,B,377,396,19,INQLVFQLSVPLNFLGSVY,0
4zzb,E,5,198,193,SPPPPIADEPLTVNTGIYLIESYSLDDCAETFKVNAFLSLSWKDRRLAFDPVRSGVRVKTYEPEAIWIPEIRFVNVENARDADVVDISVSPDGTVQYLERFSARVLSPLDFRRYPFDSQTLHIYLIVRSVDTRNIVLAVDLEKVGKNDDVFLTGWDIESFTAVVKPANFALEDRLESKLDYQLRISRQYFSYI,0
4zzb,E,199,218,19,NIILPMLFILFISWTAFWS,0
4zzb,E,222,242,20,ANVTLVVSTLIAHIAFNILV,0
4zzb,E,243,255,12,TNCPKTPYMTYT,0
4zzb,E,256,276,20,AIIFMIYLFYFVAVIEVTVQ,0
4zzb,E,292,313,21,RASRIAFPVVFLLANIILAFL,0
4zzb,E,314,315,1,F,0
2bns,C,1,10,9,VGVTAFGNF,0
2bns,C,13,31,18,SLAIYSFWIFLAGLIYYL,0
2bns,C,32,247,215,TENMREGYPLENEDGTPAANQGPFPLPKPKTFILPHGRGTLTVPGPESEDRPIALARTAVSEGFPHAPTGDPMKDGVGPASWVARRDLPELDGHGHNKIKPMKAAAGFHVSAGKNPIGLPVRGCDLEIAGKVVDIWVDIPEQMARFLEVELKDGSTRLLPMQMVKVQSNRVHVNALSSDLFAGIPTIKSPTEVTLLEEDKICGYVAGGLMYAAPK,0
2bns,C,248,260,12,KSVVAAMLAEYA,0
2ik5,_,47,68,21,YSIETVVGVLGNLCLMCVTVR,0
2ik5,_,69,75,6,KEKANV,0
2ik5,_,76,96,20,NLLIANLAFSDFLMCLLCQP,0
2ik5,_,119,140,21,IQCMSVTVSILSLVLVALERH,0
2ik5,_,141,153,12,LIINPTGWKPSI,0
2ik5,_,154,173,19,QAYLGIVLIWVIACVLSLP,0
2ik5,_,216,238,22,FLLLFQYCLPLGFILVCYARIY,0
2ik5,_,239,263,24,RLQRQGRVFHKGTYSLRAGHMKQV,0
2ik5,_,264,283,19,VVLVVMVVAFAVLWLPLHV,0
2ik5,_,307,326,19,HLLAMASTCVNPFIYGFLN,0
2ik5,_,327,338,11,NFKKEIKALVL,0
2ik5,_,339,375,36,CQQSAPLEESEHLPLSTVHTEVSKGSLRLSGRSNPI,0
2ks1,B,134,146,12,GCPTNGPKIPSI,0
2ks1,B,147,171,24,TGMVGALLLLLVVALGIGLFMRRR,0
2nmr,C,15,32,17,CTALVLFMTIPGIALFY,0
2nmr,C,33,45,12,GLIRGKNVLSML,0
2nmr,C,46,64,18,QVTVTFALVCILWVVYGY,0
2nmr,C,102,119,17,FQGSFACITVGLIVGAL,0
2nmr,C,120,126,6,ERIRFS,0
2nmr,C,127,147,20,VLIFVVVWLTLSYIPIAHMV,0
2nmr,C,161,178,17,AGGTVVHINAAIAGLVG,0
2nmr,C,179,181,2,YL,0
2nmr,C,182,194,12,GKRVGFGKEAFK,0
2nmr,C,195,201,6,HNLPMV,0
2nmr,C,202,219,17,TGTAILYIGWFGFNAGS,0
2nmr,C,231,248,17,VNTVVATAAAILGWIFG,0
2nmr,C,249,260,11,WALRGKPSLLG,0
2nmr,C,261,276,15,CSGAIAGLVGVTPAC,0
2nmr,C,282,299,17,GALIIGVVAGLAGLWGV,0
2nmr,C,300,301,1,M,0
2nmr,C,302,310,8,KRLLRVDD,0
2nmr,C,311,312,1,C,0
2nmr,C,313,332,19,VFGVHGVCGIVGCIMTGIF,0
2nmr,C,353,377,24,VQLESIAITIVWSGVVAFIGYKLA,0
2nmr,C,378,386,8,LTVGLRVP,0
2nmr,C,387,424,37,EQEREGLDVNSHGENAYNADQAQQPAQADLEHHHHHH,0
1yst,H,16,31,15,IYSFWIFLAGLIYYL,0
1yst,H,32,260,228,TENMREGYPLENEDGTPAANQGPFPLPKPKTFILPHGRGTLTVPGPESEDRPIALARTAVSEGFPHAPTGDPMKDGVGPASWVARRDLPELDGHGHNKIKPMKAAAGFHVSAGKNPIGLPVRGCDLEIAGKVVDIWVDIPEQMARFLEVELKDGSTRLLPMQMVKVQSNRVHVNALSSDLFAGIPTIKSPTEVTLLEEDKICGYVAGGLMYAAPKRKSVVAAMLAEYA,0
4mlb,A,4,6,2,TT,0
4mlb,A,7,13,6,GVQLLR,0
4mlb,A,14,20,6,DPKKAI,0
4mlb,A,21,42,21,RLSIPMMIGMSVQTLYNLADG,0
4mlb,A,57,79,22,LFFPVFMGIIALAAGLGVGTSS,0
4mlb,A,80,100,20,IARRIGARDKEGADNVAVHS,0
4mlb,A,101,123,22,ILSLILGVTITITMLPAIDSLF,0
4mlb,A,137,161,24,EYARVLLAGAFIIVFNNVGNGILR,0
4mlb,A,162,165,3,EGD,0
4mlb,A,166,187,21,NRAMLAMVLGSGLNIVLDPIF,0
4mlb,A,197,218,21,AAYATLLSMVVTSLFIAYWLF,0
4mlb,A,219,242,23,KRDTYVDITLRDFSPSREILKDI,0
4mlb,A,243,266,23,RVGLPSSLSQLSMSIAMFFLNSV,0
4mlb,A,280,301,21,SAWRITMLGIVPILGMATATT,0
4mlb,A,302,320,18,VTGAAYGERNVEKLETAY,0
4mlb,A,321,342,21,YAIKIAFMIELAVVAFIMLFA,0
4mlb,A,366,388,22,RTLPVFLVLTPFGMMTSAMFQG,0
4mlb,A,389,391,2,GE,0
4mlb,A,392,418,26,EKSLILTIFRTLVMQVGFAYIFVHYT,0
4mlb,A,424,444,20,VWIGIVIGNMVAAIVGFLWG,0
4mlb,A,445,456,11,MRISALKKTSA,0
3ayg,A,1,16,15,EVNRTVSPNIQTGRK,0
3ayg,A,21,45,24,LKSILIFTILISSTVLLVGGYWIF,0
3ayg,A,46,116,70,EMAPRPKEVRSESGEVLMTKETIIGGQAVFQKYGLMDYGTVLGHGSYMGPDYTAEALKVYTEGMQDYKAK,0
3ayg,A,117,123,6,RYNKPF,0
3ayg,A,124,253,129,DLTDDEKSIIREQVIKEMRKNRYNPVTDVLVLTDAQVYGLEKVRDYYRDVFTNGDGWGLKKGLIKESDMPKANRAWVADSDQIQQIADFFFWTAWLSSTLRIGDEITYTNNWPYYEDAGNTMSFSAVWW,0
3ayg,A,254,278,24,GASVTILILFIGIILYVFYRYQLS,0
3ayg,A,306,328,22,KYFVVVSALFFVQTMFGALLAH,0
3ayg,A,329,349,20,YTEPDSFFGINWIYDILPFN,0
3ayg,A,350,372,22,AKGYHLQLAIFWIATAWLGMGI,0
3ayg,A,390,411,21,DLLFWALVVLVGGSMIGQWLG,0
3ayg,A,412,418,6,NGYLGN,0
3ayg,A,419,452,33,WFLLGHQGWEYIELGRIWQIILVVGMLLWLFIV,0
3ayg,A,473,491,18,FYSAIAVPFFYIFAFFIQ,0
3ayg,A,492,498,6,DTNFTM,0
3ayg,A,499,524,25,DFWRWWIIHLWVEGIFEVFAVVVIG,0
3ayg,A,541,561,20,LYFQFTILLGSGVIGIGHHY,0
3ayg,A,562,569,7,YNGSPEV,0
3ayg,A,570,596,26,IALGAVFSALEVIPLTLLILEAYEQY,0
3ayg,A,610,635,25,TFWFLISTAIWNLVGAGVFGFLINL,0
3ayg,A,636,642,6,AVSYFE,0
3ayg,A,643,647,4,GQFL,0
3ayg,A,648,672,24,PAHGHAAMMGVYGMFAIAVLLYSL,0
3ayg,A,684,706,22,WLKFSCWMLNIGLAGMVVITLL,0
3ayg,A,707,741,34,VGILQMKEAFIHGYWASRSPSFLQQDVVQNLLLV,0
3ayg,A,742,764,22,AVPDTIFLIGVVALLVFAIKAL,0
3ayg,A,778,800,22,PVANHWMKDRLKNSLEHHHHHH,0
3zoj,D,1,10,9,PDIENQAAD,0
3zoj,D,49,66,17,GEFVGTFLFLWSAFVIA,0
3zoj,D,67,86,19,IANQAPETPDGGSNPAQLI,0
3zoj,D,87,104,17,ISFGFGFGVMVGVFITY,0
3zoj,D,108,121,13,GNLNPAVTLALVL,0
3zoj,D,131,148,17,LMAFTQIVAGMAAAGAA,0
3zoj,D,149,171,22,AMTPGEIAFANALGGGASRTRG,0
3zoj,D,172,189,17,FLEAFGTAILCLTVLML,0
3zoj,D,200,216,16,PFVIGIALLIAHLICI,0
3zoj,D,217,221,4,YTGA,0
3zoj,D,222,234,12,LNPARSFGPAVA,0
3zoj,D,235,242,7,RSFPNYH,0
3zoj,D,243,260,17,IYWLGPILGAFLAYSIW,0
3zoj,D,274,279,5,QDSDA,0
1iw6,C,1,4,3,AQI,0
1iw6,C,5,11,6,GRPEWI,0
1iw6,C,12,29,17,LALGTALMGLGTLYFLV,0
1iw6,C,45,61,16,TTLVPAIAFTMYLSML,0
1iw6,C,62,79,17,GYGLTMVPFGGEQNPIY,0
1iw6,C,80,95,15,ARYADWLFTTPLLLL,0
1iw6,C,110,126,16,LVGADGIMIGTGLVGA,0
1iw6,C,127,134,7,TKVYSYR,0
1iw6,C,135,153,18,VWWAISTAAMLYILYVLF,0
1iw6,C,175,192,17,NVTVVLWSAYPVVWLIG,0
1iw6,C,193,203,10,EGAGIVPLNI,0
1iw6,C,204,222,18,TLLFMVLDVSAKVGFGLI,0
1iw6,C,232,248,16,AEAPEPSAGDGAAATS,0
4mmf,B,1,4,3,EVK,0
4mmf,B,5,12,7,EHWATRL,0
4mmf,B,13,32,19,LILAMAGYAVDLGNFLRFP,0
4mmf,B,42,63,21,FMIPYIIAFLLVGIPLMWIEW,0
4mmf,B,64,89,25,MGRYGGAQGHGTTPAIFYLLWRNRF,0
4mmf,B,90,124,34,KILGVFGLWIPLVVAIYYVYIESWTLGFAIKFLV,0
4mmf,B,132,134,2,,0
4mmf,B,167,185,18,AYIVFLITMFINVSILIR,0
4mmf,B,186,190,4,ISKG,0
4mmf,B,191,214,23,ERFAKIAMPTLFILAVFLVIRVF,0
4mmf,B,223,231,8,ADGLNFLW,0
4mmf,B,242,265,23,VWIAAVGQIFFSLGLGFGAIITY,0
4mmf,B,266,277,11,SYVRKDQDIVL,0
4mmf,B,278,298,20,GLTAATLNEKAEVILGGSIS,0
4mmf,B,318,324,6,AFNLGF,0
4mmf,B,326,331,5,LPAIF,0
4mmf,B,340,367,27,GFLWFFLLFFAGLTSSIAGMQPMIAFL,0
4mmf,B,368,377,9,DELKLSRKH,0
4mmf,B,378,396,18,VLWTAAIVFFSAHLVMFL,0
4mmf,B,400,425,25,DEMDFWAGTIGVVFFGLTELIIFFW,0
4mmf,B,426,428,2,FG,0
4mmf,B,429,437,8,DKAWEEIN,0
4mmf,B,438,447,9,GGIIKVPRI,0
4mmf,B,448,472,24,YYVMRYITPAFLAVLLVVWAREYI,0
4mmf,B,473,478,5,KIMEE,0
4mmf,B,484,502,18,ITRFYIIGLFLFLTFLVF,0
4mmf,B,503,511,8,AERRRNHE,0
4mmf,B,512,518,6,AGTLVP,0
1e7p,F,29,50,21,QSATGLFLGLFMIGHMFFVST,0
1e7p,F,51,53,2,LL,0
1e7p,F,54,64,10,DNVMLWVTKK,0
1e7p,F,65,77,12,QLDFIFEGGKPI,0
1e7p,F,78,101,23,VSFLAAFVFAVFIAHAFLAMRKF,0
1e7p,F,105,118,13,RQYLTFKTHKDLM,0
1e7p,F,125,151,26,WWIQAMTGFAMFFLGSVHLYIMMTQP,0
1e7p,F,152,157,5,TIGPV,0
1e7p,F,158,165,7,SSFRMVS,0
1e7p,F,166,167,1,W,0
1e7p,F,168,192,24,WPLYLVLLFAVELHGSVGLYRLAV,0
1e7p,F,206,229,23,ANLKKLKTLMSAFLIVLGLLTFG,0
1e7p,F,230,254,24,YVKKGLEQTDPNIDYKYFDYKRTH,0
1e7p,F,255,256,1,R,0
5eqi,A,17,37,20,GAVLGSLQFGYNTGVINAPQ,0
5eqi,A,38,52,14,VIEEFYNQTWVHRY,0
5eqi,A,53,63,10,ESILPTTLTT,0
5eqi,A,64,86,22,WSLSVAIFSVGGMIGSFSVGLF,0
5eqi,A,94,113,19,SMLMMNLLAFVSAVLMGFS,0
5eqi,A,114,118,4,LGKS,0
5eqi,A,119,141,22,EMLILGRFIIGVYCGLTTGFVP,0
5eqi,A,158,178,20,LHQLGIVVGILIAQVFGLDS,0
5eqi,A,179,185,6,MGNKDL,0
5eqi,A,186,205,19,PLLLSIIFIPALLQCIVLP,0
5eqi,A,273,298,25,IAVVLQLSQQLSGINAVFYYSTSIF,0
5eqi,A,299,306,7,KAGVQQP,0
5eqi,A,307,328,21,YATIGSGIVNTAFTVVSLFVV,0
5eqi,A,334,354,20,TLHLIGLAGMAGCAILMTIA,0
5eqi,A,355,366,11,ALLEQLPWMSY,0
5eqi,A,367,391,24,SIVAIFGFVAFFEVGPGPIPWFIV,0
5eqi,A,404,426,22,AVAGFSNWTSNFIVGMCFQYVE,0
5eqi,A,427,432,5,LCGPY,0
5eqi,A,433,452,19,FIIFTVLLVLFFIFTYFKV,0
5ide,D,-7,3,10,DYKDDDDKFP,0
5ide,D,306,307,1,G,0
5ide,D,381,395,14,DQQISNDSSSSENR,0
5ide,D,508,514,6,PQKSKP,0
5ide,D,528,542,14,MCIVFAYIGVSVVL,0
5ide,D,543,546,3,LVS,0
5ide,D,547,596,49,FSPYEWHLEDNNEEPRDPQSPPDPPNEFGIFNSLWFSLGAFMQQGCDIS,0
5ide,D,597,602,5,RSLSG,0
5ide,D,603,617,14,IVGGVWWFFTLIII,0
5ide,D,634,636,2,SP,0
5ide,D,778,786,8,AKDSGSKD,0
5ide,D,799,813,14,FYILVGGLGLAMMV,0
5ide,D,814,821,7,LIEFCYK,0
5ide,D,822,866,44,RAESKRMKLTKNTQNFKPAPATNTQNYATYREGYNVYGTESVKI,0
1pw4,A,2,4,2,SI,0
1pw4,A,5,29,24,KPAPHKARLPAAEIDPTYRRLRWQ,0
1pw4,A,30,52,22,FLGIFFGYAAYYLVRKNFALAM,0
1pw4,A,64,84,20,LGFALSGISIAYGFSKFIMG,0
1pw4,A,85,90,5,VSDRS,0
1pw4,A,91,111,20,PRVFLPAGLILAAAVMLFMG,0
1pw4,A,122,141,19,MFVLLFLCGWFQGMGWPPC,0
1pw4,A,142,159,17,RTMVHWWSQKERGGIVS,0
1pw4,A,160,179,19,WNCAHNVGGGIPPLLFLLG,0
1pw4,A,190,208,18,YMPAFCAILVALFAFAMM,0
1pw4,A,209,226,17,DTPQSCGLPPIEEYKND,0
1pw4,A,227,239,12,PDDYNEKAEQEL,0
1pw4,A,240,242,2,AK,0
1pw4,A,243,248,5,IFMQY,0
1pw4,A,249,256,7,LPNKLLW,0
1pw4,A,257,280,23,IAIANVFVYLLRYGILDWSPTYL,0
1pw4,A,291,310,19,SWAYFLYEYAGIPGTLLCG,0
1pw4,A,311,322,11,MSDKVFRGNRG,0
1pw4,A,323,342,19,TGVFFMTLVTIATIVYWMN,0
1pw4,A,347,369,22,TVDMICMIVIGFLIYGPVMLIG,0
1pw4,A,370,386,16,HALELAPKKAAGTAAG,0
1pw4,A,387,408,21,TGLFGYLGGSVAASAIVGYTV,0
1pw4,A,414,433,19,GGFMVMIGGSILAVILLIV,0
1pw4,A,434,451,17,MIGEKRRHEQLLQELVP,0
3vvr,A,1,3,2,SE,0
3vvr,A,4,6,2,TT,0
3vvr,A,7,12,5,GVQLL,0
3vvr,A,13,23,10,GDPKKAIVRL,0
3vvr,A,24,44,20,IPMMIGMSVQTLYNLADGIW,0
3vvr,A,57,79,22,LFFPVFMGIIALAAGLGVGTSS,0
3vvr,A,80,99,19,IARRIGARDKEGADNVAVH,0
3vvr,A,100,120,20,LILSLILGVTITITMLPAID,0
3vvr,A,138,161,23,YARVLLAGAFIIVFNNVGNGILR,0
3vvr,A,162,166,4,EGDA,0
3vvr,A,167,188,21,RAMLAMVLGSGLNIVLDPIFI,0
3vvr,A,197,218,21,AAYATLLSMVVTSLFIAYWLF,0
3vvr,A,219,242,23,KRDTYVDITLRDFSPSREILKDI,0
3vvr,A,243,264,21,RVGLPSSLSQLSMSIAMFFLN,0
3vvr,A,280,301,21,SAWRITMLGIVPILGMAAATT,0
3vvr,A,302,323,21,VTGAAYGERNVEKLETAYLYA,0
3vvr,A,324,346,22,KIAFMIELAVVAFIMLFAPQVA,0
3vvr,A,352,357,5,ESAQV,0
3vvr,A,364,388,24,ALRTLPVFLVLTPFGMMTSAMFQG,0
3vvr,A,389,391,2,GE,0
3vvr,A,392,415,23,EKSLILTIFRTLVMQVGFAYIFV,0
3vvr,A,417,420,3,TTL,0
3vvr,A,424,444,20,VWIGIVIGNMVAAIVGFLWG,0
3vvr,A,445,454,9,MRISALKKT,0
3vvr,A,455,461,6,ATGGKR,0
3vw7,A,83,90,7,GTAFISE,0
3vw7,A,105,131,26,PSVYTGVFVVSLPLNIMAIVVFILKM,0
3vw7,A,132,136,4,VKKP,0
3vw7,A,137,159,22,VVYMLHLATADVLFVSVLPFKI,0
3vw7,A,178,200,22,TAAFYCNMYASILLMTVISIDR,0
3vw7,A,201,208,7,LAVVYPM,0
3vw7,A,209,213,4,SLSW,0
3vw7,A,214,216,2,TL,0
3vw7,A,217,238,21,RASFTCLAIWALAIAGVVPLL,0
3vw7,A,267,291,24,AYYFSAFSAVFFFVPLIISTVCYV,0
3vw7,A,292,310,18,IIRCLSSSANIFEMLRIDEGLRLKIYKNTEGYYTIGIGHLLTKSPSLNAAKSELDKAIGRNTNGVITKDEAEKLFNQDVDAAVRGILRNAKLKPVYDSLDAVRRAALINMVFQMGETGVAGFTNSLRMLQQKRWDEAAVNLAKSRWYNQTPNRAKRVITTFRTGTWDAYANRSKKSR,0
3vw7,A,311,340,29,LFLSAAVFCIFIICFGPTNVLLIAHYSFL,0
3vw7,A,353,375,22,LLCVCVSSISCCIDPLIYYYAS,0
3vw7,A,376,378,2,EC,0
3vw7,A,379,407,28,RYVYSILCCKESSDPSCYHHHHHHHHHH,0
2lx0,A,7,27,20,VIAGLVALLTFLAFGFWLFK,0
2lx0,A,28,32,4,LQKK,0
4m48,A,20,24,4,NSIS,0
4m48,A,25,34,9,ERETWSGKV,0
4m48,A,35,57,22,FLLSVIGFAVDLANVWRFPYLC,0
4m48,A,63,82,19,AFLVPYGIMLAVGGIPLFY,0
4m48,A,83,111,28,ELALGQHNRKGAITCWGRLVPLFKGIGY,0
4m48,A,112,133,21,VVLIAFYVDFYYNVIIAWSLR,0
4m48,A,238,255,17,MALCLLIVYLICYFSLW,0
4m48,A,256,260,4,GIST,0
4m48,A,261,281,20,GKVVWFTALFPYAALLILLI,0
4m48,A,304,328,24,YKAEVWADAATQVFFSLGPGFGVL,0
4m48,A,329,344,15,AYASYNKYHNNVYKD,0
4m48,A,345,362,17,LLTSFINSATSFIAGFV,0
4m48,A,409,429,20,FFMMLATLGLDSSFGGSEAI,0
4m48,A,430,447,17,TALSDEFPKIKRNRELF,0
4m48,A,448,464,16,AGLFSLYFVVGLASCT,0
4m48,A,468,491,23,YFFHLLDRYAAGYSILVAVFFEA,0
4m48,A,492,516,24,AVSWIYGTNRFSEDIRDMIGFPPG,0
4m48,A,517,524,7,YWQVCWR,0
4m48,A,526,545,19,APIFLLFITVYLLIGYEPL,0
4m48,A,555,572,17,ANALGWCIAGSSVVMIP,0
4m48,A,573,599,26,VAIFKLLSTPGSLRQRFTILTTPWRD,0
4m48,A,600,605,5,QLVPR,0
4c9q,B,-14,2,16,HHHHHHHHHIEGRSMA,0
4c9q,B,3,17,14,DAKQQETNFAINFL,0
4c9q,B,18,38,20,GGVSAAIAKTAASPIERVKI,0
4c9q,B,79,93,14,TANVIRYFPTQALN,0
4c9q,B,94,104,10,AFKDKIKLMF,0
4c9q,B,105,123,18,FKKEEGYGKWFAGNLASG,0
4c9q,B,124,142,18,AAGALSLLFVYSLDFART,0
4c9q,B,149,155,6,SSKKGG,0
4c9q,B,162,172,10,TDVYKKTLKS,0
4c9q,B,179,196,17,RGFMPSVVGIVVYRGLY,0
4c9q,B,197,207,10,GMFDSLKPLV,0
4c9q,B,208,214,6,TGSLDG,0
4c9q,B,215,224,9,FLASFLLGW,0
4c9q,B,225,242,17,VTTGASTCSYPLDTVRR,0
4c9q,B,274,294,20,KGCGANILRSVAGAGVISMY,0
4c9q,B,295,306,11,QLQMILFGKKF,0
5lx9,A,132,140,8,RACFKSIF,0
5lx9,A,147,169,22,NIWTHLLGCVFFLCLGIFYMFR,0
5lx9,A,170,179,9,NISFVAPLQ,0
5lx9,A,180,203,23,KVVFGLFFLGAILCLSFSWLFHT,0
5lx9,A,215,239,24,SKLDYSGIALLIMGSFVPWLYYSF,0
5lx9,A,240,244,4,CNPQ,0
5lx9,A,245,266,21,CFIYLIVICVLGIAAIIVSQW,0
5lx9,A,276,298,22,VRAGVFLGLGLSGIIPTLHYVI,0
5lx9,A,299,309,10,EGFLKAATIG,0
5lx9,A,310,333,23,IGWLMLMASLYITGAALYAARIP,0
5lx9,A,345,369,24,HSHQLFHIFVVAGAFVHFHGVSNL,0
5lx9,A,370,380,10,EFRFMIGGGC,0
3din,E,1,8,7,KTFFLIV,0
3din,E,15,29,14,LIYMVQVQMSKFSE,0
3din,E,30,53,23,GGAFGSGGLHTVFGRRKGLDTGG,0
3din,E,54,66,12,ITLVLSVLFFVS,0
3din,E,74,76,2,TR,0
1k6l,H,1,10,9,VGVTAFGNF,0
1k6l,H,12,32,20,ASLAIYSFWIFLAGLIYYLQ,0
1k6l,H,33,250,217,ENMREGYPLENEDGTPAANQGPFPLPKPKTFILPHGRGTLTVPGPESEDRPIALARTAVSEGFPHAPTGDPMKDGVGPASWVARRDLPELDGHGHNKIKPMKAAAGFHVSAGKNPIGLPVRGCDLEIAGKVVDIWVDIPEQMARFLEVELKDGSTRLLPMQMVKVQSNRVHVNALSSDLFAGIPTIKSPTEVTLLEEDKICGYVAGGLMYAAPKRKS,0
1k6l,H,251,260,9,VAAMLAEYA,0
1k4d,L,1,21,20,APMLSGLLARLVKLLLGRHG,0
1k4d,L,22,25,3,ALH,0
1k4d,L,26,50,24,RAAGAATVLLVIVLLAGSYLAVLA,0
1k4d,L,63,79,16,RALWWSVETATTVGYG,0
1k4d,L,87,112,25,GRCVAVVVMVAGITSFGLVTAALAT,0
1k4d,L,113,124,11,FVGREQERRGH,0
4tnh,z,1,2,1,T,0
4tnh,z,3,20,17,LFQLALAALVILSFVMV,0
4tnh,z,44,58,14,GLWIALVLVVGVLN,0
4tnh,z,59,62,3,FVV,0
5id3,E,216,235,19,AGFAASGVQTGLFARLTWW,0
5id3,E,236,239,3,YSW,0
5id3,E,240,257,17,IVEPVTYFATYSTVAAT,0
3j1z,Q,297,300,3,TQT,0
3j1z,Q,312,329,17,ASVATALTLITIKLLAW,0
3j1z,Q,330,338,8,YSGSASML,0
3j1z,Q,339,355,16,SLTDSFADTLASIINF,0
3j1z,Q,388,403,15,MGSAFLLLFYGGERL,0
3j1z,Q,404,421,17,NPSPVENATLGVVVSVV,0
3j1z,Q,422,439,17,IVLTLALVLLQKRALAA,0
3j1z,Q,446,459,13,ADSLHYKSDLFLN,0
3j1z,Q,460,476,16,AVLLALVLSQYGWWWA,0
3j1z,Q,477,492,15,GLFAVLIACYIGQQA,0
3j1z,Q,593,602,9,HHHHHHHHH,0
4djk,A,1,11,10,ATSVQTGKAK,0
4djk,A,15,22,7,LGFFAIT,0
4djk,A,23,35,12,SMVMAVYEYPTF,0
4djk,A,36,41,5,TSGFS,0
4djk,A,42,58,16,VFFLLLGGILWFIPVG,0
4djk,A,71,73,2,EG,0
4djk,A,75,83,8,FAWVSNTL,0
4djk,A,95,114,19,YLQIAIGFIPMLYFVLGAL,0
4djk,A,115,130,15,YILKWPALNEDPITK,0
4djk,A,131,147,16,IAALIILWALALTQFG,0
4djk,A,152,173,21,ARIAKVGFFAGILLPAFILIA,0
4djk,A,174,180,6,AAIYLH,0
4djk,A,181,192,11,GAPVAIEMDSK,0
4djk,A,193,204,11,FFPDFSKVGTL,0
4djk,A,205,217,12,VFVAFILSYMGV,0
4djk,A,237,254,17,MLLLMVAAICLSSVGGL,0
4djk,A,255,292,37,IAMVIPGNEINLSAGVMQTFTVLMSHVAPEIEWTVRV,0
4djk,A,293,312,19,SALLLLGVLAEIASWIVGP,0
4djk,A,343,359,16,SQLVITSIALIILTNT,0
4djk,A,360,366,6,GGNNMS,0
4djk,A,367,383,16,LIALALTVVIYLCAYF,0
4djk,A,415,433,18,AIVGLLTSIMAFIVSFLP,0
4djk,A,434,445,11,DNIQGDSTDMY,0
4djk,A,446,459,13,ELLVVSFLVVLAL,0
4djk,A,467,490,23,DRKGKANTGVTLEPINSQNAPKG,0
4djk,A,502,511,9,YIVMNDKKH,0
4c9g,A,1,23,22,SSNAQVKTPLPPAPAPKKESNF,0
4c9g,A,31,49,18,VSAAVAKTAASPIERVKL,0
4c9g,A,50,69,19,IQNQDEMLKQGTLDRKYAG,0
4c9g,A,70,81,11,LDCFKRTATQE,0
4c9g,A,82,86,4,VISF,0
4c9g,A,87,103,16,RGNTANVIRYFPTQAL,0
4c9g,A,104,115,11,FAFKDKIKAMF,0
4c9g,A,135,153,18,AAGALSLLFVYSLDYART,0
4c9g,A,154,159,5,LAADS,0
4c9g,A,160,167,7,SSKKGGA,0
4c9g,A,168,172,4,QFNG,0
4c9g,A,173,183,10,IDVYKKTLKS,0
4c9g,A,184,185,1,G,0
4c9g,A,186,211,25,AGLYRGFLPSVVGIVVYRGLYFGMY,0
4c9g,A,215,227,12,PLLLTGSLEGSF,0
4c9g,A,232,253,21,LGWVVTTGASTCSYPLDTVRR,0
4c9g,A,254,287,33,MMMTSGQAVKYDGAFDCLRKIVAAEGVGSLFKG,0
4c9g,A,288,305,17,GANILRGVAGAGVISMY,0
4c9g,A,310,318,8,ILFGKKFK,0
3mbv,C,1,4,3,AQI,0
3mbv,C,10,32,22,IWLALGTALMGLGTLYFLVKGM,0
3mbv,C,33,42,9,VSDPDAKKF,0
3mbv,C,43,62,19,AITTLVPAIAFTMYLSMLL,0
3mbv,C,80,98,18,ARYADWLFTTPLLLLDLA,0
3mbv,C,99,106,7,LVDADQG,0
3mbv,C,107,127,20,ILALVGADGIMIGTGLVGAL,0
3mbv,C,134,154,20,FVWWAISTAAMLYILYVLFF,0
3mbv,C,155,156,1,F,0
3mbv,C,157,161,4,SKAE,0
3mbv,C,162,173,11,MRPEVASTFKV,0
3mbv,C,174,192,18,RNVTVVLWSAYPVVWLIG,0
3mbv,C,203,224,21,ETLLFMVLDVSAKVGFGLILL,0
3mbv,C,225,231,6,SRAIFG,0
3mbv,C,232,248,16,AEAPEPSAGDGAAATS,0
4tni,z,1,2,1,T,0
4tni,z,3,20,17,LFQLALAALVILSFVMV,0
4tni,z,43,57,14,SGLWIALVLVVGVL,0
4tni,z,58,62,4,FFVV,0
1lgh,X,1,2,1,E,0
1lgh,X,21,40,19,TTFSAFIILAAVAHVLVWV,0
1lgh,X,41,45,4,KPWF,0
5lzq,B,4,17,13,ALFFLIPLVALGF,0
5lzq,B,18,55,37,AANFAAVVRKPEGTERMKEISSYIRSGADSFLAHETK,0
5lzq,B,56,70,14,IFKVAIVIAILLMI,0
5lzq,B,75,90,15,TGVAFLLGAVMSASA,0
5lzq,B,91,130,39,IVGMKMATRANVRVAEAARTTKKIGPALKVAYQGGSVMG,0
5lzq,B,131,147,16,SVGGFALLGLVLVYLI,0
5lzq,B,176,190,14,SGYALGCSIIAMFD,0
5lzq,B,191,240,49,VGGGVYTKAADMAADLVGKTELNLPEDDPRNPATIADNVGDNVGDVAGL,0
5lzq,B,241,255,14,ADLLESFVGAIVSS,0
5lzq,B,291,306,15,FFALVGLGCSMLGIL,0
5lzq,B,307,324,17,VIVKKPSDNPQRELNIS,0
5lzq,B,325,339,14,WTSALLTVVLTAFL,0
5lzq,B,364,380,16,SAIIGIFSGILIGFWA,0
5lzq,B,381,414,33,YYTSYRYKPTQFLGKSSIEGTGMVISNGLSLGM,0
5lzq,B,415,431,16,SVFPPTLTLVLGILFA,0
5lzq,B,441,455,14,IAALGMLSFVATSV,0
5lzq,B,456,497,41,VDSYGPIADNAGGISEMCELDPEVRKITDHLDAVGNTTAAI,0
5lzq,B,498,513,15,KGFAIGSAIFAALSL,0
5lzq,B,546,559,13,GALLGAAITYYFS,0
5lzq,B,560,612,52,YLISAVTKAAMKMVDEIRRQAREIPGLLEGKAKPDYNRCIEITSDNALKQMG,0
5lzq,B,613,626,13,PAFIAILTPLVTG,0
5lzq,B,635,651,16,GVLIGTVLSGAMLAIL,0
5lzq,B,652,699,47,ANSGGAWDNAKKYLEAGNLEGYGKGSEPHKALVIGDTVGDPLKDTVG,0
5lzq,B,700,713,13,SLDILIKIMSVVS,0
4av6,B,-8,4,12,RGSHHHHHHYVA,0
4av6,B,7,20,13,FLIPLVALGFAAA,0
4av6,B,21,28,7,FAAVVRK,0
4av6,B,29,37,8,EGTERMKE,0
4av6,B,38,54,16,SSYIRSGADSFLAHET,0
4av6,B,55,70,15,AIFKVAIVIAILLMI,0
4av6,B,77,91,14,VAFLLGAVMSASAG,0
4av6,B,92,113,21,VGMKMATRANVRVAEAARTTK,0
4av6,B,114,118,4,IGPA,0
4av6,B,119,129,10,KVAYQGGSVM,0
4av6,B,130,144,14,LSVGGFALLGLVLV,0
4av6,B,149,152,3,KWM,0
4av6,B,177,192,15,GYALGCSIIAMFDRV,0
4av6,B,193,207,14,GGVYTKAADMAADL,0
4av6,B,208,225,17,GKTELNLPEDDPRNPAT,0
4av6,B,226,240,14,ADNVGDNVGDVAGL,0
4av6,B,241,254,13,ADLLESFVGAIVS,0
4av6,B,291,307,16,FFALVGLGCSMLGILY,0
4av6,B,308,322,14,IVKKPSDNPQRELN,0
4av6,B,323,337,14,SLWTSALLTVVLTA,0
4av6,B,349,357,8,LDVLGFRF,0
4av6,B,364,380,16,SAIIGIFSGILIGFWA,0
4av6,B,381,414,33,YYTSYRYKPTQFLGKSSIEGTGMVISNGLSLGM,0
4av6,B,415,431,16,SVFPPTLTLVLGILFA,0
4av6,B,441,456,15,IAALGMLSFVATSVS,0
4av6,B,457,472,15,DSYGPIADNAGGISE,0
4av6,B,473,479,6,CELDPE,0
4av6,B,480,497,17,RKITDHLDAVGNTTAAI,0
4av6,B,498,514,16,KGFAIGSAIFAALSLF,0
4av6,B,545,559,14,AGALLGAAITYYFS,0
4av6,B,560,571,11,YLISAVTKAAM,0
4av6,B,572,599,27,MVDEIRRQAREIPGLLEGKAKPDYNRC,0
4av6,B,600,611,11,EITSDNALKQM,0
4av6,B,612,629,17,YPAFIAILTPLVTGFLL,0
4av6,B,634,651,17,GGVLIGTVLSGAMLAIL,0
4av6,B,652,699,47,ANSGGAWDNAKKYLEAGNLEGYGKGSEPHKALVIGDTVGDPLKDTVG,0
4av6,B,700,716,16,SLDILIKIMSVVSVIA,0
4av6,B,717,723,6,SIFKHV,0
5i31,A,342,360,18,GSFCVRNPGCVIFFSLVF,0
5i31,A,361,374,13,TACSSGLVFVRVT,0
5i31,A,622,635,13,TVVISYAIMFLYI,0
5i31,A,636,641,5,LALGH,0
5i31,A,658,664,6,AGILIV,0
5i31,A,665,684,19,SSVACSLGVFSYIGLPLTL,0
5i31,A,686,701,15,IEVIPFLVLAVGVDN,0
5i31,A,702,714,12,FILVQAYQRDER,0
5i31,A,724,738,14,GRVLGEVAPSMFLS,0
5i31,A,739,752,13,FSETVAFFLGALS,0
5i31,A,758,771,13,TFSLFAGLAVFID,0
5i31,A,772,792,20,LLQITCFVSLLGLDIKRQEK,0
5i31,A,828,833,5,LLKDW,0
5i31,A,834,850,16,RPIVIAIFVGVLSFSI,0
5i31,A,1100,1114,14,NLGVSLGAIFLVTM,0
5i31,A,1115,1120,5,LLGCE,0
5i31,A,1121,1137,16,WSAVIMCATIAMVLVN,0
5i31,A,1150,1162,12,AVSLVNLVMSCG,0
5i31,A,1163,1171,8,SVEFCSHI,0
5i31,A,1180,1192,12,GSRVERAEEALA,0
5i31,A,1193,1207,14,MGSSVFSGITLTKF,0
5i31,A,1222,1242,20,IFYFRMYLAMVLLGATHGLI,0
5i31,A,1243,1246,3,LPV,0
4oxs,F,126,130,4,SHMG,0
4oxs,F,133,150,17,VAALLTVVFYIAAVMAT,0
4oxs,F,151,167,16,LYGATFPEWFGDLSKS,0
4oxs,F,168,181,13,YTLFQVMTLESWS,0
4oxs,F,182,194,12,GIVRPVMNVHPN,0
4oxs,F,195,215,20,WVFFIPFIMLTTFTVLNLFI,0
4oxs,F,223,274,51,ITKEQEEEAKTGHHQEPISQTLLHLGDRLDRIEKQLAQNNELLQRQQPQKK,0
3vvs,A,1,3,2,SE,0
3vvs,A,7,12,5,GVQLL,0
3vvs,A,24,44,20,IPMMIGMSVQTLYNLADGIW,0
3vvs,A,45,56,11,SGLGPESLAAV,0
3vvs,A,57,78,21,LFFPVFMGIIALAAGLGVGTS,0
3vvs,A,101,120,19,ILSLILGVTITITMLPAID,0
3vvs,A,121,137,16,LFRSMGAKGEAVELAI,0
3vvs,A,138,161,23,YARVLLAGAFIIVFNNVGNGILR,0
3vvs,A,167,188,21,RAMLAMVLGSGLNIVLDPIFI,0
3vvs,A,189,196,7,TLGFGVV,0
3vvs,A,197,216,19,AAYATLLSMVVTSLFIAYW,0
3vvs,A,243,264,21,RVGLPSSLSQLSMSIAMFFLN,0
3vvs,A,265,279,14,VAITAGGENGVAVF,0
3vvs,A,280,301,21,SAWRITMLGIVPILGMAAATT,0
3vvs,A,324,346,22,KIAFMIELAVVAFIMLFAPQVA,0
3vvs,A,347,350,3,LFT,0
3vvs,A,351,357,6,SESAQV,0
3vvs,A,358,363,5,KGDLI,0
3vvs,A,364,387,23,ALRTLPVFLVLTPFGMMTSAMFQ,0
3vvs,A,392,414,22,EKSLILTIFRTLVMQVGFAYIF,0
3vvs,A,415,423,8,HYTTLGLR,0
3vvs,A,424,444,20,VWIGIVIGNMVAAIVGFLWG,0
3vvs,A,455,461,6,ATGGKR,0
5eqh,A,14,35,21,AVGGAVLGSLQFGYNTGVINA,0
5eqh,A,36,66,30,QKVIEEFYNQTWVHRYGESILPTTLTTLWS,0
5eqh,A,67,87,20,SVAIFSVGGMIGSFSVGLFV,0
5eqh,A,93,111,18,NSMLMMNLLAFVSAVLMG,0
5eqh,A,112,120,8,SKLGKSFE,0
5eqh,A,121,141,20,LILGRFIIGVYCGLTTGFVP,0
5eqh,A,158,175,17,LHQLGIVVGILIAQVFG,0
5eqh,A,176,188,12,DSIMGNKDLWPL,0
5eqh,A,189,207,18,LSIIFIPALLQCIVLPFC,0
5eqh,A,259,264,5,LELFR,0
5eqh,A,274,295,21,AVVLQLSQQLSGINAVFYYST,0
5eqh,A,296,307,11,IFEKAGVQQPV,0
5eqh,A,308,328,20,ATIGSGIVNTAFTVVSLFVV,0
5eqh,A,336,355,19,HLIGLAGMAGCAILMTIAL,0
5eqh,A,356,366,10,LLEQLPWMSY,0
5eqh,A,367,388,21,SIVAIFGFVAFFEVGPGPIPW,0
5eqh,A,405,426,21,VAGFSNWTSNFIVGMCFQYVE,0
5eqh,A,427,431,4,LCGP,0
5eqh,A,432,450,18,VFIIFTVLLVLFFIFTYF,0
2ksf,A,403,421,18,VAAALSAVITLIAMQWLM,0
2ksf,A,422,424,2,FD,0
2ksf,A,425,443,18,ANLVMLYLLGVVVVALFY,0
2ksf,A,450,466,16,ATVINVVSFDLFFIAP,0
2ksf,A,467,474,7,GTLAVSD,0
2ksf,A,475,495,20,QYLLTFAVMLTVGLVIGNLT,0
2ux3,M,1,54,53,EYQNIFSQVQVRGPADLGMTEDVNLANRSGVGPFSTLLGWFGNAQLGPIYLGS,0
2ux3,M,55,72,17,GVLSLFSGLMWFFTIGI,0
2ux3,M,82,87,5,AVFLR,0
2ux3,M,117,133,16,ASFFMFVAVWSWWGRT,0
2ux3,M,134,146,12,LRAQALGMGKHT,0
2ux3,M,147,164,17,WAFLSAIWLWMVLGFIR,0
2ux3,M,179,192,13,FSHLDWTNNFSLV,0
2ux3,M,200,221,21,FHGLSIAFLYGSALLFAMHGA,0
2ux3,M,222,268,46,ILAVSRFGGERELEQIADRGTAAERAALFWRWTMGFNATMEGIHRW,0
2ux3,M,269,286,17,IWMAVLVTLTGGIGILL,0
2ux3,M,294,300,6,YVWGQN,0
2ux3,M,303,307,4,APLN,0
3ayf,A,1,16,15,EVNRTVSPNIQTGRK,0
3ayf,A,20,37,17,FLKSILIFTILISSTVL,0
3ayf,A,38,116,78,VGGYWIFKEMAPRPKEVRSESGEVLMTKETIIGGQAVFQKYGLMDYGTVLGHGSYMGPDYTAEALKVYTEGMQDYKAK,0
3ayf,A,117,123,6,RYNKPF,0
3ayf,A,124,260,136,DLTDDEKSIIREQVIKEMRKNRYNPVTDVLVLTDAQVYGLEKVRDYYRDVFTNGDGWGLKKGLIKESDMPKANRAWVADSDQIQQIADFFFWTAWLSSTLRIGDEITYTNNWPYYEDAGNTMSFSAVWWSGASVTI,0
3ayf,A,261,278,17,ILFIGIILYVFYRYQLS,0
3ayf,A,309,325,16,VVVSALFFVQTMFGAL,0
3ayf,A,326,351,25,AHYYTEPDSFFGINWIYDILPFNIA,0
3ayf,A,352,371,19,GYHLQLAIFWIATAWLGMG,0
3ayf,A,392,408,16,LFWALVVLVGGSMIGQ,0
3ayf,A,409,430,21,LGVNGYLGNEWFLLGHQGWEY,0
3ayf,A,431,452,21,ELGRIWQIILVVGMLLWLFIV,0
3ayf,A,472,488,16,LFYSAIAVPFFYIFAF,0
3ayf,A,489,504,15,IQPDTNFTMADFWRW,0
3ayf,A,505,523,18,IIHLWVEGIFEVFAVVVI,0
3ayf,A,541,557,16,LYFQFTILLGSGVIGI,0
3ayf,A,558,577,19,HHYYYNGSPEVWIALGAVF,0
3ayf,A,578,594,16,ALEVIPLTLLILEAYE,0
3ayf,A,613,631,18,FLISTAIWNLVGAGVFGF,0
3ayf,A,632,650,18,INLPAVSYFEHGQFLTPA,0
3ayf,A,651,668,17,GHAAMMGVYGMFAIAVL,0
3ayf,A,686,703,17,KFSCWMLNIGLAGMVVI,0
3ayf,A,704,741,37,LLPVGILQMKEAFIHGYWASRSPSFLQQDVVQNLLLV,0
3ayf,A,742,761,19,AVPDTIFLIGVVALLVFAI,0
3ayf,A,778,800,22,PVANHWMKDRLKNSLEHHHHHH,0
4jkv,B,-2,-1,1,G,0
4jkv,B,228,250,22,DMHSYIAAFGAVTGLCTLFTLA,0
4jkv,B,251,266,15,FVADWRNSNRYPAVI,0
4jkv,B,267,290,23,FYVNACFFVGSIGWLAQFMDGAR,0
4jkv,B,312,337,25,SCVIIFVIVYYALMAGVVWFVVLTY,0
4jkv,B,338,346,8,WHTSFKAL,0
4jkv,B,347,354,7,TTYQPLS,0
4jkv,B,355,359,4,KTSY,0
4jkv,B,360,384,24,HLLTWSLPFVLTVAILAVAQVDGD,0
4jkv,B,398,423,25,YRAGFVLAPIGLVLIVGGYFLIRGV,0
4jkv,B,424,453,29,TLFSIKSNHPGLLSEKAASKINETMLRLG,0
4jkv,B,454,475,21,FGFLAFGFVLITFSCHFYDFF,0
4jkv,B,494,505,11,TIGLPTKQPIP,0
4jkv,B,515,535,20,LVEKINLFAMFGTGIAMSTW,0
4jkv,B,536,538,2,WT,0
4jkv,B,539,549,10,ATLLIWRRTW,0
4jkv,B,550,552,2,RL,0
4jkv,B,553,555,2,GQ,0
2w5j,V,14,34,20,LAVGLASIGPGVGQGTAAGQ,0
2w5j,V,35,50,15,VEGIARQPEAEGKIR,0
2w5j,V,51,74,23,TLLLSLAFMEALTIYGLVVALAL,0
4zln,C,1,10,9,PNFFIDRPI,0
4zln,C,11,25,14,AWVIAIIIMLAGGL,0
4zln,C,342,357,15,TLVEAIILVFLVMYL,0
4zln,C,358,365,7,LQNFRAT,0
4zln,C,366,383,17,IPTIAVPVVLLGTFAVL,0
4zln,C,397,411,14,MVLAIGLLVDDAIV,0
4zln,C,412,426,14,VENVERVMAEEGLP,0
4zln,C,427,438,11,KEATRKSMGQI,0
4zln,C,439,442,3,GAL,0
4zln,C,443,456,13,GIAMVLSAVFVPM,0
4zln,C,472,489,17,TIVSAMALSVLVALILT,0
4zln,C,490,511,21,ALCATMLKPIAKGDHGEGKKG,0
4zln,C,512,534,22,FGWFNRMFEKSTHHYTDSVGGI,0
4zln,C,535,541,6,RSTGRY,0
4zln,C,542,556,14,VLYLIIVVGMAYLF,0
4zln,C,870,886,16,LYAISLIVVFLCLAAL,0
4zln,C,887,893,6,ESWSIP,0
4zln,C,894,911,17,SVMLVVPLGVIGALLAA,0
4zln,C,924,938,14,GLLTTIGLSAKNAI,0
4zln,C,939,970,31,IVEFAKDLMDKEGKGLIEATLDAVRMRLRPI,0
4zln,C,971,986,15,MTSLAFILGVMPLVI,0
4zln,C,999,1014,15,TGVMGGMVTATVLAI,0
4zln,C,1015,1027,12,FVPVFFVVVRRR,0
4zln,C,1028,1029,1,S,0
3t4d,H,19,21,2,KD,0
3t4d,H,22,45,23,EFQVLFVLTILTLISGTIFYSTV,0
3t4d,H,51,67,16,DALFFSVVTLTTVGYG,0
3t4d,H,75,102,27,GKIFTILYIFIGIGLVFGFIHKLAVNV,0
3t4d,H,103,109,6,LPSILS,0
3t4d,H,110,114,4,LVPR,0
4ayx,B,151,153,2,AG,0
4ayx,B,155,165,10,EARKLLGLAY,0
4ayx,B,166,167,1,E,0
4ayx,B,168,189,21,RRLAAAVGFLTMSSVISMSAP,0
4ayx,B,219,239,20,AVFLCGAAANAIRVYLMQTS,0
4ayx,B,240,284,44,QRIVNRLRTSLFSSILRQEVAFFDKTRTGELINRLSSDTALLGR,0
4ayx,B,285,308,23,VTENLSDGLRAGAQASVGISMMF,0
4ayx,B,316,337,21,FVLSVVPPVSIIAVIYGRYLR,0
4ayx,B,338,390,52,LTKVTQDSLAQATQLAEERIGNVRTVRAFGKEMTEIEKYASKVDHVMQLARK,0
4ayx,B,391,413,22,AFARAGFFGATGLSGNLIVLSV,0
4ayx,B,435,455,20,MYAFWVGISIGGLSSFYSEL,0
4ayx,B,456,1717,1261,KGLGAGGRLWELLEREPKLPFNEGVILNEKSFQGALEFKNVHFAYPARPEVPIFQDFSLSIPSGSVTALVGPSGSGKSTVLSLLLRLYDPASGTISLDGHDIRQLNPVWLRSKIGTVSQEPILFSCSIAENIAYGADDPSSVTAEEIQRVAEVANAVAFIRNFPQGFNTVVGEKGVLLSGGQKQRIAIARALLKNPKILLLDEATSALDAENEYLVQEALDRLMDGRTVLVIAHRLSTIKNANMVAVLDQGKITEYGKHEELLSKPNGG,0
4ayx,B,1718,1737,19,RKLMNKQSFISAAENLYFQ,0
1rc2,B,6,22,16,AECFGTFWLVFGGCGS,0
1rc2,B,23,37,14,VLAAGFPELGIGFA,0
1rc2,B,38,55,17,VALAFGLTVLTMAFAVG,0
1rc2,B,60,73,13,HFNPAVTIGLWAG,0
1rc2,B,82,99,17,GYVIAQVVGGIVAAALL,0
1rc2,B,100,134,34,LIASGKTGFDAAASGFASNGYGEHSPGGYSMLSA,0
1rc2,B,135,152,17,VVELVLSAGFLLVIHGA,0
1rc2,B,162,178,16,PIAIGLALTLIHLISI,0
1rc2,B,179,182,3,VTN,0
1rc2,B,183,195,12,SVNPARSTAVAI,0
1rc2,B,196,205,9,QGGWALEQL,0
1rc2,B,206,223,17,FFWVVPIVGGIIGGLIY,0
4twk,B,25,41,16,PTVLASRVESDTTINV,0
4twk,B,42,44,2,KW,0
4twk,B,45,68,23,TVSTIFLVVVLYLIIGATVFKAL,0
4twk,B,117,123,6,GNTSNQ,0
4twk,B,130,146,16,SSFFFAGTVITTIGFG,0
4twk,B,154,182,28,GKIFCIIYALLGIPLFGFLLAGVGDQLG,0
4twk,B,183,208,25,IFGKGIAKVEDTFIKWNVSQTKIRI,0
4twk,B,209,230,21,STIIFILFGCVLFVALPAIIF,0
4twk,B,239,255,16,DAIYFVVITLTTIGFG,0
4twk,B,258,270,12,AGGSDIEYLDFY,0
4twk,B,272,297,25,VVWFWILVGLAYFAAVLSMIGDWLR,0
4twk,B,298,302,4,ISAE,0
4twk,B,303,307,4,LYFQ,0
4zzc,E,5,198,193,SPPPPIADEPLTVNTGIYLIECYSLDDKAETFKVNAFLSLSWKDRRLAFDPVRSGVRVKTYEPEAIWIPEIRFVNVENARDADVVDISVSPDGTVQYLERFSARVLSPLDFRRYPFDSQTLHIYLIVRSVDTRNIVLAVDLEKVGKNDDVFLTGWDIESFTAVVKPANFALEDRLESKLDYQLRISRQYFSYI,0
4zzc,E,199,218,19,NIILPMLFILFISWTAFWS,0
4zzc,E,222,240,18,ANVTLVVSTLIAHIAFNI,0
4zzc,E,241,255,14,VETNLPKTPYMTYT,0
4zzc,E,256,275,19,AIIFMIYLFYFVAVIEVTV,0
4zzc,E,295,313,18,RIAFPVVFLLANIILAFL,0
4zzc,E,314,315,1,F,0
4hfd,E,1,4,3,QDM,0
4hfd,E,5,195,190,SPPPPIADEPLTVNTGIYLIECYSLDDKAETFKVNAFLSLSWKDRRLAFDPVRSGVRVKTYEPEAIWIPEIRFVNVENARDADVVDISVSPDGTVQYLERFSARVLSPLDFRRYPFDSQTLHIYLIVRSVDTRNIVLAVDLEKVGKNDDVFLTGWDIESFTAVVKPANFALEDRLESKLDYQLRISRQYF,0
4hfd,E,196,218,22,YIPNIILPMLFILFISWTAFWS,0
4hfd,E,222,243,21,ANVTLVVSTLIAHIAANILVE,0
4hfd,E,244,252,8,NLPKTPYM,0
4hfd,E,253,275,22,YTGAIIFMIYLFYFVAVIEVTV,0
4hfd,E,292,315,23,RASRIAFPVVFLLANIILAFLFF,0
4hfd,E,316,317,1,F,0
1yg1,A,1,26,25,EQQDQSMKEGRLTLVLALATLIAAF,0
1yg1,A,27,45,18,SSFQYGYNVAAVNSPALL,0
1yg1,A,70,93,23,WSVTVSMFPFGGFIGSLLVGPLV,0
1yg1,A,94,96,2,KF,0
1yg1,A,97,119,22,RKGALLFNNIFSIVPAILMGCS,0
1yg1,A,127,147,20,IIISRLLVGICAGVSSNVVP,0
1yg1,A,148,162,14,YLGELAPKNLRGAL,0
1yg1,A,163,185,22,VVPQLFITVGILVAQIFGLRNL,0
1yg1,A,194,213,19,LLGLTGVPAALQLLLLPFF,0
1yg1,A,214,259,45,ESPRYLLIQKKDEAAAKKALQTLRGWDSVDREVAEIRQEDEAEKA,0
1yg1,A,260,266,6,GFISVL,0
1yg1,A,267,268,1,L,0
1yg1,A,269,298,29,RMRSLRWQLLSIIVLMGGQQLSGVNAIYY,0
1yg1,A,311,336,25,EHVQYVTAGTGAVNVVMTFCAVFVV,0
1yg1,A,337,343,6,LLGRRL,0
1yg1,A,344,365,21,LLLGFSICLIACCVLTAALAL,0
1yg1,A,370,394,24,WMPYISIVCVISYVIGHALGPSPI,0
1yg1,A,395,407,12,ALLITEIFLQSS,0
1yg1,A,408,430,22,PSAFMVGGSVHWLSNFTVGLIF,0
1yg1,A,441,462,21,FIVFAVICLLTTIYIFLIVPE,0
1yg1,A,463,501,38,KAKTFIEINQIFTKMNKVSEVYPEKEELKELPPVTSEQ,0
4amj,A,42,63,21,GMSLLMALVVLLIVAGNVLVI,0
4amj,A,64,79,15,AIGSTQRLQTLTNLF,0
4amj,A,80,103,23,TSLACADLVVGLLVVPFGATLVV,0
4amj,A,108,136,28,WGSFLCELWTSLDVLCVTASIETLCVIA,0
4amj,A,137,161,24,DRYLAITSPFRYQSLMTRARAKVI,0
4amj,A,162,183,21,CTVWAISALVSFLPIMMHWWR,0
4amj,A,187,194,7,QALKCYQ,0
4amj,A,200,228,28,FVTNRAYAIASSIISFYIPLLIMIFVAL,0
4amj,A,229,237,8,VYREAKEQ,0
4amj,A,238,249,11,RKIDRASKRKT,0
4amj,A,278,291,13,RVMLMREHKALKT,0
4amj,A,292,315,23,GIIMGVFTLCWLPFFLVNIVNVF,0
4amj,A,324,344,20,FVAFNWLGYANSAMNPIIYC,0
4amj,A,345,346,1,S,0
4amj,A,347,357,10,DFRKAFKRLL,0
4amj,A,359,373,14,PRKADRRLHHHHHH,0
5k2a,A,5,28,23,SSVYITVELAIAVLAILGNVLVC,0
5k2a,A,29,44,15,AVWLNSNLQNVTNYF,0
5k2a,A,45,67,22,VSLAAADIAVGVLAIPFAITIS,0
5k2a,A,76,97,21,CLFIACFVLVLTQSSIFSLLA,0
5k2a,A,98,123,25,AIDRYIAIRIPLRYNGLVTGTRAKG,0
5k2a,A,124,144,20,IAICWVLSFAIGLTPMLGWN,0
5k2a,A,172,195,23,PMNYMVYFNFFACVLVPLLLMLG,0
5k2a,A,196,1046,850,YLRIFLAARRQLADLEDNWETLNDNLKVIEKADNAAQVKDALTKMRAAALDAQKATPP,0
5k2a,A,1056,236,-820,EMKDFRHGFDILVGQIDDALKLANEGKVKEAQAAAEQLKTTRNAYIQKYLERARSTLQKEVHAAKSLA,0
5k2a,A,237,259,22,IVGLFALCWLPLHIINCFTFFC,0
5k2a,A,265,287,22,PLWLMYLAIVLSHTNSVVNPFI,0
5k2a,A,288,292,4,AYRI,0
5k2a,A,293,306,13,EFRQTFRKIIRSH,0
5k2a,A,307,308,1,L,0
5k0i,C,5,15,10,LVMSSPALPA,0
5k0i,C,16,32,16,LLCSTLLVIKMYVVAI,0
5k0i,C,73,90,17,NDMETIYPFLFLGFVYS,0
5k0i,C,91,98,7,LGPNPFV,0
5k0i,C,99,115,16,WMHFLVFLVGRVAHTV,0
5k0i,C,127,146,19,VTYTLAQLPCASMALQILW,0
5k0i,C,147,152,5,AARHL,0
4zyo,A,79,94,15,SLLHLGALYGITLIP,0
4zyo,A,95,98,3,CKF,0
4zyo,A,99,113,14,TWLWGVFYYFVSAL,0
4zyo,A,132,144,12,PLRLFLIIANTM,0
4zyo,A,209,216,7,LVMFQRR,0
4zyo,A,221,237,16,LLMMCFILPTLVPWYF,0
4zyo,A,238,240,2,GE,0
4zyo,A,241,260,19,FQNSVFVATFLRYAVVLNA,0
4zyo,A,286,291,5,LVSLG,0
4zyo,A,319,329,10,TTFFIDCMAA,0
3oax,C,37,64,27,MLAAYMFLLIMLGFPINFLTLYVTVQH,0
3oax,C,65,72,7,KLRTPLN,0
3oax,C,73,98,25,ILLNLAVADLFMVFGGFTTTLYTSL,0
3oax,C,109,133,24,NLEGFFATLGGEIALWSLVVLAIE,0
3oax,C,134,153,19,YVVVCKPMSNFRFGENHAI,0
3oax,C,154,176,22,GVAFTWVMALACAAPPLVGWSR,0
3oax,C,199,224,25,ESFVIYMFVVHFIIPLIVIFFCYGQ,0
3oax,C,225,253,28,VFTVKEAAAQQQESATTQKAEKEVTRMV,0
3oax,C,254,278,24,IMVIAFLICWLPYAGVAFYIFTHQ,0
3oax,C,287,309,22,TIPAFFAKTSAVYNPVIYIMMN,0
3oax,C,311,321,10,FRNCMVTTLC,0
3oax,C,322,348,26,GKNPLGDDEASTTVSKTETSQVAPA,0
4hg6,B,19,53,34,GQDAPMIVIEGLTSEEPQASPDAVAEAVPAAEVA,0
4hg6,B,532,543,11,SRLVERPATPA,0
4hg6,B,570,588,18,SDRAQTFVQATLQPVIQT,0
4hg6,B,679,692,13,DNVRSVVGNVASA,0
4hg6,B,696,712,16,LLGGMLGLAWISAAIA,0
4hg6,B,713,720,7,GFVLRTR,0
4hg6,B,721,725,4,KGLK,0
5ek0,D,1475,1492,17,DYKDDDDKGSLVPRGSH,0
5ek0,D,1510,1525,15,IYLIVLNMVTMMVEK,0
5ek0,D,1526,1534,8,GQSQHMTE,0
5ek0,D,1535,1553,18,LYWINVVFIILFTIEIIL,0
5ek0,D,1570,1587,17,DFVVVIISIVGMFLADL,0
5ek0,D,1588,1591,3,ETY,0
5ek0,D,1592,1594,2,VS,0
5ek0,D,1595,1597,2,TL,0
5ek0,D,1598,1616,18,RVIRLARIGRILRLVTAV,0
5ek0,D,1637,1655,18,ALMTLFFYIFAIMATQLF,0
5ek0,D,1656,1665,9,ERFPEWFGT,0
5ek0,D,1666,1684,18,GESFYTLFQVMTLESWSM,0
5ek0,D,1685,1696,11,IVRPLMEVYPY,0
5ek0,D,1697,1716,19,WVFFIPFIFVVTFVMINLV,0
5ek0,D,1738,1770,32,VQSHEDNINNEIIKLREEIVELKELIKTSLKN,0
1y2l,A,37,56,19,ALYSIVCVVGLFGNFLVMY,0
1y2l,A,57,73,16,IVRYTKMKTATNIYIF,0
1y2l,A,74,92,18,LALADALATSTLPFQSVN,0
1y2l,A,107,124,17,VISIDYYNMFTSIFTLC,0
1y2l,A,125,154,29,MSVDRYIAVCHPVKALDFRTPRNAKIVNV,0
1y2l,A,155,173,18,NWILSSAIGLPVMFMATT,0
1y2l,A,196,214,18,LKICVFIFAFIMPVLIIT,0
1y2l,A,215,246,31,CYGLMILRLKSVRMLSGSKEKDRNLRRITRM,0
1y2l,A,247,267,20,LVVVAVFIVCWTPIHIYVII,0
1y2l,A,282,301,19,WHFCIALGYTNSCLNPVLY,0
1y2l,A,302,316,14,FLDENFKRCFREFC,0
3v5u,A,4,24,20,GVGYFLLGLILLYYGSDWFV,0
3v5u,A,25,41,16,GSERIARHFNVSNFVI,0
3v5u,A,42,59,17,ATVMAIGTSLPEILTSA,0
3v5u,A,72,92,20,NAIGSCICNIGLVLGLSAII,0
3v5u,A,93,103,10,PIIVDKNLQK,0
3v5u,A,104,120,16,ILVYLLFVIFAAVIGI,0
3v5u,A,126,142,16,DGVVLLILFIIYLRWT,0
3v5u,A,143,148,5,KNGSA,0
3v5u,A,149,155,6,IEENND,0
3v5u,A,156,166,10,NNPSVVFSLV,0
3v5u,A,167,186,19,LIIGLIGVLVGAELFVDGA,0
3v5u,A,205,221,16,AFGTSLPELMVSLAAA,0
3v5u,A,222,228,6,RNLGGM,0
3v5u,A,229,250,21,LGNVIGSNIADIGGALAVGSL,0
3v5u,A,259,275,16,QMAVLVIMSLLLYLFA,0
3v5u,A,276,280,4,YSKI,0
3v5u,A,281,298,17,RWQGILFLALYIIAIAS,0
3v5u,A,305,320,15,LVPRGSRSHHHHHHH,0
4fe1,X,1,6,5,TKSAK,0
4fe1,X,7,12,5,TYAFR,0
4fe1,X,13,28,15,FWAVLLLAINFLVAA,0
5b66,z,8,25,17,LAALVILSFVMVIGVPV,0
5b66,z,26,39,13,YASPQDWDRSKQL,0
5b66,z,40,54,14,FLGSGLWIALVLVV,0
5b6w,C,4,11,7,TGRPEWI,0
5b6w,C,12,28,16,LALGTALMGLGTLYFL,0
5b6w,C,47,61,14,LVPAIAFTMYLSML,0
5b6w,C,62,79,17,GYGLTMVPFGGEQNPIY,0
5b6w,C,80,94,14,ARYADWLFTTPLLL,0
5b6w,C,111,126,15,VGADGIMIGTGLVGA,0
5b6w,C,127,134,7,TKVYSYR,0
5b6w,C,135,150,15,VWWAISTAAMLYILY,0
5b6w,C,178,192,14,VVLWSAYPVVWLIG,0
5b6w,C,193,203,10,EGAGIVPLNI,0
5b6w,C,204,220,16,TLLFMVLDVSAKVGFG,0
2kih,D,18,22,4,SNDS,0
2kih,D,28,49,21,AANIIGILHLILWILDRLFFK,0
2kih,D,51,58,7,YRFFEHG,0
2kih,D,59,60,1,K,0
2iql,A,68,94,26,ITIMALYSIVCVVGLFGNFLVMYVIV,0
2iql,A,95,103,8,YTKMKTAT,0
2iql,A,104,129,25,IYIFNLALADALATSTLPFQSVNYL,0
2iql,A,138,164,26,LCKIVISIDYYNMFTSIFTLCTMSVD,0
2iql,A,165,184,19,YIAVCHPVKALDFRTPRNA,0
2iql,A,185,211,26,IVNVCNWILSSAIGLPVMFMATTKYR,0
2iql,A,229,253,24,NLLKICVFIFAFIMPVLIITVCYG,0
2iql,A,254,280,26,MILRLKSVRMLSGSKEKDRNLRRITR,0
2iql,A,281,305,24,VLVVVAVFIVCWTPIHIYVIIKAL,0
2iql,A,316,339,23,SWHFCIALGYTNSCLNPVLYAFL,0
2iql,A,341,348,7,NFKRCFR,0
2iql,A,349,354,5,FCIPT,0
1pb4,D,44,63,19,ALSVVPLATTAMLTTGPLS,0
1pb4,D,65,83,18,ADSFFSVMLLGYCYMEFN,0
1pb4,D,100,123,23,YAMYMLGLGSAVSLFGIYKLETE,0
1pb4,D,124,129,5,DGVVG,0
1pb4,D,130,138,8,VKSLWDSS,0
1pb4,D,139,150,11,KDNSQKIEAKK,0
3abl,Z,20,34,14,VTFLSFLLPAGWVL,0
3abl,Z,35,43,8,HLDNYKKS,0
3abl,Z,44,46,2,AA,0
4cza,B,1,2,1,I,0
4cza,B,3,24,21,LSLAEALFLILFTGVISMLIS,0
4cza,B,30,46,16,YVPIFILTGLVIGPLL,0
4cza,B,47,53,6,LIPRDL,0
4cza,B,54,74,20,HEIFDFVRVFGLVIILFTEG,0
4cza,B,79,84,5,RLLKK,0
4cza,B,91,108,17,LDTIGLILTALIAGFIF,0
4cza,B,109,119,10,VVFNSSFLLG,0
4cza,B,120,133,13,LFGAIIGATDPAT,0
4cza,B,155,170,15,IFNDPLGIVLTLIAI,0
4cza,B,171,180,9,MLVPGYGGG,0
4cza,B,181,189,8,FSTLSEKL,0
4cza,B,190,192,2,IY,0
4cza,B,193,214,21,GGVIYFLYNVSVSISLGIFLG,0
4cza,B,234,250,16,FSLSLAFLGFFIGERL,0
4cza,B,252,262,10,SGYLVATVTG,0
4cza,B,295,313,18,TLAALATIFIFVLLGAEM,0
4cza,B,315,320,5,EVIWS,0
4cza,B,321,322,1,L,0
4cza,B,323,343,20,KGLLVALGVMILARPLATLP,0
4cza,B,358,372,14,EGPRGVVPSALASL,0
4cza,B,373,393,20,LSLALKYKSPLLTVHWGEII,0
4cza,B,394,411,17,ATVVITVLTSVIVETLW,0
2m0q,A,2,38,36,TLSNFTQTLEDVFRRIFITYMDNWRQNTTAEQEALQ,0
2m0q,A,45,70,25,FYYVILYLMVMIGMFSFIIVAILVS,0
2m0q,A,71,83,12,VKSKRREHSNDP,0
2m0q,A,84,103,19,HQYIVEDWQEKYKSQILNL,0
5tji,D,15,20,5,WYSFL,0
5tji,D,21,40,19,SSLVTFGSGLVVIIIYRIV,0
5tji,D,83,91,8,AKDWAGEL,0
5tji,D,102,118,16,VGLVFLLSIASLIIYF,0
5tji,D,119,124,5,DASTN,0
5tji,D,135,140,5,STTQQ,0
5tji,D,141,158,17,DLAFNVFFMIYFFIRFV,0
5tji,D,164,183,19,WFWVELFSFVDYFTIPPSF,0
5tji,D,184,194,10,AIYLDRNWLG,0
5tji,D,195,206,11,RFLRALRLMSI,0
5tji,D,228,244,16,VSFVSLWLTAAGFLHL,0
5tji,D,245,263,18,ENSGDPFFDFGNAQHLTY,0
5tji,D,264,280,16,ECLYFLMVTMSTVGFG,0
5tji,D,281,288,7,IFATTVL,0
5tji,D,289,305,16,RTFVVIFIMIFIGLFA,0
5tji,D,306,316,10,FIPEIAEILG,0
3usj,A,1,4,3,EVK,0
3usj,A,5,13,8,EHWATRLG,0
3usj,A,14,32,18,ILAMAGNAVGLGNFLRFP,0
3usj,A,44,63,19,IPYIIAFLLVGIPLMWIEW,0
3usj,A,64,88,24,MGRYGGAQGHGTTPAIFYLLWRNR,0
3usj,A,89,124,35,AKILGVFGLWIPLVVAIYYVYIESWTLGFAIKFLV,0
3usj,A,132,134,2,,0
3usj,A,167,184,17,AYIVFLITMFINVSILI,0
3usj,A,185,190,5,GISKG,0
3usj,A,191,214,23,ERFAKIAMPTLFILAVFLVIRVF,0
3usj,A,223,231,8,ADGLNFLW,0
3usj,A,244,266,22,IAAVGQIFFTLSLGFGAIITYA,0
3usj,A,267,276,9,YVRKDQDIV,0
3usj,A,277,297,20,SGLTAATLNEKAEVILGGSI,0
3usj,A,326,331,5,LPAIF,0
3usj,A,340,367,27,GFLWFFLLFFAGLTSSIAIMQPMIAFL,0
3usj,A,368,377,9,DELKLSRKH,0
3usj,A,378,396,18,VLWTAAIVFFSAHLVMFL,0
3usj,A,400,426,26,DEMDFWAGTIGVVFFGLTELIIFFWI,0
3usj,A,427,428,1,G,0
3usj,A,429,437,8,DKAWEEIN,0
3usj,A,438,444,6,GGIIKV,0
3usj,A,445,469,24,RIYYYVMRYITPAFLAVLLVVWAR,0
3usj,A,470,476,6,YIPKIM,0
3usj,A,484,502,18,ITRFYIIGLFLFLTFLVF,0
3usj,A,503,601,98,AERRRNL,0
3usj,A,602,610,8,SAGTLVPR,0
4rue,B,33,51,18,ALLALVLLYLVSGALVFR,0
4rue,B,52,101,49,LEQPHEQQAQRELGEVREKFLRAHPCVSDQELGLLIKEVADALGGGADP,0
4rue,B,108,116,8,SSHSAWDL,0
4rue,B,117,134,17,SAFFFSITIITTIGYGN,0
4rue,B,135,140,5,ALRTD,0
4rue,B,141,165,24,GRLFCIFYALVGIPLFGILLAGVG,0
4rue,B,166,182,16,RLGSSLRHGIGHIEAI,0
4rue,B,200,220,20,FLLIGCLLFVLTPTFVFCYM,0
4rue,B,221,224,3,DWS,0
4rue,B,225,243,18,LEAIYFVIVTLTTVGFGD,0
4rue,B,244,254,10,VAGADPRQDS,0
4rue,B,255,277,22,AYQPLVWFWILLGLAYFASVLT,0
4kx6,P,13,37,24,WGLFGAGGMWSAIIAPVMILLVGI,0
4kx6,P,38,61,23,LPLGLFPGDALSYERVLAFAQSF,0
4kx6,P,62,86,24,GRVFLFLMIVLPLWCGLHRMHHAM,0
4kx6,P,94,116,22,AGKWVFYGLAAILTVVTLIGVV,0
4kx6,P,117,118,1,I,0
1sqv,K,1,22,21,LTRFLGPRYRQLARNWVPTAS,0
1sqv,K,23,38,15,WGAVGAVGLVWATDW,0
1sqv,K,52,56,4,KKDD,0
3uq4,E,-1,10,11,SAPADNAADAR,0
3uq4,E,11,204,193,VDVSVSIFINKIYGVNTLEQTYKVDGYIVAQWTGKPRKTPGDKPLIVENTQIERWINNGLWVPALEFINVVGSPDTGNKRLMLFPDGRVIYNARFLGSFSNDMDFRLFPFDRQQFVLELEPFSYNNQQLRFSDIQVYTENIDNEEIDEWWIRGKASTHISDIRYDHLSSVQPNQNEFSRITVRIDAVRNPSYY,0
3uq4,E,205,225,20,WSFILPLGLIIAASWSVFWL,0
3uq4,E,231,250,19,LQTSFTLMLTVVAYALYTS,0
3uq4,E,251,261,10,ILPRLPYTTV,0
3uq4,E,262,282,20,DQMIIAGYGSIFAAILLIIF,0
3uq4,E,298,317,19,RCRLAFPLGFLAIGCVLVI,0
3uq4,E,318,322,4,GITL,0
2c3e,A,5,30,25,SFLKDFLAGGVAAAISKTAVAPIER,0
2c3e,A,31,37,6,KLLLQV,0
2c3e,A,38,72,34,HASKQISAEKQYKGIIDCVVRIPKEQGFLSFWRG,0
2c3e,A,73,100,27,LANVIRYFPTQALNFAFKDKYKQIFLG,0
2c3e,A,109,138,29,RYFAGNLASGGAAGATSLCFVYPLDFART,0
2c3e,A,139,155,16,LAADVGKGAAQREFTG,0
2c3e,A,156,167,11,GNCITKIFKSD,0
2c3e,A,168,172,4,LRGL,0
2c3e,A,173,203,30,QGFNVSVQGIIIYRAAYFGVYDTAKGMLPD,0
2c3e,A,207,235,28,HIIVSWMIAQTVTAVAGLVSYPFDTVRR,0
2c3e,A,236,252,16,MMMQSGRKGADIMYTG,0
2c3e,A,253,263,10,VDCWRKIAKD,0
2c3e,A,264,272,8,GPKAFFKG,0
2c3e,A,273,293,20,WSNVLRGMGGAFVLVLYDEI,0
2c3e,A,294,297,3,KFV,0
4pa4,F,126,130,4,SHMG,0
4pa4,F,135,153,18,ALLTVVFYIAAVMATNLY,0
4pa4,F,154,163,9,ATFPEWFGD,0
4pa4,F,164,182,18,SKSLYTLFQVMTLESWSM,0
4pa4,F,183,191,8,IVRPVMNV,0
4pa4,F,192,194,2,PN,0
4pa4,F,195,214,19,WVFFIPFIMLTTFTVLNLF,0
4pa4,F,223,274,51,ITKEQEEEAKTGHHQEPISQTLLHLGDRLDRIEKQLAQNNELLQRQQPQKK,0
4ryq,A,7,26,19,IIVFFLTYGLFYVSSVLFP,0
4ryq,A,27,28,1,D,0
4ryq,A,29,34,5,TWYDA,0
4ryq,A,35,45,10,EKPSWTPPGM,0
4ryq,A,46,66,20,IGMIWAVLFGLIALSVAIIY,0
4ryq,A,75,94,19,FWFLFLLNYIFNQAFSYFQ,0
4ryq,A,95,101,6,SQKNLF,0
4ryq,A,102,122,20,ATVDCLLVAITTLLLIMFSS,0
4ryq,A,127,147,20,SAWLLIPYFLWSAFATYLSW,0
4ryq,A,148,153,5,IYSIN,0
3p4w,E,1,4,3,QDM,0
3p4w,E,5,198,193,SPPPPIADEPLTVNTGIYLIECYSLDDKAETFKVNAFLSLSWKDRRLAFDPVRSGVRVKTYEPEAIWIPEIRFVNVENARDADVVDISVSPDGTVQYLERFSARVLSPLDFRRYPFDSQTLHIYLIVRSVDTRNIVLAVDLEKVGKNDDVFLTGWDIESFTAVVKPANFALEDRLESKLDYQLRISRQYFSYI,0
3p4w,E,199,218,19,NIILPMLFILFISWTAFWS,0
3p4w,E,222,240,18,ANVTLVVSTLIAHIAFNI,0
3p4w,E,241,255,14,VETNLPKTPYMTYT,0
3p4w,E,256,275,19,AIIFMIYLFYFVAVIEVTV,0
3p4w,E,295,313,18,RIAFPVVFLLANIILAFL,0
3p4w,E,314,315,1,F,0
3p4w,E,316,318,2,FG,0
5t37,C,5,15,10,LVMSSPALPA,0
5t37,C,16,36,20,LLCSTLLVIKMYVVAIITGQ,0
5t37,C,47,52,5,EDALR,0
5t37,C,69,90,21,RAHRNDMETIYPFLFLGFVYS,0
5t37,C,91,98,7,LGPNPFV,0
5t37,C,99,119,20,WMHFLVFLVGRVAHTVAYLG,0
5t37,C,125,146,21,RSVTYTLAQLPCASMALQILW,0
5t37,C,147,152,5,AARHL,0
1xl6,D,1,10,9,TGGMKPPAR,0
1xl6,D,33,39,6,LDDHYH,0
1xl6,D,45,71,26,WPVFITLITGLYLVTNALFALAYLAC,0
1xl6,D,72,83,11,DVIENARPGSF,0
1xl6,D,84,100,16,DAFFFSVQTMATIGYG,0
1xl6,D,101,107,6,LIPIGP,0
1xl6,D,108,135,27,ANTLVTLEALCGMLGLAVAASLIYARF,0
5cgc,A,569,575,6,VQYLRW,0
5cgc,A,579,600,21,PIAAVVFACLGLLATLFVTVV,0
5cgc,A,601,616,15,IIYRDTPVVKSSSRE,0
5cgc,A,617,636,19,CYIILAGICLGYLCTFCLI,0
5cgc,A,646,667,21,QRIGIGLSPAMSYSALVTKTY,0
5cgc,A,668,1038,370,AARILAMSKKNIFEMLRIDEGLRLKIYKDTEGYYTIGIGHLLTKSPS,0
5cgc,A,1039,1050,11,NAAKSELDKAI,0
5cgc,A,1051,680,-371,RNTNGVITKDEAEKLFNQDVDAAVRGILRNAKLKPVYDSLDAVRRAALINMVFQMGETGVAGFTNSLRMLQQKRWDEAAVNLAKSRWYNQTPNRAKRVITTFRTGTWDAYKI,0
5cgc,A,689,691,2,AC,0
5cgc,A,692,711,19,QLVIAFILICIQLGIIVAL,0
5cgc,A,739,759,20,VVAPLGYNGLLILACTFYAF,0
5cgc,A,760,773,13,TRNVPANFNEAKY,0
5cgc,A,774,793,19,AFTMYTTCIIWLAFVPIYF,0
5cgc,A,799,819,20,ITMCFSVSLSATVALGCMFV,0
5cgc,A,820,832,12,KVYIILAKPERN,0
1txh,F,19,22,3,IGR,0
1txh,F,23,36,13,WLSVIFIFRIMVL,0
1txh,F,41,75,34,SVWGDEKSSFICNTLQPGCNSVCYDQFFPISHVR,0
1txh,F,80,93,13,LILVSTPALLVAM,0
1txh,F,94,96,2,VA,0
1txh,F,97,130,33,QQHIEKKMLRLEGHGDPLHLEEVKRHKVHISGT,0
1txh,F,131,133,2,WW,0
1txh,F,134,148,14,YVISVVFRLLFEAV,0
1txh,F,153,188,35,YLLYPGYAMVRLVKCDVYPCPNTVDCFVSRPTEKT,0
1txh,F,192,207,15,FMLAASGICIILNVA,0
1txh,F,208,209,1,V,0
4p6v,F,3,23,20,IIFGVVMFTLIILALVLVIL,0
4p6v,F,24,408,384,AKSKLVPTGDITISINGDPEKAIVTQPGGKLLTALAGAGVFVSSACGGGGSCGQCRVKIKSGGGDILPTELDHISKGEAREGERLACQVAVKADMDLELPEEIFGVKKWECTVISNDNKATFIKELKLAIPDGESVPFRAGGYIQIEAPAHHVKYADFDVPEKYRGDWDKFNLFRYESKVDEPIIRAYSMANYPEEFGIIMLNVRIATPPPNNPNVPPGQMSSYIWSLKAGDKCTISGPFGEFFAKDTDAEMVFIGGGAGMAPMRSHIFDQLKRLKSKRKMSYWYGARSKREMFYVEDFDGLAAENDNFVWHCALSDPQPEDNWTGYTGFIHNVLYENYLKDHEAPEDCEYYMCGPPMMNAAVINMLKNLGVEEENILLDDFGG,0
1fqy,D,1,7,6,ASEFKK,0
1fqy,D,12,32,20,AVVAEFLATTLFVFISIGSA,0
1fqy,D,33,49,16,GFKYPVGNNQTAVQDN,0
1fqy,D,50,68,18,KVSLAFGLSIATLAQSVG,0
1fqy,D,73,85,12,HLNPAVTLGLLL,0
1fqy,D,94,112,18,LMYIIAQCVGAIVATAIL,0
1fqy,D,113,137,24,GITSSLTGNSLGRNDLADGVNSGQ,0
1fqy,D,138,156,18,LGIEIIGTLQLVLCVLAT,0
1fqy,D,167,184,17,APLAIGLSVALGHLLAI,0
1fqy,D,185,188,3,YTG,0
1fqy,D,189,201,12,GINPARSFGSAV,0
1fqy,D,202,207,5,THNFS,0
1fqy,D,208,230,22,HWIFWVGPFIGGALAVLIYDFI,0
1fqy,D,234,269,35,SSDLTDRVKVWTSGQVEEYDLDADDINSRVEMKPK,0
2x2v,M,1,4,3,AFL,0
2x2v,M,5,18,13,AAIAAGLAAVAGA,0
2x2v,M,55,67,12,VPIIAIVISLLI,0
2x2v,M,68,69,1,F,0
5xf1,A,138,161,23,SSFQVMYTVGYSLSLGALLLALA,0
5xf1,A,162,175,13,LGGLSKLHCTRNA,0
5xf1,A,176,200,24,HANLFASFVLKASSVLVIDGLLRT,0
5xf1,A,220,248,28,VAGCRVAAVFMQYGIVANYCWLLVEGLY,0
5xf1,A,249,1052,803,HNLLGLANIFEMLRIDEGLRLKIYKDTEGYYTIGIGHLLTKSPSLNAAKSELDKAIGR,0
5xf1,A,1058,264,-794,TKDEAEKLFNQDVDAAVRGILRNAKLKPVYDSLDAVRRAALINMVFQMGETGVAGFTNSLRMLQQKRWDEAAVNLAKSRWYNQTPNRAKRVITTFRTGTWDAYERSFF,0
5xf1,A,265,287,22,LYLGIGWGAPMLFVVPWAVVKC,0
5xf1,A,301,326,25,GFWWILRFPVFLAILINFFIFVRIV,0
5xf1,A,327,349,22,LLVAKLRARQMHHTDYKFRLAK,0
5xf1,A,350,370,20,TLTLIPLLGVHEVVFAFVTD,0
5xf1,A,379,402,23,AKLFFDLFLSSFQGLLVAVLYCF,0
5xf1,A,403,404,1,N,0
5xf1,A,405,416,11,EVQSELRRRWH,0
5xf1,A,417,418,1,W,0
5ahy,C,20,28,8,AAVRENAL,0
5ahy,C,29,53,24,SSSLWVNVALAGIAILVFVYMGRT,0
5ahy,C,61,82,21,IWGATLMIPLVSISSYLGLLS,0
5ahy,C,83,104,21,LTVGMIEMPAGHALAGEMVRS,0
5ahy,C,105,126,21,WGRYLTWALSTPMILLALGLL,0
5ahy,C,132,154,22,SLFTVIAADIGMCVTGLAAAMT,0
5ahy,C,155,159,4,SALL,0
5ahy,C,160,183,23,RWAFYAISCAFFVVVLSALVTDW,0
5ahy,C,196,221,25,DTLRVLTVVLWLGYPIVWAVGVEGL,0
5ahy,C,222,228,6,LVQSVG,0
5ahy,C,229,252,23,TSWAYSVLDVFAKYVFAFILLRW,0
1jgy,H,1,10,9,VGVTAFGNF,0
1jgy,H,16,31,15,IYSFWIFLAGLIYYL,0
1jgy,H,32,250,218,TENMREGYPLENEDGTPAANQGPFPLPKPKTFILPHGRGTLTVPGPESEDRPIALARTAVSEGFPHAPTGDPMKDGVGPASWVARRDLPELDGHGHNKIKPMKAAAGFHVSAGKNPIGLPVRGCDLEIAGKVVDIWVDIPEQMARFLEVELKDGSTRLLPMQMVKVQSNRVHVNALSSDLFAGIPTIKSPTEVTLLEEDKICGYVAGGLMYAAPKRKS,0
1jgy,H,251,260,9,VAAMLAEYA,0
2xfn,A,1,2,1,S,0
2xfn,A,3,108,105,KCDVVVVGGGISGMAAAKLLHDSGLNVVVLEARDRVGGRTYTLRNQKVKYVDLGGSYVGPTQNRILRLAKELGLETYKVNEVERLIHHVKGKSYPFRGPFPPVWN,0
2xfn,A,109,127,18,ITYLDHNNFWRTMDDMGR,0
2xfn,A,128,485,357,IPSDAPWKAPLAEEWDNMTMKELLDKLCWTESAKQLATLFVNLCVTAETHEVSALWFLWYVKQCGGTTRIISTTNGGQERKFVGGSGQVSERIMDLLGDRVKLERPVIYIDQTRENVLVETLNHEMYEAKYVISAIPPTLGMKIHFNPPLPMMRNQMITRVPLGSVIKCIVYYKEPFWRKKDYCGTMIIDGEEAPVAYTLDDTKPEGNYAAIMGFILAHKARKLARLTKEERLKKLCELYAKVLGSLEALEPVHYEEKNWCEEQYSGGCYTTYFPPGILTQYGRVLRQPVDRIYFAGTETATHWSGYMEGAVEAGERAAREILHAMGKIPEDEIWQSEPESVDVPAQPITTTFLERH,0
2xfn,A,486,498,12,PSVPGLLRLIGL,0
2xfn,A,502,520,18,SATALGFLAHKRGLLVRV,0
2afl,D,5,20,15,FFLFIGVILFSSAVY,0
2afl,D,21,37,16,AEAEEAESHFSSIPDA,0
2afl,D,38,50,12,WWAVVSMTTVGY,0
2afl,D,51,58,7,DMYPVTI,0
2afl,D,59,76,17,GKIVGSLCAIAGVLTIA,0
3udc,G,1,12,11,WADIYHKLVEI,0
3udc,G,13,16,3,DIK,0
3udc,G,17,45,28,VKFLLDVLKILIIAFIGIKFADFLIYRF,0
3udc,G,70,88,18,AVRYIIYFLAGASILKLF,0
3udc,G,90,101,11,DMTSLLAVAGI,0
3udc,G,280,285,5,EDKAA,0
3ug9,B,24,48,24,TGSDATVPVATQDGPDYVFHRAHE,0
3ug9,B,49,90,41,MLFQTSYTLENNGSVICIPNNGQCFCLAWLKSNGTNAEKLA,0
3ug9,B,91,109,18,NILQWITFALSALCLMFY,0
3ug9,B,110,117,7,YQTWKST,0
3ug9,B,121,138,17,EIYVATIEMIKFIIEYF,0
3ug9,B,139,155,16,EFDEPAVIYSSNGNKT,0
3ug9,B,156,172,16,WLRYAEWLLTCPVILI,0
3ug9,B,190,207,17,LLVSDIGTIVWGTTAAL,0
3ug9,B,208,211,3,KGY,0
3ug9,B,212,231,19,RVIFFLMGLCYGIYTFFNA,0
3ug9,B,254,272,18,AWLFFVSWGMFPILFILG,0
3ug9,B,273,283,10,EGFGVLSVYG,0
3ug9,B,284,302,18,TVGHTIIDLMSKNCWGLL,0
3ug9,B,327,332,5,IGGTE,0
3ug9,B,343,356,13,EAGAVSSEDLYFQ,0
2hlf,B,37,57,20,MAAVVGTLVGLAAVAFDKGV,0
2hlf,B,58,83,25,WLQNQRMGALVHTADNYPLLLTVAF,0
2hlf,B,84,98,14,CSAVLAMFGYFLVR,0
2hlf,B,128,142,14,PVKFFGGLGTLGGG,0
2hlf,B,144,159,15,LGREGPTVQIGGNIG,0
2hlf,B,180,204,24,GAAAGLAAAFNAPLAGILFIIEEM,0
2hlf,B,216,229,13,AVFIGVIMSTIMY,0
2hlf,B,230,255,25,IFNHEVALIDVGKLSDAPLNTLWLY,0
2hlf,B,256,277,21,ILGIIFGIFGPIFNKWVLGMQ,0
2hlf,B,290,302,12,WVLMGGAIGGLC,0
2hlf,B,303,337,34,LLGFVAPATSGGGFNLIPIATAGNFSMGMLVFIF,0
2hlf,B,338,351,13,ARVITTLLCFSSG,0
2hlf,B,353,364,11,GGIFAPMLALG,0
2hlf,B,365,392,27,VLGTAFGMVAVELFPQYHLEAGTFAIA,0
2hlf,B,393,414,21,MGALLAASIRAPLTGIILVLE,0
2hlf,B,415,422,7,TDNYQLI,0
2hlf,B,423,442,19,PMIITGLGATLLAQFTGGK,0
2hlf,B,459,460,1,Q,0
1mot,A,249,253,4,PARV,0
1mot,A,254,265,11,LGITTVLTMTT,0
4ysy,D,28,53,25,SAAVTGAAPPQFDPIAAEKGFKPLH,0
4ysy,D,54,79,25,HGTLFKIERYFAAAMVPLIPAAYFI,0
4ysy,D,85,109,24,LCLALALTLHVHWGVWGVVNDYGR,0
4ysy,D,110,115,5,FVLGD,0
4ysy,D,116,139,23,LAAAVRVGAYIFTACLLAGLLYF,0
4ysy,D,146,153,7,TRAFEMV,0
1zoy,D,41,60,19,HWTGERVVSVLLLGLLPAA,0
1zoy,D,61,68,7,LNPCSAM,0
1zoy,D,69,88,19,YSLAAALTLHGHWGIGQVV,0
1zoy,D,99,118,19,AAKAGLLALSAFTFAGLCY,0
1zoy,D,119,125,6,NYHDVG,0
1zoy,D,126,134,8,CKAVAMLW,0
1zoy,D,135,136,1,L,0
5hl9,A,70,87,17,KLAIVFAVLIAIYGVYL,0
5hl9,A,88,206,118,QKIRSRIDGKVWQLPAAVYGRMVNLEPDMTISKNEMVKLLEATQYRQVSKMTRPGEFTVQANSIEMIRRPFDFPDSKEGQVRARLTFDGDHLATIVNMENNRQFGFFRLDPRLITMIS,0
5hl9,A,209,238,29,GEQRLFVPRSGFPDLLVDTLLATEDRHFY,0
5hl9,A,268,276,8,TQQLVKNL,0
5hl9,A,277,283,6,LSSERS,0
5hl9,A,284,300,16,WRKANEAYMALIMDAR,0
5hl9,A,301,405,104,SKDRILELYMNEVYLGQSGDNEIRGFPLASLYYFGRPVEELSLDQQALLVGMVKGASIYNPWRNPKLALERRNLVLRLLQQQQIIDQELYDMLSARPLGVQPRG,0
5hl9,A,408,426,18,SPQPAFMQLVRQELQAKL,0
5hl9,A,430,797,367,KDLSGVKIFTTFDSVAQDAAEKAAVEGIPALKKQRKLSDLETAIVVVDRFSGEVRAMVGGSEPQFAGYNRAMQARRSIGSLAKPATYLTALSQPKIYRLNTWIADAPIALRQPNGQVWSPQNDDRRYSESGRVMLVDALTRSMNVPTVNLGMALGLPAVTETWIKLGVPKDQLHPVPAMLLGALNLTPIEVAQAFQTIASGGNRAPLSALRSVIAEDGKVLYQSFPQAERAVPAQAAYLTLWTMQQVVQRGTGRQLGAKYPNLHLAGKTGTTNNNVDTWFAGIDGSTVTITWVGRDNNQPTKLYGASGAMSIYQRYLANQTPTPLNLVPPEDIADMGVDYDGNFVCSGGMRILPVWTSDPQSLCQQS,0
2q72,B,1,3,2,EV,0
2q72,B,13,32,19,LILAMAGNAVGLGNFLRFP,0
2q72,B,33,43,10,QAAENGGGAF,0
2q72,B,44,63,19,IPYIIAFLLVGIPLMWIEW,0
2q72,B,90,124,34,KILGVFGLWIPLVVAIYYVYIESWTLGFAIKFLV,0
2q72,B,125,132,7,LVPEPPP,0
2q72,B,133,134,1,A,0
2q72,B,135,166,31,DPDSILRPFKEFLYSYIGVPKGDEPILKPSL,0
2q72,B,167,185,18,AYIVFLITMFINVSILIR,0
2q72,B,191,212,21,ERFAKIAMPTLFILAVFLVIR,0
2q72,B,213,222,9,FLLETPNGT,0
2q72,B,223,231,8,ADGLNFLW,0
2q72,B,232,241,9,PDFEKLKDP,0
2q72,B,242,265,23,VWIAAVGQIFFTLSLGFGAIITY,0
2q72,B,277,297,20,SGLTAATLNEKAEVILGGSI,0
2q72,B,298,318,20,IPAAVAFFGVANAVAIAKAG,0
2q72,B,319,324,5,FNLGF,0
2q72,B,326,331,5,LPAIF,0
2q72,B,332,339,7,QTAGGTF,0
2q72,B,340,367,27,GFLWFFLLFFAGLTSSIAIMQPMIAFL,0
2q72,B,378,396,18,VLWTAAIVFFSAHLVMFL,0
2q72,B,397,399,2,KS,0
2q72,B,400,426,26,DEMDFWAGTIGVVFFGLTELIIFFWI,0
2q72,B,429,437,8,DKAWEEIN,0
2q72,B,445,469,24,RIYYYVMRYITPAFLAVLLVVWAR,0
2q72,B,470,471,1,Y,0
2q72,B,472,477,5,PKIME,0
2q72,B,478,483,5,THWTV,0
2q72,B,484,502,18,ITRFYIIGLFLFLTFLVF,0
2q72,B,602,603,1,R,0
3u2f,E,13,31,18,ISTIGLLGAGIGIAIVFA,0
3u2f,E,32,51,19,LINGVSRNPSIKDTVFPMA,0
3u2f,E,52,71,19,LGFALSEATGLFCLMVSFL,0
3u2f,E,75,76,1,V,0
5af1,D,34,52,18,SVLVWIMIPGVGLLYSGI,0
5af1,D,53,61,8,RKKHALSL,0
5af1,D,62,84,22,WAALMAACVAAFQWFWWGYSLV,0
5af1,D,121,139,18,YQGMFAAVTAILMAGAGC,0
5af1,D,140,144,4,RARL,0
5af1,D,145,166,21,PMMVFLFIWLTVVYCPIAYWT,0
5af1,D,181,201,20,AGGGPVHENSGFAALAYSLW,0
5af1,D,202,223,21,GKRHDPVAKGKVPKYKPHSVS,0
5af1,D,224,242,18,IVMGTIFLWFGWYGFNGG,0
5af1,D,255,275,20,VNTNLAAATGGLTWMLVDWF,0
5af1,D,276,283,7,TGGKWST,0
5af1,D,284,301,17,GLCMGAIAGLVGITPAA,0
5af1,D,307,326,19,TSVIFGIVPAIICNFAVDL,0
5af1,D,327,335,8,DLLQIDDG,0
5af1,D,336,356,20,DVWALHGVGGFVGNFMTGLF,0
5af1,D,382,409,27,YQLAGSCAVAAWSFTVTSIILLAMDRI,0
5af1,D,410,453,43,FLRIRLHEDEEMLGTDLAQIGEYAYYADDDPETNPYVLEPIRS,0
3kly,E,1,22,21,EHNQFDSLLPPQMAERAAITG,0
3kly,E,23,34,11,GKAKKAAYKSF,0
3kly,E,35,55,20,LAISAGIQIGIAFVFYTVVT,0
3kly,E,65,82,17,TKLLGGLAFSLGLILVV,0
3kly,E,83,113,30,TGGELFTSSVLILVAKASGKISWKELVRNW,0
3kly,E,114,136,22,VVYFGNLCGSIILVFIMLATRQ,0
3kly,E,159,178,19,FLQAFALGLMCNILVCLAV,0
3kly,E,179,190,11,MTFSARSLTDK,0
3kly,E,191,203,12,MVLILPVAMFVS,0
3kly,E,204,208,4,GFEH,0
3kly,E,209,221,12,IANMFQVPMAIG,0
3kly,E,246,268,22,VNFIVNNLIPVTLGNIVGGGVF,0
3kly,E,269,278,9,GMWYWLIYL,0
3kly,E,279,280,1,D,0
2mpn,B,106,111,5,SQPLP,0
2mpn,B,112,137,25,MRQVQIAAGGLILIGVVLGYTVNSG,0
2mpn,B,141,166,25,SGFVGAGLLFAGISGFSGMARLLDK,0
2mpn,B,167,173,6,PWNQRA,0
4u15,A,56,62,6,DPLGGH,0
4u15,A,73,90,17,TGFLALVTIIGNILVIV,0
4u15,A,91,105,14,FKVNKQLKTVNNYF,0
4u15,A,106,122,16,LSLACADLIIGVISMN,0
4u15,A,142,159,17,WLSIDYVASNASVMNLL,0
4u15,A,160,187,27,ISFDRYFSITRPLTYRAKRTTKRAGVM,0
4u15,A,188,205,17,GLAWVISFVLWAPAILF,0
4u15,A,230,248,18,TFGTAIAAFYMPVTIMTI,0
4u15,A,249,492,243,YWRIYKETEKMNIFEMLRIDEGGGSGGDEAEKLFNQDVDAAVRGILRNAKLKPVYDSLDAVRRAALINMVFQMGETGVAGFTNSLRMLQQKRWDEAAVNLAKSRWYNQTPNRAKRVITTFRTGTWDAYLIKEKKAAQTL,0
4u15,A,493,511,18,AILLAFIITWTPYNIMVL,0
4u15,A,528,545,17,YWLCYINSTVNPVCYAL,0
4u15,A,546,557,11,NKTFRTTFKTL,0
4u15,A,558,577,19,LCQCDKRKRRKHHHHHHHH,0
2zqp,E,1,11,10,FARLIRYFQE,0
2zqp,E,32,52,20,AILLFTLAFMVILGLYDTVF,0
2zqp,E,53,57,4,FLIG,0
2zqp,E,58,60,2,LR,0
3beh,D,1,4,3,SVL,0
3beh,D,16,29,13,LAAPGLLAVAALT,0
3beh,D,30,39,9,PDMSGRSRL,0
3beh,D,40,54,14,LAALLAVIWGAYLL,0
3beh,D,79,92,13,LAVLVPLAAFLLD,0
3beh,D,93,96,3,SPD,0
3beh,D,97,108,11,SLYCAVWLLKP,0
3beh,D,134,150,16,LFGVVLFAVALAAYVI,0
3beh,D,151,162,11,RDIQPEKFGSI,0
3beh,D,163,179,16,QAMWWAVVTLSTTGYG,0
3beh,D,180,186,6,TIPQSF,0
3beh,D,187,203,16,GRVLAGAVMMSGIGIF,0
3beh,D,230,355,125,AAVPLFQKLGPAVLVEIVRALRARTVPAGAVICRIGEPGDRMFFVVEGSVSVATPNPVELGPGAFFGEMALISGEPRSATVSAATTVSLLSLHSADFQMLCSSSPEIAEIFRKTALERRGAAASA,0
1z9k,C,1,10,9,VGVTAFGNF,0
1z9k,C,12,29,17,ASLAIYSFWIFLAGLIY,0
1z9k,C,249,260,11,SVVAAMLAEYA,0
2jtw,A,1,4,3,KSH,0
2jtw,A,5,20,15,ASYLRLWALSLAHAQ,0
5f5j,A,93,109,16,GPVTWVMMIACVVVFI,0
5f5j,A,116,123,7,QEVMLWL,0
5f5j,A,135,146,11,WRYFTHALMHF,0
5f5j,A,148,167,19,MHILFNLLWWWYLGGAVEK,0
5f5j,A,168,170,2,LG,0
5f5j,A,171,192,21,GKLIVITLISALLSGYVQQKF,0
5f5j,A,198,214,16,GLSGVVFALMGYVWLR,0
5f5j,A,215,225,10,ERDPQSGIYL,0
5f5j,A,226,245,19,RGLIIFALIWIVAGWFDLF,0
5f5j,A,250,268,18,NGAHIAGLAVGLAMAFVD,0
5f5j,A,269,272,3,LNA,0
4ug2,A,6,8,2,SV,0
4ug2,A,9,28,19,ITVELAIAVLAILGNVLVC,0
4ug2,A,46,66,20,SAAAADILVGVLAIPFAIAI,0
4ug2,A,67,78,11,TGFCAACHGCL,0
4ug2,A,79,99,20,IACFVLVLTASSIFSLLAIA,0
4ug2,A,125,144,19,AICWVLSFAIGLTPMLGWN,0
4ug2,A,145,172,27,CGQPKEGKAHSQGCGEGQVACLFEDVV,0
4ug2,A,173,198,25,MNYMVYFNFFACVLVPLLLMLGVYL,0
4ug2,A,235,255,20,AIIVGLFALCWLPLHIINCF,0
4ug2,A,256,269,13,FFCPDCSHAPLWL,0
4ug2,A,270,288,18,YLAIVLSHTNSVVNPFIY,0
4ug2,A,293,304,11,EFRQTFRKIIR,0
4py0,A,-8,14,22,YKDDDDGAPQAVDNLTSAPGNT,0
4py0,A,24,48,24,QVLFPLLYTVLFFVGLITNGLAMR,0
4py0,A,49,62,13,FFQIRSKSNFIIF,0
4py0,A,63,85,22,KNTVISDLLMILTFPFKILSDA,0
4py0,A,87,88,1,G,0
4py0,A,93,119,26,TFVCQVTSVIFYFTMYISISFLGLIT,0
4py0,A,120,128,8,DRYQKTTR,0
4py0,A,129,134,5,FKTSN,0
4py0,A,135,143,8,KNLLGAKI,0
4py0,A,144,164,20,SVVIWAFMFLLSLPNMILTN,0
4py0,A,180,207,27,EFGLVWHEIVNYICQVIFWINFLIVIV,0
4py0,A,208,238,30,YTLITKELYRSYVRTADLEDNWETLNDNLKVIEKADNAAQVKDALTKMRAAALDAQKATPPKLEDKSPDSPEMKDFRHGFDILVGQIDDALKLANEGKVKEAQAAAEQLKTTRNAYIQKYLRGVGKVPRKKVNVKV,0
4py0,A,239,264,25,IIIAVFFICFVPFHFARIPYTLSQT,0
4py0,A,276,297,21,FYVKESTLWLTSLNACLNPFI,0
4py0,A,298,305,7,FFLCKSF,0
4py0,A,306,351,45,NSLISMLKCPNSATSLSQDNRKKEQDGGDPNEETPMGRPLEVLFQ,0
5a1s,B,16,22,6,DLLRFK,0
5a1s,B,23,40,17,FGMPLPLYAFALITLLL,0
5a1s,B,51,72,21,VGGFALMFVMGAIFGEIGKRL,0
5a1s,B,74,90,16,FNKYIGGAPVMIFLVA,0
5a1s,B,115,128,13,FLNLFIAVLITGA,0
5a1s,B,129,133,4,LSVN,0
5a1s,B,134,140,6,KLLLKS,0
5a1s,B,141,148,7,LGYIPTI,0
5a1s,B,149,165,16,AGIVGASLFGIVIGLC,0
5a1s,B,174,196,22,MLYVLPIMGGGNGAGAVPLSEI,0
5a1s,B,210,226,16,TAIAILTIANIFAIIF,0
5a1s,B,227,249,22,ALLDMVGKKYTWLSGEGELVRK,0
5a1s,B,257,269,12,EKAGQITHRETA,0
5a1s,B,270,288,18,GMVLSTTCFLLAYVVAKK,0
5a1s,B,297,311,14,IHYFAWMVLIVAAL,0
5a1s,B,312,331,19,ASGLCSPEIKAGAKRLSDF,0
5a1s,B,332,345,13,SKQLLWVLMVGVG,0
5a1s,B,351,357,6,QEIIDA,0
5a1s,B,359,376,17,FANVVIAAIIVVGAVVG,0
5a1s,B,377,396,19,AIGGWLIGFYPIESSITAG,0
5a1s,B,397,406,9,CMANRGGSG,0
5a1s,B,407,427,20,LEVLSACNRMNLISYAQISS,0
5a1s,B,428,442,14,LGGGIVLVIASIVF,0
2ad0,D,1,2,1,V,0
2ad0,D,15,35,20,FILVRATAIVLTLYIIYMVG,0
2ad0,D,36,55,19,FATSGELTYEVWIGFFASA,0
2ad0,D,56,80,24,TKVFTLLALFSILIHAWIGMWQVL,0
2ad0,D,90,113,23,LMLQLVIVVALVVYVIYGFVVVW,0
2ad0,D,114,115,1,V,0
4bev,A,1,73,72,KHDHHQGHTHSGKGHACHHEHNSPKTQQASSKMEGPIVYTCPMHPEIRQSAPGHCPLCGMALEPETVTVSEV,0
4bev,A,82,104,22,RRFWIALMLTIPVVILEMGGHG,0
4bev,A,105,112,7,KHFISGN,0
4bev,A,113,142,29,SSWIQLLLATPVVLWGGWPFFKRGWQSLK,0
4bev,A,147,170,23,MFTLIAMGIGVAWIYSMVAVLWP,0
4bev,A,171,184,13,VFPHAFRSQEGVV,0
4bev,A,185,201,16,VYFEAAAVITTLVLLG,0
4bev,A,340,361,21,GWFVPAVILVAVLSFIVWALL,0
4bev,A,362,366,4,PQPA,0
4bev,A,367,389,22,SYGLIAAVSVLIIACPCALGLA,0
4bev,A,680,701,21,NLFFAFIYNVLGVPLAAGVLY,0
4bev,A,702,706,4,LTGL,0
4bev,A,707,730,23,LSPMIAAAAMALSSVSVIINALR,0
2fbw,D,9,28,19,WTSERAVSALLLGLLPAAY,0
2fbw,D,29,34,5,YPGPA,0
2fbw,D,35,56,21,DYSLAAALTLHGHWGLGQVIT,0
2fbw,D,66,85,19,VANTGLYVLSAITFTGLCY,0
2fbw,D,86,92,6,NYYDVG,0
2fbw,D,93,100,7,CKAVAML,0
2fbw,D,101,103,2,SI,0
1oy8,C,1,6,5,PNFFI,0
1oy8,C,7,10,3,RPI,0
1oy8,C,11,27,16,AWVIAIIIMLAGGLAI,0
1oy8,C,341,357,16,KTLVEAIILVFLVMYL,0
1oy8,C,358,365,7,LQNFRAT,0
1oy8,C,366,386,20,IPTIAVPVVLLGTFAVLAAF,0
1oy8,C,395,411,16,FGMVLAIGLLVDDAIV,0
1oy8,C,412,441,29,VENVERVMAEEGLPPKEATRKSMGQIQGA,0
1oy8,C,442,458,16,VGIAMVLSAVFVPMAF,0
1oy8,C,469,489,20,FSITIVSAMALSVLVALILT,0
1oy8,C,490,498,8,ALCATMLK,0
1oy8,C,499,512,13,IAKGDHGEGKKGF,0
1oy8,C,514,524,10,WFNRMFEKST,0
1oy8,C,526,536,10,YTDSVGGILR,0
1oy8,C,537,540,3,TGR,0
1oy8,C,541,557,16,LVLYLIIVVGMAYLFV,0
1oy8,C,860,868,8,GMSYQERL,0
1oy8,C,874,891,17,SLYAISLIVVFLCLAAL,0
1oy8,C,892,897,5,ESWSI,0
1oy8,C,898,919,21,FSVMLVVPLGVIGALLAATFR,0
1oy8,C,927,943,16,QVGLLTTIGLSAKNAI,0
1oy8,C,944,975,31,IVEFAKDLMDKEGKGLIEATLDAVRMRLRPI,0
1oy8,C,976,992,16,MTSLAFILGVMPLVIS,0
1oy8,C,1004,1021,17,TGVMGGMVTATVLAIFF,0
1oy8,C,1022,1025,3,PVF,0
1oy8,C,1026,1032,6,VVVRRR,0
1oy8,C,1033,1036,3,SRK,0
1oy8,C,1037,1049,12,EDIEHSHTVDHH,0
3ldc,D,24,41,17,LLVLAVIIYGTAGFHFI,0
3ldc,D,42,46,4,GESW,0
3ldc,D,47,63,16,VSLYWTFVTIATVGYG,0
3ldc,D,64,70,6,YSPHTP,0
3ldc,D,71,92,21,GMYFTCTLIVLGIGTFAVAVE,0
3ldc,D,93,98,5,LLEFL,0
5svt,C,21,27,6,TIGIIN,0
5svt,C,28,47,19,VVQLLIISYFVGWVFLHEK,0
5svt,C,316,343,27,NIIPTIISSVAAFTSVGVGTVLCDIIL,0
5svt,C,344,345,1,N,0
1dhl,A,1,4,3,AQD,0
1dhl,A,5,22,17,ISTIGDLVKWIIDTVNK,0
5tsi,A,1,10,9,QRSPVEDAN,0
5tsi,A,11,16,5,LSRYF,0
5tsi,A,17,84,67,WWTNPIMRKGFKEKLRPSDVYQAPSQDAADILAERLEKEWDREVASGKKKPSLLRAMARCYIKPFLL,0
5tsi,A,85,100,15,GFLLYIGEATKTVQP,0
5tsi,A,129,142,13,LLFTARFLLLQPA,0
5tsi,A,143,200,57,FGLHHLGMQIRIALFSIIYKKTLKLSSRVLDKISTGQLVSLMSANLGKFDQSLGMAH,0
5tsi,A,201,216,15,IWISPLQCILCTGLI,0
5tsi,A,224,238,14,FCALAAISLLGVLQ,0
5tsi,A,239,306,67,FLSHKMGPYKAQKVLLTNKRLALTSEIMENLHSVKAYGWEEIMETLIKNIRQDEVKLTRKIGSLRYF,0
5tsi,A,307,322,15,SSAYFFSAIFVIVAA,0
5tsi,A,342,355,13,YCMVLRMTVTRQL,0
5tsi,A,356,402,46,GSIQMWYDTMRLIWKIEEFLSKEEYKLMEYDLSITELELQDVTASW,0
5tsi,A,437,669,232,PVLKDISLKLKKGEMLAVTGSMGSGKSSLLMTILGELVPSSGKIRHSGRISYSSQTAWIMPGTIRDNILFGLTYDEYRYKSVVKACQLEEDLAALPEKDKTPMAEGGLNLSGGQKARVALARAVYRDADLYLLDAPFTHLDIATEKEIFDKCLCKLMASKTRILVTNKIEHLKRADKILLLHNGESFFYGTFPELQSERPDFSSLLLGLEAYDNISAERRSSILTETLHRVS,0
5tsi,A,841,844,3,TKW,0
5tsi,A,845,852,7,TYVRYVS,0
5tsi,A,853,859,6,NKSLLY,0
5tsi,A,860,875,15,LIFILFIAAIEIAGS,0
5tsi,A,928,943,15,ATSESLLAMGFFRGL,0
5tsi,A,944,1001,57,FVHTTITISKKLHQKMLHAVLSAPMSVLNTMKTGRIMNRFTKDMATIDDMLPLLMFD,0
5tsi,A,1002,1018,16,VQLTVVVVGCILVVSI,0
5tsi,A,1023,1037,14,FLAATPLAIIFIVM,0
5tsi,A,1038,1108,70,KYFLRTGQQLKQLETEARSPIFSHLIMSLKGLWTIRAFERQAYFEALFHKTLNTHTATWFLYLSTLRWFL,0
5tsi,A,1109,1123,14,RADILFVFFFTLAA,0
5tsi,A,1142,1155,13,LAMLILGTFQWCV,0
5tsi,A,1156,1180,24,TSIAVDGMMRSVDRVFKFIDLPSE,0
5tsi,A,1203,1437,234,SWPHRGQIEVRNLTVKYTEAGHAVLKNLSFSAEGRQRVGILGRTGSGKSSLFNALLKLVYTDGEISIDGVNWNKMPLQKWRKAFGVVPQKVFIFTGPLRMNLDPYGCHSDEELWRVAEEVGLKTVIEQFPDKLDFQLEYGGYVLSNGHKQLICLARSILSGARILLLDEPSAHLDPVTIKVLKKTLRQSFSTCTILLSEHKVEPLLECQSFLMMDKGQVKTYDSIQKLLNETSH,0
3iyz,D,-16,29,45,PRGSHHHHHHGMASMTGGQQMGRDLYDDDDKDPSSRSIMVAFKGV,0
3iyz,D,30,37,7,TQAFWKA,0
3iyz,D,38,55,17,TAEFLAMLIFVLLSVGS,0
3iyz,D,71,88,17,LISLCFGLSIATMVQCF,0
3iyz,D,89,93,4,HISG,0
3iyz,D,94,104,10,HINPAVTVAM,0
3iyz,D,105,114,9,CTRKISIAK,0
3iyz,D,115,133,18,VFYITAQCLGAIIGAGIL,0
3iyz,D,157,174,17,HGLLVELIITFQLVFTI,0
3iyz,D,175,187,12,ASCDDKRTDVTG,0
3iyz,D,188,204,16,VALAIGFSVAIGHLFA,0
3iyz,D,209,222,13,ASMNPARSFGPAV,0
3iyz,D,230,247,17,WIYWVGPIIGAVLAGAL,0
3iyz,D,248,253,5,EYVFC,0
3iyz,D,254,323,69,DVELKRRLKEAFSKAAQQTKGSYMEVEDNRSQVETEDLILKPGVVHVIDIDRGDEKKGKDSSGEVLSSV,0
2hac,B,-3,-1,2,SK,0
2hac,B,1,21,20,CYLLDGILFIYGVILTALFL,0
3kcv,E,1,28,27,KADNPFDLLLPAAMAKVAEEAGVYKAT,0
3kcv,E,29,38,9,HPLKTFYLA,0
3kcv,E,39,57,18,TAGVFISIAFVFYITATT,0
3kcv,E,64,83,19,GMAKLVGGICFSLGLILCV,0
3kcv,E,84,114,30,CGADLFTSTVLIVVAKASGRITWGQLAKNW,0
3kcv,E,115,141,26,NVYFGNLVGALLFVLLMWLSGEYMTA,0
3kcv,E,149,179,30,LQTADHKVHHTFIEAVCLGILANLMVCLAV,0
3kcv,E,180,192,12,MSYSGRSLMDKA,0
3kcv,E,193,205,12,IMVLPVAMFVAS,0
3kcv,E,206,208,2,FE,0
3kcv,E,209,223,14,SIANMFMIPMGIVI,0
3kcv,E,229,235,6,EFWTAV,0
3kcv,E,246,269,23,VMNFITDNLIPVTIGNIIGGGLL,0
3kcv,E,270,280,10,GLTYWVIYLR,0
3kcv,E,281,285,4,NDHH,0
2aki,C,17,27,10,KWVVVVALLL,0
2aki,C,54,65,11,AGGVALLTTKG,0
2aki,C,66,93,27,ATVAFAREARTEVRKVIWPTRQETLHT,0
2aki,C,94,115,21,LIVAAVTAVMSLILWGLDGIL,0
2ah3,A,1,31,30,ALNSSAEDGIKRIQDDCPKAGRHSYIFVMI,0
2ah3,A,32,54,22,TLYSIIFVVGIFGNSLVVIVIY,0
2ah3,A,64,86,22,VFLLNLALADLCFLLTLPLWAV,0
2ah3,A,87,101,14,TAMEYRWPFGNHLC,0
2ah3,A,102,124,22,IASASVSFNLYASVFLLTCLSI,0
2ah3,A,147,168,21,TCIIIWLMAGLASLPAVIHRN,0
2ah3,A,169,194,25,YFIENTNITVCAFHYESRNSTLPIG,0
2ah3,A,195,216,21,GLTKNILGFLFPFLIILTSYT,0
2ah3,A,241,263,22,IMAIVLFFFFSWVPHQIFTFLD,0
2ah3,A,264,286,22,LIQLGVIHDCKISDIVDTAMPI,0
2ah3,A,287,305,18,ICIAYFNNCLNPLFYGFL,0
2ah3,A,309,314,5,KKYFL,0
3e9j,C,1,13,12,LRFLNQASQGRG,0
3e9j,C,15,31,16,LLMAFTALALELTALW,0
3e9j,C,32,47,15,QHVMLLKPCVLCIYE,0
3e9j,C,48,65,17,VALFGVLGAALIGAIAP,0
3e9j,C,71,86,15,VAMVIWLYSAFRGVQ,0
3e9j,C,87,126,39,TYEHTMLQLYPSPFATCDFMVRFPEWLPLDKWVPQVFVA,0
3e9j,C,127,141,14,GDCAERQWDFLGLE,0
3e9j,C,142,145,3,PQW,0
3e9j,C,146,162,16,LGIFIAYLIVAVLVVI,0
3e9j,C,163,182,19,QPFKAKKRDLFGRHHHHHH,0
4il3,A,1,8,7,FDLKKIL,0
4il3,A,16,35,19,LIISAFSIAQFSFESYLTY,0
4il3,A,36,73,37,QYQKLSETKLPPVLEDEIDDETFHKSRNYSRAKAKFS,0
4il3,A,74,91,17,FSDIYNLAQKLVFIKYD,0
4il3,A,93,102,9,PKIWHMAVT,0
4il3,A,107,113,6,LPVRFH,0
4il3,A,120,140,20,SLCFLGLLSSMSTLVDLPLS,0
4il3,A,141,165,24,YSHFVLEEKFGFNKLTVKLWITDM,0
4il3,A,166,187,21,KSLTLAYAIGGPILYLFLKIF,0
4il3,A,194,213,19,LWYIMVFLFVVQILAMTII,0
4il3,A,214,307,93,VFIMPLFNKFTPLEDGELKKSIESLADRVGFPLDKIFVIDGSKRSSHSNAYFTGLPFTSKRIVLFDTLVNSNSTDEITAVLAHEIGHWQKNHI,0
4il3,A,308,326,18,NMVIFSQLHTFLIFSLFT,0
4il3,A,339,346,7,FFVEKSS,0
4il3,A,360,385,25,IIGFMLFNDLLTPLECAMQFIMSLI,0
4il3,A,386,424,38,RTHEYQADAYAKKLGYKQNLCRALIDLQIKNLSTMNVD,0
4il3,A,425,430,5,LYSSY,0
4il3,A,431,445,14,YSHPTLAERLTALD,0
4il3,A,446,461,15,VSEKKKNSGLEVLFQ,0
2d57,D,23,30,7,VAFKGVW,0
2d57,D,31,38,7,QAFWKAV,0
2d57,D,39,55,16,AEFLAMLIFVLLSVGS,0
2d57,D,72,89,17,ISLCFGLSIATMVQCFG,0
2d57,D,90,94,4,ISGG,0
2d57,D,95,106,11,INPAVTVAMVC,0
2d57,D,107,115,8,RKISIAKS,0
2d57,D,116,133,17,FYITAQCLGAIIGAGIL,0
2d57,D,158,177,19,GLLVELIITFQLVFTIFAS,0
2d57,D,178,187,9,DSKRTDVTG,0
2d57,D,188,205,17,VALAIGFSVAIGHLFAI,0
2d57,D,209,222,13,ASMNPARSFGPAV,0
2d57,D,231,248,17,IYWVGPIIGAVLAGALY,0
2d57,D,249,254,5,YVFCP,0
2d57,D,255,323,68,VELKRRLKEAFSKAAQQTKGSYMEVEDNRSQVETEDLILKPGVVHVIDIDRGDEKKGKDSSGEVLSSV,0
2hvj,F,1,21,20,APMLSGLLARLVKLLLGRHG,0
2hvj,F,22,24,2,AL,0
2hvj,F,25,50,25,WRAAGAATVLLVIVLLAGSYLAVLA,0
2hvj,F,63,79,16,RALWWSVETATTVGYG,0
2hvj,F,87,114,27,GRCVAVVVMVAGITSFGLVTAALATWF,0
2hvj,F,115,124,9,GREQERRGH,0
3pcv,C,1,7,6,KDEVAL,0
3pcv,C,8,25,17,AAVTLLGVLLQAYFSLQ,0
3pcv,C,53,71,18,VNCSEYFPLFLATLWVAG,0
3pcv,C,72,78,6,FFHEGA,0
3pcv,C,79,95,16,ALCGLVYLFARLRYFQ,0
3pcv,C,106,124,18,PLYASARALWLLVALAAL,0
3pcv,C,125,145,20,LLAHFLPAALRAALLGRLRT,0
3pcv,C,147,156,9,PWAHHHHHH,0
2ht4,B,1,17,16,KTDTPSLETPQAARLR,0
2ht4,B,37,57,20,MAAVVGTLVGLAAVAFDKGV,0
2ht4,B,58,83,25,WLQNQRMGALVHTADNYPLLLTVAF,0
2ht4,B,84,98,14,CSAVLAMFGYFLVR,0
2ht4,B,128,142,14,PVKFFGGLGTLGGG,0
2ht4,B,144,159,15,LGREGPTVQIGGNIG,0
2ht4,B,180,204,24,GAAAGLAAAFNAPLAGILFIIEEM,0
2ht4,B,216,229,13,AVFIGVIMSTIMY,0
2ht4,B,230,255,25,IFNHEVALIDVGKLSDAPLNTLWLY,0
2ht4,B,256,277,21,ILGIIFGIFGPIFNKWVLGMQ,0
2ht4,B,278,284,6,LLHRVH,0
2ht4,B,289,302,13,KWVLMGGAIGGLC,0
2ht4,B,303,337,34,LLGFVAPATSGGGFNLIPIATAGNFSMGMLVFIF,0
2ht4,B,338,351,13,ARVITTLLCFSSG,0
2ht4,B,353,364,11,GGIFAPMLALG,0
2ht4,B,365,392,27,VLGTAFGMVAVELFPQYHLEAGTFAIA,0
2ht4,B,393,414,21,MGALLAASIRAPLTGIILVLE,0
2ht4,B,415,422,7,TDNYQLI,0
2ht4,B,423,442,19,PMIITGLGATLLAQFTGGK,0
2ht4,B,459,473,14,QLARSKAASASENT,0
2xq3,E,0,6,6,QDMVSP,0
2xq3,E,198,216,18,NIILPMLFILFISWTAFW,0
2xq3,E,217,220,3,TSY,0
2xq3,E,221,240,19,ANVTLVVSTLIAHIAFNIL,0
2xq3,E,255,274,19,AIIFMIYLFYFVAVIEVTV,0
2xq3,E,275,293,18,HYLKVESQPARAASITRA,0
2xq3,E,294,312,18,RIAFPVVFLLANIILAFL,0
1fdm,A,1,7,6,EGDDPA,0
1fdm,A,8,16,8,AAFDSLQA,0
1fdm,A,17,29,12,ATEYIGYAWAMV,0
1fdm,A,30,44,14,VIVGATIGIKLFKK,0
4ry2,B,154,160,6,MVKFAG,0
4ry2,B,163,187,24,PLKKTVLCIFLASLLYTALGIAGS,0
4ry2,B,188,211,23,YIKFLFDDLIKFEKLNDLHIISA,0
4ry2,B,212,235,23,FAVIFLLQIFLNYYRSILVTKLG,0
4ry2,B,280,302,22,SGATLTIMIDTIMAVIGGILLY,0
4ry2,B,303,308,5,QNSSL,0
4ry2,B,309,330,21,FISFIIILLYGIIVTVFNKPI,0
4ry2,B,386,407,21,MLYINLSSLTGIVAGLGGIVI,0
4ry2,B,408,428,20,WAGAYNVIKGNMSGGQLLAF,0
4ry2,B,429,450,21,ALLAYFLTPVKNLIDLQPLIQ,0
4pa6,F,126,130,4,SHMG,0
4pa6,F,132,151,19,SVAALLTVVFYIAAVMATN,0
4pa6,F,165,181,16,KSLYTLFQVMTLESWS,0
4pa6,F,185,191,6,RPVMNV,0
4pa6,F,195,218,23,WVFFIPFIMLTTFTVLNLFIGII,0
4pa6,F,219,220,1,D,0
4pa6,F,221,274,53,MAITKEQEEEAKTGHHQEPISQTLLHLGDRLDRIEKQLAQNNELLQRQQPQKK,0
1xl4,D,1,22,21,TGGMKPPARKPRILNSDGSSN,0
1xl4,D,38,43,5,HDLLT,0
1xl4,D,45,71,26,WPVFITLITGLYLVTNALFALAYLAC,0
1xl4,D,72,83,11,DVIENARPGSF,0
1xl4,D,84,99,15,DAFFFSVQTMATIGY,0
1xl4,D,100,107,7,KLIPIGP,0
1xl4,D,108,135,27,ANTLVTLEALCGMLGLAVAASLIYARF,0
1xl4,D,300,301,1,H,0
2db4,J,16,35,19,LAMATATIFSGIGSAKGVG,0
2db4,J,36,60,24,TGEAAAALTTSQPEKFGQALILQL,0
2db4,J,61,78,17,PGTQGLYGFVIAFLIFI,0
2db4,J,93,110,17,GASLPIAFTGLFSGIAQ,0
2db4,J,111,136,25,KVAAAGIQILAKKPEHATKGIIFAA,0
2db4,J,137,154,17,VQTYAILGFVISFLLVL,0
3p50,E,1,4,3,QDM,0
3p50,E,5,194,189,SPPPPIADEPLTVNTGIYLIECYSLDDKAETFKVNAFLSLSWKDRRLAFDPVRSGVRVKTYEPEAIWIPEIRFVNVENARDADVVDISVSPDGTVQYLERFSARVLSPLDFRRYPFDSQTLHIYLIVRSVDTRNIVLAVDLEKVGKNDDVFLTGWDIESFTAVVKPANFALEDRLESKLDYQLRISRQY,0
3p50,E,195,217,22,SYIPNIILPMLFILFISWTAFW,0
3p50,E,222,244,22,ANVTLVVSTLIAHIAFNILVET,0
3p50,E,245,251,6,LPKTPY,0
3p50,E,252,275,23,TYTGAIIFMIYLFYFVAVIEVTV,0
3p50,E,295,315,20,RIAFPVVFLLANIILAFLFF,0
3p50,E,316,318,2,FG,0
3g61,A,1,32,31,ELEEDLKGRADKNFSKMGKKSKKEKKEKKPA,0
3g61,A,45,68,23,DRLYMLVGTLAAIIHGVALPLMM,0
3g61,A,69,114,45,IFGDMTDSFASVGNVSKNSTNMSEADKRAMFAKLEEEMTTYAYYY,0
3g61,A,115,132,17,GIGAGVLIVAYIQVSFW,0
3g61,A,184,203,19,KIGMFFQAMATFFGGFIIG,0
3g61,A,204,214,10,TRGWKLTLVI,0
3g61,A,215,233,18,AISPVLGLSAGIWAKILS,0
3g61,A,291,310,19,NISMGAAFLLIYASYALAF,0
3g61,A,311,331,20,YGTSLVISKEYSIGQVLTVF,0
3g61,A,332,349,17,SVLIGAFSVGQASPNIE,0
3g61,A,627,683,56,GNEIELGNEACKSKDEIDNLDMSSKDSGSSLIRRRSTRKSICGPHDQDRKLSTKEA,0
3g61,A,695,703,8,ILKLNSTE,0
3g61,A,708,728,20,VGIFCAIINGGLQPAFSVIF,0
3g61,A,729,753,24,KVVGVFTNGGPPETQRQNSNLFSL,0
3g61,A,754,773,19,FLILGIISFITFFLQGFTF,0
3g61,A,828,847,19,LAVIFQNIANLGTGIIISL,0
3g61,A,848,853,5,YGWQL,0
3g61,A,854,872,18,LLLLAIVPIIAIAGVVEM,0
3g61,A,932,952,20,VFGITFSFTQAMMYFSYAAC,0
3g61,A,953,972,19,RFGAYLVTQQLMTFENVLL,0
3g61,A,973,990,17,FSAIVFGAMAVGQVSSF,0
3g61,A,1272,1284,12,AKRSYVHHHHHH,0
3rw0,D,1983,1998,15,DYKDDDDKGSLVPRG,0
3rw0,D,2000,2009,9,MYLRITNIV,0
3rw0,D,2015,2034,19,KFIIYLIVLNGITMGLETS,0
3rw0,D,2035,2041,6,TFMQSF,0
3rw0,D,2042,2064,22,VYTTLFNQIVITIFTIEIILRI,0
3rw0,D,2076,2094,18,SLFDFFVVAISLVPTSSG,0
3rw0,D,2096,2113,17,ILRVLRVLRLFRLVTAV,0
3rw0,D,2116,2130,14,RKIVSALISVIPGM,0
3rw0,D,2131,2151,20,SVIALMTLFFYIFAIMATQL,0
3rw0,D,2152,2162,10,GERFPEWFGT,0
3rw0,D,2163,2190,27,GESFYTLFQVMTLESWSMGIVRPLMEV,0
3rw0,D,2191,2193,2,PY,0
3rw0,D,2194,2214,20,WVFFIPFIFVVTFVMINLVV,0
3rw0,D,2222,2267,45,ILNQKEEQHIIDEVQSHEDNINNEIIKLREEIVELKELIKTSLKN,0
2vpy,G,1,15,14,EFYGLPNAQEFWHW,0
2vpy,G,16,36,20,NALHFVLVGLAGGVALLAAL,0
2vpy,G,49,66,17,LYALMLIALDLFILWAE,0
2vpy,G,67,88,21,PARFRFTHIWLFLSFHPTSPI,0
2vpy,G,89,105,16,WGAWGLGLGFLTGGLL,0
2vpy,G,115,132,17,AWALLVFSLVALSYPGL,0
2vpy,G,133,146,13,LAVNLNRPLWNGL,0
2vpy,G,147,163,16,AGLFPLTALVLALGLA,0
2vpy,G,175,189,14,RVLAGASLLLALLY,0
2vpy,G,190,206,16,LTLPPEARGHLLEEAG,0
2vpy,G,207,221,14,WYGLFLLLGLGTFW,0
2vpy,G,226,241,15,PWAGLLAAAGLRALL,0
2vpy,G,242,250,8,LAGQWQGL,0
2vpy,G,251,252,1,L,0
1qko,C,1,4,3,AQI,0
1qko,C,5,9,4,GRPE,0
1qko,C,10,33,23,IWLALGTALMGLGTLYFLVKGMG,0
1qko,C,41,62,21,FYAITTLVPAIAFTMYLSMLL,0
1qko,C,63,79,16,YGLTMVPFGGEQNPIY,0
1qko,C,80,100,20,ARYADWLFTTPLLLLDLALL,0
1qko,C,106,127,21,TILALVGADGIMIGTGLVGAL,0
1qko,C,128,133,5,KVYSY,0
1qko,C,134,157,23,FVWWAISTAAMLYILYVLFFGFT,0
1qko,C,171,192,21,KVLRNVTVVLWSAYPVVWLIG,0
1qko,C,193,203,10,EGAGIVPLNI,0
1qko,C,204,226,22,TLLFMVLDVSAKVGFGLILLRS,0
1qko,C,233,248,15,EAPEPSAGDGAAATS,0
4ky0,C,1,9,8,GKSLLRRY,0
4ky0,C,10,16,6,DYPVLW,0
4ky0,C,17,33,16,ILWGLVLGAVFGLIAG,0
4ky0,C,41,65,24,KTYIKPFGDLFVRLLKMLVMPIVL,0
4ky0,C,66,84,18,SLVVGAASISPARLGRVG,0
4ky0,C,85,109,24,KIVVYYLATSAMAVFFGLIVGRLF,0
4ky0,C,130,140,10,SLVQTLLNIV,0
4ky0,C,141,150,9,TNPFASLAK,0
4ky0,C,151,160,9,EVLPVIFFA,0
4ky0,C,161,175,14,ILGIAITYLMNRNE,0
4ky0,C,176,203,27,RVRKSAETLLRVFDGLAEAMYLIVGGV,0
4ky0,C,204,223,19,QYAPIGVFALIAYVMAEQG,0
4ky0,C,234,253,19,GAVYTGLFLQIVITYFILL,0
4ky0,C,254,259,5,VFGID,0
4ky0,C,260,267,7,IKFIRKA,0
4ky0,C,268,288,20,DAMITAFVTRSSSGTLPVTM,0
4ky0,C,289,304,15,VAEEEMGVDKGIFSF,0
4ky0,C,305,323,18,LPLGATINMDGTALYQGV,0
4ky0,C,338,345,7,GQQLVVV,0
4ky0,C,346,362,16,TAVLASIGTAGVPGAG,0
4ky0,C,395,413,18,ILDMGRTMVNVTGDLAGT,0
4ky0,C,414,431,17,IVAKTEKELDESKWISH,0
2j58,H,346,354,8,LVRWNRVI,0
2j58,H,355,374,19,QLVPTISGVHDMTETVRYI,0
2j58,H,375,376,1,R,0
2j58,H,377,379,2,PN,0
4ia4,D,1,26,25,SKEVSEEAQAHQHGKDYVDPPPAPF,0
4ia4,D,41,58,17,IAEFIATLLFLYITVAT,0
4ia4,D,59,75,16,IGHSKETVVCGSVGLL,0
4ia4,D,76,93,17,IAWAFGGMIFVLVYCTA,0
4ia4,D,97,110,13,GHINPAVTFGLFL,0
4ia4,D,120,137,17,VYMIAQCLGAICGVGLV,0
4ia4,D,138,141,3,AFM,0
4ia4,D,142,148,6,GPYNQF,0
4ia4,D,149,162,13,GGANSVALGYNKG,0
4ia4,D,163,182,19,ALGAEIIGTFVLVYTVFSA,0
4ia4,D,198,214,16,PLPIGFAVFMVHLATI,0
4ia4,D,215,218,3,ITG,0
4ia4,D,219,232,13,GINPARSFGAAVI,0
4ia4,D,233,242,9,NSNKVWDDQ,0
4ia4,D,243,260,17,IFWVGPFIGAAVAAAYH,0
4ia4,D,265,281,16,AAAIKALGSFRSNPTN,0
2vr0,F,1,13,12,SEEKSRNGPARL,0
2vr0,F,14,17,3,LVL,0
2vr0,F,18,31,13,GATLGVVALATVA,0
2vr0,F,75,93,18,LAKLPFKAIAGARDVYMN,0
3i5d,C,26,33,7,SSKKVGT,0
3i5d,C,39,55,16,ALVIAYVIGYVCVYNK,0
3i5d,C,56,330,274,YQDTDTVLSSVTTKVKGIALTNTSELGERIWDVADYIIPPQEDGSFFVLTNMIITTNQTQSKCAENPTPASTCTSHRDCKRGFNDARGDGVRTGRCVSYSASVKTCEVLSWCPLEKIVDPPNPPLLADAENFTVLIKNNIRYPKFNFNKRNILPNINSSYLTHCVFSRKTDPDCPIFRLGDIVGEAEEDFQIMAVRGGVMGVQIRWDCDLDMPQSWCVPRYTFRRLDNKDPDNNVAPGYNFRFAKYYKNSDGTETRTLIKGYGIRFDVMVFGQA,0
3i5d,C,331,352,21,KFNIIPTLLNIGAGLALLGLV,0
3i5d,C,359,381,22,VLTFMKRKQHYKEQKYTYVDDF,0
3n2f,G,31,47,16,IFAALAFIVGLIIILS,0
5hxh,A,1,7,6,VILGVG,0
5hxh,A,8,27,19,FLLGLILLYYGSDWFVLGS,0
5hxh,A,42,56,14,ATVMAIGTSLPEIL,0
5hxh,A,57,74,17,SAYASYMHAPGISIGNA,0
5hxh,A,75,93,18,GSCICNIGLVLGLSAIIS,0
5hxh,A,105,120,15,LVYLLFVIFAAVIGI,0
5hxh,A,121,126,5,GFSWI,0
5hxh,A,127,142,15,GVVLLILFIIYLRWT,0
5hxh,A,166,182,16,LLIIGLIGVLVGAELF,0
5hxh,A,183,207,24,DGAKKIALALDISDKVIGFTLVAF,0
5hxh,A,208,222,14,TSLPELMVSLAAAK,0
5hxh,A,229,247,18,LGNVIGSNIADIGGALAV,0
5hxh,A,248,258,10,SLFMHLPAEN,0
5hxh,A,259,275,16,QMAVLVIMSLLLYLFA,0
5hxh,A,281,296,15,RWQGILFLALYIIAI,0
5hxh,A,297,300,3,SLR,0
4x8a,F,126,129,3,SHM,0
4x8a,F,136,152,16,LLTVVFYIAAVMATNL,0
4x8a,F,153,163,10,GATFPEWFGD,0
4x8a,F,164,181,17,SKSLYTLFQVMTLESWS,0
4x8a,F,182,194,12,GIVRPVMNVHPN,0
4x8a,F,195,211,16,WVFFIPFIMLTTFTVL,0
4x8a,F,225,274,49,KEQEEEAKTGHHQEPISQTLLHLGDRLDRIEKQLAQNNELLQRQQPQKK,0
5eg1,B,5,15,10,KNSLFNYIYS,0
5eg1,B,16,22,6,MDVRGK,0
5eg1,B,23,46,23,LFFSMLFITSLSSIIISISPLIL,0
5eg1,B,70,93,23,LYMFCVISNKASVFLFMILQSSL,0
5eg1,B,94,138,44,INMQKKMSLKYLRELYNENITNLSKNNAGYTTQSLNQASNDIYI,0
5eg1,B,139,163,24,VRNVSQNILSPVIQLISTIVVVLS,0
5eg1,B,168,191,23,SAGVFFLYILVFVIFNTRLTGSL,0
5eg1,B,192,247,55,SLRKHSMDITLNSYSLLSDTVDNMIAAKKNNALRLISERYEDALTQENNAQKKYW,0
5eg1,B,248,270,22,LSSKVLLLNSLLAVILFGSVFI,0
5eg1,B,288,311,23,ITSYIILLSTPVENIGALLSEIR,0
5eg1,B,312,579,267,SMSSLAGFIQRHAENKATSPSIPFLNMERKLNLSIRELSFSYSDDKKILNSVSLDLFTGKMYSLTGPSGSGKSTLVKIISGYYKNYFGDIYLNDISLRNISDEDLNDAIYYLTQDDYIFMDTLRFNLRLANYDASENEIFKVLKLANLSVVNNEPVSLDTHLINRGNNYSGGQKQRISLARLFLRKPAIIIIDEATSALDYINESEILSSIRTHFPDALIINISHRINLLECSDCVYVLNEGNIVASGHFRDLMVSNEYISGLASVT,0
2iqn,A,61,85,24,ITAVYSVVFVVGLVGNSLVMFVII,0
2iqn,A,86,95,9,YTKMKTATN,0
2iqn,A,96,117,21,YIFNLALADALVTTTMPFQST,0
2iqn,A,130,154,24,CKIVISIDYYNMFTSIFTLTMMSV,0
2iqn,A,155,175,20,RYIAVCHPVKALDFRTPLKA,0
2iqn,A,176,198,22,IINICIWLLSSSVGISAIVLGG,0
2iqn,A,225,247,22,MKICVFIFAFVIPVLIIIVCYT,0
2iqn,A,248,275,27,MILRLKSVRLLSGSREKDRNLRRITRL,0
2iqn,A,276,299,23,LVVVAVFVVCWTPIHIFILVEAL,0
2iqn,A,312,333,21,YFCIALGYTNSSLNPILYAFL,0
2iqn,A,335,345,10,NFKRCFRDFC,0
2iqn,A,346,348,2,PL,0
3qe7,B,1,3,2,TR,0
3qe7,B,23,37,14,HLFAMFGATVLVPV,0
3qe7,B,38,42,4,FHIN,0
3qe7,B,43,57,14,ATVLLFNGIGTLLY,0
3qe7,B,67,76,9,YLGSSFAFI,0
3qe7,B,77,93,16,PVLLLLPLGYEVALGG,0
3qe7,B,94,111,17,IMCGVLFCLVSFIVKKA,0
3qe7,B,114,119,5,WLDVL,0
3qe7,B,124,141,17,MGAIVAVIGLELAGVAA,0
3qe7,B,142,158,16,MAGLLPAEGQTPDSKT,0
3qe7,B,159,175,16,IISITTLAVTVLGSVL,0
3qe7,B,183,203,20,PILIGVLVGYALSFAMGIVD,0
3qe7,B,204,232,28,TPIINAHWFALPTLYTPRFEWFAILTIL,0
3qe7,B,233,246,13,AALVVIAEHVGHL,0
3qe7,B,264,280,16,RSMFANGLSTVISGFF,0
3qe7,B,282,291,9,TPNTTYGEN,0
3qe7,B,310,330,20,IFAILLSCVGKLAAAIQMIP,0
3qe7,B,332,350,18,VMGGVSLLLYGVIGASGI,0
3qe7,B,367,382,15,LTSVILIIGVSGAKV,0
3qe7,B,383,389,6,IGAAEL,0
3qe7,B,390,408,18,GMALATIVGIGLSLIFKL,0
3qe7,B,411,429,18,LRPEEVVLDAEDADITDK,0
4xou,A,1,54,53,EAAHSKSTEECLAYFGVSETTGLTPDQVKRHLEKYGHNELPAEEGKSLWELVI,0
4xou,A,55,78,23,QFEDLLVRILLLAACISFVLAWF,0
4xou,A,86,105,19,AFVEPFVILLILIANAIVG,0
4xou,A,106,256,150,WQERNAENAIEALKEYEPEMGKVYRADRKSVQRIKARDIVPGDIVEVAVGDKVPADIRILSIKSTTLRVDQSILTGESVSVIKHTEPVPDPRAVNQDKKNMLFSGTNIAAGKALGIVATTGVSTEIGKIRDQMAATEQDKTPLQQKLDEF,0
4xou,A,257,276,19,EQLSKVISLICVAVWLINI,0
4xou,A,293,313,20,YYFKIAVALAVAAIPEGLPA,0
4xou,A,314,759,445,ITTCLALGTRRMAKKNAIVRSLPSVETLGCTSVICSDKTGTLTTNQMSVCKMFIIDKVDGDFCSLNEFSITGSTYAPEGEVLKNDKPIRSGQFDGLVELATICALCNDSSLDFNETKGVYEKVGEATETALTTLVEKMNVFNTEVRNLSKVERANACNSVIRQLMKKEFTLEFSRDRKSMSVYCSPAKSSRAAVGNKMFVKGAPEGVIDRCNYVRVGTTRVPMTGPVKEKILSVIKEWGTGRDTLRCLALATRDTPPKREEMVLDDSSRFMEYETDLTFVGVVGMLDPPRKEVMGSIQLCRDAGIRVIMITGDNKGTAIAICRRIGIFGENEEVADRAYTGREFDDLPLAEQREACRRACCFARVEPSHKSKIVEYLQSYDEITAMTGDGVNDAPALKKAEIGIAMGSGTAVAKTASEMVLADDNFSTIVAAVEEGRAIYNNMKQ,0
4xou,A,760,781,21,IRYLISSNVGEVVCIFLTAAL,0
4xou,A,786,807,21,LIPVQLLWVNLVTDGLPATAL,0
4xou,A,808,832,24,FNPPDLDIMDRPPRSPKEPLISGW,0
4xou,A,833,852,19,FFRYMAIGGYVGAATVGAA,0
4xou,A,898,916,18,MALSVLVTIEMCNALNSL,0
4xou,A,917,930,13,ENQSLMRMPPWVN,0
4xou,A,931,950,19,WLLGSICLSMSLHFLILYV,0
4xou,A,952,957,5,LPMIF,0
4xou,A,964,987,23,TQWLMVLKISLPVIGLDEILKFI,0
4xou,A,988,994,6,RNYLEG,0
4mt1,C,2,10,8,KFFIDRPI,0
4mt1,C,11,24,13,AWVISIFIIAAGI,0
4mt1,C,340,355,15,TLIEAMVLVFVVMYL,0
4mt1,C,356,363,7,LQNIRYT,0
4mt1,C,364,380,16,IPTIVVPISLLGGFAF,0
4mt1,C,395,408,13,MILVIGIVVDDAI,0
4mt1,C,409,440,31,VVENVERIMAGEGLPPKEATKKAMGQISGAV,0
4mt1,C,441,454,13,GITAVLISVFVPL,0
4mt1,C,470,487,17,TMASSIAFSAFLALTLT,0
4mt1,C,488,493,5,ALCAT,0
4mt1,C,494,507,13,LKTIPKGHHEEKK,0
4mt1,C,509,533,24,FGWFNKKFDSWTHGYEGRVAKVLR,0
4mt1,C,534,538,4,TFRM,0
4mt1,C,539,553,14,VVYIGLAVVGVFLF,0
4mt1,C,671,672,1,N,0
4mt1,C,874,888,14,GLAVAAVFLVLAAL,0
4mt1,C,889,894,5,ESWSI,0
4mt1,C,895,913,18,LAVILVIPLGLIGAAAGV,0
4mt1,C,938,951,13,FVTVMGLSAKNAI,0
4mt1,C,952,982,30,IIEFAKDLQAQGKSAVEAALEAARLRFRPI,0
4mt1,C,983,998,15,MTSFAFILGVVPLYI,0
4mt1,C,1012,1029,17,TVFWGMLVGTLLSVFLV,0
4mt1,C,1030,1037,7,LFYVVVR,0
4mt1,C,1038,1040,2,FF,0
4mt1,C,1041,1056,15,ETAHEHEMAVRHASK,0
2lm2,A,10,31,21,TINLIIPCVLITSLAILVFYL,0
2lm2,A,32,36,4,SDCG,0
2lm2,A,37,58,21,KMTLCISVLLALTVFLLLISK,0
2lm2,A,69,89,20,VGEYLMFTMVLVTFSIVTSV,0
2lm2,A,90,111,21,VLNVHHRSPETHTGGGGGIDR,0
2lm2,A,112,135,23,FLWIFVFVCVFGTIGMFLQPLFQ,0
3omn,B,30,60,30,EIIGRPQPGGTGFQPSASPVATQIHWLDGF,0
3omn,B,61,78,17,LVIIAAITIFVTLLILY,0
3omn,B,100,117,17,EIAWTIVPIVILVAIGA,0
3omn,B,118,285,167,SLPVLFNQQEIPEADVTVKVTGYQWYWGYEYPDEEISFESYMIGSPATGGDNRMSPEVEQQLIEAGYSRDEFLLATDTAMVVPVNKTVVVQVTGADVIHSWTVPAFGVKQDAVPGRLAQLWFRAEREGIFFGQCSELCGISHAYMPITVKVVSEEAYAAWLEQHHHH,0
4ac5,M,54,71,17,GIAAFAFGSTAILIILF,0
4ac5,M,72,80,8,MAAEVHFD,0
4ac5,M,81,86,5,LQFFR,0
4ac5,M,87,113,26,FFWLGLYPPKAQYGMGIPPLHDGGWW,0
4ac5,M,114,132,18,MAGLFMTLSLGSWWIRVY,0
4ac5,M,144,162,18,AWNFAAAIFFVLCIGCIH,0
4ac5,M,163,178,15,TLVGSWSEGVPFGIW,0
4ac5,M,179,190,11,HIDWLTAFSIR,0
4ac5,M,191,197,6,GNFYYC,0
4ac5,M,198,219,21,WHGFSIGFAYGCGLLFAAHGA,0
4ac5,M,266,284,18,GWFFSLMVMVSASVGILL,0
4ac5,M,285,291,6,GTFVDN,0
4ac5,M,292,298,6,YLWCVK,0
4ac5,M,299,323,24,GAAPDYPAYLPATPDPASLPGAPK,0
5u6o,D,95,102,7,RQFTSML,0
5u6o,D,143,164,21,YWDLIMLIMMVGNLVIIPVGI,0
5u6o,D,165,174,9,FFTEQTTTP,0
5u6o,D,175,194,19,IIFNVASDTVFLLDLIMNF,0
5u6o,D,218,239,21,KSWFVVDFISSIPVDYIFLIV,0
5u6o,D,240,242,2,KG,0
5u6o,D,252,260,8,ALRIVRFT,0
5u6o,D,261,279,18,ILSLLRLLRLSRLIRYIH,0
5u6o,D,295,316,21,VRIFNLIGMMLLLCHWDGCLQ,0
5u6o,D,317,349,32,LVPLLQDFPPDCWVSLNEMVNDSWGKQYSYAL,0
5u6o,D,350,360,10,KAMSHMLCIG,0
5u6o,D,361,373,12,GAQAPVSMSDLW,0
5u6o,D,374,397,23,TMLSMIVGATCYAMFVGHATALI,0
3h1l,W,5,12,7,LRQAYSA,0
3h1l,W,13,18,5,FRRTS,0
3h1l,W,19,43,24,FALTVVLGAVLFERAFDQGADAIF,0
3h1l,W,63,64,1,E,0
3hfx,C,1,11,10,KNEKRKTGIE,0
3hfx,C,16,28,12,PPLIIVGILCWL,0
3hfx,C,29,32,3,VRD,0
3hfx,C,33,46,13,DAANVVINAVFSY,0
3hfx,C,47,63,16,TNVWGWAFEWYMVVML,0
3hfx,C,97,109,12,SCTSAAVLFWGS,0
3hfx,C,110,133,23,EIYYYISTPPFGLEPNSTGAKEL,0
3hfx,C,134,149,15,LAYSLFHWGPLPWAT,0
3hfx,C,195,215,20,YLVALIFAMGTSLGLATPLV,0
3hfx,C,216,232,16,ECMQWLFGIPHTLQLD,0
3hfx,C,233,246,13,IIITCWIILNAIC,0
3hfx,C,258,278,20,SDVRSYLSFLMLGWVFIVSG,0
3hfx,C,280,293,13,FIMNYFTDSVGML,0
3hfx,C,295,305,10,YLPRMLFYTD,0
3hfx,C,306,313,7,IAKGGFP,0
3hfx,C,314,328,14,GWTVFYWAWWVIYA,0
3hfx,C,356,369,13,ASTWILWTVLGSN,0
3hfx,C,370,389,19,LLLIDKNIINIPNLIEQYG,0
3hfx,C,390,399,9,ARAIIETWA,0
3hfx,C,400,406,6,LPLSTA,0
3hfx,C,407,427,20,MWGFFILCFIATVTLVNACS,0
3hfx,C,448,463,15,RIGWSILVGIIGIVL,0
3hfx,C,464,471,7,ALGGLKP,0
3hfx,C,472,486,14,QTAIIAGGCPLFFV,0
3v8g,C,1,5,4,GLYR,0
3v8g,C,16,30,14,LIGLILGAIVGLIL,0
3v8g,C,31,42,11,HYGYAHAVHTY,0
3v8g,C,43,63,20,KPFGDLFVRLLKMLVMPIVF,0
3v8g,C,86,100,14,VYYLLTSAFAVTLG,0
3v8g,C,101,117,16,IMARLFNPGAGIHLAV,0
3v8g,C,118,128,10,GQQFQPHQAP,0
3v8g,C,129,130,1,L,0
3v8g,C,131,140,9,HILLDIVPT,0
3v8g,C,141,150,9,PFGALANGQ,0
3v8g,C,151,160,9,LPTIFFAII,0
3v8g,C,202,217,15,QYAPIGVFALIAYVM,0
3v8g,C,218,235,17,EQGVHVVGELAKVTAAV,0
3v8g,C,236,250,14,VGLTLQILLVYFVL,0
3v8g,C,270,282,12,TAFVTRSSSGTL,0
3v8g,C,305,317,12,GATINMDGTALY,0
3v8g,C,318,342,24,GVATFFIANALGSHLTVGQQLTIV,0
3v8g,C,343,359,16,TAVLASIGTAGVPGAG,0
3v8g,C,360,391,31,IMLAMVLHSVGLPLTDPNVCAAYAMILGIDA,0
3v8g,C,392,405,13,LDMGRTMVNVTGD,0
3v8g,C,417,422,5,TLVPR,0
2boc,F,1,21,20,APMLSGLLARLVKLLLGRHG,0
2boc,F,26,50,24,RAAGAATVLLVIVLLAGSYLAVLA,0
2boc,F,51,62,11,RGAPGAQLITY,0
2boc,F,63,78,15,RALWWSVETATTVGY,0
2boc,F,79,86,7,DLYPVTL,0
2boc,F,87,112,25,GRCVAVVVMVAGITSFGLVTAALAT,0
1rwt,G,1,13,12,KTAGKPKTVQSS,0
1rwt,G,65,85,20,VIHCRWAMLGALGCVFPELL,0
1rwt,G,86,96,10,RNGVKFGEAV,0
1rwt,G,97,105,8,FKAGSQIF,0
1rwt,G,106,123,17,EGGLDYLGNPSLVHAQS,0
1rwt,G,124,142,18,LAIWACQVILMGAVEGYR,0
1rwt,G,180,199,19,IKNGRLAMFSMFGFFVQAI,0
1rwt,G,200,204,4,TGKG,0
1rwt,G,205,214,9,LENLADHLA,0
1rwt,G,215,231,16,PVNNNAWNFATNFVPG,0
5l7i,A,231,254,23,SYIAAFGAVTGLCTLFTLATFVA,0
5l7i,A,255,265,10,WRNSNRYPAV,0
5l7i,A,266,287,21,LFYVNACFFVGSIGWLAQFMD,0
5l7i,A,312,337,25,SCVIIFVIVYYALMAGFVWFVVLTY,0
5l7i,A,338,343,5,WHTSF,0
5l7i,A,353,359,6,SGKTSY,0
5l7i,A,360,383,23,HLLTWSLPFVLTVAILAVAQVDG,0
5l7i,A,397,420,23,RYRAGFVLAPIGLVLIVGGYFLI,0
5l7i,A,421,1057,636,GVMTLFSARRQLADLEDNWETLNDNLKVIEKADNAAQVKDALTKMRAAALDAQK,0
5l7i,A,1074,453,-621,DFRHGFDILVGQIDDALKLANEGKVKEAQAAAEQLKTTRNAYIQKYLERARSTLSKINETMLRLG,0
5l7i,A,454,476,22,FGFLAFGFVLITFSCHFYDFFN,0
5l7i,A,515,537,22,LVEKINLFAMFGTGIAMSTWVW,0
5l7i,A,538,539,1,K,0
5l7i,A,540,550,10,TLLIWRRTWC,0
2lcx,B,42,50,8,TLPQHART,0
2lcx,B,51,74,23,LIAAGVIGGLFILVIVGLTFAVY,0
2bnp,C,1,10,9,VGVTAFGNF,0
2bnp,C,16,31,15,IYSFWIFLAGLIYYL,0
2bnp,C,32,247,215,TENMREGYPLENEDGTPAANQGPFPLPKPKTFILPHGRGTLTVPGPESEDRPIALARTAVSEGFPHAPTGDPMKDGVGPASWVARRDLPELDGHGHNKIKPMKAAAGFHVSAGKNPIGLPVRGCDLEIAGKVVDIWVDIPEQMARFLEVELKDGSTRLLPMQMVKVQSNRVHVNALSSDLFAGIPTIKSPTEVTLLEEDKICGYVAGGLMYAAPK,0
2bnp,C,248,260,12,KSVVAAMLAEYA,0
4h13,P,6,26,20,YAALLSFGLIFVGWGLGVLL,0
4h13,P,27,32,5,KIQGA,0
4h13,P,33,35,2,KE,0
1brd,C,1,7,6,QITGRP,0
1brd,C,8,12,4,WIWL,0
1brd,C,13,32,19,LGTALMGLGTLYFLVKGMG,0
1brd,C,33,37,4,SDPD,0
1brd,C,43,61,18,ITTLVPAIAFTMYLSMLL,0
1brd,C,63,73,10,GLTMVPFGGE,0
1brd,C,74,80,6,NPIYWA,0
1brd,C,81,99,18,YADWLFTTPLLLLDLALL,0
1brd,C,101,105,4,ADQG,0
1brd,C,107,122,15,LALVGADGIMIGTGL,0
1brd,C,123,127,4,GALT,0
1brd,C,128,136,8,VYSYRFVW,0
1brd,C,138,154,16,ISTAAMLYILYVLFFG,0
1brd,C,158,165,7,AESMRPE,0
1brd,C,172,191,19,LRNVTVVLWSAYPVVWLIG,0
1brd,C,192,201,9,EGAGIVPLN,0
1brd,C,202,205,3,ETL,0
1brd,C,206,224,18,FMVLDVSAKVGFGLILLR,0
1brd,C,226,248,22,AIFGEAEAPEPSAGDGAAATS,0
5k2c,A,-2,5,7,GAPPIMG,0
5k2c,A,6,28,22,SVYITVELAIAVLAILGNVLVC,0
5k2c,A,45,67,22,VSLAAADIAVGVLAIPFAITIS,0
5k2c,A,68,75,7,GFCAACH,0
5k2c,A,76,97,21,CLFIACFVLVLTQSSIFSLLA,0
5k2c,A,124,144,20,IAICWVLSFAIGLTPMLGWN,0
5k2c,A,145,172,27,CGQPKEGKNHSQGCGEGQVACLFEDVV,0
5k2c,A,173,195,22,MNYMVYFNFFACVLVPLLLMLG,0
5k2c,A,237,259,22,IVGLFALCWLPLHIINCFTFFC,0
5k2c,A,260,265,5,DCSHA,0
5k2c,A,266,287,21,LWLMYLAIVLSHTNSVVNPFI,0
5k2c,A,293,306,13,EFRQTFRKIIRSH,0
5l4e,E,5,198,193,SPPPPIADEPLTVNTGIYLIESYSLDDCAETFKVNAFLSLSWKDRRLAFDPVRSGVRVKTYEPEAIWIPEIRFVNVENARDADVVDISVSPDGTVQYLERFSARVLSPLDFRRYPFDSQTLHIYLIVRSVDTRNIVLAVDLEKVGKNDDVFLTGWDIESFTAVVKPANFALEDRLESKLDYQLRISRQYFSYI,0
5l4e,E,199,218,19,NIILPMLFILFISWTAFWS,0
5l4e,E,222,242,20,ANVTLVVSTLIAHIAFNILV,0
5l4e,E,243,255,12,TNCPKTPYMTYT,0
5l4e,E,256,275,19,AIIFMIYLFYFVAVIEVTV,0
5l4e,E,292,313,21,RASRIAFPVVFLLANIILAFL,0
5l4e,E,314,315,1,F,0
5u9w,C,4,7,3,HSL,0
5u9w,C,8,22,14,GMAVLIAIAVLLST,0
5u9w,C,28,43,15,IRTVAGAFLIQVALG,0
5u9w,C,44,52,8,LVLYVPQG,0
5u9w,C,53,78,25,DMLGEASKTISNVIAYGNNGVDFLF,0
5u9w,C,79,102,23,GLVSEKMFEVFGGGGFVFALRVL,0
5u9w,C,103,138,35,MIVFFSSLMAVLYYIGVMQLLIKVIGGFLQKMLGT,0
5u9w,C,141,162,21,ESMSAAALIFVGQTEAPLVVR,0
5u9w,C,173,187,14,FAVMSGGLASVAGS,0
5u9w,C,188,206,18,LAGYVQMGVPLPYLIAAS,0
5u9w,C,207,222,15,MAAPGGLLFAKLLVP,0
5u9w,C,242,270,28,TNVIDAAASGAVTGAQIAIAVGASLLAF,0
5u9w,C,271,285,14,ALIAMINGIIGGVG,0
5u9w,C,286,294,8,WFGHGDLT,0
5u9w,C,295,303,8,QAILGWLF,0
5u9w,C,304,365,61,PLAWVIGVPWSEAGIAGSLIGQKVVINEFVAYSEFVKYLKPEAAVQLSDTTKAIISFALCG,0
5u9w,C,366,382,16,ANLGSIAVLVGGLSIM,0
5u9w,C,391,408,17,RLGIKAVVAGSLSNLMS,0
5u9w,C,409,418,9,VIAGLFTGL,0
5g28,A,15,38,23,EFIDHLLTMGVGVHFAALIFFLV,0
5g28,A,39,50,11,SQFVAPKYRIA,0
5g28,A,51,74,23,ALSCIVMVSAGLILNSQAVMWTD,0
5g28,A,91,111,20,NGYRYVNWMATIPCLLLQLL,0
5g28,A,112,122,10,VLNLKGKELF,0
5g28,A,123,146,23,TATWLILAAWGMIITGYVGQLYE,0
5g28,A,153,176,23,MIWGAVSTAFFVVMNWIVGTKIF,0
5g28,A,177,190,13,NRATMLGGTDSTI,0
5g28,A,191,213,22,KVFWLMMFAWTLYPIAYLVPAF,0
5g28,A,220,243,23,VLRQLLFTIADISSKVIYGLMIT,0
5g28,A,244,265,21,IAIQQSAAAGYVPAQQALGRI,0
1u19,A,39,64,25,AAYMFLLIMLGFPINFLTLYVTVQH,0
1u19,A,65,71,6,KLRTPL,0
1u19,A,72,98,26,YILLNLAVADLFMVFGGFTTTLYTSL,0
1u19,A,109,135,26,NLEGFFATLGGEIALWSLVVLAIERY,0
1u19,A,136,151,15,VVCKPMSNFRFGENH,0
1u19,A,152,176,24,IMGVAFTWVMALACAAPPLVGWSR,0
1u19,A,200,225,25,SFVIYMFVVHFIIPLIVIFFCYGQL,0
1u19,A,226,251,25,FTVKEAAAQQQESATTQKAEKEVTR,0
1u19,A,252,277,25,VIIMVIAFLICWLPYAGVAFYIFTH,0
1u19,A,288,309,21,IPAFFAKTSAVYNPVIYIMMN,0
1u19,A,311,321,10,FRNCMVTTLC,0
1u19,A,322,348,26,GKNPLGDDEASTTVSKTETSQVAPA,0
2ltq,A,1,9,8,LRFLNQAS,0
2ltq,A,10,13,3,GRG,0
2ltq,A,14,28,14,WLLMAFTALALELT,0
2ltq,A,49,63,14,ALFGVLGAALIGAI,0
2ltq,A,64,72,8,PKTPLRYV,0
2ltq,A,73,86,13,MVIWLYSAFRGVQ,0
2ltq,A,109,113,4,FPEW,0
2ltq,A,147,162,15,GIFIAYLIVAVLVVI,0
2ltq,A,163,176,13,QPFKAKKRDLFGR,0
3s3d,C,2,4,2,EK,0
3s3d,C,5,25,20,KGALAVILVLTLTILVFWLG,0
4zow,A,10,20,10,LGRQALLFPL,0
4zow,A,21,40,19,LVLYEFSTYIGNDMIQPGM,0
4zow,A,55,72,17,TSMTAYLAGGMFLQWLL,0
4zow,A,73,83,10,PLSDRIGRRP,0
4zow,A,84,102,18,MLAGVVWFIVTCLAILLA,0
4zow,A,108,126,18,TLLRFLQGISLCFIGAVG,0
4zow,A,127,144,17,AAIRESFEEAVCIKITA,0
4zow,A,145,164,19,MANVALIAPLLGPLVGAAW,0
4zow,A,171,189,18,GMFVLFAALAAISFFGLQ,0
4zow,A,190,204,14,AMPETATRIGEKLS,0
4zow,A,205,215,10,KELGRDYKLV,0
4zow,A,216,221,5,KNGRF,0
4zow,A,222,242,20,AGALALGFVSLPLLAWIAQS,0
4zow,A,258,276,18,LLQVPIFGALIAGNLLLA,0
4zow,A,277,287,10,LTSRRTVRSL,0
4zow,A,288,305,17,IMGGWPIMIGLLVAAAA,0
4zow,A,315,335,20,MTAGLSIYAFGIGLANAGLV,0
4zow,A,336,350,14,LTLFASDMSKGTVS,0
4zow,A,351,369,18,AMGMLQMLIFTVGIEISK,0
4zow,A,380,398,18,NLFNLVNGILWLSLMVIF,0
4zow,A,399,400,1,K,0
4zll,C,1,10,9,PNFFIDRPI,0
4zll,C,11,25,14,AWVIAIIIMLAGGL,0
4zll,C,342,357,15,TLVEAIILVFLVMYL,0
4zll,C,358,365,7,LQNFRAT,0
4zll,C,366,383,17,IPTIAVPVVLLGTFAVL,0
4zll,C,398,411,13,VLAIGLLVDDAIV,0
4zll,C,412,441,29,VENVERVMAEEGLPPKEATRKSMGQIQGA,0
4zll,C,442,456,14,VGIAMVLSAVFVPM,0
4zll,C,471,489,18,ITIVSAMALSVLVALILT,0
4zll,C,490,511,21,ALCATMLKPIAKGDHGEGKKG,0
4zll,C,512,535,23,FGWFNRMFEKSTHHYTDSVGGIL,0
4zll,C,536,541,5,STGRY,0
4zll,C,542,556,14,VLYLIIVVGMAYLF,0
4zll,C,875,891,16,LYAISLIVVFLCLAAL,0
4zll,C,892,898,6,ESWSIP,0
4zll,C,899,916,17,SVMLVVPLGVIGALLAA,0
4zll,C,928,943,15,VGLLTTIGLSAKNAI,0
4zll,C,944,975,31,IVEFAKDLMDKEGKGLIEATLDAVRMRLRPI,0
4zll,C,976,991,15,MTSLAFILGVMPLVI,0
4zll,C,1004,1019,15,TGVMGGMVTATVLAI,0
4zll,C,1020,1032,12,FVPVFFVVVRRR,0
4zll,C,1033,1034,1,S,0
4mme,B,1,4,3,EVK,0
4mme,B,14,32,18,ILAMAGYAVDLGNFLRFP,0
4mme,B,33,41,8,QAAENGGG,0
4mme,B,42,63,21,FMIPYIIAFLLVGIPLMWIEW,0
4mme,B,90,124,34,KILGVFGLWIPLVVAIYYVYIESWTLGFAIKFLV,0
4mme,B,125,131,6,LVPEPP,0
4mme,B,132,134,2,,0
4mme,B,135,166,31,DPDSILRPFKEFLYSYIGVPKGDEPILKPSL,0
4mme,B,167,184,17,AYIVFLITMFINVSILI,0
4mme,B,191,214,23,ERFAKIAMPTLFILAVFLVIRVF,0
4mme,B,215,222,7,LETPNGT,0
4mme,B,223,231,8,ADGLNFLW,0
4mme,B,232,241,9,PDFEKLKDP,0
4mme,B,242,265,23,VWIAAVGQIFFSLGLGFGAIITF,0
4mme,B,279,298,19,LTAATLNEKAEVILGGSIS,0
4mme,B,299,318,19,PAAVAFFGVANAVAIAKAG,0
4mme,B,319,324,5,FNLGF,0
4mme,B,326,331,5,LPAIF,0
4mme,B,332,339,7,QTAGGTF,0
4mme,B,340,366,26,GFLWFFLLFFAGLTSSIAGMQPMIAF,0
4mme,B,378,396,18,VLWTAAIVFFSAHLVMFL,0
4mme,B,397,399,2,KS,0
4mme,B,400,425,25,DEMDFWAGTIGVVFFGLTELIIFFW,0
4mme,B,429,437,8,DKAWEEIN,0
4mme,B,448,472,24,YYVMRYITPAFLAVLLVVWAREYI,0
4mme,B,473,483,10,KIMEETHWTV,0
4mme,B,484,501,17,ITRFYIIGLFLFLTFLV,0
4mme,B,512,519,7,AGTLVPR,0
4z91,E,206,225,19,SFILPLGLIIAASWSVFWL,0
4z91,E,226,229,3,SFS,0
4z91,E,230,249,19,RLQTSFTLMLTVVAYAFYT,0
4z91,E,262,282,20,DQMIIAGYGSIFAAILLIIF,0
4z91,E,283,297,14,HHRQANGVEDDLLI,0
4z91,E,298,317,19,RCRLAFPLGFLAIGCVLVI,0
4d2d,A,1,5,4,EDKG,0
4d2d,A,6,15,9,TFFGQPLGL,0
4d2d,A,16,37,21,TLFMTEMWERFSYYGMRAILL,0
4d2d,A,57,78,21,SIMAIYASMVYLSGTIGGFVA,0
4d2d,A,79,84,5,RIIGA,0
4d2d,A,85,104,19,PAVFWGGVLIMLGHIVLAL,0
4d2d,A,110,130,20,LFGSIILIIIGTGFLKPNVS,0
4d2d,A,131,148,17,LVGTLYDEHDRRRDAGF,0
4d2d,A,149,169,20,IFVFGINLGAFIAPLIVGAA,0
4d2d,A,177,197,20,AFSLAAIGMFIGLLVYYFGG,0
4d2d,A,198,219,21,KTLDPHYLRPTDPLAPEEVKP,0
4d2d,A,220,241,21,LVKVSLAVAGFIAIIVVMNLV,0
4d2d,A,247,267,20,AYINLLTIVAIAIPVFYFAW,0
4d2d,A,268,271,3,ISS,0
4d2d,A,272,275,3,KVT,0
4d2d,A,276,282,6,TEHLRV,0
4d2d,A,283,307,24,SYIPLFIAAVLFWAIEEQGSVVLA,0
4d2d,A,322,340,18,WFQSLNPLFIMLYTPFFA,0
4d2d,A,341,353,12,LWTAWKKNQPSS,0
4d2d,A,354,373,19,TKFAVGLMFAGLSFLLMAI,0
4d2d,A,386,408,22,LWLVGSWALVILGEMLISPVGL,0
4d2d,A,409,413,4,VTTK,0
4d2d,A,414,419,5,APKAF,0
4d2d,A,420,424,4,SQMM,0
4d2d,A,425,442,17,MWFLSSSVGSALNAQLV,0
4d2d,A,453,472,19,FSYFGLGSVVLGIVLVFLS,0
4d2d,A,473,478,5,RIQGL,0
4d2d,A,479,491,12,QGVEGSENLYFQ,0
2ksd,A,1,14,13,KQIRLLAQYYVDL,0
2ksd,A,15,23,8,MKLGLVRF,0
2ksd,A,24,47,23,MLLALALVVLAIVVQMAVTMVLH,0
2ksd,A,56,79,23,RSIFFGLLITPWAVYFLSVVVEQ,0
2ksd,A,80,89,9,EESRQRLSR,0
2ksd,A,90,115,25,VQKLEEMRERDLSLNVQLKDNIAQL,0
2ycw,A,31,32,1,G,0
2ycw,A,33,41,8,ELLSQQWE,0
2ycw,A,42,63,21,GMSLLMALVVLLIVAGNVLVI,0
2ycw,A,80,103,23,TSLACADLVVGLLVVPFGATLVV,0
2ycw,A,104,107,3,GTW,0
2ycw,A,108,136,28,WGSFLCELWTSLDVLCVTASIETLCVIA,0
2ycw,A,163,183,20,TVWAISALVSFLPIMMHWWR,0
2ycw,A,184,186,2,ED,0
2ycw,A,187,194,7,QALKCYQ,0
2ycw,A,195,199,4,PGCC,0
2ycw,A,200,228,28,FVTNRAYAIASSIISFYIPLLIMIFVAL,0
2ycw,A,292,315,23,GIIMGVFTLCWLPFFLVNIVNVF,0
2ycw,A,316,323,7,RDLVPDW,0
2ycw,A,324,345,21,FVAFNWLGYANSAMNPIIYCR,0
2ycw,A,347,357,10,DFRKAFKRLL,0
2ycw,A,360,373,13,RKADRRLHHHHHH,0
5idf,D,-7,3,10,DYKDDDDKFP,0
5idf,D,306,307,1,G,0
5idf,D,381,395,14,DQQISNDSSSSENR,0
5idf,D,507,507,0,PQKSK,0
5idf,D,529,542,13,CIVFAYIGVSVVL,0
5idf,D,543,546,3,LVS,0
5idf,D,547,596,49,FSPYEWHLEDNNEEPRDPQSPPDPPNEFGIFNSLWFSLGAFMQQGCDIS,0
5idf,D,597,600,3,RSL,0
5idf,D,601,615,14,GRIVGGVWWFFTLI,0
5idf,D,634,635,1,S,0
5idf,D,778,786,8,AKDSGSKD,0
5idf,D,799,813,14,FYILVGGLGLAMMV,0
5idf,D,814,821,7,LIEFCYK,0
5idf,D,822,866,44,RAESKRMKLTKNTQNFKPAPATNTQNYATYREGYNVYGTESVKI,0
4fpd,C,-12,4,16,LELLPTAVEGVSQAQI,0
4fpd,C,5,10,5,GRPEW,0
4fpd,C,11,32,21,WLALGTALMGLGTLYFLVKGM,0
4fpd,C,42,62,20,YAITTLVPAIAFTMYLSMLL,0
4fpd,C,63,79,16,YGLTMVPFGGEQNPIY,0
4fpd,C,80,98,18,ARYADWLFTTPLLLLGLA,0
4fpd,C,107,127,20,ILALVGADGIMIGTGLVGAL,0
4fpd,C,128,133,5,KVYSY,0
4fpd,C,134,156,22,FVWWAISTAAMLYILYVLFFGF,0
4fpd,C,173,192,19,LRNVTVVLWSAYPVVWLIG,0
4fpd,C,193,203,10,EGAGIVPLNI,0
4fpd,C,204,225,21,TLLFMVLDVSAKVGLGLILLR,0
4fpd,C,230,249,19,GEAEAPEPSAGDGAAATSD,0
1ldf,D,1,5,4,SQTS,0
1ldf,D,11,28,17,IAEFLGTGLLIFFGVGC,0
1ldf,D,29,42,13,AALKVAGASFGQW,0
1ldf,D,43,60,17,ISVIFGLGVAMAIYLTA,0
1ldf,D,64,77,13,AHLNPAVTIALWL,0
1ldf,D,86,104,18,IPFIVSQVAGAFCAAALV,0
1ldf,D,105,149,44,GLYYNLFFDFEQTHHIVRGSVESVDLAGTFSTYPNPHINFVQAF,0
1ldf,D,150,166,16,VEMVITAILMGLILAL,0
1ldf,D,179,195,16,PLLIGLLIAVIGASMG,0
1ldf,D,196,199,3,LTG,0
1ldf,D,200,213,13,AMNPARDFGPKVF,0
1ldf,D,214,233,19,WLAGWGNVAFTGGRDIPYF,0
1ldf,D,234,255,21,VPLFGPIVGAIVGAFAYRKLI,0
1ldf,D,260,281,21,CDICVVEEKETTTPSEQKASL,0
5i1m,V,383,408,25,NKFTAGFQSICDCYGIAQYREINAG,0
5i1m,V,409,424,15,PTIVTFPFMFAIMFG,0
5i1m,V,427,443,16,HGFLMTLAALSLVLNE,0
5i1m,V,444,460,16,KINKMKRGEIFDMAFT,0
5i1m,V,461,480,19,RYIILLMGVFSMYTGFLYN,0
5i1m,V,539,557,18,SILMGFIHMTYSYFFSLA,0
5i1m,V,558,570,12,HLYFNSMIDIIG,0
5i1m,V,571,591,20,FIPGLLFMQGIFGYLSVCIV,0
5i1m,V,635,650,15,FLLLMALVCIPWLLL,0
5i1m,V,651,717,66,KPLHFKFTHKKKSHEPLPSTEADASSEDLEAQQLISAMDADDAEEEEVGSGSHGEDFGDIMIHQVI,0
5i1m,V,718,744,26,TIEFCLNCVSHTASYLRLWALSLAHA,0
5i1m,V,779,808,29,LTCAVLVLMEGTSAMLHSLRLHWVESMSK,0
5i1m,V,809,840,31,FVGEGLPYEPFAFEYKDMEVAVASASSSASS,0
3c9l,A,39,64,25,LAAYMFLLIMLGFPINFLTLYVTVQ,0
3c9l,A,65,71,6,KKLRTP,0
3c9l,A,72,96,24,NYILLNLAVADLFMVFGGFTTTLY,0
3c9l,A,110,136,26,NLEGFFATLGGEIALWSLVVLAIERY,0
3c9l,A,137,151,14,VVCKPMSNFRFGEN,0
3c9l,A,152,173,21,AIMGVAFTWVMALACAAPPLV,0
3c9l,A,203,228,25,VIYMFVVHFIIPLIVIFFCYGQLVF,0
3c9l,A,229,250,21,VKEAAAQQQESATTQKAEKEV,0
3c9l,A,251,274,23,RMVIIMVIAFLICWLPYAGVAFY,0
3c9l,A,289,310,21,IPAFFAKTSAVYNPVIYIMMN,0
3c9l,A,311,322,11,QFRNCMVTTLC,0
3c9l,A,323,326,3,GKN,0
3c9l,A,327,329,2,LG,0
3c9l,A,330,331,1,D,0
3c9l,A,332,348,16,ASTTVSKTETSQVAPA,0
4djh,B,38,54,16,GTTMGSEDAQLEPAHI,0
4djh,B,58,85,27,PVIITAVYSVVFVVGLVGNSLVMFVII,0
4djh,B,86,94,8,YTKMKTAT,0
4djh,B,95,116,21,IYIFNLALADALVTTTMPFQS,0
4djh,B,133,155,22,VLSIDYYNMFTSIFTLTMMSVD,0
4djh,B,156,162,6,YIAVCH,0
4djh,B,163,169,6,VKALDF,0
4djh,B,170,174,4,TPLK,0
4djh,B,175,195,20,KIINICIWLLSSSVGISAIV,0
4djh,B,226,247,21,KICVFIFAFVIPVLIIIVCYT,0
4djh,B,248,261,13,MILRLKSVRLLSG,0
4djh,B,1002,1161,159,IFEMLRIDEGLRLKIYKDTEGYYTIGIGHLLTKSPSLNAAKSELDKAIGRNTNGVITKDEAEKLFNQDVDAAVRGILRNAKLKPVYDSLDAVRRAALINMVFQMGETGVAGFTNSLRMLQQKRWDEAAVNLAKSRWYNQTPNRAKRVITTFRTGTWDAY,0
4djh,B,263,275,12,EKDRNLRRITRL,0
4djh,B,276,296,20,LVVVAVFVVCWTPIHIFILV,0
4djh,B,301,304,3,TSH,0
4djh,B,312,333,21,YFCIALGYTNSSLNPILYAFL,0
4djh,B,335,345,10,NFKRCFRDFC,0
4djh,B,346,347,1,P,0
4djh,B,348,358,10,KMRMERQSTS,0
4dkl,B,52,64,12,SHSLCPQTGSPS,0
4dkl,B,65,66,1,V,0
4dkl,B,67,95,28,AITIMALYSIVCVVGLFGNFLVMYVIVR,0
4dkl,B,101,125,24,ATNIYIFNLALADALATSTLPFQS,0
4dkl,B,126,142,16,NYLMGTWPFGNILCKI,0
4dkl,B,143,167,24,ISIDYYNMFTSIFTLCTMSVDRYI,0
4dkl,B,172,178,6,VKALDF,0
4dkl,B,182,203,21,NAKIVNVCNWILSSAIGLPVM,0
4dkl,B,204,232,28,MATTKYRQGSIDCTLTFSHPTWYWENLL,0
4dkl,B,233,255,22,ICVFIFAFIMPVLIITVCYGLM,0
4dkl,B,280,302,22,MVLVVVAVFIVCWTPIHIYVII,0
4dkl,B,303,316,13,ALITIPETTFQTV,0
4dkl,B,317,339,22,WHFCIALGYTNSCLNPVLYAFL,0
4dkl,B,341,351,10,NFKRCFREFC,0
4dkl,B,353,361,8,TSSTIEQP,0
4j05,A,-1,29,30,PMLADLDHFGKNYKHDEEAQRNQKPWMLTW,0
4j05,A,30,39,9,QIKLVLLAG,0
4j05,A,40,59,19,GFFLDAYDLFIINQVAPML,0
4j05,A,73,95,22,QDLMKAAANIGCVVGQVMFGVL,0
4j05,A,96,106,10,DSFGRKFVYG,0
4j05,A,107,123,16,ELILIIVATIFQMSAP,0
4j05,A,132,151,19,TWITICRVFLGIGIGGDYP,0
4j05,A,152,174,22,SATVVSDRANIHRRGTLLCFIF,0
4j05,A,175,195,20,NQGWGSFVGSLVTIVTISGF,0
4j05,A,209,227,18,AWRILIGLSLIPAFGTLY,0
4j05,A,228,229,1,R,0
4j05,A,230,296,66,TLPESRKFELTRDAASSSTVAIDKKDHDATHEVKDAPESEKSSPKVTPADAIDDDRHGVIASKKAH,0
4j05,A,297,314,17,QEFVAYFSTWNHFRNLL,0
4j05,A,315,340,25,SMLGWFLVDIAFYGINLNQSVVLAQ,0
4j05,A,355,376,21,QLATGNIIVTALGFLPGYYFT,0
4j05,A,377,388,11,FLIDIVGRKKL,0
4j05,A,389,407,18,FMGFIMSGLFLAILAGEI,0
4j05,A,412,435,23,GPLLACFTFMQFFFNFGANTTTF,0
4j05,A,436,452,16,VAAELFPTRIRASAHG,0
4j05,A,453,473,20,SAAAGKCGAILSSLVFNQLK,0
4j05,A,479,497,18,AVLWIFFSTCILGFISTF,0
4j05,A,498,518,20,IDETMGVDPDEKDLEERRAR,0
4j05,A,519,528,9,EIPGGLVPR,0
4tnk,z,1,2,1,T,0
4tnk,z,3,20,17,LFQLALAALVILSFVMV,0
4tnk,z,44,57,13,GLWIALVLVVGVL,0
4tnk,z,58,62,4,FFVV,0
4tnj,z,1,2,1,T,0
4tnj,z,3,20,17,LFQLALAALVILSFVMV,0
4tnj,z,44,57,13,GLWIALVLVVGVL,0
4tnj,z,58,62,4,FFVV,0
5lzr,B,7,27,20,FLIPLVALGFAAANFAAVVR,0
5lzr,B,28,46,18,PEGTERMKEISSYIRSGA,0
5lzr,B,47,69,22,SFLAHETKAIFKVAIVIAILLM,0
5lzr,B,78,98,20,AFLLGAVMSASAGIVGMKMA,0
5lzr,B,99,113,14,RANVRVAEAARTTK,0
5lzr,B,115,120,5,GPALK,0
5lzr,B,121,144,23,AYQGGSVMGLSVGGFALLGLVLV,0
5lzr,B,177,198,21,GYALGCSIIAMFDRVGGGVYT,0
5lzr,B,199,208,9,AADMAADLV,0
5lzr,B,221,233,12,NPATIADNVGDN,0
5lzr,B,234,254,20,GDVAGLGADLLESFVGAIVS,0
5lzr,B,292,314,22,FALVGLGCSMLGILYVIVKKPS,0
5lzr,B,315,317,2,NP,0
5lzr,B,318,336,18,RELNISLWTSALLTVVLT,0
5lzr,B,365,385,20,AIIGIFSGILIGFWAEYYTS,0
5lzr,B,386,409,23,RYKPTQFLGKSSIEGTGMVISNG,0
5lzr,B,410,431,21,SLGMKSVFPPTLTLVLGILFA,0
5lzr,B,441,463,22,IAALGMLSFVATSVSVDSYGPI,0
5lzr,B,464,491,27,DNAGGISEMCELDPEVRKITDHLDAVG,0
5lzr,B,492,514,22,TTAAIGKGFAIGSAIFAALSLF,0
5lzr,B,544,566,22,IAGALLGAAITYYFSGYLISAV,0
5lzr,B,567,583,16,KAAMKMVDEIRRQARE,0
5lzr,B,599,604,5,IEITS,0
5lzr,B,605,629,24,NALKQMGYPAFIAILTPLVTGFLL,0
5lzr,B,634,658,24,GGVLIGTVLSGAMLAILTANSGGA,0
5lzr,B,659,693,34,DNAKKYLEAGNLEGYGKGSEPHKALVIGDTVGDP,0
5lzr,B,694,716,22,KDTVGPSLDILIKIMSVVSVIA,0
5lzr,B,717,723,6,SIFKHV,0
3c9m,A,39,64,25,LAAYMFLLIMLGFPINFLTLYVTVQ,0
3c9m,A,65,71,6,KKLRTP,0
3c9m,A,72,96,24,NYILLNLAVADLFMVFGGFTTTLY,0
3c9m,A,110,136,26,NLEGFFATLGGEIALWSLVVLAIERY,0
3c9m,A,137,151,14,VVCKPMSNFRFGEN,0
3c9m,A,152,176,24,AIMGVAFTWVMALACAAPPLVGWS,0
3c9m,A,202,226,24,FVIYMFVVHFIIPLIVIFFCYGQL,0
3c9m,A,227,251,24,FTVKEAAAQQQESATTQKAEKEVT,0
3c9m,A,252,277,25,MVIIMVIAFLICWLPYAGVAFYIFT,0
3c9m,A,288,310,22,TIPAFFAKTSAVYNPVIYIMMN,0
3c9m,A,311,322,11,QFRNCMVTTLC,0
3c9m,A,323,326,3,GKN,0
3c9m,A,327,348,21,LGDDEASTTVSKTETSQVAPA,0
1gue,A,2,5,3,GLT,0
1gue,A,6,26,20,LFWLGAIGMLVGTLAFAWAG,0
1gue,A,36,56,20,YVTLVGISGIAAVAYVVMAL,0
1gue,A,57,69,12,VGWVPVAERTVF,0
1gue,A,70,90,20,PRYIDWILTTPLIVYFLGLL,0
1gue,A,96,115,19,EFGIVITLNTVVMLAGFAG,0
1gue,A,116,125,9,MVPGIERYA,0
1gue,A,126,146,20,FGMGAVAFLGLVYYLVGPMT,0
1gue,A,160,179,19,VRLRNLTVILWAIYPFIWL,0
1gue,A,180,193,13,GPPGVALLTPTVD,0
1gue,A,194,214,20,ALIVYLDLVTKVGFGFIALD,0
1gue,A,220,239,19,AEHGESLAGVDTDAPAVAD,0
4dji,A,1,9,8,ATSVQTGK,0
4dji,A,10,13,3,KQL,0
4dji,A,14,35,21,LLGFFAITASMVMAVYEYPTF,0
4dji,A,42,65,23,VFFLLLGGILWFIPVGLCAAEMA,0
4dji,A,66,76,10,VDGWEEGGVF,0
4dji,A,77,82,5,WVSNT,0
4dji,A,83,86,3,GPR,0
4dji,A,87,111,24,GFAAISFGYLQIAIGFIPMLYFVL,0
4dji,A,132,149,17,AALIILWALALTQFGGT,0
4dji,A,151,172,21,TARIAKVGFFAGILLPAFILI,0
4dji,A,184,186,2,VA,0
4dji,A,205,224,19,VFVAFILSYMGVEASATHV,0
4dji,A,225,230,5,EMSNP,0
4dji,A,231,253,22,RDYPLAMLLLMVAAICLSSVGG,0
4dji,A,294,320,26,ALLLLGVLAEIASWIVGPSRGMYVTA,0
4dji,A,321,329,8,KNLLPAAF,0
4dji,A,330,358,28,KMNKNGVPVTLVISQLVITSIALIILTN,0
4dji,A,367,391,24,LIALALTVVIYLCAYFMLFIGYIV,0
4dji,A,392,405,13,VLKHPDLKRTFNI,0
4dji,A,406,433,27,GGKGVKLVVAIVGLLTSIMAFIVSFLP,0
4dji,A,446,467,21,ELLVVSFLVVLALPFILYAVH,0
4dji,A,469,472,3,KGK,0
4dji,A,473,482,9,NTGVTLEPI,0
4dji,A,483,504,21,SQNAPKGHFFLHPRARSPHYI,0
4dji,A,505,509,4,MNDK,0
4dji,A,510,511,1,H,0
3vvp,A,1,3,2,SE,0
3vvp,A,24,42,18,IPMMIGMSVQTLYNLADG,0
3vvp,A,43,59,16,WVSGLGPESLAAVGLF,0
3vvp,A,60,79,19,PVFMGIIALAAGLGVGTSS,0
3vvp,A,100,119,19,LILSLILGVTITITMLPAI,0
3vvp,A,120,124,4,SLFR,0
3vvp,A,125,131,6,MGAKGE,0
3vvp,A,132,139,7,VELAIEY,0
3vvp,A,140,161,21,RVLLAGAFIIVFNNVGNGILR,0
3vvp,A,166,187,21,NRAMLAMVLGSGLNIVLDPIF,0
3vvp,A,188,197,9,YTLGFGVVG,0
3vvp,A,198,219,21,AYATLLSMVVTSLFIAYWLFV,0
3vvp,A,228,230,2,LR,0
3vvp,A,243,264,21,RVGLPSSLSQLSMSIAMFFLN,0
3vvp,A,265,279,14,VAITAGGENGVAVF,0
3vvp,A,280,301,21,SAWRITMLGIVPILGMAAATT,0
3vvp,A,324,340,16,KIAFMIELAVVAFIML,0
3vvp,A,341,360,19,APQVAYLFTYSESAQVIKG,0
3vvp,A,361,363,2,LI,0
3vvp,A,364,387,23,ALRTLPVFLVLTPFGMMTSAMFQ,0
3vvp,A,392,415,23,EKSLILTIFRTLVMQVGFAYIFV,0
3vvp,A,416,423,7,YTTLGLR,0
3vvp,A,424,444,20,VWIGIVIGNMVAAIVGFLWG,0
3vvp,A,454,461,7,SATGGKR,0
2lzl,A,357,373,16,PAEEELVEADEAGSVY,0
2lzl,A,374,396,22,GILSYGVGFFLFILVVAAVTLC,0
2gif,C,12,28,16,WVIAIIIMLAGGLAIL,0
2gif,C,29,340,311,LPVAQYPTIAPPAVTISASYPGADAKTVQDTVTQVIEQNMNGIDNLMYMSSNSDSTGTVQITLTFESGTDADIAQVQVQNKLQLAMPLLPQEVQQQGVSVEKSSSSFLMVVGVINTDGTMTQEDISDYVAANMKDAISRTSGVGDVQLFGSQYAMRIWMNPNELNKFQLTPVDVITAIKAQNAQVAAGQLGGTPPVKGQQLNASIIAQTRLTSTEEFGKILLKVNQDGSRVLLRDVAKIELGGENYDIIAEFNGQPASGLGIKLATGANALDTAAAIRAELAKMEPFFPSGLKIVYPYDTTPFVKISIHEV,0
2gif,C,341,357,16,KTLVEAIILVFLVMYL,0
2gif,C,366,386,20,IPTIAVPVVLLGTFAVLAAF,0
2gif,C,387,394,7,FSINTLT,0
2gif,C,395,410,15,FGMVLAIGLLVDDAI,0
2gif,C,443,458,15,GIAMVLSAVFVPMAF,0
2gif,C,459,467,8,GGSTGAIY,0
2gif,C,468,488,20,QFSITIVSAMALSVLVALIL,0
2gif,C,515,535,20,FNRMFEKSTHHYTDSVGGIL,0
2gif,C,541,558,17,LVLYLIIVVGMAYLFVR,0
2gif,C,559,873,314,PSSFLPDEDQGVFMTMVQLPAGATQERTQKVLNEVTHYYLTKEKNNVESVFAVNGFGFAGRGQNTGIAFVSLKDWADRPGEENKVEAITMRATRAFSQIKDAMVFAFNLPAIVELGTATGFDFELIDQAGLGHEKLTQARNQLLAEAAKHPDMLTSVRPNGLEDTPQFKIDIDQEKAQALGVSINDINTTLGAAWGGSYVNDFIDRGRVKKVYVMSEAKYRMLPDDIGDWYVRAADGQMVPFSAFSSSRWEYGSPRLERYNGLPSMEILGQAAPGKSTGEAMELMEQLASKLPTGVGYDWTGMSYQERLSGNQA,0
2gif,C,874,891,17,SLYAISLIVVFLCLAAL,0
2gif,C,899,919,20,SVMLVVPLGVIGALLAATFR,0
2gif,C,920,926,6,LTNDVY,0
2gif,C,927,943,16,QVGLLTTIGLSAKNAI,0
2gif,C,976,992,16,MTSLAFILGVMPLVIS,0
2gif,C,993,1000,7,GAGSGAQ,0
2gif,C,1001,1019,18,AVGTGVMGGMVTATVLAI,0
2gif,C,1020,1030,10,FVPVFFVVVR,0
2gif,C,1034,1057,23,RKNEDIEHSHTVDHHLEHHHHHH,0
2n4x,A,-9,0,9,STSQEQPTA,0
2n4x,A,2,13,11,MAFALGILSVF,0
2n4x,A,30,45,15,RALDAFLIVAGLTIS,0
2n4x,A,46,61,15,LILGYTASLFFGFFR,0
2n4x,A,62,77,15,VAMLFLLIFALILLS,0
2n4x,A,83,96,13,VSIFASRMTSGLS,0
2n4x,A,97,105,8,KIQTLPSF,0
2n4x,A,106,131,25,FGMLLAFLWLPAILPFAGIAISQTL,0
2n4x,A,132,136,4,SENP,0
2n4x,A,137,157,20,VMLSYGLGMAVTIAAVFKMG,0
2n4x,A,168,182,14,RKVTGAIVLLYLAY,0
2n4x,A,183,192,9,ALTEVLLLE,0
2n4x,A,193,198,5,HHHHH,0
4xxj,C,4,9,5,TGRPE,0
4xxj,C,10,29,19,IWLALGTALMGLGTLYFLV,0
4xxj,C,46,62,16,TLVPAIAFTMYLSMLL,0
4xxj,C,63,79,16,YGLTMVPFGGEQNPIY,0
4xxj,C,80,94,14,ARYADWLFTTPLLL,0
4xxj,C,110,127,17,LVGADGIMIGTGLVGAL,0
4xxj,C,128,133,5,KVYSY,0
4xxj,C,134,150,16,FVWWAISTAAMLYILY,0
4xxj,C,177,192,15,TVVLWSAYPVVWLIG,0
4xxj,C,193,202,9,EGAGIVPLN,0
4xxj,C,203,221,18,ETLLFMVLDVSAKVGFGL,0
1k6n,H,1,10,9,VGVTAFGNF,0
1k6n,H,13,32,19,SLAIYSFWIFLAGLIYYLQ,0
1k6n,H,33,250,217,ENMREGYPLENEDGTPAANQGPFPLPKPKTFILPHGRGTLTVPGPESEDRPIALARTAVSEGFPHAPTGDPMKDGVGPASWVARRDLPELDGHGHNKIKPMKAAAGFHVSAGKNPIGLPVRGCDLEIAGKVVDIWVDIPEQMARFLEVELKDGSTRLLPMQMVKVQSNRVHVNALSSDLFAGIPTIKSPTEVTLLEEDKICGYVAGGLMYAAPKRKS,0
1k6n,H,251,260,9,VAAMLAEYA,0
5i32,D,1,20,19,AGVAFGSFDDSFSLASLRA,0
5i32,D,21,38,17,LAEFISTLLFVFAGVGS,0
5i32,D,58,75,17,IAVCHGFALFVAVAIGA,0
5i32,D,76,78,2,IS,0
5i32,D,79,92,13,GHVNPAVTFGLAV,0
5i32,D,93,98,5,GQITV,0
5i32,D,99,122,23,TGVFYWIAQLLGSTAACFLLKYV,0
5i32,D,141,161,20,GVVMEIIITFALVYTVYATA,0
5i32,D,162,172,10,DPKKGSLGTI,0
5i32,D,173,189,16,PLAIGLIVGANILAAG,0
5i32,D,193,207,14,GSMNPARSFGPAVA,0
5i32,D,215,232,17,VYWVGPLIGGGLAGLIY,0
5i32,D,233,238,5,NVFMG,0
4z90,E,206,225,19,SFILPLGLIIAASWSVFWL,0
4z90,E,226,230,4,SFSE,0
4z90,E,231,249,18,LQTSFTLMLTVVAYAFYT,0
4z90,E,262,282,20,DQMIIAGYGSIFAAILLIIF,0
4z90,E,283,299,16,HHRQANGVEDDLLIQR,0
4z90,E,300,317,17,RLAFPLGFLAIGCVLVI,0
2kse,A,18,34,16,LILASVTWLLSSFVAW,0
2kse,A,35,40,5,QTTDN,0
2kse,A,41,149,108,DELFDTQLMLFAKRLSTLDLNEINAADRMAQTPNRLKHGHVDDDALTFAIFTHDGRMVLNDGDNGEDIPYSYQREGFADGQLVGEDDPWRFVWMTSPDGKYRIVVGQE,0
2kse,A,150,160,10,EYREDMALAI,0
2kse,A,161,177,16,AGQLIPWLVALPIMLI,0
4d2e,C,-8,28,36,HHHHHHELANNTTGFTRIIKAAGYSWKGLRAAWINE,0
4d2e,C,29,33,4,AFRQ,0
4d2e,C,34,47,13,GVAVLLCVVIAAW,0
4d2e,C,54,68,14,RVLLISSVMLVMIV,0
4d2e,C,69,101,32,LLNSAIEAVVDRIGSEYHELSGRAKDLGSAAV,0
4d2e,C,102,116,14,IAIIDAVITWAILL,0
4mmd,B,1,4,3,EVK,0
4mmd,B,5,13,8,EHWATRLG,0
4mmd,B,14,35,21,ILAMAGYAVDLGNFLRFPVQA,0
4mmd,B,42,63,21,FMIPYIIAFLLVGIPLMWIEW,0
4mmd,B,64,89,25,MGRYGGAQGHGTTPAIFYLLWRNRF,0
4mmd,B,90,124,34,KILGVFGLWIPLVVAIYYVYIESWTLGFAIKFLV,0
4mmd,B,132,134,2,,0
4mmd,B,167,185,18,AYIVFLITMFINVSILIR,0
4mmd,B,186,190,4,ISKG,0
4mmd,B,191,214,23,ERFAKIAMPTLFILAVFLVIRVF,0
4mmd,B,223,231,8,ADGLNFLW,0
4mmd,B,242,265,23,VWIAAVGQIFFSLGLGFGAIITF,0
4mmd,B,266,278,12,SYVRKDQDIVLS,0
4mmd,B,279,298,19,LTAATLNEKAEVILGGSIS,0
4mmd,B,319,324,5,FNLGF,0
4mmd,B,326,331,5,LPAIF,0
4mmd,B,340,367,27,GFLWFFLLFFAGLTSSIAGMQPMIAFL,0
4mmd,B,368,377,9,DELKLSRKH,0
4mmd,B,378,396,18,VLWTAAIVFFSAHLVMFL,0
4mmd,B,400,425,25,DEMDFWAGTIGVVFFGLTELIIFFW,0
4mmd,B,426,428,2,FG,0
4mmd,B,429,437,8,DKAWEEIN,0
4mmd,B,438,447,9,GGIIKVPRI,0
4mmd,B,448,472,24,YYVMRYITPAFLAVLLVVWAREYI,0
4mmd,B,484,502,18,ITRFYIIGLFLFLTFLVF,0
4mmd,B,503,511,8,AERRRNHE,0
4mmd,B,512,519,7,AGTLVPR,0
3s33,C,2,6,4,EKPK,0
3s33,C,7,22,15,ALAVILVLTLTILVF,0
2ksr,A,1,24,23,HHHHHHSTSVDLGTENLYFQSNA,0
2ksr,A,29,52,23,FYTINLIIPCVLITSLAILVFYL,0
2ksr,A,53,58,5,SDCGE,0
2ksr,A,59,81,22,MTLCISVLLALTVFLLLISKIV,0
2ksr,A,88,109,21,PLVGKYLMFTMVLVTFSIVTS,0
2ksr,A,110,137,27,CVLNVHHRSPTTHTPRGGGGYVAMVID,0
2ksr,A,138,161,23,LFLWIFVFVCVFGTIGMFLQPLF,0
5k2b,A,5,28,23,SSVYITVELAIAVLAILGNVLVC,0
5k2b,A,29,44,15,AVWLNSNLQNVTNYF,0
5k2b,A,45,67,22,VSLAAADIAVGVLAIPFAITIS,0
5k2b,A,76,97,21,CLFIACFVLVLTQSSIFSLLA,0
5k2b,A,98,123,25,AIDRYIAIRIPLRYNGLVTGTRAKG,0
5k2b,A,124,144,20,IAICWVLSFAIGLTPMLGWN,0
5k2b,A,172,195,23,PMNYMVYFNFFACVLVPLLLMLG,0
5k2b,A,196,1043,847,YLRIFLAARRQLADLEDNWETLNDNLKVIEKADNAAQVKDALTKMRAAALDAQKA,0
5k2b,A,1057,236,-821,MKDFRHGFDILVGQIDDALKLANEGKVKEAQAAAEQLKTTRNAYIQKYLERARSTLQKEVHAAKSLA,0
5k2b,A,237,259,22,IVGLFALCWLPLHIINCFTFFC,0
5k2b,A,265,287,22,PLWLMYLAIVLSHTNSVVNPFI,0
5k2b,A,288,292,4,AYRI,0
5k2b,A,293,305,12,EFRQTFRKIIRS,0
5k2b,A,306,308,2,VL,0
4ami,A,31,32,1,G,0
4ami,A,42,61,19,GMSLLMALVVLLIVAGNVL,0
4ami,A,62,82,20,IAAIGSTQRLQTLTNLFITS,0
4ami,A,83,103,20,ACADLVVGLLVVPFGATLVV,0
4ami,A,108,133,25,WGSFLCELWTSLDVLCVTASIETLC,0
4ami,A,134,163,29,IAIDRYLAITSPFRYQSLMTRARAKVIIC,0
4ami,A,164,183,19,VWAISALVSFLPIMMHWWR,0
4ami,A,187,194,7,QALKCYQ,0
4ami,A,200,225,25,FVTNRAYAIASSIISFYIPLLIMIF,0
4ami,A,226,237,11,ALRVYREAKEQ,0
4ami,A,238,253,15,RKIDRASKRKTSRVM,0
4ami,A,282,294,12,MREHKALKTLGI,0
4ami,A,295,316,21,MGVFTLCWLPFFLVNIVNVFN,0
4ami,A,320,342,22,PDWLFVAFNWLGYANSAMNPII,0
4ami,A,343,346,3,CRS,0
4ami,A,347,356,9,DFRKAFKRL,0
4ami,A,357,358,1,A,0
4ami,A,359,373,14,PRKADRRLHHHHHH,0
3spc,D,36,40,4,ARRK,0
3spc,D,64,68,4,RYIA,0
3spc,D,70,76,6,FTTCVD,0
3spc,D,78,104,26,WRYMLLLFSLAFLVSWLLFGLIFWLI,0
3spc,D,105,130,25,LIHGDLENPGGDDTFKPCVLQVNGF,0
3spc,D,131,147,16,AAFLFSIETQTTIGYG,0
3spc,D,148,155,7,RCVTEEC,0
3spc,D,156,184,28,LAVFMVVVQSIVGCIIDSFMIGAIMAKM,0
3spc,D,373,378,5,EVLFQ,0
1kyk,E,14,22,8,NVVDLAVG,0
1kyk,E,23,40,17,IIGAAFGKIVSSLVADI,0
1kyk,E,44,71,27,LGLLIGGIDFKQFAVTLRDAQGDIPAV,0
1kyk,E,78,94,16,IQNVFDFLIVAFAIFM,0
1kyk,E,95,96,1,I,0
3ob6,B,1,4,3,SSD,0
3ob6,B,5,16,11,DAHKVGLIPVT,0
3ob6,B,17,32,15,MVSGNIMGSGVFLLP,0
3ob6,B,42,57,15,IYGWLVTIIGALGLS,0
3ob6,B,58,91,33,VYAKMSFLDPSPGGSYAYARRCFGPFLGYQTNV,0
3ob6,B,92,112,20,YWLACWIGAIAMVVIGVGYL,0
3ob6,B,124,140,16,LTITCVVVLWIFVLLN,0
3ob6,B,141,146,5,VGPKM,0
3ob6,B,147,170,23,TRVQAVATVLALIPIVGIAVFGW,0
3ob6,B,175,180,5,ETYMA,0
3ob6,B,194,209,15,STLNVTLWSFIGVES,0
3ob6,B,210,228,18,SVAAGVVKNPKRNVPIAT,0
3ob6,B,229,245,16,GGVLIAAVCYVLSTTA,0
3ob6,B,261,269,8,FGDAARMA,0
3ob6,B,278,297,19,SFCAAAGCLGSLGGWTLLA,0
3ob6,B,298,327,29,QTAKAAADDGLFPPIFARVNKAGTPVAGL,0
3ob6,B,328,342,14,IVGILMTIFQLSSI,0
3ob6,B,350,366,16,GLVSSVSVIFTLVPYL,0
3ob6,B,367,389,22,TCAALLLLGHGHFGKARPAYLA,0
3ob6,B,390,407,17,TTIAFLYCIWAVVGSGA,0
3ob6,B,409,423,14,VMWSFVTLMVITAM,0
3ob6,B,424,450,26,ALNYNRLHKNPYPLDAR,0
3ob6,B,451,454,3,SKD,0
5eke,D,-3,123,126,QSNATIELSIVIPMYNEEDNLEHLFARLLEVLTPLKITYEIICVNDGSKDKTLKQLIDCYQSNRQIKIVNLSRNFGKEIALSAGIDYAQGNAVIPIDADLQDPPELIHELVDKWREGYDIVYATRR,0
5eke,D,129,195,66,WVKQFTAKMFYKVIGRMTEIKIPPNTGDFRLMDRKVVNAIKQLPERTRFMKGLFAWVGYRQTFVLF,0
5eke,D,207,213,6,NYWKLW,0
5eke,D,214,222,8,AALDGIFS,0
5eke,D,223,230,7,SLLPLKV,0
5eke,D,231,252,21,TYLGSIISLLSLAYASFLILK,0
5eke,D,260,282,22,PGYASLMVAILFLGGVQLISLG,0
5eke,D,283,314,31,IGEYLGRVYEEVKARPLYLVSDLWGLEYLPL,0
2wu5,L,1,10,9,VSNASALGR,0
2wu5,L,15,38,23,FILVRATAIVLTLYIIYMVGFFA,0
2wu5,L,39,56,17,SGELTYEVWIGFFASAF,0
2wu5,L,57,80,23,KVFTLLALFSILIMAWIGMWQVL,0
2wu5,L,89,110,21,RLMLQLVIVVALVVYVIYGFV,0
2wu5,L,111,115,4,VWGV,0
4twh,E,11,210,199,VDVSVSIFINKIYGVNTLEQTYKVDGYIVAQWTGKPRKTPGDKPLIVENTQIERWINNGLWVPALEFINVVGSPDTGNKRLMLFPDGRVIYNARFLGSFSNDMDFRLFPFDRQQFVLELEPFSYNNQQLRFSDIQVYTENADNEEIDEWWIRGKASTHISDIRYDHLSSVQPNQNEFSRITVRIDAVRNPSYYLWSFIL,0
4twh,E,211,225,14,LGLIIAASWSVFWL,0
4twh,E,230,245,15,RLQTSFTLMLTVVAY,0
4twh,E,246,265,19,SYTSNILPRLPYTTVIDQM,0
4twh,E,266,282,16,IAGYGSIFAAILLIIF,0
4twh,E,300,315,15,RLAFPLGFLAIGCVL,0
4twh,E,316,317,1,I,0
1yf6,H,1,10,9,VGVTAFGNF,0
1yf6,H,16,32,16,IYSFWIFLAGLIYYLQ,0
1yf6,H,33,248,215,ENMREGYPLENEDGTPAANQGPFPLPKPKTFILPHGRGTLTVPGPESEDRPIALARTAVSEGFPHAPTGDPMKDGVGPASWVARRDLPELDGHGHNKIKPMKAAAGFHVSAGKNPIGLPVRGCDLEIAGKVVDIWVDIPEQMARFLEVELKDGSTRLLPMQMVKVQSNRVHVNALSSDLFAGIPTIKSPTEVTLLEEDKICGYVAGGLMYAAPKR,0
1yf6,H,249,260,11,SVVAAMLAEYA,0
3v8f,C,1,6,5,GLYRK,0
3v8f,C,14,28,14,KILIGLILGAIVGL,0
3v8f,C,29,42,13,LGHYGYAHAVHTY,0
3v8f,C,43,66,23,KPFGDLFVRLLKMLVMPIVFASL,0
3v8f,C,94,110,16,FAVTLGIIMARLFNPG,0
3v8f,C,111,130,19,GIHLAVGGQQFQPHQAPPL,0
3v8f,C,131,140,9,HILLDIVPT,0
3v8f,C,141,150,9,PFGALANGQ,0
3v8f,C,151,161,10,LPTIFFAIIL,0
3v8f,C,201,217,16,MQYAPIGVFALIAYCM,0
3v8f,C,218,224,6,EQGVHV,0
3v8f,C,225,242,17,GELAKVTAAVYVGLTLQ,0
3v8f,C,313,326,13,TALYQGVATFFIA,0
3v8f,C,327,333,6,ALGSHL,0
3v8f,C,334,352,18,VGQQLTIVLTAVLASIGT,0
3v8f,C,358,373,15,GAIMLAMVLHSVGLP,0
3v8f,C,374,379,5,TDPNV,0
3v8f,C,380,397,17,AAYACILGIDAILDMGR,0
3v8f,C,417,422,5,TLVPR,0
1brr,C,1,9,8,AQITGRPE,0
1brr,C,10,30,20,IWLALGTALMGLGTLYFLVK,0
1brr,C,44,66,22,ITTLVPAIAFTMYLSMLLGYGL,0
1brr,C,67,78,11,MVPFGGEQNPI,0
1brr,C,79,97,18,WARYADWLFTTPLLLLDL,0
1brr,C,109,128,19,ALVGADGIMIGTGLVGALT,0
1brr,C,129,133,4,VYSY,0
1brr,C,134,153,19,FVWWAISTAAMLYILYVLF,0
1brr,C,175,196,21,NVTVVLWSAYPVVWLIGSEGA,0
1brr,C,197,201,4,IVPL,0
1brr,C,202,222,20,IETLLFMVLDVSAKVGFGLI,0
1brr,C,233,247,14,EAPEPSADGAAATS,0
3am6,D,1,12,11,ADVETETGMIA,0
3am6,D,13,33,20,WIVFAIMAAAAIAFGVAVHF,0
3am6,D,36,37,1,E,0
3am6,D,40,60,20,AYYINIAICTIAATAYYAMA,0
3am6,D,61,76,15,NYQDLTMNGERQVVY,0
3am6,D,77,96,19,RYIDWVLTTPLLLLDLIVM,0
3am6,D,102,122,20,MISWVIGADIFMIVFGILGA,0
3am6,D,123,131,8,EDEHKFKW,0
3am6,D,132,153,21,YFIAGCVMQAVLTYGMYNATW,0
3am6,D,157,158,1,K,0
3am6,D,166,186,20,YVSLLVFLSILWVFYPVVWA,0
3am6,D,187,199,12,GSGSGVLSVDNE,0
3am6,D,200,222,22,ILMGILDVLAKPLFGMGCLIAH,0
2bob,F,1,21,20,APMLSGLLARLVKLLLGRHG,0
2bob,F,26,50,24,RAAGAATVLLVIVLLAGSYLAVLA,0
2bob,F,51,62,11,RGAPGAQLITY,0
2bob,F,63,79,16,RALWWSVETATTVGYG,0
2bob,F,80,86,6,LYPVTL,0
2bob,F,87,111,24,GRCVAVVVMVAGITSFGLVTAALA,0
4h1d,C,94,113,19,PVTWVMMIACVVVFIAMQI,0
4h1d,C,114,139,25,GDQEVMLWLAWPFDPTLKFEFWRYF,0
4h1d,C,140,165,25,HALMHFSLMHILFNLLWWWYLGGAV,0
4h1d,C,172,189,17,KLIVITLISALLSGYVQ,0
4h1d,C,190,197,7,KFSGPWF,0
4h1d,C,198,214,16,GLSGVVYALMGYVWLR,0
4h1d,C,226,242,16,RGLIIFALIWIVAGWF,0
4h1d,C,243,244,1,L,0
4h1d,C,245,250,5,GMSMA,0
4h1d,C,252,267,15,AHIAGLAVGLAMAFV,0
2b5f,D,1,27,26,SKEVSEEAQAHQHGKDYVDPPPAPFF,0
2b5f,D,28,38,10,LGELKLWSFW,0
2b5f,D,39,59,20,AAIAEFIATLLFLYITVATV,0
2b5f,D,75,93,18,GIAWAFGGMIFVLVYCTA,0
2b5f,D,94,96,2,IS,0
2b5f,D,97,110,13,GHINPAVTFGLFL,0
2b5f,D,111,116,5,RKVSL,0
2b5f,D,117,140,23,RALVYMIAQCLGAICGVGLVKAF,0
2b5f,D,162,182,20,TALGAEIIGTFVLVYTVFSA,0
2b5f,D,183,186,3,DPK,0
2b5f,D,187,192,5,SARDS,0
2b5f,D,193,197,4,VPIL,0
2b5f,D,198,214,16,PLPIGFAVFMVHLATI,0
2b5f,D,217,233,16,GTGINPARSFGAAVIF,0
2b5f,D,240,262,22,DQWIFWVGPFIGAAVAAAYHQY,0
2b5f,D,264,303,39,RAAAIKALGSFRSNPTNLEQKLISEEDLNSAVDHHHHHH,0
4czb,B,4,24,20,MAIGYLGLALVLGSLVAKIA,0
4czb,B,25,29,4,KLKI,0
4czb,B,30,46,16,DIPLLLLLGLIIGPFL,0
4czb,B,51,57,6,DSAMEI,0
4czb,B,58,74,16,EYAGPIGLIFILLGGA,0
4czb,B,75,89,14,TMRISLLKRVIKTV,0
4czb,B,90,108,18,RLDTITFLITLLISGFIF,0
4czb,B,122,135,13,LFGAITAATDPAT,0
4czb,B,136,155,19,IPVFSRVRTNPEVAITLEA,0
4czb,B,156,171,15,SIFNDPLGIVSTSVI,0
4czb,B,184,206,22,IDLITLAGGAIVVGLLLAKIYE,0
4czb,B,207,217,10,IIIHCDFHEY,0
4czb,B,218,234,16,APLVLGGAMLLLYVGD,0
4czb,B,245,258,13,SGYMAVAIMGLYL,0
4czb,B,259,276,17,DALFRADDIDYKYIVSF,0
4czb,B,277,296,19,DDLSLLARVFIFVFLGACI,0
4czb,B,298,303,5,SMLEN,0
4czb,B,306,330,24,PGLLVALGSIFLARPLGVFLGLIG,0
4czb,B,331,341,10,KHSFKEKLYF,0
4czb,B,342,358,16,LEGPRGVVPAALAVTV,0
4czb,B,387,403,16,IGTFMTILLSVILEAS,0
4czb,B,404,419,15,AGMLALKLLGEYKPK,0
1pcr,H,1,10,9,VGVTAFGNF,0
1pcr,H,16,31,15,IYSFWIFLAGLIYYL,0
1pcr,H,32,250,218,TENMREGYPLENEDGTPAANQGPFPLPKPKTFILPHGRGTLTVPGPESEDRPIALARTAVSEGFPHAPTGDPMKDGVGPASWVARRDLPELDGHGHNKIKPMKAAAGFHVSAGKNPIGLPVRGCDLEIAGKVVDIWVDIPEQMARFLEVELKDGSTRLLPMQMVKVQSNRVHVNALSSDLFAGIPTIKSPTEVTLLEEDKICGYVAGGLMYAAPKRKS,0
1pcr,H,251,260,9,VAAMLAEYA,0
2lom,A,1,3,2,ST,0
2lom,A,4,21,17,TGVSLPSYEEDQGSKLI,0
2lom,A,22,31,9,KAKEAPFVP,0
2lom,A,32,48,16,GIAGFAAIVAYGLYKL,0
2lom,A,59,85,26,LIHMRVAAQGFVVGAMTVGMGYSMYR,0
2lom,A,86,93,7,FWAKPKP,0
1eys,H,1,6,5,PAGIT,0
1eys,H,7,13,6,YIDAAQ,0
1eys,H,14,28,14,TIWAFWLFFFGLII,0
1eys,H,44,58,14,RTERSGGRYKVVGF,0
4f35,A,14,18,4,EWFL,0
4f35,A,19,22,3,RNS,0
4f35,A,23,35,12,IVLADVALFLAL,0
4f35,A,51,64,13,LAFIAVLWLTEAL,0
4f35,A,66,76,10,TVTAILVPVM,0
4f35,A,90,106,16,NFANSIIFLFLGGFAL,0
4f35,A,107,190,83,AAMHHQGLDKVIADKVLAMAQGKMSVAVFMLFGVTALLSMWISNTATAAMMLPLVLGVLSKVDADKQRSTYVFVLLGVAYSAS,0
4f35,A,191,209,18,GGIATLVGSPPNAIAAAE,0
4f35,A,213,229,16,FTDWMKFGLPTAMMML,0
4f35,A,230,242,12,MAIAILYFLLKP,0
4f35,A,243,252,9,LNGMFELDR,0
4f35,A,253,266,13,PVNWDKGKVVTLG,0
4f35,A,267,279,12,FGLTVFLWIFSS,0
4f35,A,291,306,15,DTLVALGAILMLSFA,0
4f35,A,307,310,3,VVH,0
4f35,A,311,317,6,KEIQKT,0
4f35,A,319,332,13,WGVLLLFGGGLCL,0
4f35,A,341,354,13,SVFLANALSDMVS,0
4f35,A,360,375,15,VILVVATFVVFLTEF,0
4f35,A,377,389,12,NTASAALLIPVF,0
4f35,A,403,414,11,SVLIAVAASCA,0
4f35,A,415,446,31,MLPVATPPNAIVFASGHIKQSEMMRVGLYLN,0
4f35,A,447,460,13,ACIGLLTAIAMLF,0
4muu,A,15,21,6,FNVRLL,0
4muu,A,22,41,19,EIAFMAALAFIISLIPNTV,0
4muu,A,46,59,13,VEIACIPILLLSL,0
4muu,A,60,63,3,RGL,0
4muu,A,64,83,19,AGLVGGLIWGILSMITGHA,0
4muu,A,90,107,17,AFLEYLVAPVSLGIAGL,0
4muu,A,108,120,12,RQKTAPLKLAPV,0
4muu,A,121,138,17,LGTFVAVLLKYFFHFIA,0
4muu,A,159,179,20,VNGISGILTAIAAFVILIIF,0
4muu,A,180,192,12,KKFPKLFIHSNY,0
2iqo,A,67,94,27,AITIMALYSIVCVVGLFGNFLVMYVIV,0
2iqo,A,95,104,9,YTKMKTATN,0
2iqo,A,105,129,24,YIFNLALADALATSTLPFQSVNYL,0
2iqo,A,139,163,24,CKIVISIDYYNMFTSIFTLCTMSV,0
2iqo,A,164,183,19,RYIAVCHPVKALDFRTPRN,0
2iqo,A,184,210,26,KIVNVCNWILSSAIGLPVMFMATTKY,0
2iqo,A,229,253,24,NLLKICVFIFAFIMPVLIITVCYG,0
2iqo,A,254,280,26,MILRLKSVRMLSGSKEKDRNLRRITR,0
2iqo,A,281,305,24,VLVVVAVFIVCWTPIHIYVIIKAL,0
2iqo,A,317,338,21,WHFCIALGYTNSCLNPVLYAF,0
2iqo,A,339,340,1,D,0
2iqo,A,341,351,10,NFKRCFREFC,0
2iqo,A,352,354,2,PT,0
5e1a,F,23,25,2,CH,0
5e1a,F,26,50,24,RAAGAATVLLVIVLLAGSYLAVLA,0
5e1a,F,63,79,16,RALWWSVETATTVGYG,0
5e1a,F,87,114,27,GRLVAVVVMVAGITSFGLVTAALATWF,0
5e1a,F,115,124,9,GCEQERRGH,0
3pl9,A,1,87,86,QPKSGFSTDRPLWYPGAKAPEYLDGSLVGDYGFDPFGLGKPAEYLQYDYDGLDQNLAKNLAGDIIGTRTESADVKSTSLQPYSEVF,0
3pl9,A,88,94,6,LQRFRE,0
3pl9,A,95,113,18,ELIHGRWAMLATLGALTV,0
3pl9,A,124,130,6,GKVELI,0
3pl9,A,145,162,17,TLIWIEVLVIGYIEFQR,0
3pl9,A,163,196,33,AELDTEKRLYPGGTFDPLGLASDPEKKPILQLA,0
3pl9,A,197,214,17,IKHARLAMVGFLGFAVQ,0
3pl9,A,222,231,9,LNNWVTHLS,0
4pl0,B,1,3,2,ER,0
4pl0,B,5,15,10,KNSLFNYIYS,0
4pl0,B,16,22,6,MDVRGK,0
4pl0,B,23,46,23,LFFSMLFITSLSSIIISISPLIL,0
4pl0,B,70,92,22,LYMFCVISNKASVFLFMILQSS,0
4pl0,B,93,138,45,RINMQKKMSLKYLRELYNENITNLSKNNAGYTTQSLNQASNDIYI,0
4pl0,B,139,163,24,VRNVSQNILSPVIQLISTIVVVLS,0
4pl0,B,167,189,22,FSAGVFFLYILVFVIFNTRLTG,0
4pl0,B,190,247,57,LASLRKHSMDITLNSYSLLSDTVDNMIAAKKNNALRLISERYEDALTQENNAQKKYW,0
4pl0,B,248,271,23,LSSKVLLLNSLLAVILFGSVFIY,0
4pl0,B,288,311,23,ITSYIILLSTPVENIGALLSEIR,0
4pl0,B,312,579,267,SMSSLAGFIQRHAENKATSPSIPFLNMERKLNLSIRELSFSYSDDKKILNSVSLDLFTGKMYSLTGPSGSGKSTLVKIISGYYKNYFGDIYLNDISLRNISDEDLNDAIYYLTQDDYIFMDTLRFNLRLANYDASENEIFKVLKLANLSVVNNEPVSLDTHLINRGNNYSGGQKQRISLARLFLRKPAIIIIDEATSALDYINESEILSSIRTHFPDALIINISHRINLLECSDCVYVLNEGNIVASGHFRDLMVSNEYISGLASVT,0
3ne2,D,9,26,17,TAEVVGTFILVFFGPGA,0
3ne2,D,27,56,29,VITLMIANGADKPNEFNIGIGALGGLGDW,0
3ne2,D,57,75,18,AIGMAFALAIAAVIYSLG,0
3ne2,D,80,92,12,HINPAVTIALWS,0
3ne2,D,102,119,17,PYIVAQFIGAALGSLLF,0
3ne2,D,120,145,25,ACVGPAAATVGGLGATAPFPGIGYG,0
3ne2,D,146,165,19,AILTEAIGTFLLMLVIMGV,0
3ne2,D,176,192,16,GLVIGLTVGGIITTIG,0
3ne2,D,193,195,2,IT,0
3ne2,D,196,209,13,SSLNPARTFGPYL,0
3ne2,D,210,222,12,DSLMGINLWQYF,0
3ne2,D,223,240,17,IYVIGPIVGAVAAAWLY,0
1sqb,K,2,21,19,TRFLGPRYRQLARNWVPTA,0
1sqb,K,22,39,17,LWGAVGAVGLVWATDSR,0
1sqb,K,54,56,2,DD,0
2hyd,B,2,9,7,KRYLQFV,0
2hyd,B,10,34,24,PYKYRIFATIIVGIIKFGIPMLIP,0
2hyd,B,35,63,28,LIKYAIDGVINNHALTTDEKVHHLTIAI,0
2hyd,B,64,89,25,IALFIFVIVRPPIEFIRQYLAQWTS,0
2hyd,B,133,157,24,FILTGLMNIWLDCITIIIALSIMF,0
2hyd,B,158,164,6,LDVKLT,0
2hyd,B,165,186,21,AALFIFPFYILTVYVFFGRLR,0
2hyd,B,241,263,22,RWNAYSFAAINTVTDIGPIIVI,0
2hyd,B,264,285,21,VGAYLAISGSITVGTLAAFVG,0
2hyd,B,286,308,22,LELLFGPLRRLVASFTTLTQSF,0
3uq7,E,-1,10,11,SAPADNAADAR,0
3uq7,E,205,222,17,WSFILPLGLIIAASWSV,0
3uq7,E,223,233,10,WLESFSERLQ,0
3uq7,E,234,250,16,SFTLMSTVVAYALYTS,0
3uq7,E,262,279,17,DQMIIAGYGSIFAAILL,0
3uq7,E,280,302,22,IFAHHRQANGVEDDLLIQRCRL,0
3uq7,E,303,317,14,FPLGFLAIGCVLVI,0
3uq7,E,318,322,4,GITL,0
2vpx,G,1,15,14,EFYGLPNAQEFWHW,0
2vpx,G,16,36,20,NALHFVLVGLAGGVALLAAL,0
2vpx,G,50,66,16,YALMLIALDLFILWAE,0
2vpx,G,67,88,21,PARFRFTHIWLFLSFHPTSPI,0
2vpx,G,89,105,16,WGAWGLGLGFLTGGLL,0
2vpx,G,115,132,17,AWALLVFSLVALSYPGL,0
2vpx,G,133,146,13,LAVNLNRPLWNGL,0
2vpx,G,147,163,16,AGLFPLTALVLALGLA,0
2vpx,G,175,189,14,RVLAGASLLLALLY,0
2vpx,G,190,206,16,LTLPPEARGHLLEEAG,0
2vpx,G,207,221,14,WYGLFLLLGLGTFW,0
2vpx,G,226,241,15,PWAGLLAAAGLRALL,0
2vpx,G,242,250,8,LAGQWQGL,0
2vpx,G,251,252,1,L,0
1fjp,A,1,30,29,DKVQYLTRSAIRRASTIEMPQQARQNLQN,0
1fjp,A,31,49,18,FINFCLILIFLLLICIIV,0
3usi,A,1,4,3,EVK,0
3usi,A,5,12,7,EHWATRL,0
3usi,A,13,31,18,LILAMAGNAVGLGNFLRF,0
3usi,A,45,63,18,PYIIAFLLVGIPLMWIEW,0
3usi,A,64,89,25,MGRYGGAQGHGTTPAIFYLLWRNRF,0
3usi,A,90,124,34,KILGVFGLWIPLVVAIYYVYIESWTLGFAIKFLV,0
3usi,A,132,134,2,,0
3usi,A,167,184,17,AYIVFLITMFINVSILI,0
3usi,A,185,190,5,GISKG,0
3usi,A,191,211,20,ERFAKIAMPTLFILAVFLVI,0
3usi,A,223,231,8,ADGLNFLW,0
3usi,A,245,266,21,AAVGQIFFTLSLGFGAIITYA,0
3usi,A,267,276,9,YVRKDQDIV,0
3usi,A,277,296,19,SGLTAATLNEKAEVILGGS,0
3usi,A,319,324,5,FNLGF,0
3usi,A,326,331,5,LPAIF,0
3usi,A,343,366,23,WFFLLFFAGLTSSIAIMQPMIAF,0
3usi,A,367,378,11,EDELKLSRKHA,0
3usi,A,379,396,17,LWTAAIVFFSAHLVMFL,0
3usi,A,400,426,26,DEMDFWAGTIGVVFFGLTELIIFFWI,0
3usi,A,427,428,1,G,0
3usi,A,429,437,8,DKAWEEIN,0
3usi,A,438,444,6,GGIIKV,0
3usi,A,445,469,24,RIYYYVMRYITPAFLAVLLVVWAR,0
3usi,A,475,478,3,MEE,0
3usi,A,484,501,17,ITRFYIIGLFLFLTFLV,0
3usi,A,502,601,99,LAERRRNHESAL,0
3usi,A,602,606,4,LVPR,0
4ruf,B,33,51,18,ALLALVLLYLVSGALVFR,0
4ruf,B,52,105,53,LEQPHEQQAQRELGEVREKFLRAHPCVSDQELGLLIKEVADALGGGADPETQS,0
4ruf,B,110,116,6,HSAWDL,0
4ruf,B,117,133,16,SAFFFSGTIITTIGYG,0
4ruf,B,134,140,6,VALRTD,0
4ruf,B,141,165,24,GRLFCIFYALVGIPLFGILLAGVG,0
4ruf,B,166,183,17,RLGSSLRHGIGHIEAIF,0
4ruf,B,200,220,20,FLLIGCLLFVLTPTFVFCYM,0
4ruf,B,221,224,3,DWS,0
4ruf,B,225,245,20,LEAIYFVIVTLTTVGFGDYV,0
4ruf,B,246,254,8,GADPRQDS,0
4ruf,B,255,277,22,AYQPLVSFWILLGLAYFASVLT,0
2jbl,M,1,51,50,DYQTIYTQIQARGPHITVSGEWGDNDRVGKPFYSYWLGKIGDAQIGPIYL,0
2jbl,M,52,70,18,ASGIAAFAFGSTAILIIL,0
2jbl,M,81,87,6,LQFFRQ,0
2jbl,M,116,132,16,GLFMTLSLGSWWIRVY,0
2jbl,M,133,143,10,RARALGLGTH,0
2jbl,M,144,161,17,AWNFAAAIFFVLCIGCI,0
2jbl,M,177,190,13,WPHIDWLTAFSIR,0
2jbl,M,198,218,20,WHGFSIGFAYGCGLLFAAHG,0
2jbl,M,219,266,47,TILAVARFGGDREIEQITDRGTAVERAALFWRWTIGFNATIESVHRW,0
2jbl,M,267,284,17,WFFSLMVMVSASVGILL,0
2jbl,M,292,298,6,YLWCVK,0
1h2s,D,24,40,16,VFIFVGALTVLFGAIA,0
1h2s,D,63,80,17,ILGLIILLGINLGLVAA,0
1h2s,D,81,82,1,L,0
5tgz,A,119,143,24,AVLSLTLGTFTVLENLLVLCVILH,0
5tgz,A,144,153,9,RSLRCRPSY,0
5tgz,A,154,176,22,FIGSLAVADLLGSVIFVYSFID,0
5tgz,A,188,212,24,FLFKLGGVTASFTASVGSLFLAAI,0
5tgz,A,213,234,21,RYISIHRPLAYKRIVTRPKAV,0
5tgz,A,235,256,21,AFCLMWTIAIVIAVLPLLGWN,0
5tgz,A,271,295,24,DKTYLMFWIGVVSVLLLFIVYAYM,0
5tgz,A,296,1013,717,ILWKAHSHAVAKALIVYGSTTG,0
5tgz,A,1014,1028,14,TEYTAETIARELAD,0
5tgz,A,1029,343,-686,GYEVDSRDAASVEAGGLFEGFDLVLLGCSTWGDDSIELQDDFIPLFDSLEETGAQGRKVACFGCGDSSWEYFCGAVDAIEEKLKNLGAEIVQDGLRIDGDPRAARDDIVGWAHDVRGAIPDQARMDIELAK,0
5tgz,A,344,369,25,LVLILVVLIICWGPLLAIMVYDVFG,0
5tgz,A,373,378,5,LIKTV,0
5tgz,A,379,401,22,AFCSMLCLLNSTVNPIIYALRS,0
5tgz,A,402,410,8,DLRHAFRS,0
5tgz,A,411,412,1,F,0
4lp8,D,1,12,11,TGGMKPPARKP,0
4lp8,D,13,27,14,ILNSDGSSNITRLG,0
4lp8,D,28,31,3,EKR,0
4lp8,D,32,36,4,WLDD,0
4lp8,D,37,43,6,YHDLLT,0
4lp8,D,44,46,2,SW,0
4lp8,D,47,71,24,VFITLITGLYLVTNALFALAYLAC,0
4lp8,D,87,99,12,FFSVQTMATIGY,0
4lp8,D,108,132,24,ANTLVTLEALCGMLGLAVAARLIY,0
4lp8,D,133,299,166,RFTRPTAGVLFSSRMVISDFEGKPTLMMRLANLRIEQIIEADVHLVLVRSEISQEGMVFRRFHDLTLTRSRLPIFSLSWTVMHPIDHHSPIYGETDETLRNSHSEFLVLFTGHHEAFAQNVHARHAYSCDEIIWGGHFVDVFTTLPDGRRALDLGKFHEIAQHHHH,0
4lp8,D,300,301,1,H,0
3g60,A,1,32,31,ELEEDLKGRADKNFSKMGKKSKKEKKEKKPA,0
3g60,A,34,39,5,VLTMF,0
3g60,A,45,68,23,DRLYMLVGTLAAIIHGVALPLMM,0
3g60,A,69,114,45,IFGDMTDSFASVGNVSKNSTNMSEADKRAMFAKLEEEMTTYAYYY,0
3g60,A,115,135,20,GIGAGVLIVAYIQVSFWCLA,0
3g60,A,184,203,19,KIGMFFQAMATFFGGFIIG,0
3g60,A,204,214,10,TRGWKLTLVI,0
3g60,A,215,233,18,AISPVLGLSAGIWAKILS,0
3g60,A,291,310,19,NISMGAAFLLIYASYALAF,0
3g60,A,311,330,19,YGTSLVISKEYSIGQVLTV,0
3g60,A,331,349,18,FSVLIGAFSVGQASPNIE,0
3g60,A,627,683,56,GNEIELGNEACKSKDEIDNLDMSSKDSGSSLIRRRSTRKSICGPHDQDRKLSTKEA,0
3g60,A,695,702,7,ILKLNST,0
3g60,A,708,728,20,VGIFCAIINGGLQPAFSVIF,0
3g60,A,729,752,23,KVVGVFTNGGPPETQRQNSNLFS,0
3g60,A,753,773,20,LFLILGIISFITFFLQGFTF,0
3g60,A,829,847,18,AVIFQNIANLGTGIIISL,0
3g60,A,848,853,5,YGWQL,0
3g60,A,854,872,18,LLLLAIVPIIAIAGVVEM,0
3g60,A,932,952,20,VFGITFSFTQAMMYFSYAAC,0
3g60,A,953,971,18,RFGAYLVTQQLMTFENVL,0
3g60,A,972,990,18,VFSAIVFGAMAVGQVSSF,0
3g60,A,1272,1284,12,AKRSYVHHHHHH,0
4pa7,F,126,130,4,SHMG,0
4pa7,F,132,152,20,SVAALLTVVFYIAAVMATNL,0
4pa7,F,153,163,10,GATFPEWFGD,0
4pa7,F,164,181,17,SKSLYTLFQVMTLESWS,0
4pa7,F,182,191,9,GIVRPVMNV,0
4pa7,F,192,194,2,PN,0
4pa7,F,195,218,23,WVFFIPFIMLTTFTVLNLFIGII,0
4pa7,F,221,274,53,MAITKEQEEEAKTGHHQEPISQTLLHLGDRLDRIEKQLAQNNELLQRQQPQKK,0
4ryr,A,9,27,18,VFFLTYGLFYVSSVLFPI,0
4ryr,A,29,34,5,TWYDA,0
4ryr,A,35,45,10,EKPSWTPPGM,0
4ryr,A,46,64,18,IGMIWAVLFGLIALSVAI,0
4ryr,A,76,96,20,WFLFLLNYIFNQAFSYFQFS,0
4ryr,A,97,101,4,KNLF,0
4ryr,A,102,122,20,ATVDCLLVAITTLLLIMFSS,0
4ryr,A,127,147,20,SAWLLIPYFLWSAFATYLSW,0
4ryr,A,148,153,5,IYSIN,0
5jnq,B,6,19,13,LAIIIAFAISALL,0
5jnq,B,20,32,12,PIIIPFLHKLKF,0
5jnq,B,49,55,6,TPTMGG,0
5jnq,B,56,69,13,IILSSIIITSVFY,0
5jnq,B,77,90,13,PVLFVTVGFGIIG,0
5jnq,B,91,99,8,LDDYIKIV,0
5jnq,B,107,111,4,PMQK,0
5jnq,B,112,125,13,VGQFIITGIFAWY,0
5jnq,B,156,172,16,VPALFFIMLGTDNGVN,0
5jnq,B,173,181,8,TDGLDGLC,0
5jnq,B,182,194,12,SVTILVATFLTI,0
5jnq,B,204,218,14,PITGAVVGSLLGFL,0
5jnq,B,219,232,13,FNVYPAKVFMGDT,0
5jnq,B,233,246,13,SLALGGFVAASCY,0
5jnq,B,251,266,15,LFIPVIGLIYLVEVL,0
5jnq,B,267,305,38,VIIQVTYFKRTGGKRIFKMAPIHHHFELCGWSETRVVA,0
5jnq,B,306,319,13,FAIVTAILCMVAY,0
2xqs,P,1,15,14,ESNLTTAASVIAAA,0
2xqs,P,16,38,22,AVGIGSIGPGLGQGQAAGQAVE,0
2xqs,P,51,73,22,GTLLLSLAFMEALTIYGLVVAL,0
2xqs,P,74,82,8,LLFANPFV,0
2xq2,B,58,73,15,SLIAANISAEQFIGM,0
2xq2,B,74,84,10,GSGYSIGLAI,0
2xq2,B,85,97,12,SYEWMSAITLII,0
2xq2,B,130,150,20,AVFWISLYIFVNLTSVLYLG,0
2xq2,B,151,166,15,LALETILGIPLMYSI,0
2xq2,B,167,179,12,GLALFALVYSIY,0
2xq2,B,180,185,5,GLSAV,0
2xq2,B,187,201,14,TDVIQVFFLVLGGF,0
2xq2,B,202,219,17,TTYMAVSFIGGTDGWFA,0
2xq2,B,220,221,1,V,0
2xq2,B,222,246,24,KMVDAAPGHFEMILDQSNPQYMNL,0
2xq2,B,247,268,21,GIAVLIGGLWVANLYYWGFNQ,0
2xq2,B,288,302,14,FAAFLALIVPFLVV,0
2xq2,B,303,323,20,PGIAAYVITSDPQLMASLGD,0
2xq2,B,324,329,5,AATNL,0
2xq2,B,330,336,6,SAANAD,0
2xq2,B,337,343,6,AYPWLT,0
2xq2,B,344,346,2,FL,0
2xq2,B,347,349,2,VG,0
2xq2,B,350,353,3,KGV,0
2xq2,B,354,374,20,FAALAAAIVSSLASMLNSTA,0
2xq2,B,400,414,14,TAAVVALIIAALIA,0
2xq2,B,415,423,8,MLGGIGQC,0
2xq2,B,424,440,16,QYIQEYTGLVSPGILA,0
2xq2,B,460,473,13,VASIPFALFLKFM,0
2xq2,B,474,478,4,LSMP,0
2xq2,B,479,493,14,MDQMLYTLLFTMVV,0
2xq2,B,527,541,14,AYGIMIVLAVLYTL,0
2xq2,B,542,555,13,WVNADAEITLIIF,0
2xq2,B,556,572,16,VMAGVIGTILLISYGI,0
2xq2,B,574,593,19,LIKASYKSGGSPGHHHHHH,0
5da0,A,14,21,7,REWFANP,0
5da0,A,22,47,25,KDVLAGIVVALALIPEAIAFSIIAG,0
5da0,A,53,68,15,LYASFIIALITAFLG,0
5da0,A,69,73,4,RPGM,0
5da0,A,74,90,16,SAATGAMALLMTGLVK,0
5da0,A,97,113,16,FAATVLTGVLQVVFGW,0
5da0,A,114,116,2,KL,0
5da0,A,117,122,5,RYLKF,0
5da0,A,123,130,7,PRSVMVG,0
5da0,A,131,147,16,VNALAILIFMAQLPQF,0
5da0,A,155,172,17,AMVAAGLAIIYLLPLVF,0
5da0,A,174,187,13,MPSALVAIVVLTV,0
5da0,A,221,239,18,ETLAIIFPVALTLSLVGL,0
5da0,A,240,262,22,ESLLTAQLIDERTDTTSDKNVE,0
5da0,A,263,277,14,RGQGVANIVTGFFG,0
5da0,A,279,288,9,AGCAMIGQS,0
5da0,A,289,299,10,INVTSGGRGR,0
5da0,A,300,313,13,STFVAGAFLMVLI,0
5da0,A,326,340,14,ALVAVMMVVAISTF,0
5da0,A,341,346,5,WGSLR,0
5da0,A,351,484,133,PKGETVVMLATVAVTVFTHDLSLGVLIGVVLSALFFARKVSQLSQVTPVDEVDGTRTYRVRGQLFFVSTHDFLHQFDFTHPARRVVIDLSDAHFWDGSAVGALDKVMLKFMRQGTSVELRGLNAASATLVERL,0
4ezd,C,1,30,29,DDNPTAVKLDQGGNQAPQGRGRRCLPKAL,0
4ezd,C,31,37,6,YITGDM,0
4ezd,C,38,44,6,EFANWL,0
4ezd,C,45,48,3,DKP,0
4ezd,C,49,67,18,ALQFVDWVLRGISQVVFV,0
4ezd,C,69,83,14,PISGILILVGLLVQ,0
4ezd,C,88,105,17,LNGCVGTVVSTLTALLL,0
4ezd,C,106,115,9,QDRSAITAG,0
4ezd,C,116,128,12,QGYNATLVGILM,0
4ezd,C,143,160,17,PVSAMSMTCPVFSSALN,0
4ezd,C,161,169,8,VLSKWDLP,0
4ezd,C,170,182,12,FTLPFNMALSMY,0
4ezd,C,222,231,9,VGVGQIYGC,0
4ezd,C,236,249,13,GGIFLGAILLSSP,0
4ezd,C,251,265,14,CLHAAIGSLLGIIA,0
4ezd,C,282,295,13,FNSSLACIAIGGT,0
4ezd,C,296,301,5,MALTW,0
4ezd,C,302,321,19,THLLALACALFTAYLGASM,0
4ezd,C,333,347,14,TWPFCLATLLFLLL,0
4ezd,C,348,376,28,TKNPNIYKMPISKVTYPEENRIFYLQSR,0
4ezd,C,377,384,7,RTVQGPL,0
5te3,B,1,36,35,NGTEGPNFYVPFSNKTGVVRSPFEAPQYYLAEPWQ,0
5te3,B,37,63,26,SMLAAYMFLLIMLGFPINFLTLYVTV,0
5te3,B,75,98,23,LLNLAVADLFMVFGGFTTTLYTS,0
5te3,B,99,109,10,HGYFVFGPTG,0
5te3,B,110,133,23,NLEGFFATLGGEIALWSLVVLAI,0
5te3,B,154,176,22,MGVAFTWVMALACAAPPLVGWS,0
5te3,B,177,198,21,YIPEGMQCSCGIDYYTPHEET,0
5te3,B,199,222,23,NESFVIYMFVVHFIIPLIVIFFC,0
5te3,B,255,279,24,IMVIAFLICWLPYAGVAFYIFTHQ,0
5te3,B,280,286,6,SDFGPI,0
5te3,B,287,309,22,MTIPAFFAKTSAVYNPVIYIMM,0
5te3,B,311,321,10,QFRNCMVTTL,0
2hvk,F,1,21,20,APMLSGLLARLVKLLLGRHG,0
2hvk,F,22,24,2,AL,0
2hvk,F,25,50,25,WRAAGAATVLLVIVLLAGSYLAVLA,0
2hvk,F,63,79,16,RALWWSVETATTVGYG,0
2hvk,F,87,113,26,GRCVAVVVMVAGITSFGLVTAALATW,0
2hvk,F,114,124,10,VGREQERRGH,0
2akh,C,17,19,2,KW,0
2akh,C,20,32,12,VVVALLLVAIVG,0
2akh,C,49,60,11,ILIAAAGGVAL,0
2akh,C,61,97,36,TTKGKATVAFAREARTEVRKVIWPTRQETLHTTLIV,0
2akh,C,98,115,17,AVTAVMSLILWGLDGIL,0
5x3x,q,1,4,3,SIA,0
5x3x,q,5,11,6,IDRVAA,0
5x3x,q,12,21,9,GHWRSRPLA,0
5x3x,q,22,37,15,KSLIGLGFLALAVTV,0
5x3x,q,43,61,18,VLVTVAILAFTFLGARVP,0
5x3x,q,62,83,21,RFWASVAVLPLGFLTTGAAVL,0
5x3x,q,105,122,17,VMRATAATCCLLFLATT,0
5x3x,q,123,124,1,P,0
5x3x,q,125,134,9,ADLLSGLRR,0
5x3x,q,135,222,87,RVPAELIEIALLTYRFVFILAEEAAAMTTAQRARLGHATRRRWLRSTAQVIAALLPRALTRARRLETGLGARNWQGEMRVLSTRPPA,0
5x3x,q,223,238,15,ARVLGLILTLQAAIL,0
5ahz,C,20,28,8,AAVRENAL,0
5ahz,C,29,52,23,SSSLWVNVALAGIAILVFVYMGR,0
5ahz,C,63,82,19,GATLMIPLVSISSYLGLLS,0
5ahz,C,83,104,21,LTVGMIEMPAGHALAGEMVRS,0
5ahz,C,105,124,19,WGRYLTWALSTPMILLALG,0
5ahz,C,133,154,21,LFTVIAADIGMCVTGLAAAMT,0
5ahz,C,155,159,4,SALL,0
5ahz,C,160,180,20,RWAFYAISCAFFVVVLSALV,0
5ahz,C,199,221,22,RVLTVVLWLGYPIVWAVGVEGL,0
5ahz,C,222,228,6,LVQSVG,0
5ahz,C,229,251,22,TSWAYSVLDVFAKYVFAFILLR,0
2o01,4,34,40,6,ENLRWF,0
2o01,4,41,57,16,QAELVNGRWAMLGVAG,0
2o01,4,92,108,16,IEFILSHYVEIRRWQD,0
2o01,4,109,150,41,KNPGSVNQDPIFKQYSLPAGEVGYPGGIFNPLNFAPTLEAK,0
2o01,4,151,168,17,KEIANGRLAMLAFLGFI,0
4k7q,C,1,6,5,PNFFI,0
4k7q,C,7,10,3,RPI,0
4k7q,C,11,27,16,AWVIAIIIMLAGGLAI,0
4k7q,C,341,357,16,KTLVEAIILVFLVMYL,0
4k7q,C,358,365,7,LQNFRAT,0
4k7q,C,366,386,20,IPTIAVPVVLLGTFAVLAAF,0
4k7q,C,396,411,15,GMVLAIGLLVDDAIV,0
4k7q,C,412,441,29,VENVERVMAEEGLPPKEATRKSMGQIQGA,0
4k7q,C,442,458,16,VGIAMVLSAVFVPMAF,0
4k7q,C,471,489,18,ITIVSAMALSVLVALILT,0
4k7q,C,490,498,8,ALCATMLK,0
4k7q,C,499,512,13,IAKGDHGEGKKGF,0
4k7q,C,514,524,10,WFNRMFEKST,0
4k7q,C,526,536,10,YTDSVGGILR,0
4k7q,C,537,540,3,TGR,0
4k7q,C,541,557,16,LVLYLIIVVGMAYLFV,0
4k7q,C,865,868,3,ERL,0
4k7q,C,875,892,17,LYAISLIVVFLCLAALY,0
4k7q,C,893,895,2,SW,0
4k7q,C,896,919,23,IPFSVMLVVPLGVIGALLAATFR,0
4k7q,C,928,944,16,VGLLTTIGLSAKNAIL,0
4k7q,C,945,962,17,VEFAKDLMDKEGKGLIE,0
4k7q,C,963,968,5,TLDAV,0
4k7q,C,969,974,5,MRLRP,0
4k7q,C,975,992,17,LMTSLAFILGVMPLVIS,0
4k7q,C,1004,1021,17,TGVMGGMVTATVLAIFF,0
4k7q,C,1022,1025,3,PVF,0
4k7q,C,1026,1032,6,VVVRRR,0
4k7q,C,1033,1036,3,SRK,0
4k7q,C,1037,1053,16,EDIEHSHTVDHHHHHH,0
1oz5,A,1,24,23,RTLNTSAMDGTGLVVERDFSVRI,0
1oz5,A,25,29,4,TACF,0
1oz5,A,30,49,19,SLLILSTLLGNTLVCAAVI,0
1oz5,A,60,79,19,FFVISLAVSDLLVAVLVMP,0
1oz5,A,80,101,21,KAVAEIAGFWPFGSFCNIWVA,0
1oz5,A,102,119,17,DIMCSTASILNLCVISV,0
1oz5,A,141,157,16,ILISVAWTLSVLISFI,0
1oz5,A,158,196,38,VQLSWHKAKPTSPSDGNATSLAETIDNCDSSLSRTYAI,0
1oz5,A,197,216,19,SSVISFYIPVAIMIVTYTR,0
1oz5,A,273,290,17,LSVIMGVFVCCWLPFFI,0
1oz5,A,291,318,27,NCILPFCGSGETQPFCIDSNTFDVFVW,0
1oz5,A,319,333,14,GWANSSLNPIIYAF,0
1oz5,A,338,344,6,KAFSTL,0
1oz5,A,347,446,99,YRLCPATNNAIETVSINNNGAAMFSSHHEPRGSISKECNLVYLIPHAVGSSEDLKKEEAAGIARPLEKLSPALSVILDYDTDVSLEKIQPITQNGQHPT,0
1tn0,C,1,4,3,AQI,0
1tn0,C,5,9,4,GRPE,0
1tn0,C,10,34,24,IWLALGTALMGLGTLYFLVKGMGV,0
1tn0,C,41,62,21,FYAITTLVPPIAFTMYLSMLL,0
1tn0,C,63,78,15,YGLTMVPFGGEQNPI,0
1tn0,C,79,100,21,WARYADWLFTTPLLLLDLALL,0
1tn0,C,104,128,24,QGTILALVGADGIMIGTGLVGALT,0
1tn0,C,129,133,4,VYSY,0
1tn0,C,134,157,23,FVWWAISTAAMLYILYVLFFGFT,0
1tn0,C,171,195,24,KVLRNVTVVLWSAYPVVWLIGSEG,0
1tn0,C,196,202,6,GIVPLN,0
1tn0,C,203,226,23,ETLLFMVLDVSAKVGFGLILLRS,0
1tn0,C,232,249,17,AEAPEPSAGDGAAATSD,0
5vhw,D,527,540,13,CIVFAYIGVSVVL,0
5vhw,D,541,544,3,LVS,0
5vhw,D,573,577,4,FNSL,0
5vhw,D,578,590,12,FSLGAFMQQGCD,0
5vhw,D,591,597,6,SPRSLS,0
5vhw,D,598,613,15,RIVGGVWWFFTLIII,0
5vhw,D,796,809,13,YILVGGLGLAMLV,0
5vhw,D,810,817,7,LIEFCYK,0
1clt,M,1,51,50,EYQNFFNQVQVAGAPEMGLKEDVDTFERTPAGMFNILGWMGNAQIGPIYL,0
1clt,M,52,71,19,IAGTVSLAFGAAWFFTIGV,0
1clt,M,115,132,17,ASLFMAISVIAWWVRVY,0
1clt,M,133,143,10,RADQLGMGKH,0
1clt,M,144,162,18,AWAFLSAIWLWSVLGFWR,0
1clt,M,181,190,9,DWTNQFSLD,0
1clt,M,198,219,21,FHGLSIAALYGSALLFAMHGA,0
1clt,M,220,265,45,ILAVTRFGGERELEQIVDRGTASERAALFWRWTMGFNATMEGIHR,0
1clt,M,266,284,18,AIWMAVMVTLTGGIGILL,0
1clt,M,292,299,7,YVWAQVH,0
1oy9,C,1,6,5,PNFFI,0
1oy9,C,11,27,16,AWVIAIIIMLAGGLAI,0
1oy9,C,28,340,312,KLPVAQYPTIAPPAVTISASYPGADAKTVQDTVTQVIEQNMNGIDNLMYMSSNSDSTGTVQITLTFESGTDADIAQVQVQNKLQLAMPLLPQEVQQQGVSVEKSSSSFLMVVGVINTDGTMTQEDISDYVAANMKDAISRTSGVGDVQLFGSQYAMRIWMNPNELNKFQLTPVDVITAIKAQNAQVAAGQLGGTPPVKGQQLNASIIAQTRLTSTEEFGKILLKVNQDGSRVLLRDVAKIELGGENYDIIAEFNGQPASGLGIKLATGANALDTAAAIRAELAKMEPFFPSGLKIVYPYDTTPFVKISIHEV,0
1oy9,C,341,357,16,KTLVEAIILVFLVMYL,0
1oy9,C,366,386,20,IPTIAVPVVLLGTFAVLAAF,0
1oy9,C,387,394,7,FSINTLT,0
1oy9,C,395,411,16,FGMVLAIGLLVDDAIV,0
1oy9,C,442,458,16,VGIAMVLSAVFVPMAF,0
1oy9,C,459,468,9,GGSTGAIYR,0
1oy9,C,469,489,20,FSITIVSAMALSVLVALILT,0
1oy9,C,499,512,13,IAKGDHGEGKKGF,0
1oy9,C,514,524,10,WFNRMFEKST,0
1oy9,C,526,536,10,YTDSVGGILR,0
1oy9,C,541,557,16,LVLYLIIVVGMAYLFV,0
1oy9,C,558,710,152,LPSSFLPDEDQGVFMTMVQLPAGATQERTQKVLNEVTHYYLTKEKNNVESVFAVNGFGFAGRGQNTGIAFVSLKDWADRPGEENKVEAITMRATRAFSQIKDAMVFAFNLPAIVELGTATGFDFELIDQAGLGHEKLTQARNQLLAEAAKHP,0
1oy9,C,712,859,147,LTSVRPNGLEDTPQFKIDIDQEKAQALGVSINDINTTLGAAWGGSYVNDFIDRGRVKKVYVMSEAKYRMLPDDIGDWYVRAADGQMVPFSAFSSSRWEYGSPRLERYNGLPSMEILGQAAPGKSTGEAMELMEQLASKLPTGVGYDW,0
1oy9,C,860,868,8,GMSYQERL,0
1oy9,C,869,873,4,GNQA,0
1oy9,C,874,891,17,SLYAISLIVVFLCLAAL,0
1oy9,C,898,919,21,FSVMLVVPLGVIGALLAATFR,0
1oy9,C,920,926,6,LTNDVY,0
1oy9,C,927,943,16,QVGLLTTIGLSAKNAI,0
1oy9,C,975,993,18,LMTSLAFILGVMPLVIST,0
1oy9,C,994,1000,6,AGSGAQ,0
1oy9,C,1001,1021,20,AVGTGVMGGMVTATVLAIFF,0
1oy9,C,1026,1032,6,VVVRRR,0
1oy9,C,1037,1049,12,EDIEHSHTVDHH,0
1ozc,A,1,46,45,EPAPSAGAELQPPLFANASDAYPSACPSAGANASGPPGARSASSL,0
1ozc,A,47,54,7,LAIAITA,0
1ozc,A,55,73,18,YSAVCAVGLLGNVLVMFG,0
1ozc,A,87,105,18,IFNLALADALATSTLPFQ,0
1ozc,A,106,123,17,AKYLMETWPFGELLCKA,0
1ozc,A,124,144,20,LSIDYYNMFTSIFTLTMMSV,0
1ozc,A,167,184,17,INICIWVLASGVGVPIM,0
1ozc,A,185,187,2,MA,0
1ozc,A,188,206,18,TRPRDGAVVCMLQFPSPS,0
1ozc,A,207,213,6,YWDTVT,0
1ozc,A,214,234,20,ICVFLFAFVVPILIITVCYG,0
1ozc,A,263,280,17,LVVVGAFVVCWAPIHIF,0
1ozc,A,281,303,22,IVWTLVDIDRRDPLVVAALHLC,0
1ozc,A,304,320,16,ALGYANSSLNPVLYAF,0
1ozc,A,323,329,6,NFKRCF,0
1ozc,A,334,372,38,KPCGRPDPSSFSRAREATARERVTACTPSDGPGGGAAA,0
4k5y,A,103,114,11,EILNEEKKSKV,0
4k5y,A,115,122,7,YHVAAII,0
4k5y,A,123,143,20,YLGHCISLVALLVAFVLFLR,0
4k5y,A,153,171,18,IHANLIAAFILRNATWFV,0
4k5y,A,172,193,21,QLTMSPEVHQSNVGWCRLVTA,0
4k5y,A,194,212,18,YNYFHVTNFFWMFGEGCY,0
4k5y,A,229,247,18,MFICIGWGVPFPIIVAWA,0
4k5y,A,248,269,21,GKLYYDNEKCWAGKRPGVYTD,0
4k5y,A,270,289,19,IYQGPMALVLLINFIFLFN,0
4k5y,A,313,332,19,KATLVLLPLLGITYMLAFV,0
4k5y,A,334,337,3,GED,0
4k5y,A,339,346,7,SRVVFIY,0
4k5y,A,347,366,19,NAFLESFQGFFVSVFACFL,0
4k5y,A,369,386,17,VRSAAAAHHHHHHHHHH,0
3e89,E,19,22,3,KDK,0
3e89,E,23,25,2,FQ,0
3e89,E,26,45,19,LFVLTILTLISGTIFYSTV,0
3e89,E,51,67,16,DALYFSVVTLTTVGDG,0
3e89,E,75,96,21,GKIFTILYIFIGIGLVFGFIH,0
3e89,E,97,103,6,LAVNVQ,0
3e89,E,104,110,6,PSILSN,0
3e89,E,111,113,2,VP,0
5dwk,B,8,27,19,RIIKAAGYSWKGLRAAWIN,0
5dwk,B,34,48,14,GVAVLLCVVIAAWL,0
5dwk,B,49,52,3,VDA,0
5dwk,B,53,67,14,TRVLLISSVMLVMI,0
5dwk,B,106,120,14,AIIDAVITWAILLW,0
5dwk,B,121,123,2,HF,0
1jgz,H,1,10,9,VGVTAFGNF,0
1jgz,H,16,32,16,IYSFWIFLAGLIYYLQ,0
1jgz,H,33,246,213,ENMREGYPLENEDGTPAANQGPFPLPKPKTFILPHGRGTLTVPGPESEDRPIALARTAVSEGFPHAPTGDPMKDGVGPASWVARRDLPELDGHGHNKIKPMKAAAGFHVSAGKNPIGLPVRGCDLEIAGKVVDIWVDIPEQMARFLEVELKDGSTRLLPMQMVKVQSNRVHVNALSSDLFAGIPTIKSPTEVTLLEEDKICGYVAGGLMYAAP,0
1jgz,H,247,260,13,RKSVVAAMLAEYA,0
4bew,A,49,74,25,WELVIEQFEDLLVRILLLAACISFV,0
4bew,A,75,88,13,AWFEEGEETITAF,0
4bew,A,89,107,18,EPFVILLILIANAIVGVW,0
4bew,A,254,277,23,EFGEQLSKVISLICVAVWLINIG,0
4bew,A,278,295,17,FNDPVHGGSWIRGAIYY,0
4bew,A,296,317,21,KIAVALAVAAIPEGLPAVITT,0
4bew,A,760,781,21,IRYLISSNVGEVVCIFLTAAL,0
4bew,A,782,785,3,LPE,0
4bew,A,786,807,21,LIPVQLLWVNLVTDGLPATAL,0
4bew,A,832,852,20,LFFRYMAIGGYVGAATVGAA,0
4bew,A,853,897,44,WWFMYAEDGPGVTYHQLTHFMQCTEDHPHFEGLDCEIFEAPEPM,0
4bew,A,898,916,18,MALSVLVTIEMCNALNSL,0
4bew,A,931,950,19,WLLGSICLSMSLHFLILYV,0
4bew,A,951,967,16,PLPMIFKLKALDLTQW,0
4bew,A,968,987,19,MVLKISLPVIGLDEILKFI,0
4ysz,D,56,78,22,TLFKIERYFAAAMVPLIPAAYF,0
4ysz,D,79,84,5,HGREM,0
4ysz,D,85,108,23,LCLALALTLHVHWGVWGVVNDYG,0
4ysz,D,117,139,22,AAAVRVGAYIFTACLLAGLLYF,0
4ysz,D,140,145,5,EHDVG,0
4ysz,D,146,154,8,TRAFEMVW,0
4ysz,D,155,156,1,L,0
1mmh,7,264,272,8,PLWLMYLA,0
1mmh,7,273,287,14,VLSHTNSVVNPFIY,0
5f5k,A,94,108,14,PVTWVMMIACVVVF,0
5f5k,A,116,123,7,QEVMLWL,0
5f5k,A,137,143,6,YFTHAL,0
5f5k,A,149,166,17,HILFNLLWWWYLGGAVE,0
5f5k,A,167,170,3,RLG,0
5f5k,A,171,188,17,GKLIVITLISALLSGYV,0
5f5k,A,200,214,14,SGVVFALMGYVWLR,0
5f5k,A,215,225,10,ERDPQSGIYL,0
5f5k,A,226,241,15,RGLIIFALIWIVAGW,0
5f5k,A,251,268,17,GAHIAGLAVGLAMAFVD,0
5f5k,A,269,272,3,LNA,0
4pyp,A,1,8,7,EPSSKKL,0
4pyp,A,14,36,22,AVGGAVLGSLQFGYNTGVINAP,0
4pyp,A,37,52,15,KVIEEFYTQTWVHRY,0
4pyp,A,53,65,12,ESILPTTLTTLW,0
4pyp,A,66,87,21,LSVAIFSVGGMIGSFSVGLFV,0
4pyp,A,93,113,20,NSMLMMNLLAFVSAVLMGFS,0
4pyp,A,114,120,6,LGKSFE,0
4pyp,A,121,141,20,LILGRFIIGVYCGLTTGFVP,0
4pyp,A,158,176,18,LHQLGIVVGILIAQVFGL,0
4pyp,A,177,186,9,SIMGNKDLW,0
4pyp,A,187,207,20,LLLSIIFIPALLQCIVLPFC,0
4pyp,A,259,264,5,LELFR,0
4pyp,A,273,295,22,IAVVLQLSQQLSGINAVFYYST,0
4pyp,A,296,307,11,IFEKAGVQQPV,0
4pyp,A,308,328,20,ATIGSGIVNTAFTVVSLFVV,0
4pyp,A,334,354,20,TLHLIGLAGMAGCAILMTIA,0
4pyp,A,355,366,11,ALLEQLPWMSY,0
4pyp,A,367,389,22,SIVAIFGFVAFFEVGPGPIPWF,0
4pyp,A,405,426,21,VAGFSNWTSNFIVGMCFQYVE,0
4pyp,A,427,432,5,LCGPY,0
4pyp,A,433,452,19,FIIFTVLLVLFFIFTYFKV,0
4pyp,A,456,504,48,GRTFDEIASGFRQGGASQSDKTPEELFHPLGADSQVLEHHHHHHHHHH,0
1z9j,C,1,10,9,VGVTAFGNF,0
1z9j,C,11,15,4,LASL,0
1z9j,C,16,32,16,IYSFWIFLAGLIYYLQ,0
1z9j,C,249,260,11,SVVAAMLAEYA,0
1t78,A,1,26,25,QAVDNLTSAPGNTSLCTRDYKITQV,0
1t78,A,27,47,20,FPLLYTVLFFVGLITNGLAM,0
1t78,A,63,80,17,KNTVISDLLMILTFPFK,0
1t78,A,81,101,20,LSDAKLGTGPLRTFVCQVTS,0
1t78,A,102,121,19,IFYFTMYISISFLGLITID,0
1t78,A,145,157,12,VVIWAFMFLLSL,0
1t78,A,158,190,32,NMILTNRQPRDKNVKKCSFLKSEFGLVWHEIV,0
1t78,A,191,211,20,YICQVIFWINFLIVIVCYTL,0
1t78,A,238,258,20,FIIIAVFFICFVPFHFARIP,0
1t78,A,259,275,16,TLSQTRDVFDCTAENT,0
1t78,A,276,300,24,FYVKESTLWLTSLNACLDPFIYFF,0
1t78,A,303,313,10,SFRNSLISML,0
4u14,A,63,66,3,IWQ,0
4u14,A,67,87,20,VFIAFLTGFLALVTIIGNIL,0
4u14,A,109,129,20,ACADLIIGVISMNLFTTYII,0
4u14,A,130,138,8,NRWALGNL,0
4u14,A,139,159,20,CDLWLSIDYVASNASVMNLL,0
4u14,A,190,210,20,AWVISFVLWAPAILFWQYFV,0
4u14,A,211,220,9,KRTVPPGEC,0
4u14,A,221,245,24,IQFLSEPTITFGTAIAAFYMPVTI,0
4u14,A,496,516,20,LAFIITWTPYNIMVLVNTFC,0
4u14,A,517,519,2,SC,0
4u14,A,520,542,22,PKTYWNLGYWLCYINSTVNPVC,0
4u14,A,548,556,8,TFRTTFKT,0
1jh0,H,1,10,9,VGVTAFGNF,0
1jh0,H,16,31,15,IYSFWIFLAGLIYYL,0
1jh0,H,32,248,216,TENMREGYPLENEDGTPAANQGPFPLPKPKTFILPHGRGTLTVPGPESEDRPIALARTAVSEGFPHAPTGDPMKDGVGPASWVARRDLPELDGHGHNKIKPMKAAAGFHVSAGKNPIGLPVRGCDLEIAGKVVDIWVDIPEQMARFLEVELKDGSTRLLPMQMVKVQSNRVHVNALSSDLFAGIPTIKSPTEVTLLEEDKICGYVAGGLMYAAPKR,0
1jh0,H,249,260,11,SVVAAMLAEYA,0
1z98,D,1,23,22,SKEVSEEAQAHQHGKDYVDPPP,0
1z98,D,41,58,17,IAEFIATLLFLYITVAT,0
1z98,D,59,75,16,IGHSKETVVCGSVGLL,0
1z98,D,76,93,17,IAWAFGGMIFVLVYCTA,0
1z98,D,97,110,13,GHINPAVTFGLFL,0
1z98,D,119,137,18,LVYMIAQCLGAICGVGLV,0
1z98,D,138,141,3,AFM,0
1z98,D,142,147,5,GPYNQ,0
1z98,D,148,162,14,GGGANSVALGYNKG,0
1z98,D,163,182,19,ALGAEIIGTFVLVYTVFSA,0
1z98,D,198,214,16,PLPIGFAVFMVHLATI,0
1z98,D,215,217,2,IT,0
1z98,D,218,232,14,TGINPARSFGAAVI,0
1z98,D,233,242,9,NSNKVWDDQ,0
1z98,D,243,260,17,IFWVGPFIGAAVAAAYH,0
1z98,D,275,281,6,RSNPTN,0
2h88,D,1,2,1,S,0
2h88,D,9,28,19,WTSERAVSALLLGLLPAAY,0
2h88,D,29,34,5,YPGPA,0
2h88,D,35,55,20,DYSLAAALTLHGHWGLGQVI,0
2h88,D,67,87,20,ANTGLYVLSAITFTGLCYFN,0
2h88,D,88,92,4,YDVG,0
2h88,D,93,101,8,CKAVAMLW,0
2h88,D,102,103,1,I,0
5dys,A,1,39,38,CGTEGPNFYVPFSNKTGVVRSPFEAPQYYLAEPWQFSM,0
5dys,A,40,63,23,AAYMFLLIMLGFPINFLTLYVTV,0
5dys,A,74,95,21,ILLNLAVADLFMVFGGFTTIL,0
5dys,A,96,112,16,TSLHGYFVFGPTGCNL,0
5dys,A,113,134,21,GFFATLGGEIALWSLVVLAIE,0
5dys,A,153,172,19,IMGVAFTWVMALACAAPPL,0
5dys,A,173,202,29,GWSRYIPEGMQCSCGIDYYTPHEETNNES,0
5dys,A,203,224,21,VIYMFVVHFIIPLIVIFFCYG,0
5dys,A,254,274,20,IIMVIAFLICWLPYAGVAFY,0
5dys,A,275,289,14,FTHQGSCFGPIFMT,0
5dys,A,290,309,19,PAFFAKTSAVYNPVIYIMM,0
5dys,A,311,321,10,QFRNCMVTTL,0
1t9v,C,1,6,5,PNFFI,0
1t9v,C,11,25,14,AWVIAIIIMLAGGL,0
1t9v,C,26,341,315,ILKLPVAQYPTIAPPAVTISASYPGADAKTVQDTVTQVIEQNMNGIDNLMYMSSNSDSTGTVQITLTFESGTDADIAQVQVQAKLQLAMPLLPQEVQQQGVSVEKSSSSFLMVVGVINTDGTMTQEDISDYVAANMKDAISRTSGVGDVQLFGSQYAMRIWMNPNELNKFQLTPVDVITAIKAQNAQVAAGQLGGTPPVKGQQLNASIIAQTRLTSTEEFGKILLKVNQDGSRVLLRDVAKIELGGENYDIIAEFNGQPASGLGIKLATGANALDTAAAIRAELAKMEPFFPSGLKIVYPYDTTPFVKISIHEVV,0
1t9v,C,342,357,15,TLVEAIILVFLVMYL,0
1t9v,C,366,382,16,IPTIAVPVVLLGTFAV,0
1t9v,C,383,397,14,AAFGFSINTLTMFG,0
1t9v,C,398,411,13,VLAIGLLVDDAIV,0
1t9v,C,442,456,14,VGIAMVLSAVFVPM,0
1t9v,C,457,469,12,FFGGSTGAIYRQ,0
1t9v,C,472,489,17,TIVSAMALSVLVALILT,0
1t9v,C,499,512,13,IAKGDHGEGKKGF,0
1t9v,C,514,524,10,WFNRMFEKST,0
1t9v,C,529,536,7,SVGGILR,0
1t9v,C,541,556,15,LVLYLIIVVGMAYLF,0
1t9v,C,557,861,304,RLPSSFLPDEDQGVFMTMVQLPAGATQERTQKVLNEVTHYYLTKEKNNVESVFAVNGFGFAGRGQNTGIAFVSLKDWADRPGEENKVEAITMRATRAFSQIKDAMVFAFNLPAIVELGTATGFDFELIDQAGLGHEKLTQARNQLLAEAAKHPDMLTSVRPNGLEDTPQFKIDIDQEKAQALGVSINDINTTLGAAWGGSYVNDFIDRGRVKKVYVMSEAKYRMLPDDIGDWYVRAADGQMVPFSAFSSSRWEYGSPRLERYNGLPSMEILGQAAPGKSTGEAMELMEQLASKLPTGVGYDWTG,0
1t9v,C,863,876,13,YQERLSGNQAPSL,0
1t9v,C,877,891,14,AISLIVVFLCLAAL,0
1t9v,C,898,916,18,FSVMLVVPLGVIGALLAA,0
1t9v,C,917,929,12,FRGLTNDVYFQV,0
1t9v,C,930,943,13,LLTTIGLSAKNAI,0
1t9v,C,976,992,16,MTSLAFILGVMPLVIS,0
1t9v,C,993,1003,10,GAGSGAQNAV,0
1t9v,C,1004,1021,17,TGVMGGMVTATVLAIFF,0
1t9v,C,1026,1032,6,VVVRRR,0
1t9v,C,1037,1049,12,EDIEHSHTVDHH,0
3iz2,F,7,17,10,TILGGVNKHS,0
3iz2,F,19,45,26,IGKIWLTVLFIFRIMILVVAAKEVWG,0
3iz2,F,70,93,23,ISHIRLWALQLIFVSTPALLVAM,0
3iz2,F,94,109,15,VAYRRHEKKRKFIKG,0
3iz2,F,110,124,14,IKSEFKDIEEIKTQ,0
3iz2,F,125,134,9,VRIEGSLWW,0
3iz2,F,135,158,23,YTSSIFFRVIFEAAFMYVFYVMY,0
3iz2,F,187,215,28,KTVFTVFMIAVSGICILLNVTELCYLLI,0
3iz2,F,216,217,1,Y,0
3iz2,F,218,238,20,SGKSKKPVLVPRGSHHHHHH,0
2cps,A,1,7,6,EGDDPA,0
2cps,A,8,15,7,AAFNSLQ,0
2cps,A,16,19,3,SAT,0
2cps,A,20,41,21,YIGYAWAMVVVIVGATIGIKL,0
1siw,F,5,28,23,MFFFDIYPYIAGAVFLIGSWLRY,0
1siw,F,29,47,18,YGQYTWRAASSQMLDRKG,0
1siw,F,48,72,24,NLASNLFHIGILGIFVGHFFGMLT,0
1siw,F,73,78,5,HWMYE,0
1siw,F,87,114,27,KMAMFAGGASGVLCLIGGVLLLKRRLF,0
1siw,F,116,121,5,RVRAT,0
1siw,F,122,124,2,TG,0
1siw,F,125,145,20,DILILSLLVIQCALGLLTIP,0
1siw,F,183,204,21,FRLHLVLGMTLFLLFPFSRLI,0
1siw,F,205,225,20,IWSVPVEYLTRKYQLVRARH,0
2f93,D,2,28,26,LNVSRLLLPSRVRHSYTGKMGAVFIF,0
2f93,D,29,39,10,GALTVLFGAI,0
2f93,D,40,64,24,YGEVTAAAATGDAAAVQEAAVSAI,0
2f93,D,65,79,14,GLIILLGINLGLVA,0
2f93,D,80,123,43,TLGGDTAASLSTLAAKASRMGDGDLDVELETRRENSHHHHHHH,0
4ene,B,37,60,23,MAAVVGTLVGLAAVAFDKGVAWL,0
4ene,B,61,83,22,NQRMGALVHTADNYPLLLTVAF,0
4ene,B,84,97,13,CSAVLAMFGYFLV,0
4ene,B,128,142,14,PVKFFGGLGTLGGG,0
4ene,B,144,156,12,LGREGPTVQIGG,0
4ene,B,180,203,23,GAAAGLAAAFNAPLAGILFIIEE,0
4ene,B,216,232,16,AVFIGVIMSTIMYRIF,0
4ene,B,233,252,19,HEVALIDVGKLSDAPLNTL,0
4ene,B,253,277,24,LYLILGIIFGIFGPIFNKWVLGMQ,0
4ene,B,290,304,14,WVLMGGAIGGLCGL,0
4ene,B,305,337,32,GFVAPATSGGGFNLIPIATAGNFSMGMLVFIF,0
4ene,B,338,351,13,ARVITTLLCFSSG,0
4ene,B,353,368,15,GGIFAPMLALGTVLG,0
4ene,B,369,392,23,AFGMVAVELFPQYHLEAGTFAIA,0
4ene,B,393,415,22,MGALLAASIRAPLTGIILVLEM,0
4ene,B,416,422,6,DNYQLI,0
4ene,B,423,439,16,PMIITGLGATLLAQFT,0
4ene,B,459,461,2,QK,0
1skh,A,7,24,17,SWILVLFVAMWSDVGLC,0
1skh,A,25,30,5,KRPKP,0
4izm,C,1,12,11,GLYRKYIEYPV,0
4izm,C,14,31,17,KILIGLILGAIVGLILG,0
4izm,C,32,38,6,YGYAHA,0
4izm,C,39,67,28,HTYVKPFGDLFVRLLKMLVMPIVFASCV,0
4izm,C,79,107,28,RVGVKIVVYYLLTSAFAVTLGIIMARLF,0
4izm,C,108,127,19,PGAGIHLAVGGQQFQPHQA,0
4izm,C,128,140,12,PLVHILLDIVPT,0
4izm,C,141,150,9,PFGALANGQ,0
4izm,C,151,161,10,LPTIFFAIIL,0
4izm,C,174,197,23,KVRKSAETLLDAINGLAEAMYKI,0
4izm,C,198,222,24,NGVMQYAPIGVFALIAYVMAEQGV,0
4izm,C,223,229,6,VVGELA,0
4izm,C,230,254,24,VTAAVYVGLTLQILLVYFVLLKIY,0
4izm,C,262,286,24,KHAKDAMLTAFVTRSSSGTLPVTM,0
4izm,C,302,321,19,LPLGATINMDGTALYQGVA,0
4izm,C,322,338,16,FFIANALGSHLTVGQQ,0
4izm,C,339,362,23,TIVLTAVLASIGTAGVPGAGAIM,0
4izm,C,363,389,26,AMVLHSVGLPLTDPNVAAAYAMILGI,0
4izm,C,390,412,22,AILDMGRTMVNVTGDLTGTAIV,0
4izm,C,417,421,4,TLVP,0
1m56,D,1,9,8,ADHSHPAH,0
1m56,D,10,31,21,HVAGSMDITQQEKTFAGFVRM,0
1m56,D,32,49,17,TWAAVVIVAALIFLALA,0
5svq,C,21,28,7,TIGIINR,0
5svq,C,29,47,18,VQLLIISYFVGWVFLHEK,0
5svq,C,316,343,27,NIIPTIISSVAAFTSVGVGTVLCDIIL,0
5svq,C,344,346,2,NF,0
5sv0,A,2,22,20,NNLMQTDLSVWGMYQHADIV,0
5sv0,A,23,49,26,KCVMIGLILASVVTWAIFFSKSVEFF,0
5sv0,A,128,149,21,GNGYLATIGAISPFVGLFGTV,0
5sv0,A,150,180,30,GIMNSFIGIAQTQTTNLAVVAPGIAEALLA,0
5sv0,A,181,201,20,AIGLVAAIPAVVIYNVFARQ,0
2mka,B,104,130,26,PFELFFMINTSILLIFIFIVLLIHFE,0
2mka,B,131,134,3,WRI,0
3p4p,P,13,38,25,WGLFGAGGMWSAIIAPVMILLVGIL,0
3p4p,P,39,61,22,PLGLFPGDALSYERVLAFAQSF,0
3p4p,P,62,86,24,GRVFLFLMIVLPLWCGLHRMHHAM,0
3p4p,P,94,116,22,AGKWVFYGLAAILTVVTLIGVV,0
3p4p,P,117,118,1,I,0
4pa3,F,126,130,4,SHMG,0
4pa3,F,132,152,20,SVAALLTVVFYIAAVMATNL,0
4pa3,F,153,163,10,GATFPEWFGD,0
4pa3,F,164,181,17,SKSLYTLFQVMTLESWS,0
4pa3,F,182,191,9,GIVRPVMNV,0
4pa3,F,192,194,2,PN,0
4pa3,F,195,218,23,WVFFIPFIMLTTFTVLNLFIGII,0
4pa3,F,221,274,53,MAITKEQEEEAKTGHHQEPISQTLLHLGDRLDRIEKQLAQNNELLQRQQPQKK,0
1jq2,D,86,96,10,WGRCVAVVVM,0
1jq2,D,97,112,15,AGITSFGLVTAALAT,0
5cgd,A,569,575,6,VQYLRW,0
5cgd,A,580,603,23,IAAVVFACLGLLATLFVTVVFII,0
5cgd,A,604,614,10,RDTPVVKSSS,0
5cgd,A,615,637,22,ELCYIILAGICLGYLCTFCLIA,0
5cgd,A,643,667,24,CYLQRIGIGLSPAMSYSALVTKTY,0
5cgd,A,668,1038,370,AARILAMSKKNIFEMLRIDEGLRLKIYKDTEGYYTIGIGHLLTKSPS,0
5cgd,A,1039,1050,11,NAAKSELDKAI,0
5cgd,A,1051,680,-371,RNTNGVITKDEAEKLFNQDVDAAVRGILRNAKLKPVYDSLDAVRRAALINMVFQMGETGVAGFTNSLRMLQQKRWDEAAVNLAKSRWYNQTPNRAKRVITTFRTGTWDAYKI,0
5cgd,A,689,691,2,AC,0
5cgd,A,692,715,23,QLVIAFILICIQLGIIVALFIME,0
5cgd,A,736,760,24,NLGVVAPLGYNGLLILACTFYAFK,0
5cgd,A,761,771,10,RNVPANFNEA,0
5cgd,A,772,795,23,YIAFTMYTTCIIWLAFVPIYFGS,0
5cgd,A,799,823,24,ITMCFSVSLSATVALGCMFVPKVY,0
5cgd,A,824,831,7,ILAKPER,0
2htg,A,255,273,18,HILVFGESLLNDAVTVVL,0
2htg,A,274,276,2,KK,0
2mkv,A,30,50,20,FAGLAFIVGLLILLSRRFRS,0
2mkv,A,51,64,13,GNKKRRQINEDEP,0
4il6,z,1,4,3,TIL,0
4il6,z,5,25,20,QLALAALVILSFVMVIGVPV,0
4il6,z,40,56,16,FLGSGLWIALVLVVGV,0
4il6,z,57,62,5,NFFVV,0
3g7f,M,1,53,52,DYQTIYTQIQARGPHITVSGEWGDNDRVGKPFYSYWLGKIGDAQIGPIYLGA,0
3g7f,M,54,71,17,GIAAFAFGSTAILIILF,0
3g7f,M,81,87,6,LQFFRQ,0
3g7f,M,116,132,16,GLFMTLSLGSWWIRVY,0
3g7f,M,133,143,10,RARALGLGTH,0
3g7f,M,144,161,17,AWNFAAAIFFVLCIGCI,0
3g7f,M,177,190,13,WPHIDWLTAFSIR,0
3g7f,M,199,218,19,LGFSIGFAYGCGLLFAAHG,0
3g7f,M,219,265,46,TILAVARFGGDREIEQITDRGTAVERAALFWRWTIGFNATIESVHR,0
3g7f,M,266,283,17,GWFFSLMVMVSASVGIL,0
3g7f,M,292,298,6,YLWCVK,0
3g6b,B,125,145,20,IMRIARETNILALNATIEAA,0
3g6b,B,146,151,5,AGEAG,0
3g6b,B,152,173,21,GFMIVANEVQNLSNETNEVTK,0
2xq6,E,0,6,6,QDMVSP,0
2xq6,E,198,217,19,NIILPMLFILFISWTAFWS,0
2xq6,E,218,220,2,SY,0
2xq6,E,221,240,19,ANVTLVVSTLIAHIAFNIL,0
2xq6,E,255,274,19,AIIFMIYLFYFVAVIEVTV,0
2xq6,E,275,293,18,HYLKVESQPARAASITRA,0
2xq6,E,294,312,18,RIAFPVVFLLANIILAFL,0
4wfg,B,28,32,4,STTL,0
4wfg,B,33,50,17,ALLALVLLYLVSGALVF,0
4wfg,B,117,133,16,SAFFFSGTIITTIGYG,0
4wfg,B,142,162,20,RLFCIFYALVGIPLFGILLA,0
4wfg,B,163,185,22,VGDRLGSSLRHGIGHIEAIFLK,0
4wfg,B,186,202,16,HVPPELVRVLSAMLFL,0
4wfg,B,203,220,17,IGCLLFVLTPTFVFCYM,0
4wfg,B,225,242,17,LEAIYFVIVTLTTVGFG,0
4wfg,B,255,277,22,AYQPLVWFWILLGLAYFASVLT,0
4wfg,B,278,285,7,IGNWLRV,0
1mxm,G,27,39,12,AVNIVAALAIII,0
1mxm,G,40,58,18,GLIIARMISNAVNRLMIS,0
1mxm,G,66,88,22,DFLSALVRYGIIAFTLIAALGR,0
1mxm,G,89,92,3,GVQ,0
1mxm,G,93,108,15,ASVIAVLGAAGLAVG,0
1ocr,Z,16,34,18,IGLSVTFLSFLLPAGWVL,0
1ocr,Z,35,43,8,HLDNYKKS,0
1ocr,Z,44,46,2,AA,0
1sqq,K,1,21,20,LTRFLGPRYRQLARNWVPTA,0
1sqq,K,22,38,16,LWGAVGAVGLVWATDW,0
1sqq,K,55,56,1,D,0
4rvy,z,1,7,6,TILFQL,0
4rvy,z,8,25,17,LAALVILSFVMVIGVPV,0
4rvy,z,40,55,15,FLGSGLWIALVLVVG,0
4rvy,z,56,62,6,LNFFVV,0
3usm,B,1,4,3,EVK,0
3usm,B,14,35,21,ILAMAGNAVGLGNFLRFPVQA,0
3usm,B,36,41,5,ENGGG,0
3usm,B,42,63,21,FMIPYIIAFLLVGIPLMWIEW,0
3usm,B,89,124,35,AKILGVFGLWIPLVVAIYYVYIESWTLGFAIKFLV,0
3usm,B,125,131,6,LVPEPP,0
3usm,B,132,134,2,,0
3usm,B,135,166,31,DPDSILRPFKEFLYSYIGVPKGDEPILKPSL,0
3usm,B,167,185,18,AYIVFLITMFINVSILIR,0
3usm,B,191,214,23,ERFAKIAMPTLFILAVFLVIRVF,0
3usm,B,215,222,7,LETPNGT,0
3usm,B,223,231,8,ADGLNFLW,0
3usm,B,232,241,9,PDFEKLKDP,0
3usm,B,242,265,23,VWIAAVGQIFFTLSLGFGAIITY,0
3usm,B,278,298,20,GLTAATLNEKAEVILGGSIS,0
3usm,B,299,307,8,PAAVAFFG,0
3usm,B,308,317,9,ANAVAIAKA,0
3usm,B,319,324,5,FNLGF,0
3usm,B,326,331,5,LPAIF,0
3usm,B,332,339,7,QTAGGTF,0
3usm,B,340,367,27,GFLWFFLLFFAGLTSSIAIMQPMIAFL,0
3usm,B,377,396,19,AVLWTAAIVFFSAHLVMFL,0
3usm,B,397,399,2,KS,0
3usm,B,400,425,25,DEMDFWAGTIGVVFFGLTELIIFFW,0
3usm,B,429,437,8,DKAWEEIN,0
3usm,B,445,472,27,RIYYYVMRYITPAFLAVLLVVWAREYI,0
3usm,B,473,483,10,KIMEETHWTV,0
3usm,B,484,502,18,ITRFYIIGLFLFLTFLVF,0
3usm,B,602,610,8,SAGTLVPR,0
4kyt,B,1,20,19,DKVQYLTRSAIRRASTIEM,0
4kyt,B,28,48,20,QCLFINFCAILICLLLICII,0
4kyt,B,50,52,2,LL,0
2ki9,A,1,8,7,VRLAKTL,0
2ki9,A,9,27,18,LVLAVLLICWFPVLALMA,0
4zwc,A,15,32,17,VATIGSFQFGYNTGVIN,0
4zwc,A,33,34,1,P,0
4zwc,A,35,48,13,KIIKEFITKTLTD,0
4zwc,A,49,64,15,GNAPPSEVLLTSLWS,0
4zwc,A,65,83,18,SVAIFSVGGMIGSFSVGL,0
4zwc,A,94,111,17,LIVNLLAVTGGCFMGLC,0
4zwc,A,112,118,6,VAKSVE,0
4zwc,A,119,139,20,LILGRLVIGLFCGLCTGFVP,0
4zwc,A,154,173,19,GTLNQLGIVVGILVAQIFG,0
4zwc,A,174,184,10,EFILGSEELW,0
4zwc,A,185,202,17,LLLGFTILPAILQSAAL,0
4zwc,A,257,262,5,LELFR,0
4zwc,A,271,290,19,ISIVLQLSQQLSGINAVFY,0
4zwc,A,291,307,16,STGIFKDAGVQEPIYA,0
4zwc,A,308,326,18,IGAGVVNTIFTVVSLFLV,0
4zwc,A,332,350,18,TLHMIGLGGMAFCSTLMT,0
4zwc,A,351,366,15,SLLLKDNYNGMSFVC,0
4zwc,A,367,389,22,GAILVFVAFFEIGPGPIPWFIV,0
4zwc,A,403,420,17,VAGCSNWTSNFLVGLLF,0
4zwc,A,421,430,9,SAAHYLGAY,0
4zwc,A,431,450,19,FIIFTGFLITFLAFTFFKV,0
2iqk,C,43,66,23,MFLLIMLGFPINFLTLYVTVQHK,0
2iqk,C,67,68,1,L,0
2iqk,C,69,94,25,TPLNYILLNLAVADLFMVFGGFTTT,0
2iqk,C,113,136,23,GFFATLGGEIALWSLVVLAIERY,0
2iqk,C,137,150,13,VVCKPMSNFRFGE,0
2iqk,C,151,173,22,HAIMGVAFTWVMALACAAPPLV,0
2iqk,C,202,224,22,FVIYMFVVHFIIPLIVIFFCYG,0
2iqk,C,225,251,26,LVFTVKEAAAQQQESATTQKAEKEVT,0
2iqk,C,252,274,22,MVIIMVIAFLICWLPYAGVAFY,0
2iqk,C,288,310,22,TIPAFFAKTSAVYNPVIYIMMN,0
2iqk,C,311,322,11,QFRNCMVTTLC,0
2iqk,C,323,326,3,GKN,0
2iqk,C,327,348,21,LGDDEASTTVSKTETSQVAPA,0
4hks,F,133,143,10,SQSGEDLHSP,0
4hks,F,162,178,16,WTSALLSGFAMVAMVE,0
4hks,F,179,180,1,Q,0
4hks,F,181,190,9,DHDTNVPPG,0
4hks,F,192,211,19,IAFAICTTLLVAVHMLALM,0
4hks,F,220,235,15,ETVSNLHSISLVHES,0
4hks,F,251,268,17,TLLGLILFLLEIAILCW,0
4hks,F,269,278,9,KFYDLSRRA,0
4hks,F,279,298,19,WSATVVLIPVMIIFMAFAI,0
4hks,F,299,305,6,FYRSLV,0
4hks,F,308,328,20,YEVTVSGIRELEMLKEQMEQ,0
4hks,F,330,346,16,LEHHNNIRNNGEGEEF,0
3abk,Z,20,36,16,VTFLSFLLPAGWVLYH,0
3abk,Z,37,43,6,DNYKKS,0
3abk,Z,44,46,2,AA,0
4h1w,B,4,22,18,TRELCLNFTVVLITVILI,0
4h1w,B,23,31,8,LLVRSYQY,0
4oaa,A,1,3,2,YY,0
4oaa,A,4,10,6,KNTNFW,0
4oaa,A,11,28,17,FGLFFFFYFFIMGAYFP,0
4oaa,A,50,67,17,AISLFSLLFQPLFGLLS,0
4oaa,A,68,74,6,KLGLRK,0
4oaa,A,75,88,13,LLWIITGMLVMFA,0
4oaa,A,110,129,19,GIYLGFCFNAGAPAVEAFI,0
4oaa,A,130,141,11,KVSRRSNFEFG,0
4oaa,A,142,156,14,ARMFGCVGWALCAS,0
4oaa,A,172,186,14,GSGCALILAVLLFF,0
4oaa,A,187,190,3,KTD,0
4oaa,A,191,206,15,PSSATVANAVGANHS,0
4oaa,A,207,209,2,FS,0
4oaa,A,210,217,7,KLALELF,0
4oaa,A,218,225,7,QPKLWFL,0
4oaa,A,226,241,15,LYVIGVSCTYDVFDQ,0
4oaa,A,243,248,5,ANFFT,0
4oaa,A,264,279,15,TTMGELLNASIMFFA,0
4oaa,A,280,291,11,LIINRIGGKNA,0
4oaa,A,292,309,17,LLAGTIMSVRIIGSSFA,0
4oaa,A,314,333,19,VVILKTLHMFEVPFLLVGC,0
4oaa,A,334,348,14,KYITSQFEVRFSAT,0
4oaa,A,349,369,20,YLVCFCFFKQLAMIFMSVLA,0
4oaa,A,382,396,14,LVLGLVALGFTLIS,0
4oaa,A,397,410,13,FTLSGPGPLSLLR,0
4oaa,A,411,417,6,QVNEVA,0
5unf,A,1084,1091,7,KEAQAAA,0
5unf,A,46,68,22,IPILYYIIFVIGFLVNIVVVTL,0
5unf,A,69,81,12,CCQKGPKKVSSI,0
5unf,A,82,105,23,IFNLAVADLLLLATLPLWATYYS,0
5unf,A,111,140,29,FGPVMCKVFGSFLTLNMFASIFFITCMSV,0
5unf,A,141,150,9,RYQSVIYPF,0
5unf,A,157,162,5,WQASY,0
5unf,A,163,183,20,VPLVWCMACLSSLPTFYFRD,0
5unf,A,207,233,26,SAGIALMKNILGFIIPLIFIATCYFG,0
5unf,A,234,255,21,RKHLLKTNSYGKNRITRDQVL,0
5unf,A,256,281,25,MAAAVVLAFIICWLPFHVLTFLDAL,0
5unf,A,300,322,22,PFAILLGFTNSCVNPFLYCFVG,0
5unf,A,323,334,11,RFQQKLRSVFR,0
4qin,B,187,191,4,GTSG,0
4qin,B,230,253,23,HSYIAAFGAVTGLCTLFTLATFV,0
4qin,B,254,265,11,DWRNSNRYPAV,0
4qin,B,266,287,21,LFYVNACFFVGSIGWLAQFMD,0
4qin,B,289,294,5,RREIV,0
4qin,B,313,337,24,CVIIFVIVYYALMAGVVWFVVLTY,0
4qin,B,338,358,20,WHTSFKALGTTYQPLSGKTS,0
4qin,B,359,381,22,FHLLTWSLPFVLTVAILAVAQV,0
4qin,B,398,421,23,YRAGFVLAPIGLVLIVGGYFLIR,0
4qin,B,422,453,31,VMTLFSIKSNHADLEDNWETLNDNLKVIEKADNAAQVKDALTKMRAAALDAQKATPPKLEDKSPDSPEMKDFRHGFDILVGQIDDALKLANEGKVKEAQAAAEQLKTTRNAYIQKYLAASKINETMLRLG,0
4qin,B,454,475,21,FGFLAFGFVLITFSCHFYDFF,0
4qin,B,494,505,11,TIGLPTKQPIP,0
4qin,B,515,537,22,LVEKINLFAMFGTGIAMSTWVW,0
4qin,B,539,544,5,ATLLI,0
4qin,B,545,551,6,RRTWCR,0
4qin,B,552,555,3,TGQ,0
2bmn,A,8,36,28,SPLKNLLAGGFGGVCLVFVGHPLDTVKV,0
2bmn,A,37,71,34,LQTQPPSLPGQPPMYSGTIDCFRKTLFREGITGL,0
2bmn,A,72,101,29,RGMAAPIIGVTPMFAVCFFGFGLGKRLQQ,0
2bmn,A,112,136,24,LFTAGMLSGVFTTGIMTPGERIKC,0
2bmn,A,137,151,14,LQIQASSGKNKYSG,0
2bmn,A,152,163,11,LDCAKKLYQEF,0
2bmn,A,164,168,4,IRGF,0
2bmn,A,169,194,25,KGTALTLMRDVPASGMYFMTYEWLK,0
2bmn,A,206,231,25,LSVPRVLVAGGFRGIFNWVVAIPPD,0
2bmn,A,232,248,16,LKSRFQTAPPGKYPNG,0
2bmn,A,249,259,10,RDVLRELIRE,0
2bmn,A,260,262,2,GV,0
2bmn,A,263,289,26,SLYKGFNAVMIRAFPANAACFLGFEI,0
4hfc,E,1,4,3,QDM,0
4hfc,E,5,198,193,SPPPPIADEPLTVNTGIYLIECYSLDDKAETFKVNAFLSLSWKDRRLAFDPVRSGVRVKTYEPEAIWIPEIRFVNVENARDADVVDISVSPDGTVQYLERFSARVLSPLDFRRYPFDSQTLHIYLIVRSVDTRNIVLAVDLEKVGKNDDVFLTGWDIESFTAVVKPANFALEDRLESKLDYQLRISRQYFSYI,0
4hfc,E,199,218,19,NIILPMLFILFISWTAFWS,0
4hfc,E,222,240,18,ANVTLVVSTLIAHIAANI,0
4hfc,E,241,255,14,VETNLPKTPYMTYT,0
4hfc,E,256,275,19,AIIFMIYLFYFVAVIEVTV,0
4hfc,E,292,313,21,RASRIAFPVVFLLANIILAFL,0
4hfc,E,314,315,1,F,0
4hfc,E,316,317,1,F,0
4x5t,E,225,239,14,QMYIPSLLIVILSW,0
4x5t,E,249,253,4,PARV,0
4x5t,E,254,270,16,LGITTVLTMTTQSSGS,0
4x5t,E,284,302,18,IWMAVCLLFVFSALLEYA,0
4x5t,E,303,391,88,VNFVSRQSQPQRAKKIDKIS,0
4x5t,E,392,409,17,IGFPMAFLIFNMFYWII,0
3spg,D,36,40,4,ARRK,0
3spg,D,41,61,20,RNRFVKKNGQCNVEFTNMDD,0
3spg,D,62,68,6,PQRYIA,0
3spg,D,70,76,6,FTTCVD,0
3spg,D,78,104,26,WRYMLLLFSLAFLVSWLLFGLIFWLI,0
3spg,D,131,147,16,AAFLFSIETQTTIGYG,0
3spg,D,156,184,28,LAVFMVVVQSIVGCIIDSFMIGAIMAKM,0
3spg,D,185,186,1,A,0
3spg,D,187,192,5,KKRAQ,0
3spg,D,193,372,179,LLFSHNAVVAMRDGKLCLMWRVGNLRKSHIVEAHVRAQLIKPRITEEGEYIPLDQIDIDVGFDKGLDRIFLVSPITILHEINEDSPLFGISRQDLETDDFEIVVILEGMVEATAMTTQARSSYLASEILWGHRFEPVLFEEKNQYKVDYSHFHKTYEVPSTPRCSAKDLVENKFLLSNS,0
3spg,D,373,378,5,EVLFQ,0
3h1i,W,5,12,7,LRQAYSA,0
3h1i,W,13,19,6,FRRTST,0
3h1i,W,20,43,23,ALTVVLGAVLFERAFDQGADAIF,0
3h1i,W,63,64,1,E,0
1pln,E,35,39,4,CLIL,0
1pln,E,40,49,9,CLLLICIIV,0
3t51,I,-6,3,9,HHHHHHMIE,0
3t51,I,4,14,10,IIRRSVANRF,0
3t51,I,15,33,18,VLMGALFLSIWGTWTIIN,0
3t51,I,339,355,16,GKLLEEFIVVAVVCAL,0
3t51,I,356,363,7,LWHVRSA,0
3t51,I,364,384,20,VAIISLPLGLCIAFIVMHFQ,0
3t51,I,393,409,16,GGIAIAVGAMVDAAIV,0
3t51,I,410,450,40,IENAHKRLEEWQHQHPDATLDNKTRWQVITDASVEVGPAL,0
3t51,I,451,466,15,ISLLIITLSFIPIFT,0
3t51,I,477,497,20,LAFTKTYAMAGAALLAIVVI,0
3t51,I,498,504,6,ILMGYW,0
3t51,I,505,516,11,RGKIPPESSNP,0
3t51,I,517,522,5,NRFLI,0
3t51,I,523,532,9,VYHPLLLKV,0
3t51,I,533,539,6,HWPKTT,0
3t51,I,540,555,15,LVAALSVLTVLWPLN,0
3t51,I,873,890,17,LMVPMTLMIIFVLLYLA,0
3t51,I,891,896,5,RRVGE,0
3t51,I,897,919,22,LLIISSVPFALVGGIWLLWWMG,0
3t51,I,926,943,17,GTGFIALAGVAAEFGVV,0
3t51,I,944,984,40,LMYLRHAIEAVPSLNNPQTFSEQKLDEALYHGAVLRVRPK,0
3t51,I,985,1001,16,MTVAVIIAGLLPILWG,0
3t51,I,1010,1028,18,RIAAPMIGGMITAPLLSL,0
3t51,I,1030,1039,9,IPAAYKLMW,0
3t51,I,1040,1043,3,HRH,0
3t51,I,1044,1047,3,VRK,0
3t45,C,7,9,2,PE,0
3t45,C,10,29,19,IWLALGTALMGLGTLYFLV,0
3t45,C,46,62,16,TLVPAIAFTMYLSMLL,0
3t45,C,63,79,16,YGLTMVPFGGEQNPIY,0
3t45,C,80,94,14,ARYADWLFTTPLLL,0
3t45,C,110,127,17,LVGADGIMIGTGLVGAL,0
3t45,C,128,133,5,KVYSY,0
3t45,C,134,150,16,FVWWAISTAAMLYILY,0
3t45,C,177,192,15,TVVLWSAYPVVWLIG,0
3t45,C,193,202,9,EGAGIVPLN,0
3t45,C,203,221,18,ETLLFMVLDVSTKVGFGL,0
2ksa,A,2,33,31,NVLPVDSDLSPNISTNTSEPNQFVQPAWQIV,0
2ksa,A,34,58,24,WAAAYTVIVVTSVVGNVVVMWIIL,0
2ksa,A,70,93,23,LVNLAFAEASMAAFNTVVNFTYA,0
2ksa,A,94,103,9,HNEWYYGLF,0
2ksa,A,104,127,23,CKFHNFFPIAAVFASIYSMTAVA,0
2ksa,A,149,174,25,VICVIWVLALLLAFPQGYYSTTETM,0
2ksa,A,175,191,16,SRVVCMIEWPEHPNKI,0
2ksa,A,192,217,25,EKVYHICVTVLIYFLPLLVIGYAYT,0
2ksa,A,250,274,24,IVVVCTFAICWLPFHIFFLLPYIN,0
2ksa,A,275,285,10,DLYLKKFIQQ,0
2ksa,A,286,308,22,YLAIMWLAMSSTMYNPIIYCCL,0
2ksa,A,310,320,10,RFRLGFKHAF,0
2ux4,M,1,52,51,EYQNIFSQVQVRGPADLGMTEDVNLANRSGVGPFSTLLGWFGNAQLGPIYL,0
2ux4,M,53,72,19,SLGVLSLFSGLMWFFTIGI,0
2ux4,M,82,87,5,AVFLR,0
2ux4,M,118,135,17,SFFMFVAVWSWWGRTYL,0
2ux4,M,136,144,8,AQALGMGK,0
2ux4,M,145,163,18,TAWAFLSAIWLWMVLGFI,0
2ux4,M,179,192,13,FSHLDWTNNFSLV,0
2ux4,M,201,221,20,HGLSIAFLYGSALLFAMHGA,0
2ux4,M,222,266,44,ILAVSRFGGERELEQIADRGTAAERAALFWRWTMGFNATMEGIH,0
2ux4,M,267,285,18,WAIWMAVLVTLTGGIGIL,0
2ux4,M,294,299,5,YVWGQ,0
2ux4,M,303,307,4,APLN,0
3s3a,C,5,25,20,KGALAVILVLTLTILVFWLG,0
3s3a,C,26,34,8,YAVFFARG,0
4mm6,A,1,4,3,EVK,0
4mm6,A,16,35,19,AMAGYAVDLGNFLRFPVQA,0
4mm6,A,36,38,2,EN,0
4mm6,A,39,60,21,GGAFMIPYIIAFLLVGIPLMW,0
4mm6,A,93,120,27,GVFGLWIPLVVASYYVYIESWTLGFAI,0
4mm6,A,121,131,10,FLVGLVPEPP,0
4mm6,A,132,134,2,,0
4mm6,A,135,167,32,DPDSILRPFKEFLYSYIGVPKGDEPILKPSLF,0
4mm6,A,168,185,17,YIVFLITMFINVSILIR,0
4mm6,A,191,212,21,ERFAKIAMPTLFILAVFLVIR,0
4mm6,A,213,222,9,FLLETPNGT,0
4mm6,A,223,231,8,ADGLNFLW,0
4mm6,A,232,238,6,PDFEKL,0
4mm6,A,239,265,26,DPGVWIAAVGQIFFSLGLGFGVLITF,0
4mm6,A,280,298,18,TAATLNEKASVILGGSIS,0
4mm6,A,299,318,19,PAAVAFFGVANAVAIAKAG,0
4mm6,A,319,324,5,FNLGF,0
4mm6,A,326,331,5,LPAIF,0
4mm6,A,332,342,10,QTAGGTFLGF,0
4mm6,A,343,364,21,WFFLLFFAGLTSSIAGMQGMI,0
4mm6,A,378,396,18,VLWTAAIVFFSAHLVMFL,0
4mm6,A,397,399,2,KS,0
4mm6,A,400,421,21,DEMDFWATGIGVVFFGLTELI,0
4mm6,A,429,437,8,DKAWEEIN,0
4mm6,A,451,473,22,MRYITPAFLAVLLVVWAREYIP,0
4mm6,A,474,483,9,IMEETHWTV,0
4mm6,A,484,500,16,ITRFYIIGLFLFLTFL,0
4mm6,A,512,519,7,AGTLVPR,0
2gfz,A,1,38,37,LGRCFPPDTKEKQQLRMTKLCDPAESELSPFLITLIL,0
2gfz,A,39,64,25,VLLAEYLIGIIANGFIMAIHAAEWV,0
2gfz,A,72,95,23,GRILVFLSVSRIALQSLMMLEIT,0
2gfz,A,96,115,19,SSTSLSFYSEDAVYYAFKI,0
2gfz,A,116,138,22,FIFLNFCSLWFAAWLSFFYFVK,0
2gfz,A,156,176,20,LIPWLLWLSVFISFSHSMFC,0
2gfz,A,177,207,30,NICTVYCNNSFPIHSSNSTKKTYLSEINVV,0
2gfz,A,208,230,22,LAFFFNLGIVTPLIMFILTATL,0
2gfz,A,259,279,20,AIKAISYFLILYIFNAVALF,0
2gfz,A,280,292,12,YLSNMFDINSLW,0
2gfz,A,293,314,21,NLCQIIMAAYPASHSILLIQD,0
2gfz,A,316,326,10,GLRRAWKRLQ,0
2ik3,_,1,48,47,GPIGAEADENQTVEEMKVEQYGPQTTPRGELVPDPEPELIDSTKLIE,0
2ik3,_,49,77,28,QVVLILAYCSIILLGVIGNSLVIHVVIK,0
2ik3,_,85,108,23,NFFIANLAVADLLVNTLCLPFTL,0
2ik3,_,109,124,15,YTLMGEWKMGPVLCH,0
2ik3,_,125,147,22,VPYAQGLAVQVSTITLTVIALD,0
2ik3,_,164,184,20,SFLIIGLAWGISALLASPLA,0
2ik3,_,185,218,33,FREYSLIEIIPDFEIVACTEKWPGEEKSIYGTV,0
2ik3,_,219,240,21,SLSSLLILYVLPLGIISFSYT,0
2ik3,_,269,290,21,LVCVVVVFAVSWLPLHAFQLA,0
2ik3,_,291,307,16,DIDSQVLDLKEYKLIF,0
2ik3,_,308,328,20,VFHIIAMCSTFANPLLYGWM,0
2ik3,_,330,340,10,NYRKAFLSAF,0
5kpd,A,35,68,33,LTMFRYAGWLDRLYMLVGTLAAIIHGVALPLMM,0
5kpd,A,69,117,48,IFGDMTDSFASVGNVSKNSTNMSEADKRAMFAKLEEEMTTYAYYYTGI,0
5kpd,A,118,139,21,AGVLIVAYIQVSFWCLAAGRQ,0
5kpd,A,180,204,24,GIGDKIGMFFQAMATFFGGFIIGF,0
5kpd,A,205,210,5,RGWKL,0
5kpd,A,211,231,20,LVILAISPVLGLSAGIWAKI,0
5kpd,A,290,311,21,ANISMGAAFLLIYASYALAFW,0
5kpd,A,312,330,18,GTSLVISKEYSIGQVLTV,0
5kpd,A,331,352,21,FSVLIGAFSVGQASPNIEAFA,0
5kpd,A,693,699,6,WRILKL,0
5kpd,A,706,728,22,FVVGIFCAIINGGLQPAFSVIF,0
5kpd,A,729,751,22,KVVGVFTNGGPPETQRQNSNLF,0
5kpd,A,752,773,21,LLFLILGIISFITFFLQGFTF,0
5kpd,A,827,847,20,RLAVIFQNIANLGTGIIISL,0
5kpd,A,848,854,6,YGWQLT,0
5kpd,A,855,879,24,LLLAIVPIIAIAGVVEMKMLSGQA,0
5kpd,A,926,949,23,AMKKAHVFGITFSFTQAMMYFSY,0
5kpd,A,950,972,22,ACFRFGAYLVTQQLMTFENVLL,0
5kpd,A,973,994,21,FSAIVFGAMAVGQVSSFAPDY,0
4hqj,E,1,18,17,AGLSTDDGGSPKGDVDP,0
4hqj,E,30,47,17,LIFAALAFIVGLIILLS,0
4hqj,E,48,65,17,RLRCGGKKHRPINEDEL,0
4oyg,C,1,5,4,GLYR,0
4oyg,C,15,32,17,ILIGLILGAIVGLILGH,0
4oyg,C,33,35,2,GY,0
4oyg,C,36,63,27,HAVHTYVKPFGDLFVRLLKMLVMPIVF,0
4oyg,C,83,108,25,KIVVYYLLTSAFAVTLGIIMARLFN,0
4oyg,C,109,127,18,GAGIHLAVGGQQFQPHQA,0
4oyg,C,128,158,30,PLVHILLDIVPTNPFGALANGQVLPTIFFA,0
4oyg,C,176,200,24,RKSAETLLDAINGLAEAMYKIVNG,0
4oyg,C,202,222,20,QYAPIGVFALIAYVMAEQGV,0
4oyg,C,223,229,6,VVGELA,0
4oyg,C,230,250,20,VTAAVYVGLTLQILLVYFVL,0
4oyg,C,258,263,5,ISFIK,0
4oyg,C,267,285,18,AMLTAFVTRSSSGTLPVT,0
4oyg,C,302,321,19,LPLGATINMDGTALYQGVC,0
4oyg,C,322,338,16,FFIANALGSHLTVGQQ,0
4oyg,C,339,355,16,TIVLTAVLASIGTAGV,0
4oyg,C,356,389,33,GAGAIMLAMVLHSVGLPLTDPNVAAAYAMILGI,0
4oyg,C,390,408,18,AILDMGATMVNVTGDLTG,0
4oyg,C,417,425,8,ELEKGVIA,0
3j09,B,100,121,21,KLYVAAFAGVLLLFLAHFISL,0
3j09,B,122,129,7,YEDFVQL,0
3j09,B,130,150,20,IALPAIFYSGSSIFKAAFSA,0
3j09,B,164,183,19,GVGAAFLASVLSTAGVLPR,0
3j09,B,185,206,21,SFYETSVLLLAFLLLGRTLEA,0
3j09,B,335,357,22,DKVVAYFIPTVLLVAISAFIYW,0
3j09,B,358,367,9,FIAHAPLLF,0
3j09,B,368,387,19,FTTLIAVLVVACPCAFGLA,0
3j09,B,674,695,21,NIFWALIYNVILIPAAAGLLY,0
3j09,B,696,700,4,IFGV,0
3j09,B,701,722,21,FRPEFAGLAMAMSSVSVVANS,0
1l0l,K,1,21,20,LTRFLGPRYRQLARNWVPTA,0
1l0l,K,22,39,17,LWGAVGAVGLVWATDWR,0
1l0l,K,54,56,2,DD,0
1pv6,A,1,7,6,YYLKNT,0
1pv6,A,8,32,24,FWMFGLFFFFYFFIMGAYFPFFPI,0
1pv6,A,46,67,21,IIFAAISLFSLLFQPLFGLLS,0
1pv6,A,68,73,5,KLGLR,0
1pv6,A,74,91,17,YLLWIITGMLVMFAPFF,0
1pv6,A,95,100,5,GPLLQ,0
1pv6,A,106,130,24,SIVGGIYLGFCFNAGAPAVEAFIE,0
1pv6,A,131,140,9,VSRRSNFEF,0
1pv6,A,141,161,20,RARMFGCVGWALGASIVGIM,0
1pv6,A,169,188,19,FWLGSGCALILAVLLFFAK,0
1pv6,A,189,209,20,DAPSSATVANAVGANHSAFS,0
1pv6,A,210,218,8,KLALELFR,0
1pv6,A,219,222,3,PKL,0
1pv6,A,223,245,22,FLSLYVIGVSCTYDVFDQQFAN,0
1pv6,A,260,279,19,FGYVTTMGELLNASIMFFA,0
1pv6,A,280,286,6,LIINRI,0
1pv6,A,287,288,1,G,0
1pv6,A,289,309,20,NALLLAGTIMSVRIIGSSFA,0
1pv6,A,314,334,20,VVILKTLHMFEVPFLLVGCF,0
1pv6,A,335,349,14,YITSQFEVRFSATI,0
1pv6,A,350,370,20,LVCFCFFKQLAMIFMSVLAG,0
1pv6,A,382,400,18,LVLGLVALGFTLISVFTL,0
1pv6,A,401,417,16,GPGPLSLLRRQVNEVA,0
3dhl,A,1,4,3,AQD,0
3dhl,A,5,23,18,ISTIGDLVKWIIDTVNKF,0
2na6,C,167,168,1,N,0
2na6,C,169,188,19,LWLLTILVLLIPLVFIYRK,0
2na7,C,171,177,6,SNLGWL,0
2na7,C,178,193,15,LLLLPIPLIVWVKRK,0
1pv7,A,1,7,6,YYLKNT,0
1pv7,A,8,31,23,FWMFGLFFFFYFFIMGAYFPFFP,0
1pv7,A,46,67,21,IIFAAISLFSLLFQPLFGLLS,0
1pv7,A,68,73,5,KLGLR,0
1pv7,A,74,88,14,YLLWIITGMLVMFA,0
1pv7,A,95,100,5,GPLLQ,0
1pv7,A,109,129,20,GGIYLGFCFNAGAPAVEAFI,0
1pv7,A,130,142,12,KVSRRSNFEFGR,0
1pv7,A,143,159,16,RMFGCVGWALGASIVG,0
1pv7,A,171,188,17,LGSGCALILAVLLFFAK,0
1pv7,A,189,209,20,DAPSSATVANAVGANHSAFS,0
1pv7,A,210,216,6,KLALEL,0
1pv7,A,217,223,6,RQPKLW,0
1pv7,A,224,244,20,LSLYVIGVSCTYDVFDQQFA,0
1pv7,A,261,279,18,GYVTTMGELLNASIMFFA,0
1pv7,A,280,286,6,LIINRI,0
1pv7,A,287,290,3,GKN,0
1pv7,A,291,309,18,LLLAGTIMSVRIIGSSFA,0
1pv7,A,314,333,19,VVILKTLHMFEVPFLLVGC,0
1pv7,A,334,350,16,KYITSQFEVRFSATIY,0
1pv7,A,351,370,19,VCFCFFKQLAMIFMSVLAG,0
1pv7,A,382,399,17,LVLGLVALGFTLISVFT,0
1pv7,A,400,417,17,SGPGPLSLLRRQVNEVA,0
2y69,Z,17,35,18,GLSVTFLSFLLPAGWVLY,0
2y69,Z,36,42,6,LDNYKK,0
4cof,E,-2,9,11,TGQSVNDPGNM,0
4cof,E,10,225,215,FVKETVDKLLKGYDIRLRPDFGGPPVCVGMNIDIASIDMVSEVNMDYTLTMYFQQYWRDKRLAYSGIPLNLTLDNRVADQLWVPDTYFLNDKKSFVHGVTVKNRMIRLHPDGTVLYGLRITTTAACMMDLRRYPLDEQNCTLEIESYGYTTDDIEFYWRGGDKAVTGVERIELPQFSIVEHRLVSRNVVFATGAYPRLSLSFRLKRNIGYFILQT,0
4cof,E,226,242,16,MPSILITILSWVSFWI,0
4cof,E,247,265,18,AARVALGITTVLTMTTIN,0
4cof,E,266,283,17,HLRETLPKIPYVKAIDM,0
4cof,E,284,303,19,LMGCFVFVFLALLEYAFVN,0
4cof,E,424,445,21,RWSRIVFPFTFSLFNLVYWLY,0
4cof,E,446,447,1,V,0
4cof,E,448,459,11,GATETSQVAPA,0
3m7l,C,1,5,4,NITK,0
3m7l,C,6,9,3,FPL,0
3m7l,C,10,27,17,TGYFGIPLGLAALSLAW,0
3m7l,C,41,64,23,DVLGIVASAVWILFILMYAYKLR,0
3m7l,C,65,66,1,Y,0
3m7l,C,67,75,8,EEVRAEYH,0
3m7l,C,76,80,4,PVRF,0
3m7l,C,81,97,16,FIALIPITTMLVGDIL,0
3m7l,C,105,128,23,EVLIWIGTIGQLLFSTLRVSELW,0
3m7l,C,129,139,10,GGVFEQKSTH,0
3m7l,C,140,157,17,SFYLPAVAANFTSASSL,0
3m7l,C,166,186,20,YLFFGAGMIAWIIFEPVLLQ,0
3m7l,C,187,199,12,LRISSLEPQFRA,0
3m7l,C,200,215,15,MGIVLAPAFVCVSAY,0
3m7l,C,227,246,19,KILWGYGFLQLFFLLRLFP,0
3m7l,C,247,253,6,IVEKGL,0
3m7l,C,254,271,17,IGLWAFSFGLASMANSA,0
3m7l,C,284,309,25,IFAFVFSNVMIGLLVLMTIYKLTKG,0
3m7l,C,310,313,3,FFL,0
1k4c,L,1,21,20,APMLSGLLARLVKLLLGRHG,0
1k4c,L,22,24,2,AL,0
1k4c,L,25,50,25,WRAAGAATVLLVIVLLAGSYLAVLA,0
1k4c,L,63,79,16,RALWWSVETATTVGYG,0
1k4c,L,87,114,27,GRCVAVVVMVAGITSFGLVTAALATWF,0
1k4c,L,115,124,9,GREQERRGH,0
2n7q,A,5,22,17,ELITLTVGFGILIFSLI,0
2n7q,A,23,46,23,TYCINAKADVLFIAPREPGAVSY,0
3j08,B,93,101,8,HLSRMKRK,0
3j08,B,102,123,21,YVAAFAGVLLLFLAHFISLPY,0
3j08,B,128,146,18,LLIALPAIFYSGSSIFKA,0
3j08,B,147,163,16,FSALRRRTLNMDVMYS,0
3j08,B,164,182,18,GVGAAFLASVLSTAGVLP,0
3j08,B,188,205,17,ETSVLLLAFLLLGRTLE,0
3j08,B,206,334,128,RAKSRTGEAIKKLVGLQAKTAVVIRDGKEIAVPVEEVAVGDIVIVRPGEKIPVDGVVVEGESYVDESMISGEPVPVLKSKGDEVFGATINNTGVLKIRATRVGGETLLAQIVKLVEDAMGSKPPIQRL,0
3j08,B,335,356,21,DKVVAYFIPTVLLVAISAFIY,0
3j08,B,367,391,24,AFTTLIAVLVVACPCAFGLATPTA,0
3j08,B,392,668,276,TVGMGKGAELGILIKNADALEVAEKVTAVIFDKTGTLTKGKPEVTDLVPLNGDERELLRLAAIAERRSEHPIAEAIVKKALEHGIELGEPEKVEVIAGEGVVADGILVGNKRLMEDFGVAVSNEVELALEKLEREAKTAVIVARNGRVEGIIAVSDTLKESAKPAVQELKRMGIKVGMITGDNWRSAEAISRELNLDLVIAEVLPHQKSEEVKKLQAKEVVAFVGDGINDAPALAQADLGIAVGSGSDVAVESGDIVLIRDDLRDVVAAIQLSRKT,0
3j08,B,669,694,25,SKIKQNIFWALIYNVILIPAAAGLL,0
3j08,B,701,729,28,FRPEFAGLAMAMSSVSVVANSLLLRNYV,0
3j08,B,730,737,7,PIRRGGD,0
4oyf,C,1,8,7,GLYRKYI,0
4oyf,C,14,31,17,KILIGLILGAIVGLILG,0
4oyf,C,32,38,6,YGYAHA,0
4oyf,C,39,63,24,HTYVKPFGDLFVRLLKMLVMPIVF,0
4oyf,C,83,107,24,KIVVYYLLTSAFAVTLGIIMARLF,0
4oyf,C,108,120,12,PGAGIHLAVGGQ,0
4oyf,C,121,129,8,FQPHQAPP,0
4oyf,C,131,140,9,HILLDIVPT,0
4oyf,C,141,150,9,PFGALANGQ,0
4oyf,C,151,160,9,LPTIFFAII,0
4oyf,C,174,201,27,KVRKSAETLLDAINGLAEAMYKIVNGV,0
4oyf,C,202,221,19,QYAPIGVFALIAYVMAEQG,0
4oyf,C,222,229,7,HVVGELA,0
4oyf,C,230,250,20,VTAAVYVGLTLQILLVYFVL,0
4oyf,C,258,264,6,ISFIKH,0
4oyf,C,266,286,20,DAMLTAFVTRSSSGTLPVTM,0
4oyf,C,302,320,18,LPLGATINMDGTALYQGV,0
4oyf,C,321,338,17,TFFIANALGSHLTVGQQ,0
4oyf,C,339,352,13,TIVLTAVLASIGT,0
4oyf,C,353,389,36,GVPGAGAIMLAMVLHSVGLPLTDPNVAAAYAMILGI,0
4oyf,C,390,409,19,AILDMGRTMVNVTGDLTGT,0
4oyf,C,417,422,5,TLVPR,0
1r84,A,9,32,23,WIWLALGTALMGLGTLYFLVKGM,0
1r84,A,33,41,8,VSDPDAKK,0
1r84,A,42,66,24,YAITTLVPAIAFTMYLSMLLGYGL,0
1r84,A,79,99,20,WARYADWLFTTPLLLLDLAL,0
1r84,A,100,103,3,VDA,0
1r84,A,104,127,23,QGTILALVGADGIMIGTGLVGAL,0
1r84,A,134,157,23,FVWWAISTAAMLYILYVLFFGFT,0
1r84,A,158,171,13,KAESMRPEVASTF,0
1r84,A,172,195,23,VLRNVTVVLWSAYPVVWLIGSEG,0
1r84,A,199,225,26,PLNIETLLFMVLDVSAKVGFGLILLR,0
1r84,A,226,232,6,RAIFGE,0
1wpg,A,1,48,47,EAAHSKSTEECLAYFGVSETTGLTPDQVKRHLEKYGHNELPAEEGKS,0
1wpg,A,49,56,7,WELVIEQ,0
1wpg,A,58,74,16,DLLVRILLLAACISFV,0
1wpg,A,89,110,21,EPFVILLILIANAIVGVWQER,0
1wpg,A,111,253,142,AENAIEALKEYEPEMGKVYRADRKSVQRIKARDIVPGDIVEVAVGDKVPADIRILSIKSTTLRVDQSILTGESVSVIKHTEPVPDPRAVNQDKKNMLFSGTNIAAGKALGIVATTGVSTEIGKIRDQMAATEQDKTPLQQKL,0
1wpg,A,254,275,21,EFGEQLSKVISLICVAVWLIN,0
1wpg,A,296,318,22,KIAVALAVAAIPEGLPAVITTC,0
1wpg,A,319,759,440,ALGTRRMAKKNAIVRSLPSVETLGCTSVICSDKTGTLTTNQMSVCKMFIIDKVDGDFCSLNEFSITGSTYAPEGEVLKNDKPIRSGQFDGLVELATICALCNDSSLDFNETKGVYEKVGEATETALTTLVEKMNVFNTEVRNLSKVERANACNSVIRQLMKKEFTLEFSRDRKSMSVYCSPAKSSRAAVGNKMFVKGAPEGVIDRCNYVRVGTTRVPMTGPVKEKILSVIKEWGTGRDTLRCLALATRDTPPKREEMVLDDSSRFMEYETDLTFVGVVGMLDPPRKEVMGSIQLCRDAGIRVIMITGDNKGTAIAICRRIGIFGENEEVADRAYTGREFDDLPLAEQREACRRACCFARVEPSHKSKIVEYLQSYDEITAMTGDGVNDAPALKKAEIGIAMGSGTAVAKTASEMVLADDNFSTIVAAVEEGRAIYNNMKQ,0
1wpg,A,760,781,21,IRYLISSNVGEVVCIFLTAAL,0
1wpg,A,786,809,23,LIPVQLLWVNLVTDGLPATALGF,0
1wpg,A,810,829,19,PPDLDIMDRPPRSPKEPLI,0
1wpg,A,830,852,22,GWLFFRYMAIGGYVGAATVGAA,0
1wpg,A,898,916,18,MALSVLVTIEMCNALNSL,0
1wpg,A,917,926,9,ENQSLMRMP,0
1wpg,A,927,950,23,WVNIWLLGSICLSMSLHFLILYV,0
1wpg,A,951,957,6,PLPMIF,0
1wpg,A,965,987,22,QWLMVLKISLPVIGLDEILKFI,0
1wpg,A,988,994,6,RNYLEG,0
1e6d,H,1,10,9,VGVTAFGNF,0
1e6d,H,11,15,4,LASL,0
1e6d,H,16,32,16,IYSFWIFLAGLIYYLQ,0
1e6d,H,251,260,9,VAAMLAEYA,0
4xtl,A,2,6,4,QELG,0
4xtl,A,8,28,20,NFENFIGATEGFSEIAYQFT,0
4xtl,A,29,52,23,HILTLGYAVMLAGLLYFILTIKN,0
4xtl,A,59,81,22,SNILSAVVMVSAFLLLYAQAQN,0
4xtl,A,82,105,23,TSSFTFNEEVGRYFLDPSGDLFN,0
4xtl,A,106,125,19,GYRYLNWLIDVPMLLFQIL,0
4xtl,A,139,160,21,NQFWFSGAMMIITGYIGQFYE,0
4xtl,A,161,163,2,SN,0
4xtl,A,164,189,25,TAFLVWGAISSAFFFHILWVMKKVI,0
4xtl,A,203,228,25,LSNIWILFLISWTLYPGAYLMPYLT,0
4xtl,A,229,239,10,VDGFLYSEDG,0
4xtl,A,240,265,25,MARQLVYTIADVSSKVIYGVLLGNL,0
1iwg,C,1,6,5,PNFFI,0
1iwg,C,7,11,4,RPIF,0
1iwg,C,12,27,15,WVIAIIIMLAGGLAI,0
1iwg,C,341,356,15,KTLVEAIILVFLVMY,0
1iwg,C,357,366,9,FLQNFRATL,0
1iwg,C,367,386,19,PTIAVPVVLLGTFAVLAAF,0
1iwg,C,395,410,15,FGMVLAIGLLVDDAI,0
1iwg,C,411,442,31,VVENVERVMAEEGLPPKEATRKSMGQIQGAL,0
1iwg,C,443,458,15,GIAMVLSAVFVPMAF,0
1iwg,C,469,489,20,FSITIVSAMALSVLVALILT,0
1iwg,C,490,498,8,ALCATMLK,0
1iwg,C,499,512,13,IAKGDHGEGKKGF,0
1iwg,C,514,524,10,WFNRMFEKST,0
1iwg,C,526,536,10,YTDSVGGILR,0
1iwg,C,537,542,5,TGRYL,0
1iwg,C,543,557,14,LYLIIVVGMAYLFV,0
1iwg,C,860,868,8,GMSYQERL,0
1iwg,C,874,890,16,SLYAISLIVVFLCLAA,0
1iwg,C,891,898,7,YESWSIP,0
1iwg,C,899,919,20,SVMLVVPLGVIGALLAATFR,0
1iwg,C,927,943,16,QVGLLTTIGLSAKNAI,0
1iwg,C,944,975,31,IVEFAKDLMDKEGKGLIEATLDAVRMRLRPI,0
1iwg,C,976,993,17,MTSLAFILGVMPLVIST,0
1iwg,C,1001,1018,17,AVGTGVMGGMVTATVLA,0
1iwg,C,1019,1025,6,FFVPVF,0
1iwg,C,1026,1032,6,VVVRRR,0
1iwg,C,1033,1036,3,SRK,0
1iwg,C,1037,1053,16,EDIEHSHTVDHHHHHH,0
4mm7,A,1,4,3,EVK,0
4mm7,A,5,12,7,EHWATRL,0
4mm7,A,13,31,18,LILAMAGYAVDLGNFLRF,0
4mm7,A,45,63,18,PYIIAFLLVGIPLMWIEW,0
4mm7,A,64,92,28,MGRYGGAQGHGTTPAIFYLLWRNRFAKI,0
4mm7,A,93,120,27,GVFGLWIPLVVASYYVYIESWTLGFAI,0
4mm7,A,132,134,2,,0
4mm7,A,167,184,17,AYIVFLITMFINVSILI,0
4mm7,A,185,190,5,GISKG,0
4mm7,A,191,211,20,ERFAKIAMPTLFILAVFLVI,0
4mm7,A,223,231,8,ADGLNFLW,0
4mm7,A,245,265,20,AAVGQIFFSLGLGFGVLITF,0
4mm7,A,266,276,10,SYVRKDQDIV,0
4mm7,A,277,295,18,SGLTAATLNEKASVILGG,0
4mm7,A,319,324,5,FNLGF,0
4mm7,A,326,331,5,LPAIF,0
4mm7,A,343,364,21,WFFLLFFAGLTSSIAGMQGMI,0
4mm7,A,365,379,14,FLEDELKLSRKHAV,0
4mm7,A,380,396,16,WTAAIVFFSAHLVMFL,0
4mm7,A,400,425,25,DEMDFWATGIGVVFFGLTELIIFFW,0
4mm7,A,426,428,2,FG,0
4mm7,A,429,437,8,DKAWEEIN,0
4mm7,A,438,444,6,GGIIKV,0
4mm7,A,445,469,24,RIYYYVMRYITPAFLAVLLVVWAR,0
4mm7,A,474,478,4,IMEE,0
4mm7,A,484,499,15,ITRFYIIGLFLFLTF,0
4mm7,A,500,511,11,VFLAERRRNHE,0
4mm7,A,512,519,7,AGTLVPR,0
2iil,_,1,43,42,NSTLFSQVENHSVHSNFSEKNAQLLAFENDDCHLPLAMIFTL,0
2iil,_,44,68,24,LAYGAVIILGVSGNLALIIIILKQ,0
2iil,_,72,98,26,NVTNILIVNLSFSDLLVAIMCLPFTF,0
2iil,_,99,114,15,YTLMDHWVFGEAMCK,0
2iil,_,115,139,24,NPFVQCVSITVSIFSLVLIAVERH,0
2iil,_,153,174,21,HAYVGIAVIWVLAVASSLPFL,0
2iil,_,175,210,35,YQVMTDEPFQNVTLDAYKDKYVCFDQFPSDSHRLS,0
2iil,_,211,235,24,TTLLLVLQYFGPLCFIFICYFKIY,0
2iil,_,262,286,24,IMLLSIVVAFAVCWLPLTIFNTVF,0
2iil,_,287,301,14,WNHQIIATCNHNLL,0
2iil,_,302,324,22,LLCHLTAMISTCVNPIFYGFLN,0
2iil,_,325,336,11,NFQRDLQFFFN,0
2ux5,M,1,54,53,EYQNIFSQVQVRGPADLGMTEDVNLANRSGVGPFSTLLGWFGNAQLGPIYLGS,0
2ux5,M,55,72,17,GVLSLFSGLMWFFTIGI,0
2ux5,M,82,87,5,AVFLR,0
2ux5,M,117,134,17,ASFFMFVAVWSWWGRTY,0
2ux5,M,135,146,11,RAQALGMGKHT,0
2ux5,M,147,164,17,WAFLSAIWLWMVLGFIR,0
2ux5,M,179,192,13,FSHLDWTNNFSLV,0
2ux5,M,200,221,21,FHGLSIAFLYGSALLFAMHGA,0
2ux5,M,222,268,46,ILAVSRFGGERELEQIADRGTAAERAALFWRWTMGFNATMEGIHRW,0
2ux5,M,269,286,17,IWMAVLVTLTGGIGILL,0
2ux5,M,294,300,6,YVWGQN,0
2ux5,M,303,307,4,APLN,0
2g1x,A,1,47,46,EEPGAQCAPPPPAGSETWVPQANLSSAPSQNCSAKDYIYQDSISLP,0
2g1x,A,48,66,18,KVLLVMLLALITLATTLS,0
2g1x,A,91,111,20,AVTDLLVSILVMPISTMYTV,0
2g1x,A,112,119,7,GRWTLGQ,0
2g1x,A,120,142,22,VCDFWLSSDITCCTASILHLCV,0
2g1x,A,171,193,22,LVWVFSISISLPPFFWRQAKAE,0
2g1x,A,194,204,10,EVSECVVNTD,0
2g1x,A,205,229,24,ILYTVYSTVGAFYFPTLLLIALYG,0
2g1x,A,318,336,18,ILGAFIVCWLPFFIISLV,0
2g1x,A,337,351,14,PICKDACWFHLAIF,0
2g1x,A,352,368,16,FFTWLGYLNSLINPII,0
2g1x,A,374,384,10,DFKQAFHKLI,0
5iji,B,1,15,14,IVKRPVSASLARAF,0
5iji,B,16,38,22,YIVLLSILSTGIALLTLASSLR,0
5iji,B,143,166,23,ERKMLLVVAISLAGGIGIFTLVF,0
5iji,B,167,227,60,TLRRIRHQVVAPLNQLVTASQRIEHGQFDSPPLDTNLPNELGLLAKTFNQMSSELHKLYR,0
4m8j,C,1,8,7,SKDNKKA,0
4m8j,C,16,29,13,PPLIIVGILCWLT,0
4m8j,C,30,35,5,RDLDA,0
4m8j,C,36,46,10,NEVINAVFSY,0
4m8j,C,47,64,17,TNVWGWAFEWYMVIMFG,0
4m8j,C,97,109,12,SCTSAAVLFWGS,0
4m8j,C,110,133,23,EIYYYISSPPFGMEGYSAPAKEI,0
4m8j,C,134,150,16,LAYSLFHWGPLPWATY,0
4m8j,C,195,216,21,YLVALILAMGTSLGLATPLVT,0
4m8j,C,217,232,15,CIQYLFGIPHTLQLD,0
4m8j,C,233,246,13,IIISCWILLNAIC,0
4m8j,C,259,278,19,DVETYLSFLMLGWVFIVGG,0
4m8j,C,280,293,13,FIVNYFTDSVGTL,0
4m8j,C,295,304,9,YMPRMLFYT,0
4m8j,C,305,313,8,PIGKGGFP,0
4m8j,C,314,328,14,AWTVFYWAWWVIYA,0
4m8j,C,353,369,16,GLTAGTWLIWTILGGN,0
4m8j,C,370,389,19,LQLIDQNILNIPQLIDQYG,0
4m8j,C,390,399,9,PRAIIETWA,0
4m8j,C,400,406,6,LPLSTA,0
4m8j,C,407,427,20,MWGFFILCFIATVTLINACS,0
4m8j,C,448,464,16,RIGWSVLVGIIGIILL,0
4m8j,C,465,471,6,LGGLKP,0
4m8j,C,472,487,15,QTAIIAGGCPLFFVN,0
3s3w,C,5,44,39,SYYHHHHHHGASLVPRGSHMSTLHGISHIFSYERLSLKR,0
3s3w,C,50,71,21,FMGSLALLALVCTNRIQYYFL,0
3s3w,C,72,294,222,PHVTKLDEVAATRLTFPAVTFCNLNEFRFSRVTKNDLYHAGELLALLNNRYEIPDTQTADEKQLEILQDKANFRNFKPKPFNMLEFYDRAGHDIREMLLSCFFRGEQCSPEDFKVVFTRYGKCYTFNAGQDGKPRLITMKGGTGNGLEIMLDIQQDEYLPVWGETDETSFEAGIKVQIHSQDEPPLIDQLGFGVAPGFQTFVSCQEQRLIYLPPPWGDCKAT,0
3s3w,C,295,299,4,GDSE,0
3s3w,C,300,425,125,YDTYSITACRIDCETRYLVENCNCRMVHMPGDAPYCTPEQYKECADPALDFLVEKDNEYCVCEMPCNVTRYGKELSMVKIPSKASAKYLAKKYNKSEQYIGENILVLDIFFEALNYETIEQKKAY,0
3s3w,C,426,447,21,VAGLLGDIGGQMGLFIGASIL,0
3s3w,C,451,463,12,LFDYAYEVIKHR,0
4mma,A,1,4,3,EVK,0
4mma,A,5,15,10,EHWATRLGLI,0
4mma,A,16,35,19,AMAGYAVDLGNFLRFPVQA,0
4mma,A,39,62,23,GGAFMIPYIIAFLLVGIPLMWIE,0
4mma,A,63,88,25,AMGRYGGAQGHGTTPAIFYLLWRNR,0
4mma,A,89,120,31,AKILGVFGLWIPLVVASYYVYIESWTLGFAI,0
4mma,A,132,134,2,,0
4mma,A,168,185,17,YIVFLITMFINVSILIR,0
4mma,A,186,190,4,ISKG,0
4mma,A,191,215,24,ERFAKIAMPTLFILAVFLVIRVFL,0
4mma,A,223,231,8,ADGLNFLW,0
4mma,A,242,265,23,VWIAAVGQIFFSLGLGFGVLITF,0
4mma,A,266,279,13,SYVRKDQDIVLSG,0
4mma,A,280,298,18,TAATLNEKASVILGGSIS,0
4mma,A,311,316,5,VAIAK,0
4mma,A,318,324,6,AFNLGF,0
4mma,A,326,331,5,LPAIF,0
4mma,A,340,367,27,GFLWFFLLFFAGLTSSIAGMQGMIAFL,0
4mma,A,368,376,8,DELKLSRK,0
4mma,A,377,394,17,AVLWTAAIVFFSAHLVM,0
4mma,A,401,422,21,EMDFWATGIGVVFFGLTELII,0
4mma,A,423,428,5,FWIFG,0
4mma,A,429,437,8,DKAWEEIN,0
4mma,A,438,450,12,GGIIKVPRIYYY,0
4mma,A,451,469,18,MRYITPAFLAVLLVVWAR,0
4mma,A,472,477,5,PKIME,0
4mma,A,487,503,16,FYIIGLFLFLTFLVFL,0
4mma,A,504,511,7,ERRRNHE,0
4mma,A,512,519,7,AGTLVPR,0
5l47,E,5,198,193,SPPPPIADEPLTVNTGIYLIESYSLDDCAETFKVNAFLSLSWKDRRLAFDPVRSGVRVKTYEPEAIWIPEIRFVNVENARDADVVDISVSPDGTVQYLERFSARVLSPLDFRRYPFDSQTLHIYLIVRSVDTRNIVLAVDLEKVGKNDDVFLTGWDIESFTAVVKPANFALEDRLESKLDYQLRISRQYFSYI,0
5l47,E,199,216,17,NIILPMLFILFISWTAF,0
5l47,E,224,242,18,VTLVVSTLIAHIAFNILV,0
5l47,E,243,254,11,TNCPKTPYMTY,0
5l47,E,255,274,19,GAIIFMIYLFYFVAVIEVT,0
5l47,E,295,313,18,RIAFPVVFLLANIILAFL,0
5l47,E,314,315,1,F,0
2lat,A,1,5,4,ITDV,0
2lat,A,6,29,23,LAIFANMLGVSLFLLVVLYHYVA,0
2lck,A,14,35,21,VKFLGAGTAACIADLITFPLD,0
2lck,A,83,111,28,AGLQRQMSFASVRIGLYDSVKQFYTKGS,0
2lck,A,112,114,2,HA,0
2lck,A,115,139,24,IGSRLLAGSTTGALAVAVAQPTDV,0
2lck,A,179,201,22,SPNVARNAIVNCAELVTYDLIK,0
2lck,A,202,218,16,TLLKANLMTDDLPCHF,0
2lck,A,219,242,23,SAFGAGFCTTVIASPVDVVKTRY,0
2lck,A,253,262,9,GHCALTMLR,0
2lck,A,271,299,28,GFMPSFLRLGSWNVVMFVTYEQLKRALM,0
2lck,A,301,307,6,YQSREA,0
2lck,A,308,309,1,F,0
2lck,A,310,315,5,HHHHH,0
4o7g,B,1,8,7,AVPVLGG,0
4o7g,B,9,13,4,PIFM,0
4o7g,B,14,35,21,VRVLGFIIAALVLTWTVHYRG,0
4o7g,B,45,66,21,HIFNVHPVMMVIGLILFNGEA,0
4o7g,B,67,86,19,LAYKSVQGTKNLKKLVHLT,0
4o7g,B,87,107,20,QLTAFILSLIGVWAALKFHI,0
4o7g,B,113,134,21,FYSLHSWLGLACLFLFAFQWA,0
4o7g,B,135,160,25,GFVTYWYPGGSRNSRASLMPWHVFL,0
4o7g,B,161,184,23,ISIYALALVTATTGILEKVTFLQ,0
4o7g,B,192,213,21,STEAMLVNTMGVLILILGGFV,0
4o7g,B,214,220,6,LGVVTP,0
4o7g,B,221,230,9,SGKDQVLTQ,0
3h1h,W,5,12,7,LRQAYSA,0
3h1h,W,19,39,20,FALTVVLGAVLFERAFDQGA,0
3h1h,W,40,62,22,AIFEHLNEGKLWKHIKHKYEAS,0
3h1h,W,63,64,1,E,0
1kzu,S,19,37,18,RVFLGLALVAHFLAFSAT,0
1kzu,S,38,41,3,WLH,0
4hfb,E,1,4,3,QDM,0
4hfb,E,5,202,197,SPPPPIADEPLTVNTGIYLIECYSLDDKAETFKVNAFLSLSWKDRRLAFDPVRSGVRVKTYEPEAIWIPEIRFVNVENARDADVVDISVSPDGTVQYLERFSARVLSPLDFRRYPFDSQTLHIYLIVRSVDTRNIVLAVDLEKVGKNDDVFLTGWDIESFTAVVKPANFALEDRLESKLDYQLRISRQYFSYIPNII,0
4hfb,E,203,218,15,PMLFILFISWTAFWS,0
4hfb,E,222,238,16,ANVTLVVSTLIAHIAA,0
4hfb,E,239,258,19,ILVETNLPKTPYMTYTGAI,0
4hfb,E,259,275,16,FMIYLFYFVAVIEVTV,0
4hfb,E,292,310,18,RASRIAFPVVFLLANIIL,0
4hfb,E,311,315,4,FLFF,0
4hfb,E,316,317,1,F,0
4he8,C,14,31,17,LKALLVVVGLLTAFAFM,0
4he8,C,32,40,8,LIERRLLA,0
4he8,C,41,78,37,FQVRMGPNRVGPFGLLQPLADAIKSIFKEDIVVAQAD,0
4he8,C,79,87,8,FLFVLAPL,0
4he8,C,88,102,14,SVVFALLAFGLIPF,0
4he8,C,121,135,14,ILYLFAVSELAVYG,0
4he8,C,136,159,23,FLSGWASGSKYSLLGSLRSSASL,0
4he8,C,160,174,14,SYELGLGLALLAPV,0
4he8,C,182,191,9,NDIVNWQKE,0
4he8,C,195,213,18,FLYAFPAFLVYLIASMAE,0
4he8,C,214,217,3,ART,0
4he8,C,218,235,17,FDLPEAEQELVGGYHTE,0
4he8,C,236,247,11,SSIKWALFQMA,0
4he8,C,248,267,19,YIHFITASALIPTLFLGGW,0
4he8,C,277,290,13,WMFLKIAFFLFFF,0
4he8,C,291,309,18,WIRATWFRLRYDQLLRFG,0
4he8,C,310,325,15,GFLFPLALLWFLVTA,0
4he8,C,338,354,16,YLSALSFLVLLGAVLY,0
4he8,C,355,365,10,PKPARKGGGA,0
1yg7,A,30,50,20,AFGSAFQYGYNLSVVNTPHK,0
1yg7,A,51,88,37,GTSCGWGNVFQVFKSFYNETYFERHATFMDGKLMLLL,0
1yg7,A,89,107,18,SCTVSMFPLGGLLGSLLV,0
1yg7,A,118,137,19,TLLINNIFAIIPAILMGVS,0
1yg7,A,138,144,6,VAKAFE,0
1yg7,A,145,164,19,IVFSRVVLGVCAGISYSAL,0
1yg7,A,182,202,20,MTEVFVIVGVFLAQIFSLQA,0
1yg7,A,203,211,8,LGNPAGWP,0
1yg7,A,212,230,18,LLALTGVPALLQLLTLPF,0
1yg7,A,290,313,23,SLRWQLLSIIVLMAGQQLSGINA,0
1yg7,A,314,329,15,NYYADTIYTSAGVEA,0
1yg7,A,330,354,24,HSQYVTVGSGVVNIVMTITSAVLV,0
1yg7,A,362,381,19,LLAGYGICGSACLVLTVVL,0
1yg7,A,382,389,7,FQNRVPE,0
1yg7,A,390,411,21,SYLGIICVFAYIAGHSIGPSP,0
1yg7,A,428,446,18,AFMVDGAVHWLTNFIIGF,0
1yg7,A,447,459,12,FPSIQEAIGAYS,0
1yg7,A,460,480,20,IIFAGICLLTAIYIYVVIPE,0
5ul9,B,18,22,4,HRNS,0
5ul9,B,23,35,12,IVLADVALFLAL,0
5ul9,B,51,64,13,LAFIAVLWLTEAL,0
5ul9,B,66,77,11,TVTAILVPVMA,0
5ul9,B,89,106,17,NNFANSIIFLFLGGFAL,0
5ul9,B,107,191,84,AAMHHQGLDKVIADKVLAMAQGKMSVAVFMLFGVTALLSMWISNTATAAMMLPLVLGVLSKVDADKQRSTYVFVLLGVAYSASI,0
5ul9,B,192,211,19,GIATLVGSPPNAIAAAEVG,0
5ul9,B,212,228,16,SFTDWMKFGLPTAMMM,0
5ul9,B,229,266,37,PMAIAILYFLLKPTLNGMFELDRAPVNWDKGKVVTLG,0
5ul9,B,267,281,14,FGLTVFLWIFSSPI,0
5ul9,B,291,306,15,DTLVALGAILMLSFA,0
5ul9,B,307,318,11,VVHWKEIQKTA,0
5ul9,B,319,333,14,WGVLLLFGGGLCLS,0
5ul9,B,360,376,16,VILVVATFVVFLTEFA,0
5ul9,B,378,389,11,TASAALLIPVF,0
5ul9,B,402,414,12,LSVLIAVAASCA,0
5ul9,B,415,446,31,MLPVATPPNAIVFASGHIKQSEMMRVGLYLN,0
5ul9,B,447,460,13,ACIGLLTAIAMLF,0
5ung,B,45,68,23,AIPILYYIIFVIGFLVNIVVVTL,0
5ung,B,69,82,13,CCQKGPKKVSSIY,0
5ung,B,83,105,22,FNLAVADLLLLATLPLWATYYS,0
5ung,B,111,140,29,FGPVMCKVFGSFLTLNMFASIFFITCMSV,0
5ung,B,141,162,21,RYQSVIYPFLSQRRNPWQASY,0
5ung,B,163,183,20,VPLVWCMACLSSLPTFYFRD,0
5ung,B,207,232,25,SAGIALMKNILGFIIPLIFIATCYF,0
5ung,B,233,256,23,IRKHLLKTNSYGKNRITRDQVLK,0
5ung,B,257,281,24,AAAVVLAFIICWLPFHVLTFLDAL,0
5ung,B,296,321,25,DLALPFAILLGFTNSCVNPFLYCFV,0
5ung,B,322,334,12,NRFQQKLRSVFR,0
2l6w,A,10,32,22,ISAILALVVLTIISLIILIMLW,0
2l6w,A,33,39,6,KKPRYE,0
1upe,A,9,32,23,ITVELAIAVLAILGNVLVCWAVW,0
1upe,A,33,43,10,NSNLQNVTNY,0
1upe,A,44,64,20,VVSLAAADIAVGVLAIPFAI,0
1upe,A,79,99,20,IACFVLVLTQSSIFSLLAIA,0
1upe,A,100,122,22,DRYIAIRIPLRYNGLVTGTRAK,0
1upe,A,123,141,18,IIAICWVLSFAIGLTPML,0
1upe,A,176,195,19,MVYFNFFACVLVPLLLMLG,0
1upe,A,196,234,38,YLRIFLAARRQLKQMESQPLPGERARSTLQKEVHAAKS,0
1upe,A,235,255,20,AIIVGLFALCWLPLHIINCF,0
1upe,A,270,290,20,YLAIVLSHTNSVVNPFIYAY,0
1upe,A,291,292,1,I,0
1upe,A,293,303,10,EFRQTFRKII,0
2gsm,B,26,29,3,QQS,0
2gsm,B,30,60,30,EIIGRPQPGGTGFQPSASPVATQIHWLDGF,0
2gsm,B,61,80,19,LVIIAAITIFVTLLILYAV,0
2gsm,B,100,117,17,EIAWTIVPIVILVAIGA,0
2gsm,B,118,285,167,SLPVLFNQQEIPEADVTVKVTGYQWYWGYEYPDEEISFESYMIGSPATGGDNRMSPEVEQQLIEAGYSRDEFLLATDTAMVVPVNKTVVVQVTGADVIHSWTVPAFGVKQDAVPGRLAQLWFRAEREGIFFGQCSELCGISHAYMPITVKVVSEEAYAAWLEQHHHH,0
2gsm,B,286,287,1,H,0
2lnl,A,43,67,24,IAYALVFLLSLLGNSLVMLVILYS,0
2lnl,A,68,70,2,VG,0
2lnl,A,71,97,26,SVTDVYLLNLALADLLFALTLPIWAA,0
2lnl,A,107,133,26,FLCKVVSLLKEVNFYSGILLLACISV,0
2lnl,A,134,150,16,RYLAIVHATRTLTQKR,0
2lnl,A,151,178,27,LVKFVCLGCWGLSMNLSLPFFLFRQAY,0
2lnl,A,185,221,36,VCYEVLGNDTAKWRMVLRILPHTFGFIVPLFVMLFC,0
2lnl,A,222,241,19,GFTLRTLFKAHMGQKHRAM,0
2lnl,A,242,268,26,VIFAVVLIFLLCWLPYNLVLLADTLM,0
2lnl,A,281,303,22,NIGRALDATEILGFLHSCLNPI,0
2lnl,A,304,324,20,YAFIGQNFRHGFLKILAMHG,0
2b6o,K,1,4,3,WEL,0
2b6o,K,14,31,17,AEFFATLFYVFFGLGAS,0
2b6o,K,32,41,9,RWAPGPLHV,0
2b6o,K,42,60,18,QVALAFGLALATLVQAVG,0
2b6o,K,65,77,12,HVNPAVTFAFLV,0
2b6o,K,87,107,20,CYVVAQLLGAVAGAAVLYSV,0
2b6o,K,108,127,19,PPAVRGNLALNTLHPGVSV,0
2b6o,K,128,148,20,QATIVEIFLTLQFVLCIFAT,0
2b6o,K,159,176,17,VALAVGFSLTLGHLFGM,0
2b6o,K,177,178,1,Y,0
2b6o,K,179,194,15,GAGMNPARSFAPAIL,0
2b6o,K,195,201,6,RNFTNH,0
2b6o,K,202,219,17,VYWVGPVIGAGLGSLLY,0
2b6o,K,240,263,23,RPSESNGQPEVTGEPVELKTQAL,0
4xnu,A,38,54,16,SVIGFAVDLANVWRFP,0
4xnu,A,55,63,8,LCYKNGGG,0
4xnu,A,64,81,17,FLVPYGIMLAVGGIPLF,0
4xnu,A,113,132,19,VLIAFYVDFYYNVIIAWSL,0
4xnu,A,133,239,106,FFFASFTNSLPWTSCNNIWNTPNCRPFESQGFQSAASEYFNRYILELNRSEGIHDLGAIKWDM,0
4xnu,A,240,255,15,LCLLIVYLICYFSLW,0
4xnu,A,261,278,17,GKVVWFTALFPYAALLI,0
4xnu,A,279,301,22,LIRGLTLPGSFLGIQYYLTPNF,0
4xnu,A,302,328,26,AIYKAEVWADAATQVFFSLGPGFGVL,0
4xnu,A,346,361,15,LTSFINSATSFIAGF,0
4xnu,A,362,409,47,IFSVLGYMAHTLGVRIEDVATEGPGLVFVVYPAAIATMPASTFWALI,0
4xnu,A,410,429,19,FMMLATLGLDSSFGGSEAI,0
4xnu,A,448,463,15,AGLFSLYFVVGLASC,0
4xnu,A,464,470,6,QGGFYF,0
4xnu,A,471,488,17,HLLDRYAAGYSILVAVF,0
4xnu,A,517,524,7,YWQVCWR,0
4xnu,A,527,545,18,PIFLLFITVYLLIGYEPL,0
4xnu,A,546,554,8,YADYVYPS,0
4xnu,A,555,570,15,ANALGWCIAGSSVVM,0
2nwl,C,1,9,8,GLYRKYIE,0
2nwl,C,15,29,14,ILIGLILGAIVGLI,0
2nwl,C,30,42,12,GHYGYAHAVHTY,0
2nwl,C,43,63,20,KPFGDLFVRLLKMLVMPIVF,0
2nwl,C,83,103,20,KIVVYYLLTSAFAVTLGIIM,0
2nwl,C,104,123,19,RLFNPGAGIHLAVGGQQFQ,0
2nwl,C,124,127,3,HQA,0
2nwl,C,128,130,2,PL,0
2nwl,C,131,140,9,HILLDIVPT,0
2nwl,C,141,150,9,PFGALANGQ,0
2nwl,C,151,158,7,LPTIFFA,0
2nwl,C,202,217,15,QYAPIGVFALIAYVM,0
2nwl,C,218,233,15,EQGVHVVGELAKVTA,0
2nwl,C,234,250,16,VYVGLTLQILLVYFVL,0
2nwl,C,266,286,20,DAMLTAFVTRSSSGTLPVTM,0
2nwl,C,302,317,15,LPLGATINMDGTALY,0
2nwl,C,318,342,24,GVCTFFIANALGSHLTVGQQLTIV,0
2nwl,C,343,359,16,TAVLASIGTAGVPGAG,0
2nwl,C,360,391,31,IMLAMVLHSVGLPLTDPNVAAAYAMILGIDA,0
2nwl,C,392,408,16,LDMGRTMVNVTGDLTG,0
2nwl,C,417,422,5,TLVPR,0
2ntw,C,1,4,3,AQI,0
2ntw,C,5,9,4,GRPE,0
2ntw,C,10,32,22,IWLALGTALMGLGTLYFLVKGM,0
2ntw,C,41,62,21,FYAITTLVPAIAFTMYLSMLL,0
2ntw,C,63,79,16,YGLTMVPFGGEQNPIY,0
2ntw,C,80,99,19,ARYADWLFTTPLLLLDLAL,0
2ntw,C,106,127,21,TILALVGADGIMIGTGLVGAL,0
2ntw,C,128,133,5,KVYSY,0
2ntw,C,134,155,21,FVWWAISTAAMLYILYVLFFG,0
2ntw,C,157,161,4,SKAE,0
2ntw,C,171,192,21,KVLRNVTVVLWSAYPVVWLIG,0
2ntw,C,193,202,9,EGAGIVPLN,0
2ntw,C,203,225,22,ETLLFMVLDVSAKVGFGLILLR,0
2ntw,C,232,249,17,AEAPEPSAGDGAAATSD,0
4hkr,F,133,143,10,SQSGEDLHSP,0
4hkr,F,161,176,15,SKTSALLSGFAMVAM,0
4hkr,F,177,180,3,EVQ,0
4hkr,F,181,190,9,DHDTNVPPG,0
4hkr,F,191,194,3,LIA,0
4hkr,F,195,212,17,AICTTLLVAVHMLALMI,0
4hkr,F,220,235,15,ETVSNLHSISLVHES,0
4hkr,F,248,266,18,AFSTLLGLILFLLEIAIL,0
4hkr,F,267,281,14,WVKFYDLSRRAAWS,0
4hkr,F,282,302,20,TVVLIPVMIIFMAFAIHFYR,0
4hkr,F,308,328,20,YEVTVSGIRELEMLKEQMEQ,0
4hkr,F,330,346,16,LEHHNNIRNNGEGEEF,0
1pb2,A,45,68,23,LLYSLIFLLSVLGNTLVITVLIR,0
1pb2,A,69,75,6,KRMRTV,0
1pb2,A,76,97,21,NIFLLSLAVSDLMLCLFCMPF,0
1pb2,A,113,139,26,CKTTTYFMGTSVSVSTFNLVAISLER,0
1pb2,A,140,158,18,GAICKPLQSRVWQTKSHA,0
1pb2,A,159,182,23,KVIAATWCLSFTIMTPYPIYSNL,0
1pb2,A,209,233,24,HTFLLLILFLIPGIVMMVAYGLIS,0
1pb2,A,234,251,17,ELYQGIKFEANLMAKKR,0
1pb2,A,252,275,23,IRMLIVIVVLFFLCWMPIFSANA,0
1pb2,A,295,315,20,ILLLSYTSSCVNPIIYCFMN,0
1pb2,A,316,322,6,RFRLGF,0
2loh,B,18,41,23,IIGLMVGGVVIATVIVITLVMLK,0
2loh,B,42,43,1,K,0
4jre,A,-2,12,14,SHMSHSSAPERATG,0
4jre,A,40,59,19,SVPCLLLAFCVWMLFSAVA,0
4jre,A,60,75,15,NLPKVGFNFTTDQLF,0
4jre,A,76,92,16,LTALPSVSGALLRVPY,0
4jre,A,105,121,16,AFSTGILIIPCVWLGF,0
4jre,A,122,131,9,VQDTSTPYS,0
4jre,A,132,150,18,FIIISLLCGFAGANFASS,0
4jre,A,170,188,18,GGLGNMGVSVMQLVAPLV,0
4jre,A,189,190,1,S,0
4jre,A,191,210,19,SIFAVFGSQGVKQPDGTEL,0
4jre,A,211,213,2,LA,0
4jre,A,214,231,17,ASWIWVPFLAIFTIAAW,0
4jre,A,239,255,16,SKASIKEQLPVLKRGH,0
4jre,A,258,280,22,MSLLYLATFGSFIGFSAGFAML,0
4jre,A,281,291,10,KTQFPDVQIL,0
4jre,A,292,309,17,YAFFGPFIGALARSAGG,0
4jre,A,320,337,17,TLVNFILMAIFSGLLFL,0
4jre,A,338,349,11,LPTDGQGGSFM,0
4jre,A,350,370,20,FFAVFLALFLTAGLGSGSTF,0
4jre,A,409,428,19,ISAIGAIGGFFIPKAFGSS,0
4jre,A,429,436,7,ALTGSPV,0
4jre,A,437,455,18,AMKVFLIFYIACVVITWA,0
4jre,A,459,463,4,HSKK,0
4zwb,A,3,11,8,QKVTPALI,0
4zwb,A,12,33,21,AITVATIGSFQFGYNTGVINA,0
4zwb,A,35,48,13,KIIKEFITKTLTD,0
4zwb,A,65,85,20,SVAIFSVGGMIGSFSVGLFV,0
4zwb,A,86,91,5,RFGRR,0
4zwb,A,92,111,19,SMLIVNLLAVTGGCFMGLC,0
4zwb,A,119,142,23,LILGRLVIGLFCGLCTGFVPMYI,0
4zwb,A,143,153,10,EISPTALRGA,0
4zwb,A,154,174,20,GTLNQLGIVVGILVAQIFGL,0
4zwb,A,186,203,17,LLGFTILPAILQSAALP,0
4zwb,A,204,256,52,CPESPRFLLINRKEEENAKQILQRLWGTQDVSQDIQEMKDESARMSQEKQVT,0
4zwb,A,257,262,5,LELFR,0
4zwb,A,263,270,7,SSYRQPI,0
4zwb,A,271,292,21,ISIVLQLSQQLSGINAVFYYS,0
4zwb,A,307,326,19,TIGAGVVNTIFTVVSLFLV,0
4zwb,A,327,331,4,RAGR,0
4zwb,A,332,352,20,TLHMIGLGGMAFCSTLMTVS,0
4zwb,A,365,389,24,CIGAILVFVAFFEIGPGPIPWFIV,0
4zwb,A,390,400,10,ELFSQGPRPA,0
4zwb,A,401,424,23,MAVAGCSNWTSNFLVGLLFPSAA,0
4zwb,A,430,448,18,VFIIFTGFLITFLAFTFF,0
4zwb,A,449,470,21,VPETRGRTFEDITRAFEGQAH,0
3v5s,A,8,27,19,FLLGLILLYYGSDWFVLGS,0
3v5s,A,28,40,12,RIARHFNVSNFV,0
3v5s,A,41,58,17,GATVMAIGTSLPEILTS,0
3v5s,A,74,93,19,IGSCICNIGLVLGLSAIIS,0
3v5s,A,94,104,10,IIVDKNLQKN,0
3v5s,A,105,119,14,LVYLLFVIFAAVIG,0
3v5s,A,127,143,16,GVVLLILFIIYLRWTV,0
3v5s,A,144,146,2,NG,0
3v5s,A,147,158,11,AEIEENNDKNN,0
3v5s,A,159,165,6,SVVFSL,0
3v5s,A,166,183,17,LLIIGLIGVLVGAELFV,0
3v5s,A,207,222,15,GTSLPELMVSLAAAK,0
3v5s,A,223,228,5,NLGGM,0
3v5s,A,229,247,18,LGNVIGSNIADIGGALAV,0
3v5s,A,259,275,16,QMAVLVIMSLLLYLFA,0
3v5s,A,276,280,4,YSKI,0
3v5s,A,281,297,16,RWQGILFLALYIIAIA,0
3v5s,A,302,320,18,GGSLVPRGSRSHHHHHHH,0
4iaq,A,30,37,7,GTCSAKD,0
4iaq,A,38,53,15,IYQDSISLPWKVLLV,0
4iaq,A,54,72,18,LLALITLATTLSNAFVIA,0
4iaq,A,88,107,19,ASLAVTDLLVSILVMPIST,0
4iaq,A,108,123,15,YTVTGRWTLGQVVCD,0
4iaq,A,124,143,19,WLSSDITCCTASIWHLCVI,0
4iaq,A,170,185,15,ALVWVFSISISLPPF,0
4iaq,A,186,190,4,WRQA,0
4iaq,A,191,196,5,AEEEV,0
4iaq,A,197,205,8,ECVVNTDH,0
4iaq,A,206,226,20,LYTVYSTVGAFYFPTLLLIA,0
4iaq,A,1018,1021,3,KAD,0
4iaq,A,1045,1052,7,PKLEDKS,0
4iaq,A,317,336,19,IILGAFIVCWLPFFIISLV,0
4iaq,A,337,339,2,PI,0
4iaq,A,340,346,6,KDACWF,0
4iaq,A,347,351,4,LAIF,0
4iaq,A,352,371,19,FFTWLGYLNSLINPIIYTM,0
4iaq,A,374,384,10,DFKQAFHKLI,0
4iaq,A,388,390,2,TS,0
4bpd,C,-8,28,36,HHHHHHELANNTTGFTRIIKAAGYSWKGLRAAWINE,0
4bpd,C,29,32,3,AFR,0
4bpd,C,33,48,15,EGVAVLLCVVIAAWL,0
4bpd,C,53,68,15,TRVLLISSVMLVMIV,0
4bpd,C,69,101,32,LLNSAIEAVVDRIGSEYHELSGRAKDLGSAAV,0
4bpd,C,102,116,14,IAIIDAVITWAILL,0
3usl,B,1,4,3,EVK,0
3usl,B,14,35,21,ILAMAGNAVGLGNFLRFPVQA,0
3usl,B,36,41,5,ENGGG,0
3usl,B,42,63,21,FMIPYIIAFLLVGIPLMWIEW,0
3usl,B,89,124,35,AKILGVFGLWIPLVVAIYYVYIESWTLGFAIKFLV,0
3usl,B,125,131,6,LVPEPP,0
3usl,B,132,134,2,,0
3usl,B,135,166,31,DPDSILRPFKEFLYSYIGVPKGDEPILKPSL,0
3usl,B,167,185,18,AYIVFLITMFINVSILIR,0
3usl,B,191,214,23,ERFAKIAMPTLFILAVFLVIRVF,0
3usl,B,215,222,7,LETPNGT,0
3usl,B,223,231,8,ADGLNFLW,0
3usl,B,232,241,9,PDFEKLKDP,0
3usl,B,242,265,23,VWIAAVGQIFFTLSLGFGAIITY,0
3usl,B,278,298,20,GLTAATLNEKAEVILGGSIS,0
3usl,B,299,307,8,PAAVAFFG,0
3usl,B,308,317,9,ANAVAIAKA,0
3usl,B,319,324,5,FNLGF,0
3usl,B,326,331,5,LPAIF,0
3usl,B,332,339,7,QTAGGTF,0
3usl,B,340,367,27,GFLWFFLLFFAGLTSSIAIMQPMIAFL,0
3usl,B,377,396,19,AVLWTAAIVFFSAHLVMFL,0
3usl,B,397,399,2,KS,0
3usl,B,400,425,25,DEMDFWAGTIGVVFFGLTELIIFFW,0
3usl,B,429,437,8,DKAWEEIN,0
3usl,B,445,472,27,RIYYYVMRYITPAFLAVLLVVWAREYI,0
3usl,B,473,483,10,KIMEETHWTV,0
3usl,B,484,502,18,ITRFYIIGLFLFLTFLVF,0
3usl,B,602,610,8,SAGTLVPR,0
2j4y,A,1,38,37,CGTEGPNFYVPFSNKTGVVRSPFEAPQYYLAEPWQFS,0
2j4y,A,39,64,25,LAAYMFLLIMLGFPINFLTLYVTVQ,0
2j4y,A,72,98,26,NYILLNLAVADLFMVFGGFTTTLYTS,0
2j4y,A,99,109,10,HGYFVFGPTG,0
2j4y,A,110,134,24,NLEGFFATLGGEIALWSLVVLAIE,0
2j4y,A,153,176,23,IMGVAFTWVMALACAAPPLVGWS,0
2j4y,A,177,199,22,YIPEGMQCSCGIDYYTPHEETN,0
2j4y,A,200,224,24,ESFVIYMFVVHFIIPLIVIFFCYG,0
2j4y,A,253,277,24,VIIMVIAFLICWLPYAGVAFYIFT,0
2j4y,A,278,286,8,QGSCFGPI,0
2j4y,A,287,309,22,MTIPAFFAKTSAVYNPVIYIMM,0
2j4y,A,311,321,10,QFRNCMVTTL,0
2j4y,A,327,348,21,LGDDEASTTVSKTETSQVAPA,0
1sqp,K,1,19,18,LTRFLGPRYRQLARNWVP,0
1sqp,K,20,38,18,AGLWGAVGAVGLVWATDW,0
1sqp,K,54,56,2,DD,0
3i4d,H,1,9,8,VGVTAFGN,0
3i4d,H,11,29,18,LASLAIYSFWIFLAGLIY,0
3i4d,H,249,260,11,SVVAAMLAEYA,0
2qts,C,26,39,13,TLHGISHIFSYER,0
2qts,C,43,67,24,RVVWALCFMGSLALLALVCTNRIQ,0
2qts,C,68,430,362,YFLYPHVTKLDEVAATRLTFPAVTFCNLNEFRFSRVTKNDLYHAGELLALLNNRYEIPDTQTADEKQLEILQDKANFRNFKPKPFNMLEFYDRAGHDIREMLLSCFFRGEQCSPEDFKVVFTRYGKCYTFNAGQDGKPRLITMKGGTGNGLEIMLDIQQDEYLPVWGETDETSFEAGIKVQIHSQDEPPLIDQLGFGVAPGFQTFVSCQEQRLIYLPPPWGDCKATTGDSEFYDTYSITACRIDCETRYLVENCNCRMVHMPGDAPYCTPEQYKECADPALDFLVEKDNEYCVCEMPCNVTRYGKELSMVKIPSKASAKYLAKKYNKSEQYIGENILVLDIFFEALNYETIEQKKAYEVAGL,0
2qts,C,431,453,22,GDIGGQMGLFIGASILTVLELF,0
2qts,C,458,463,5,VIKHR,0
4us3,A,19,39,20,LAAMGSAVGLGNIWRFSYVT,0
4us3,A,40,44,4,ENGG,0
4us3,A,45,67,22,AFLLVYLGFIALIGIPIVLAEF,0
4us3,A,90,124,34,KVAGLMGVAAGFLILSFYGVIAGWILFYLFNYIT,0
4us3,A,125,146,21,QLWSAPAEGFGGFFEGFIANP,0
4us3,A,147,166,19,LPLFWQALFMIATIWIVAI,0
4us3,A,172,192,20,ERSNKILMPLLGVLLIALAI,0
4us3,A,193,217,24,SLTLGGAKEGLAFLFSPDWSALKD,0
4us3,A,218,242,24,GVYLAAISQAFFTLSLGMGALITY,0
4us3,A,254,274,20,AAVSVAGLDTAFAIIAGIMI,0
4us3,A,275,290,15,PAVFALGLSPSGGPG,0
4us3,A,291,301,10,VFVVLPDIFD,0
4us3,A,302,307,5,IRLGP,0
4us3,A,308,336,28,VGIAFFILLGAAALSSAVSLLEVPVAYF,0
4us3,A,346,365,19,AAITLGVIITLLGIPSSLS,0
4us3,A,366,378,12,GVLGEVTIIPGL,0
4us3,A,379,403,24,IFDSVDFIASSVFLPLGGMIIALF,0
4us3,A,410,415,5,SDALA,0
4us3,A,427,448,21,WILSLRFIAPIAILIVFLSAF,0
2xq7,E,0,6,6,QDMVSP,0
2xq7,E,198,211,13,NIILPMLFILFIS,0
2xq7,E,212,227,15,TAFWSTSYEANVTLV,0
2xq7,E,228,240,12,STLIAHIAFNIL,0
2xq7,E,254,267,13,GAIIFMIYLFYFV,0
2xq7,E,268,298,30,VIEVTVQHYLKVESQPARAASITRASRIAF,0
2xq7,E,299,312,13,VVFLLANIILAFL,0
4wff,B,28,31,3,STT,0
4wff,B,32,50,18,LALLALVLLYLVSGALVF,0
4wff,B,117,133,16,SAFFFSGTIITTIGYG,0
4wff,B,141,162,21,GRLFCIFYALVGIPLFGILLA,0
4wff,B,163,185,22,VGDRLGSSLRHGIGHIEAIFLK,0
4wff,B,186,199,13,HVPPELVRVLSAM,0
4wff,B,200,220,20,FLLIGCLLFVLTPTFVFCYM,0
4wff,B,225,242,17,LEAIYFVIVTLTTVGFG,0
4wff,B,255,276,21,AYQPLVWFWILLGLAYFASVL,0
4wff,B,277,284,7,TIGNWLR,0
4wd8,E,24,25,1,I,0
4wd8,E,26,42,16,RLLLNVLMSIIAIISY,0
4wd8,E,49,64,15,IHLTVAPFSLLGIAI,0
4wd8,E,65,218,153,IFLGFRNSASYSRFVEARNLWGTVLIAERTLVRQLRNILPAEHDAHRRIVSYLVAFSWSLKHQLRKTDPTADLRRLLPEERVTEILASSMPTNRILLLAGNEIGQLREAGKLSDITYGLMDNKLDELAHVLGGCERLATTPVPFAYTLILQRT,0
4wd8,E,219,234,15,YLFCTLLPFALVGDL,0
4wd8,E,236,249,13,MTPFVSVFISYTF,0
4wd8,E,250,293,43,SWDSLAEELEDPFGTAANDLPLNAMCNTIERNLLDMTGQHPLP,0
4njp,A,66,90,24,GSSHHHHHHSSGLVPRGSHMAALR,0
4njp,A,91,92,1,R,0
4njp,A,93,110,17,GPVTWVMMIACVVVFIA,0
4njp,A,134,145,11,FWRYFTHALMH,0
4njp,A,148,166,18,MHILFNLLWWWYLGGAVE,0
4njp,A,167,171,4,RLGS,0
4njp,A,172,189,17,KLIVITLISALLSGYVQ,0
4njp,A,199,217,18,LSGVVYALMGYVWLRGER,0
4njp,A,218,224,6,PQSGIY,0
4njp,A,225,241,16,QRGLIIFALIWIVAGW,0
4njp,A,252,268,16,AHIAGLAVGLAMAFVD,0
4njp,A,269,272,3,LNA,0
4njp,A,273,276,3,KRK,0
2xqa,E,0,6,6,QDMVSP,0
2xqa,E,198,217,19,NIILPMLFILFISWTAFWS,0
2xqa,E,218,220,2,SY,0
2xqa,E,221,240,19,ANVTLVVSTLIAHIAFNIL,0
2xqa,E,255,274,19,AIIFMIYLFYFVAVIEVTV,0
2xqa,E,275,293,18,HYLKVESQPARAASITRA,0
2xqa,E,294,312,18,RIAFPVVFLLANIILAFL,0
2fyn,F,1,8,7,SNAEDHA,0
2fyn,F,9,13,4,TRRD,0
2fyn,F,14,32,18,LYYATAGAGAVATGAAVW,0
4lsg,A,1,32,31,ELEEDLKGRADKNFSKMGKKSKKEKKEKKPA,0
4lsg,A,43,69,26,WLDRLYMLVGTLAAIIHGVALPLMML,0
4lsg,A,70,114,44,FGDMTDSFASVGNVSKNSTNMSEADKRAMFAKLEEEMTTYAYYY,0
4lsg,A,115,137,22,GIGAGVLIVAYIQVSFWCLAAG,0
4lsg,A,182,204,22,GDKIGMFFQAMATFFGGFIIGF,0
4lsg,A,205,209,4,RGWK,0
4lsg,A,210,230,20,TLVILAISPVLGLSAGIWAK,0
4lsg,A,290,311,21,ANISMGAAFLLIYASYALAFW,0
4lsg,A,312,329,17,GTSLVISKEYSIGQVLT,0
4lsg,A,330,352,22,FFSVLIGAFSVGQASPNIEAFA,0
4lsg,A,627,683,56,GNEIELGNEACKSKDEIDNLDMSSKDSGSSLIRRRSTRKSICGPHDQDRKLSTKEA,0
4lsg,A,696,703,7,LKLNSTE,0
4lsg,A,708,729,21,VGIFCAIINGGLQPAFSVIFS,0
4lsg,A,730,750,20,VVGVFTNGGPPETQRQNSNL,0
4lsg,A,751,773,22,SLLFLILGIISFITFFLQGFTF,0
4lsg,A,827,848,21,RLAVIFQNIANLGTGIIISLI,0
4lsg,A,849,851,2,GW,0
4lsg,A,852,875,23,LTLLLLAIVPIIAIAGVVEMKML,0
4lsg,A,928,952,24,KKAHVFGITFSFTQAMMYFSYAAA,0
4lsg,A,953,971,18,RFGAYLVTQQLMTFENVL,0
4lsg,A,972,991,19,VFSAIVFGAMAVGQVSSFA,0
4lsg,A,1272,1284,12,AKRSLEHHHHHH,0
4g7y,S,79,103,24,RGSHHHHHHGVDDGRMEIPTTGVG,0
4g7y,S,107,113,6,RVRAVI,0
4g7y,S,114,138,24,HLGMRVFGVFLIFLDIILMIIDLS,0
4g7y,S,139,148,9,PGKSESSQS,0
4g7y,S,149,171,22,YDGMALALSCYFMLDLGLRIFA,0
4g7y,S,174,179,5,KNFFT,0
4g7y,S,181,204,23,WEVADGLIIVVTFVVTIFYTVLD,0
4g7y,S,205,209,4,YVQE,0
4g7y,S,210,234,24,GADGLGELVVLARLLRVVRLARIF,0
4g7y,S,235,263,28,SHQQMKASSRRTISQNKRRYRKDGFKLN,0
3rze,A,20,27,7,TMASPQL,0
3rze,A,28,32,4,PLVV,0
3rze,A,33,50,17,LSTICLVTVGLNLLVLY,0
3rze,A,68,84,16,LSVADLIVGAVVMPMN,0
3rze,A,85,101,16,LYLLMSKWSLGRPLCL,0
3rze,A,102,120,18,WLSMDYVASTASIFSVFI,0
3rze,A,149,164,15,GAWFLSFLWVIPILG,0
3rze,A,165,167,2,NH,0
3rze,A,168,174,6,MQQTSV,0
3rze,A,175,189,14,REDKCETDFYDVTW,0
3rze,A,190,208,18,KVMTAIINFYLPTLLMLW,0
3rze,A,420,436,16,MAAFILCWIPYFIFFM,0
3rze,A,437,452,15,IAFCKNCCNEHLHMF,0
3rze,A,453,467,14,IWLGYINSTLNPLI,0
3rze,A,473,483,10,NFKKTFKRIL,0
3rze,A,486,494,8,SGENLYFQ,0
3p4q,P,13,37,24,WGLFGAGGMWSAIIAPVMILLVGI,0
3p4q,P,38,61,23,LPLGLFPGDALSYERVLAFAQSF,0
3p4q,P,62,86,24,GRVFLFLMIVLPLWCGLHRMHHAM,0
3p4q,P,94,116,22,AGKWVFYGLAAILTVVTLIGVV,0
3p4q,P,117,118,1,I,0
5c3j,D,28,55,27,SAAVTGAAPPQFDPIAAEKGFKPLHSH,0
5c3j,D,56,78,22,TLFKIERYFAAAMVPLIPAAYF,0
5c3j,D,84,109,25,DLCLALALTLHVHWGVWGVVNDYGR,0
5c3j,D,110,113,3,FVL,0
5c3j,D,114,138,24,DTLAAAVRVGAYIFTACLLAGLLY,0
5c3j,D,146,154,8,TRAFEMVW,0
4ila,E,-3,4,7,SAAAQDM,0
4ila,E,5,53,48,SPPPPIADEPLTVNTGIYLIECYSLDDKAETFKVNAFLSLSWKDRRLA,0
4ila,E,55,198,143,PVRSGVRVKTYEPEAIWIPEIRFVNVENARDADVVDISVSPDGTVQYLERFSARVLSPLDFRRYPFDSQTLHIYLIVRSVDTRNIVLAVDLEKVGKNDDVFLTGWDIESFTAVVKPANFALEDRLESKLDYQLRISRQYFSYI,0
4ila,E,199,218,19,NIILPMLFILFISWTAFWS,0
4ila,E,222,240,18,ANVTLVVSTLIAHIFFNI,0
4ila,E,241,255,14,VETNLPKTPYMTYT,0
4ila,E,256,275,19,AIIFMIYLFYFVAVIEVTV,0
4ila,E,293,313,20,ASRIAFPVVFLLANIILAFL,0
4ila,E,314,315,1,F,0
3l1l,A,1,6,5,SSDAD,0
3l1l,A,7,10,3,HKV,0
3l1l,A,11,32,21,LIPVTLMVSGAIMGSGVFLLP,0
3l1l,A,43,62,19,YGWLVTIIGALGLSMVYAK,0
3l1l,A,63,84,21,SFLDPSPGGSYAYARRCFGPF,0
3l1l,A,85,112,27,GYQTNVLYWLACWIGNIAMVVIGVGYL,0
3l1l,A,125,144,19,TITCVVVLWIFVLLNIVGP,0
3l1l,A,146,170,24,ITRVQAVATVLALIPIVGIAVFGW,0
3l1l,A,181,191,10,WNVSGLGTFG,0
3l1l,A,196,213,17,LNVTLWSFIGVESASVA,0
3l1l,A,214,224,10,GVVKNPKRNV,0
3l1l,A,225,245,20,IATIGGVLIAAVCYVLSTTA,0
3l1l,A,262,270,8,GDAARMAL,0
3l1l,A,278,302,24,SFCAAAGCLGSLGGWTLLAGQTAK,0
3l1l,A,303,323,20,AADDGLFPPIFARVNKAGTP,0
3l1l,A,324,346,22,AGLIIVGILMTIFQLSSISPNA,0
3l1l,A,350,372,22,GLVSSVSVIFTLVPYLYTCAAL,0
3l1l,A,373,385,12,LLGHGHFGKARP,0
3l1l,A,386,407,21,YLAVTTIAFLYCIWAVVGSGA,0
3l1l,A,409,427,18,VMWSFVTLMVITAMYALN,0
3l1l,A,428,446,18,NRLHKNPYPLDAR,0
3l1l,A,447,450,3,SKD,0
1tn5,C,1,4,3,AQI,0
1tn5,C,5,9,4,GRPE,0
1tn5,C,10,34,24,IWLALGTALMGLGTLYFLVKGMGV,0
1tn5,C,41,62,21,FYAITTLVPAIAFTMYLSMLL,0
1tn5,C,63,78,15,YGLTMVPFGGEQNPI,0
1tn5,C,79,100,21,WARYADWLFTTPLLLLDLALL,0
1tn5,C,106,127,21,TILALVGADGIMIGTGLVGAL,0
1tn5,C,128,133,5,KVYSY,0
1tn5,C,134,157,23,FVWWAISTAAMLYILYVLFFGFT,0
1tn5,C,171,192,21,KVLRNVTVVLWSAYPVVWLIG,0
1tn5,C,193,202,9,EGAGIVPLN,0
1tn5,C,203,226,23,ETLLFMVLDVSAKVGFGLILLRS,0
1tn5,C,232,249,17,AEAPEPSAGDGAAATSD,0
5xez,A,142,166,24,VMYTVGYSLSLGALLLALAILGGL,0
5xez,A,167,174,7,KLHCTRN,0
5xez,A,175,196,21,IHANLFASFVLKASSVLVIDG,0
5xez,A,223,247,24,CRVAAVFMQYGIVANYCWLLVEGL,0
5xez,A,248,1053,805,LHNLLGLANIFEMLRIDEGLRLKIYKDTEGYYTIGIGHLLTKSPSLNAAKSELDKAIGRN,0
5xez,A,1058,265,-793,TKDEAEKLFNQDVDAAVRGILRNAKLKPVYDSLDAVRRAALINMVFQMGETGVAGFTNSLRMLQQKRWDEAAVNLAKSRWYNQTPNRAKRVITTFRTGTWDAYERSFFS,0
5xez,A,266,289,23,YLGIGWGAPMLFVVPWAVVKCLF,0
5xez,A,295,323,28,TSNDNMGFWWILRFPVFLAILINFFIFV,0
5xez,A,324,348,24,IVQLLVAKLRARQMHHTDYKFRLA,0
5xez,A,349,371,22,STLTLIPLLGVHEVVFAFVTDE,0
5xez,A,381,404,23,LFFDLFLSSFQGLLVAVLYCFLN,0
5xez,A,405,414,9,EVQSELRRR,0
5xez,A,415,418,3,HRW,0
5svp,D,27,47,20,RVVQLLIISYFVGWVFLHEK,0
5svp,D,48,315,267,YQVRDTAIESSVVTKVKGSGLYANRVMDVSDYVTPPQGTSVFVIITKMIVTENQMQGFCPESEEKYRCVSDSQCGPERLPGGGILTGRCVNYSSVLRTCEIQGWCPTEVDTVETPIMMEAENFTIFIKNSIRFPLFNFEKGNLLPNLTARDMKTCRFHPDKDPFCPILRVGDVVKFAGQDFAKLARTGGVLGIKIGWVCDLDKAWDQCIPKYSFTRLDSVSEKSSVSPGYNFRFAKYYKMENGSEYRTLLKAFGIRFDVLVYGNAGK,0
5svp,D,316,339,23,NIIPTIISSVAAFTSVGVGTVLC,0
1m57,D,-1,7,8,ADHSHPAH,0
1m57,D,8,26,18,HVAGSMDITQQEKTFAGF,0
1m57,D,27,47,20,RMVTWAAVVIVAALIFLALA,0
3ixz,B,1,32,31,AALQEKKSCSQRMEEFQRYCWNPDTGQMLGR,0
3ixz,B,41,58,17,LYYVAFYVVMSGIFALC,0
3ixz,B,59,78,19,YVLMRTIDPYTPDYQDQLK,0
3ixz,B,79,290,211,PGVTLRPDVYGEKGLDISYNVSDSTTWAGLAHTLHRFLAGYSPAAQEGSINCTSEKYFFQESFLAPNHTKFSCKFTADMLQNCSGRPDPTFGFAEGKPCFIIKMNRIVKFLPGNSTAPRVDCAFLDQPRDGPPLQVEYFPANGTYSLHYFPYYGKKAQPHYSNPLVAAKLLNVPRNRDVVIVCKILAEHVSFDNPHDPYEGKVEFKLKIQK,0
1t9w,C,1,6,5,PNFFI,0
1t9w,C,11,27,16,AWVIAIIIMLAGGLAI,0
1t9w,C,28,340,312,KLPVAQYPTIAPPAVTISASYPGADAKTVQDTVTQVIEQNMNGIDNLMYMSSNSDSTGTVQITLTFESGTDADIAQVQVQAKLQLAMPLLPQEVQQQGVSVEKSSSSFLMVVGVINTDGTMTQEDISDYVAANMKDAISRTSGVGDVQLFGSQYAMRIWMNPNELNKFQLTPVDVITAIKAQNAQVAAGQLGGTPPVKGQQLNASIIAQTRLTSTEEFGKILLKVNQDGSRVLLRDVAKIELGGENYDIIAEFNGQPASGLGIKLATGANALDTAAAIRAELAKMEPFFPSGLKIVYPYDTTPFVKISIHEV,0
1t9w,C,341,357,16,KTLVEAIILVFLVMYL,0
1t9w,C,366,386,20,IPTIAVPVVLLGTFAVLAAF,0
1t9w,C,387,394,7,FSINTLT,0
1t9w,C,395,411,16,FGMVLAIGLLVDDAIV,0
1t9w,C,442,458,16,VGIAMVLSAVFVPMAF,0
1t9w,C,459,469,10,GGSTGAIYRQ,0
1t9w,C,470,489,19,SITIVSAMALSVLVALILT,0
1t9w,C,499,512,13,IAKGDHGEGKKGF,0
1t9w,C,514,524,10,WFNRMFEKST,0
1t9w,C,527,536,9,TDSVGGILR,0
1t9w,C,542,557,15,VLYLIIVVGMAYLFV,0
1t9w,C,558,873,315,LPSSFLPDEDQGVFMTMVQLPAGATQERTQKVLNEVTHYYLTKEKNNVESVFAVNGFGFAGRGQNTGIAFVSLKDWADRPGEENKVEAITMRATRAFSQIKDAMVFAFNLPAIVELGTATGFDFELIDQAGLGHEKLTQARNQLLAEAAKHPDMLTSVRPNGLEDTPQFKIDIDQEKAQALGVSINDINTTLGAAWGGSYVNDFIDRGRVKKVYVMSEAKYRMLPDDIGDWYVRAADGQMVPFSAFSSSRWEYGSPRLERYNGLPSMEILGQAAPGKSTGEAMELMEQLASKLPTGVGYDWTGMSYQERLSGNQA,0
1t9w,C,874,891,17,SLYAISLIVVFLCLAAL,0
1t9w,C,898,919,21,FSVMLVVPLGVIGALLAATFR,0
1t9w,C,920,926,6,LTNDVY,0
1t9w,C,927,943,16,QVGLLTTIGLSAKNAI,0
1t9w,C,976,993,17,MTSLAFILGVMPLVIST,0
1t9w,C,994,1003,9,AGSGAQNAV,0
1t9w,C,1004,1021,17,TGVMGGMVTATVLAIFF,0
1t9w,C,1026,1032,6,VVVRRR,0
1t9w,C,1037,1049,12,EDIEHSHTVDHH,0
5dwy,B,3,4,1,S,0
5dwy,B,5,11,6,LRRYLD,0
5dwy,B,12,16,4,PVLW,0
5dwy,B,17,33,16,ILWGLVLGAVFGLIAG,0
5dwy,B,38,65,27,GAVKTYIKPFGDLFVRLLKMLVMPIVL,0
5dwy,B,66,83,17,SLVVGAASISPARLGRV,0
5dwy,B,84,109,25,VKIVVYYLATSAMAVFFGLIVGRLF,0
5dwy,B,131,162,31,LVQTLLNIVPTNPFASLAKGEVLPVIFFAII,0
5dwy,B,163,175,12,GIAITYLMNRNE,0
5dwy,B,176,202,26,RVRKSAETLLRVFDGLAEAMYLIVGG,0
5dwy,B,203,223,20,MQYAPIGVFALIAYVMAEQG,0
5dwy,B,233,253,20,VGAVYTGLFLQIVITYFILL,0
5dwy,B,254,259,5,VFGID,0
5dwy,B,260,267,7,IKFIRKA,0
5dwy,B,268,288,20,DAMITAFVTRSSSGTLPVTM,0
5dwy,B,289,302,13,VAEEEMGVDKGIF,0
5dwy,B,303,323,20,FTLPLGATINMDGTALYQGV,0
5dwy,B,338,345,7,GQQLVVV,0
5dwy,B,346,363,17,TAVLASIGTAGVPGAGA,0
5dwy,B,395,413,18,ILDMGRTMVNVTGDLAGT,0
5dwy,B,414,430,16,IVAKTEKELDESKWIS,0
3pxo,A,1,39,38,NGTEGPNFYVPFSNKTGVVRSPFEAPQYYLAEPWQFSM,0
3pxo,A,40,64,24,AAYMFLLIMLGFPINFLTLYVTVQ,0
3pxo,A,72,96,24,NYILLNLAVADLFMVFGGFTTTLY,0
3pxo,A,97,112,15,SLHGYFVFGPTGCNL,0
3pxo,A,113,137,24,GFFATLGGEIALWSLVVLAIERYV,0
3pxo,A,151,173,22,HAIMGVAFTWVMALACAAPPLV,0
3pxo,A,174,202,28,WSRYIPEGMQCSCGIDYYTPHEETNNES,0
3pxo,A,203,227,24,VIYMFVVHFIIPLIVIFFCYGQLV,0
3pxo,A,252,274,22,MVIIMVIAFLICWLPYAGVAFY,0
3pxo,A,275,288,13,FTHQGSDFGPIFM,0
3pxo,A,289,310,21,IPAFFAKTSAVYNPVIYIMMN,0
3pxo,A,311,321,10,QFRNCMVTTL,0
3pxo,A,327,348,21,LGDDEASTTVSKTETSQVAPA,0
4pxf,C,2,39,37,GTEGPNFYVPFSNKTGVVRSPFEAPQYYLAEPWQFSM,0
4pxf,C,40,63,23,AAYMFLLIMLGFPINFLTLYVTV,0
4pxf,C,75,95,20,LLNLAVADLFMVFGGFTTTL,0
4pxf,C,96,112,16,TSLHGYFVFGPTGCNL,0
4pxf,C,113,133,20,GFFATLGGEIALWSLVVLAI,0
4pxf,C,154,172,18,MGVAFTWVMALACAAPPL,0
4pxf,C,173,201,28,GWSRYIPEGMQCSCGIDYYTPHEETNNE,0
4pxf,C,202,221,19,FVIYMFVVHFIIPLIVIFF,0
4pxf,C,256,277,21,MVIAFLICWLPYAGVAFYIFT,0
4pxf,C,278,289,11,QGSDFGPIFMT,0
4pxf,C,290,309,19,PAFFAKTSAVYNPVIYIMM,0
4pxf,C,311,321,10,QFRNCMVTTL,0
2h89,D,9,28,19,WTSERAVSALLLGLLPAAY,0
2h89,D,29,34,5,YPGPA,0
2h89,D,35,55,20,DYSLAAALTLHGHWGLGQVI,0
2h89,D,67,85,18,ANTGLYVLSAITFTGLCY,0
2h89,D,86,92,6,NYYDVG,0
2h89,D,93,100,7,CKAVAML,0
2h89,D,101,103,2,SI,0
3b29,C,2,7,5,DEVAL,0
3b29,C,8,25,17,AAVTLLGVLLQAYFSLQ,0
3b29,C,53,71,18,VNCSEYFPLFLATLWVAG,0
3b29,C,72,78,6,FFHEGA,0
3b29,C,79,95,16,ALCGLVYLFARLRYFQ,0
3b29,C,106,124,18,PLYASARALWLLVALAAL,0
3b29,C,125,143,18,LLAHFLPAALRAALLGRL,0
3b29,C,144,156,12,TLLPWAHHHHHH,0
1s3e,A,1,2,1,S,0
1s3e,A,3,108,105,KCDVVVVGGGISGMAAAKLLHDSGLNVVVLEARDRVGGRTYTLRNQKVKYVDLGGSYVGPTQNRILRLAKELGLETYKVNEVERLIHHVKGKSYPFRGPFPPVWN,0
1s3e,A,109,126,17,ITYLDHNNFWRTMDDMG,0
1s3e,A,127,490,363,EIPSDAPWKAPLAEEWDNMTMKELLDKLCWTESAKQLATLFVNLCVTAETHEVSALWFLWYVKQCGGTTRIISTTNGGQERKFVGGSGQVSERIMDLLGDRVKLERPVIYIDQTRENVLVETLNHEMYEAKYVISAIPPTLGMKIHFNPPLPMMRNQMITRVPLGSVIKCIVYYKEPFWRKKDYCGTMIIDGEEAPVAYTLDDTKPEGNYAAIMGFILAHKARKLARLTKEERLKKLCELYAKVLGSLEALEPVHYEEKNWCEEQYSGGCYTTYFPPGILTQYGRVLRQPVDRIYFAGTETATHWSGYMEGAVEAGERAAREILHAMGKIPEDEIWQSEPESVDVPAQPITTTFLERHLPSVP,0
1s3e,A,491,501,10,LLRLIGLTTI,0
1s3e,A,502,520,18,SATALGFLAHKRGLLVRV,0
1t5t,A,1,60,59,EAAHSKSTEECLAYFGVSETTGLTPDQVKRHLEKYGHNELPAEEGKSLWELVIEQFEDL,0
1t5t,A,61,78,17,VRILLLAACISFVLAWF,0
1t5t,A,86,102,16,AFVEPFVILLILIANA,0
1t5t,A,103,256,153,VGVWQERNAENAIEALKEYEPEMGKVYRADRKSVQRIKARDIVPGDIVEVAVGDKVPADIRILSIKSTTLRVDQSILTGESVSVIKHTEPVPDPRAVNQDKKNMLFSGTNIAAGKALGIVATTGVSTEIGKIRDQMAATEQDKTPLQQKLDEF,0
1t5t,A,257,274,17,EQLSKVISLICVAVWLI,0
1t5t,A,296,311,15,KIAVALAVAAIPEGL,0
1t5t,A,312,759,447,AVITTCLALGTRRMAKKNAIVRSLPSVETLGCTSVICSDKTGTLTTNQMSVCKMFIIDKVDGDFCSLNEFSITGSTYAPEGEVLKNDKPIRSGQFDGLVELATICALCNDSSLDFNETKGVYEKVGEATETALTTLVEKMNVFNTEVRNLSKVERANACNSVIRQLMKKEFTLEFSRDRKSMSVYCSPAKSSRAAVGNKMFVKGAPEGVIDRCNYVRVGTTRVPMTGPVKEKILSVIKEWGTGRDTLRCLALATRDTPPKREEMVLDDSSRFMEYETDLTFVGVVGMLDPPRKEVMGSIQLCRDAGIRVIMITGDNKGTAIAICRRIGIFGENEEVADRAYTGREFDDLPLAEQREACRRACCFARVEPSHKSKIVEYLQSYDEITAMTGDGVNDAPALKKAEIGIAMGSGTAVAKTASEMVLADDNFSTIVAAVEEGRAIYNNMKQ,0
1t5t,A,760,777,17,IRYLISSNVGEVVCIFL,0
1t5t,A,787,807,20,IPVQLLWVNLVTDGLPATAL,0
1t5t,A,808,831,23,FNPPDLDIMDRPPRSPKEPLISG,0
1t5t,A,832,851,19,LFFRYMAIGGYVGAATVGA,0
1t5t,A,899,916,17,ALSVLVTIEMCNALNSL,0
1t5t,A,917,931,14,ENQSLMRMPPWVNI,0
1t5t,A,932,951,19,LLGSICLSMSLHFLILYVD,0
1t5t,A,967,988,21,LMVLKISLPVIGLDEILKFIA,0
1t5t,A,989,994,5,NYLEG,0
5v33,M,1,52,51,EYQNIFSQVQVRGPADLGMTEDVNLANRSGVGPFSTLLGWFGNAQLGPIYL,0
5v33,M,53,72,19,SLGVLSLFSGLMWFFTIGI,0
5v33,M,82,87,5,AVFLR,0
5v33,M,118,135,17,SFFMFVAVWSWWGRTYL,0
5v33,M,136,144,8,AQALGMGK,0
5v33,M,145,163,18,TAWAFLSAIWLWMVLGFI,0
5v33,M,181,192,11,HLDWTNNFSLV,0
5v33,M,201,221,20,HGLSIAFLYGSALLFAMHGA,0
5v33,M,222,265,43,ILAVSRFGGERELEQIADRGTAAERAALFWRWTMGFNATMEGI,0
5v33,M,266,285,19,RWAIWMAVLVTLTGGIGIL,0
5v33,M,294,299,5,YVWGQ,0
5aex,C,2,36,34,YNFTGTPTGEGTGGNSLTTDLNTQFDLANMGWIG,0
5aex,C,37,54,17,ASAGVWIMVPGIGLLYS,0
5aex,C,66,88,22,WASMMASAVCIFQWFFWGYSLA,0
5aex,C,89,126,37,SHNTRGNGFIGTLEFFGFRNVLGAPSSVSSLPDILFA,0
5aex,C,127,145,18,YQGMFAAVTGALMLGGAC,0
5aex,C,151,172,21,PMMVFLFLWMTIVYCPIACWV,0
5aex,C,173,186,13,NAEGWLVKLGSLD,0
5aex,C,187,207,20,AGGLCVHLTSGHGGLVYALI,0
5aex,C,230,249,19,VVLGTVFLWFGWMFFNGGS,0
5aex,C,250,260,10,GNATIRAWYS,0
5aex,C,261,280,19,MSTNLAAACGGLTWMVIDY,0
5aex,C,291,307,16,LCSGIIAGLVGITPAA,0
5aex,C,308,312,4,FVPI,0
5aex,C,313,332,19,SAVVIGVVTGAGCNLAVDL,0
5aex,C,342,362,20,DCYSIHGVGGCIGSVLTGIF,0
5aex,C,363,364,1,A,0
5aex,C,365,371,6,YVNATA,0
5aex,C,372,393,21,SYISPIDGGWINHHYKQVGYQ,0
5aex,C,394,418,24,AGICAALAWTVTVTSILLLTMNAI,0
1s33,D,23,25,2,LH,0
1s33,D,26,50,24,RAAGAATVLLVIVLLAGSYLAVLA,0
1s33,D,63,79,16,RALWWSVETATTVGYG,0
1s33,D,87,111,24,GRCVAVVVMVAGITSFGLVTAALA,0
1s33,D,112,119,7,WFVGREQ,0
5a2n,B,32,56,24,SAAMILCIEAVERLTTLGIGVNLV,0
5a2n,B,57,71,14,YLTGTMHLGNATAA,0
5a2n,B,72,89,17,TVTNFLGTSFMLCLLGG,0
5a2n,B,101,119,18,IAIFAAIQATGVSILTLS,0
5a2n,B,120,123,3,IIP,0
5a2n,B,142,146,4,GIQL,0
5a2n,B,147,171,24,VLYLALYLTALGTGGVKASVSGFG,0
5a2n,B,188,208,20,FFNRFFFCINVGSLLAVTVL,0
5a2n,B,209,220,11,YVQDDVGRKWG,0
5a2n,B,221,239,18,GICAFAIVLALSVFLAGT,0
5a2n,B,252,260,8,TQVAAVIV,0
5a2n,B,344,361,17,IWATCILFWTVHAQLTT,0
5a2n,B,362,385,23,SVAQSETLDRSIGSFEIPPASMA,0
5a2n,B,386,410,24,FYVGGLLLTTAVYDRVAIRLCKKL,0
5a2n,B,416,436,20,LRPLQRIGLGLFFGSMAMAV,0
5a2n,B,437,451,14,ALVELKRLRTAHAH,0
5a2n,B,461,467,6,FYLLIP,0
5a2n,B,468,486,18,YLIVGIGEALIYTGQLDF,0
5a2n,B,501,524,23,LLLSTLALGFFFSSVLVTIVEKF,0
5a2n,B,525,544,19,GKAHPWIADDLNKGRLYNF,0
5a2n,B,545,564,19,WLVAVLVALNFLIFLVFSK,0
3u32,E,13,31,18,ISTIGLLGAGIGIAIVFA,0
3u32,E,32,50,18,LINGVSRNPSIKDTVFPM,0
3u32,E,51,71,20,ILGFALSEATGLFCLMVSFL,0
3u32,E,75,76,1,V,0
3rce,A,17,30,13,ILILIAFAFSVLC,0
3rce,A,31,82,51,LYWVAWASEFYEFFFNDQLMITTNDGYAFAEGARDMIAGFHQPNDLSYFGS,0
3rce,A,83,93,10,LSTLTYWLYS,0
3rce,A,94,109,15,LPFSFESIILYMSTF,0
3rce,A,110,123,13,ASLIVVPIILIAR,0
3rce,A,129,141,12,YGFIAALLGSIA,0
3rce,A,142,158,16,SYYNRTMSGYYDTDML,0
3rce,A,159,173,14,LVLPMLILLTFIRL,0
3rce,A,181,195,14,LLLSPIFIMIYLWW,0
3rce,A,196,199,3,PSS,0
3rce,A,200,215,15,SLNFAMIGLFGLYTL,0
3rce,A,225,239,14,LAIALMIIALSMLA,0
3rce,A,241,251,10,YKLALIVLLF,0
3rce,A,267,282,15,ALIFISISILHLSGG,0
3rce,A,283,306,23,DPVLYQLKFYVFKASDVQNLKDA,0
3rce,A,307,324,17,FMYFNVNETIMEVNTID,0
3rce,A,325,332,7,EVFMQRI,0
3rce,A,333,351,18,SSVLVFILSFIGFILLCK,0
3rce,A,355,367,12,MLLALPMLALGF,0
3rce,A,368,378,10,ALRAGLRFTI,0
3rce,A,379,395,16,AVPVMALGFGYFLYAF,0
3rce,A,413,427,14,LLILIAFFSISPAL,0
3rce,A,428,604,176,HIYYYKSSTVFTSYEASILNDLKNKAQREDYVVAWWDYGYPIRYYSDVKTLIDGGKHLGKDNFFSSFVLSKEQIPAANMARLSVEYTEKSFKENYPDVLKAMVKDYNQTSAKDFLESLNDKNFKFDTNKTRDVYIYMPYRMLRIMPVVAQFANTNPDNGEQEKSLFFSQANAIAQD,0
3rce,A,605,607,2,TT,0
3rce,A,608,711,103,SVMLDNGVEIINDFRALKVEGASIPLKAFVDIESITNGKFYYNEIDSKAQIYLLFLREYKSFVILDESLYNSAYIQMFLLNQYDQDLFEQVTNDTRAKIYRLK,0
3rce,A,712,724,12,EFHHHHHHHHHH,0
5aez,C,1,32,31,SGQFTGTGTGGDVFKVDLNEQFDRADMVWIG,0
5aez,C,33,48,15,ASVLVWIMIPGVGLL,0
5aez,C,63,84,21,AALMAACVAAFQWFWWGYSLV,0
5aez,C,85,120,35,AHNGSVFLGTLQNFCLKDVLGAPSIVKTVPDILFC,0
5aez,C,121,137,16,YQGMFAAVTAILMAGA,0
5aez,C,148,166,18,VFLFIWLTVVYCPIAYWT,0
5aez,C,167,180,13,GGNGWLVSLGALD,0
5aez,C,181,198,17,AGGGPVHENSGFAALAY,0
5aez,C,227,243,16,GTIFLWFGWYGFNGGS,0
5aez,C,244,254,10,GNSSMRSWYA,0
5aez,C,255,272,17,VNTNLAAATGGLTWMLV,0
5aez,C,287,301,14,MGAIAGLVGITPAA,0
5aez,C,302,306,4,YVPV,0
5aez,C,307,323,16,TSVIFGIVPAIICNFA,0
5aez,C,338,356,18,WALHGVGGFVGNFMTGLF,0
5aez,C,357,358,1,A,0
5aez,C,359,365,6,YVAMID,0
5aez,C,366,381,15,TEIDGGWMNHHWKQL,0
5aez,C,382,406,24,YQLAGSCAVAAWSFTVTSIILLAM,0
1ov1,A,1,38,37,NGTEGPNFYVPFSNKTGVVRSPFEAPQYYLAEPWQFS,0
1ov1,A,39,63,24,LAAYMFLLIMLGFPINFLTLYVTV,0
1ov1,A,72,96,24,NYILLNLAVADLFMVFGGFTTTLY,0
1ov1,A,97,111,14,SLHGYFVFGPTGCN,0
1ov1,A,112,135,23,EGFFATLGGEIALWSLVVLAIER,0
1ov1,A,152,172,20,AIMGVAFTWVMALACAAPPL,0
1ov1,A,173,199,26,GWSRYIPEGMQCSCGIDYYTPHEETN,0
1ov1,A,200,222,22,ESFCIYMFVVHFIIPLIVIFFC,0
1ov1,A,254,279,25,IIMVIAFLICWLPYAGVAFYICTHQ,0
1ov1,A,280,286,6,SDFGPI,0
1ov1,A,287,309,22,MTIPAFFAKTSAVYNPVIYIMM,0
1ov1,A,311,322,11,QFRNCMVTTLC,0
4r7c,F,20,25,5,DKEFQ,0
4r7c,F,26,42,16,LFVLTILTLISGTIFY,0
4r7c,F,51,67,16,DALYFSVVTLTTVGET,0
4r7c,F,75,95,20,KIFTILYIFIGIGLVFGFIH,0
4r7c,F,96,101,5,LAVNV,0
4r7c,F,102,109,7,LPSILSN,0
4r7c,F,110,113,3,VPR,0
5vew,A,127,135,8,ESKRGERS,0
5vew,A,148,169,21,TVGYALSFSALVIASAILLGF,0
5vew,A,170,176,6,HLHCTR,0
5vew,A,177,196,19,YIHLNLFASFILRALCVFF,0
5vew,A,204,210,6,GSGDGL,0
5vew,A,253,265,12,LLAFNIFEMLRIDEGLRLKIYKDTEGYYTIGIGHLLTKSPSLNAAKSELDKAIGRNTNGVITKDEAEKLFNQDVDAAVRGILRNAKLKPVYDSLDAVRRAALINMVFQMGETGVAGFTNSLRMLQQKRWDEAAVNLAKSRWYNQTPNRAKRVITTFRTGTWDAYSEQWI,0
5vew,A,266,286,20,RLYVAIGWGVPLLFVVPWGI,0
5vew,A,306,329,23,LIIRLPILFACIVNFLIFVRVIC,0
5vew,A,330,348,18,VVSKLKANLMCKTDIAFR,0
5vew,A,349,370,21,AKSTLTLIPLLCTHEVIFAFV,0
5vew,A,373,379,6,HARGTL,0
5vew,A,387,406,19,LSFTSFQGLMVAILYCFVN,0
5vew,A,407,422,15,EVQLEFRKSWERWRL,0
5vew,A,423,431,8,HLHIQRDS,0
3iz1,F,1,17,16,DWGTLQTILGGVNKHS,0
3iz1,F,18,22,4,SIGK,0
3iz1,F,23,48,25,WLTVLFIFRIMILVVAAKEVWGDEQ,0
3iz1,F,69,90,21,PISHIRLWALQLIFVSTPALL,0
3iz1,F,91,109,18,AMHVAYRRHEKKRKFIKG,0
3iz1,F,110,124,14,IKSEFKDIEEIKTQ,0
3iz1,F,125,137,12,VRIEGSLWWTYT,0
3iz1,F,138,163,25,SIFFRVIFEAAFMYVFYVMYDGFSM,0
3iz1,F,184,211,27,PTEKTVFTVFMIAVSGICILLNVTELC,0
3iz1,F,212,217,5,LLIRY,0
3iz1,F,218,238,20,SGKSKKPVLVPRGSHHHHHH,0
2dw3,A,23,47,24,FQMMKGAGWAGGVFFGTLLLIGFF,0
2dw3,A,48,77,29,VVGRMLPIQENQAPAPNITGALEHHHHHH,0
1t9u,C,1,6,5,PNFFI,0
1t9u,C,11,25,14,AWVIAIIIMLAGGL,0
1t9u,C,26,341,315,ILKLPVAQYPTIAPPAVTISASYPGADAKTVQDTVTQVIEQNMNGIDNLMYMSSNSDSTGTVQITLTFESGTDADIAQVQVQAKLQLAMPLLPQEVQQQGVSVEKSSSSFLMVVGVINTDGTMTQEDISDYVAANMKDAISRTSGVGDVQLFGSQYAMRIWMNPNELNKFQLTPVDVITAIKAQNAQVAAGQLGGTPPVKGQQLNASIIAQTRLTSTEEFGKILLKVNQDGSRVLLRDVAKIELGGENYDIIAEFNGQPASGLGIKLATGANALDTAAAIRAELAKMEPFFPSGLKIVYPYDTTPFVKISIHEVV,0
1t9u,C,342,357,15,TLVEAIILVFLVMYL,0
1t9u,C,366,382,16,IPTIAVPVVLLGTFAV,0
1t9u,C,383,397,14,AAFGFSINTLTMFG,0
1t9u,C,398,411,13,VLAIGLLVDDAIV,0
1t9u,C,442,456,14,VGIAMVLSAVFVPM,0
1t9u,C,457,469,12,FFGGSTGAIYRQ,0
1t9u,C,472,489,17,TIVSAMALSVLVALILT,0
1t9u,C,499,512,13,IAKGDHGEGKKGF,0
1t9u,C,514,524,10,WFNRMFEKST,0
1t9u,C,529,536,7,SVGGILR,0
1t9u,C,541,556,15,LVLYLIIVVGMAYLF,0
1t9u,C,557,710,153,RLPSSFLPDEDQGVFMTMVQLPAGATQERTQKVLNEVTHYYLTKEKNNVESVFAVNGFGFAGRGQNTGIAFVSLKDWADRPGEENKVEAITMRATRAFSQIKDAMVFAFNLPAIVELGTATGFDFELIDQAGLGHEKLTQARNQLLAEAAKHP,0
1t9u,C,712,861,149,LTSVRPNGLEDTPQFKIDIDQEKAQALGVSINDINTTLGAAWGGSYVNDFIDRGRVKKVYVMSEAKYRMLPDDIGDWYVRAADGQMVPFSAFSSSRWEYGSPRLERYNGLPSMEILGQAAPGKSTGEAMELMEQLASKLPTGVGYDWTG,0
1t9u,C,863,875,12,YQERLSGNQAPS,0
1t9u,C,876,891,15,YAISLIVVFLCLAAL,0
1t9u,C,898,916,18,FSVMLVVPLGVIGALLAA,0
1t9u,C,917,929,12,FRGLTNDVYFQV,0
1t9u,C,930,943,13,LLTTIGLSAKNAI,0
1t9u,C,975,992,17,LMTSLAFILGVMPLVIS,0
1t9u,C,993,1003,10,GAGSGAQNAV,0
1t9u,C,1004,1021,17,TGVMGGMVTATVLAIFF,0
1t9u,C,1026,1032,6,VVVRRR,0
1t9u,C,1037,1049,12,EDIEHSHTVDHH,0
3e8h,E,19,22,3,KDK,0
3e8h,E,23,25,2,FQ,0
3e8h,E,26,45,19,LFVLTILTLISGTIFYSTV,0
3e8h,E,51,67,16,DALYFSVVTLTTVGDG,0
3e8h,E,75,96,21,GKIFTILYIFIGIGLVFGFIH,0
3e8h,E,97,102,5,LAVNV,0
3e8h,E,103,111,8,LPSILSNL,0
3e8h,E,112,113,1,P,0
1jgj,A,4,27,23,TTLFWLGAIGMLVGTLAFAWAGR,0
1jgj,A,28,35,7,AGSGERR,0
1jgj,A,36,60,24,YVTLVGISGIAAVAYAVMALGVGW,0
1jgj,A,69,90,21,VPRYIDWILTTPLIVYFLGLL,0
1jgj,A,91,95,4,GLDS,0
1jgj,A,96,118,22,EFGIVITLNTVVMLAGFAGAMV,0
1jgj,A,123,146,23,YALFGMGAVAFIGLVYYLVGPMT,0
1jgj,A,147,159,12,SASQRSSGIKSL,0
1jgj,A,160,181,21,VRLRNLTVVLWAIYPFIWLLG,0
1jgj,A,192,215,23,DVALIVYLDLVTKVGFGFIALDA,0
1jgj,A,216,217,1,A,0
3lde,D,22,41,19,ILLLVLAVIIYGTAGFHFI,0
3lde,D,42,46,4,GESW,0
3lde,D,47,63,16,VSLYWTFVTIATVGYG,0
3lde,D,64,70,6,YSPHTP,0
3lde,D,71,95,24,GMYFTCTLIVLGIGTFAVAVERLL,0
5fmw,V,75,79,4,AEDD,0
5fmw,V,202,208,6,FKSIIQ,0
5fmw,V,209,224,15,KTSNFNAAISLKFTP,0
5fmw,V,225,244,19,ETNKAEQCCEETASSISLH,0
5fmw,V,245,260,15,KGSFRFSYSKNETYQ,0
5fmw,V,261,266,5,FLSYS,0
5fmw,V,347,353,6,RKGVEL,0
5fmw,V,354,389,35,DIKRCLGYHLDVSLAFSEISVGAEFNKDDCVKRGE,0
5fmw,V,390,395,5,RAVNI,0
5svr,C,21,28,7,TIGIINR,0
5svr,C,29,47,18,VQLLIISYFVGWVFLHEK,0
5svr,C,316,343,27,NIIPTIISSVAAFTSVGVGTVLCDIIL,0
5svr,C,344,347,3,NFL,0
3kbc,C,1,5,4,GLYR,0
3kbc,C,13,29,16,QKILIGLILGAIVGLI,0
3kbc,C,30,42,12,GHYGYAHAVHTY,0
3kbc,C,43,66,23,KPFGDLFVRLLCMLVMPIVFASL,0
3kbc,C,91,110,19,TSAFAVTLGIIMARLFNPG,0
3kbc,C,111,130,19,GIHLAVGGQQFQPHQAPPL,0
3kbc,C,131,140,9,HILLDIVPT,0
3kbc,C,141,149,8,PFGALANG,0
3kbc,C,150,161,11,VLPTIFFAIIL,0
3kbc,C,174,200,26,KVRKSAETLLDAINGLAEAMYKIVNG,0
3kbc,C,201,217,16,MQYAPIGVFALIAYVM,0
3kbc,C,218,224,6,EQGVHV,0
3kbc,C,225,242,17,GELAKVTAAVYVGLTLQ,0
3kbc,C,313,326,13,TALYQGVATFFIA,0
3kbc,C,327,335,8,ALGSHLTV,0
3kbc,C,336,352,16,QQLTIVLTAVLASIGT,0
3kbc,C,357,375,18,AGAIMLCMVLHSVGLPLT,0
3kbc,C,376,379,3,PNV,0
3kbc,C,380,397,17,AAYAMILGIDAILDMGR,0
3kbc,C,501,508,7,LEKGVIA,0
2dwe,F,22,24,2,AL,0
2dwe,F,25,50,25,WRAAGAATVLLVIVLLAGSYLAVLA,0
2dwe,F,63,79,16,RALWWSVETATTVGYG,0
2dwe,F,87,114,27,GRCVAVVVMVAGITSFGLVTAALATWF,0
2dwe,F,115,124,9,GREQERRGH,0
1c99,A,6,32,26,DLLYMAAAVMMGLAAIGAAIGIGILG,0
1c99,A,33,41,8,KFLEGAAR,0
1c99,A,42,50,8,PDLIPLLR,0
1c99,A,51,77,26,QFFIVMGLVDAIPMIAVGLGLYVMFA,0
1jq1,D,86,93,7,WGRCVAV,0
1jq1,D,94,111,17,VMVAGITSFGLVTAALA,0
4ilc,E,-3,4,7,SAAAQDM,0
4ilc,E,5,198,193,SPPPPIADEPLTVNTGIYLIECYSLDDKAETFKVNAFLSLSWKDRRLAFDPVRSGVRVKTYEPEAIWIPEIRFVNVENARDADVVDISVSPDGTVQYLERFSARVLSPLDFRRYPFDSQTLHIYLIVRSVDTRNIVLAVDLEKVGKNDDVFLTGWDIESFTAVVKPANFALEDRLESKLDYQLRISRQYFSYI,0
4ilc,E,199,218,19,NIILPMLFILFISWTAFWS,0
4ilc,E,222,240,18,ANVTLVVSTLIAHIAFNI,0
4ilc,E,241,255,14,VETNLPKTPYMTYT,0
4ilc,E,256,275,19,AIIFMIYLFYFVAVIEVTV,0
4ilc,E,293,313,20,ASRIAFPVVFLLANIILAFL,0
4ilc,E,314,315,1,F,0
1v55,Z,13,37,24,EQAIGLSVTFLSFLLPAGWVLYHL,0
1v55,Z,38,43,5,NYKKS,0
1v55,Z,44,46,2,AA,0
3p4s,P,13,41,28,WGLFGAGGMWSAIIAPVMILLVGILLPL,0
3p4s,P,42,60,18,LFPGDALSYERVLAFAQS,0
3p4s,P,61,86,25,IGRVFLFLMIVLPLWCGLHRMHHAM,0
3p4s,P,94,117,23,AGKWVFYGLAAILTVVTLIGVVT,0
4wgw,A,71,88,17,LISSLAAMLLQSMTVRL,0
4wgw,A,89,95,6,IATGKD,0
4wgw,A,96,101,5,AQMTR,0
4wgw,A,102,107,5,FLSKP,0
4wgw,A,108,135,27,AIIFWIIAELAIIATDIAEVIGSAIAL,0
4wgw,A,144,157,13,VGALITVFDVFLL,0
4wgw,A,159,180,21,IMRFGFRKIEAIVGTLIFTVL,0
4wgw,A,219,234,15,IIGATIMPHNLYLHS,0
4wgw,A,235,254,19,IVQSRKYDRHDNEEKAQAI,0
4wgw,A,255,272,17,YATIDSNLQLSIAFVVN,0
4wgw,A,294,302,8,YDLYHALK,0
4wgw,A,321,342,21,ALLASGQNSTITGTLAGQIVM,0
4wgw,A,343,352,9,GFLRLSIPN,0
4wgw,A,353,371,18,LRRLITRSLAVIPVIICL,0
4wgw,A,385,408,23,VFSQVFLSIALPFSLIPLQLATS,0
4wgw,A,409,413,4,KKLM,0
4wgw,A,414,436,22,PFINKTWVNIISWTLIVILSGL,0
5mkk,B,5,17,12,AAPLLRRLWPYV,0
5mkk,B,23,42,19,YLWAVLAGLVSIFFFVLTP,0
5mkk,B,43,65,22,FLRLAVDAVQAGRGFGVYALAI,0
5mkk,B,66,84,18,ASAALSGLLSYAMRRLAV,0
5mkk,B,136,156,20,ILMGSRLSFLVLLAFLSMYA,0
5mkk,B,157,162,5,NARLA,0
5mkk,B,163,184,21,YLTLILPGIFLAMRFLLRLID,0
5mkk,B,237,258,21,LARVEGPLHALLGFLMGFAFL,0
5mkk,B,259,281,22,VLWAGGAMVVRGELSVGELVQF,0
5mkk,B,282,299,17,AYLAQLTWPILGLGWVM,0
2ht2,B,1,17,16,KTDTPSLETPQAARLR,0
2ht2,B,18,39,21,RQLIRQLLERDKTPLAILFMA,0
2ht2,B,40,61,21,VVGTLVGLAAVAFDKGVAWLQ,0
2ht2,B,84,96,12,CSAVLAMFGYFL,0
2ht2,B,97,128,31,RKYAPEAGGSGIPEIEGALEDQRPVRWWRVL,0
2ht2,B,129,142,13,VKFFGGLGTLGGG,0
2ht2,B,144,155,11,LGREGPTVQIG,0
2ht2,B,156,180,24,NIGRMVLDIFRLKGDEARHTLLAT,0
2ht2,B,181,200,19,AAAGLAAAFNAPLAGILFI,0
2ht2,B,201,216,15,EEMRPQFRYTLISIK,0
2ht2,B,217,232,15,VFIGVIMSTIMYRIF,0
2ht2,B,253,273,20,LYLILGIIFGIFGPIFNKWV,0
2ht2,B,274,282,8,GMQDLLHR,0
2ht2,B,283,290,7,HGGNITK,0
2ht2,B,291,305,14,VLMGGAIGGLCGLL,0
2ht2,B,338,351,13,ARVITTLLCFSSG,0
2ht2,B,353,368,15,GGIFAPMLALGTVLG,0
2ht2,B,392,415,23,GMGALLAASIRAPLTGIILVLEM,0
2ht2,B,422,436,14,LPMIITGLGATLLA,0
2ht2,B,437,458,21,FTGGKPLHSAILARTLAKQEA,0
2ht2,B,459,473,14,QLARSKAASASENT,0
2xq5,E,0,6,6,QDMVSP,0
2xq5,E,198,215,17,NIILPMLFILFISWTAF,0
2xq5,E,216,222,6,STSYEA,0
2xq5,E,223,239,16,VTLVVSTLIAHIAFNI,0
2xq5,E,255,273,18,AIIFMIYLFYFVAVIEVT,0
2xq5,E,274,294,20,QHYLKVESQPARAASITRAS,0
2xq5,E,295,312,17,IAFPVVFLLANIILAFL,0
2xqt,P,1,13,12,ESNLTTAASVIA,0
2xqt,P,14,28,14,ALAVGIGSIGPGLG,0
2xqt,P,60,74,14,MEALTIYGLVVALV,0
2xqt,P,75,82,7,LFANPFV,0
4ezc,C,1,30,29,DDNPTAVKLDQGGNQAPQGRGRRCLPKAL,0
4ezc,C,31,37,6,YITGDM,0
4ezc,C,38,44,6,EFANWL,0
4ezc,C,45,48,3,DKP,0
4ezc,C,49,67,18,ALQFVDWVLRGISQVVFV,0
4ezc,C,69,83,14,PISGILILVGLLVQ,0
4ezc,C,88,105,17,LNGCVGTVVSTLTALLL,0
4ezc,C,106,115,9,QDRSAITAG,0
4ezc,C,116,128,12,QGYNATLVGILM,0
4ezc,C,143,159,16,PVSAMSMTCPVFSSAL,0
4ezc,C,160,169,9,SVLSKWDLP,0
4ezc,C,170,182,12,FTLPFNMALSMY,0
4ezc,C,222,231,9,VGVGQIYGC,0
4ezc,C,236,249,13,GGIFLGAILLSSP,0
4ezc,C,251,265,14,CLHAAIGSLLGIIA,0
4ezc,C,282,295,13,FNSSLACIAIGGT,0
4ezc,C,296,303,7,MALTWQT,0
4ezc,C,304,318,14,LLALACALFTAYLG,0
4ezc,C,333,347,14,TWPFCLATLLFLLL,0
4ezc,C,348,376,28,TKNPNIYKMPISKVTYPEENRIFYLQSR,0
4ezc,C,377,384,7,RTVQGPL,0
5d58,A,5,19,14,KTFFGQPLGLSTLF,0
5d58,A,20,36,16,TEMWERFSYYGMRAIL,0
5d58,A,59,74,15,MAIYASMVYLSGTIG,0
5d58,A,75,87,12,FVADRIIGARPA,0
5d58,A,88,103,15,FWGGVLIMLGHIVLA,0
5d58,A,111,127,16,FGSIILIIIGTGFLKP,0
5d58,A,128,151,23,VSTLVGTLYDEHDRRRDAGFSIF,0
5d58,A,152,167,15,FGINLGAFIAPLIVG,0
5d58,A,179,194,15,SLAAIGMFIGLLVYY,0
5d58,A,195,222,27,GGKKTLDPHYLRPTDPLAPEEVKPLLV,0
5d58,A,223,239,16,VSLAVAGFIAIIVVMN,0
5d58,A,249,266,17,INLLTIVAIAIPVFYFA,0
5d58,A,267,269,2,MI,0
5d58,A,275,286,11,STEHLRVVSYI,0
5d58,A,287,307,20,LFIAAVLFWAIEEQGSVVLA,0
5d58,A,323,339,16,FQSLNPLFIMLYTPFF,0
5d58,A,340,355,15,WLWTAWKKNQPSSPT,0
5d58,A,356,371,15,FAVGLMFAGLSFLLM,0
5d58,A,388,404,16,LVGSWALVILGEMLIS,0
5d58,A,423,425,2,MS,0
5d58,A,426,442,16,WFLSSSVGSALNAQLV,0
5d58,A,455,471,16,YFGLGSVVLGIVLVFL,0
5d58,A,472,475,3,KRI,0
5fuf,C,4,32,28,FTGTGTGGDVFKVDLNEQFDRADMVWIG,0
5fuf,C,33,49,16,ASVLVWIMIPGVGLLY,0
5fuf,C,62,84,22,WAALMAACVAAFQWFWWGYSLV,0
5fuf,C,85,120,35,AHNGSVFLGTLQNFCLKDVLGAPSIVKTVPDILFC,0
5fuf,C,121,138,17,YQGMFAAVTAILMAGAG,0
5fuf,C,146,166,20,MMVFLFIWLTVVYCPIAYWT,0
5fuf,C,167,180,13,GGNGWLVSLGALD,0
5fuf,C,181,198,17,AGGGPVHENSGFAALAY,0
5fuf,C,225,243,18,VMGTIFLWFGWYGFNGGS,0
5fuf,C,244,254,10,GNSSMRSWYA,0
5fuf,C,255,272,17,VNTNLAAATGGLTWMLV,0
5fuf,C,286,301,15,CMGAIAGLVGITPAA,0
5fuf,C,302,306,4,YVPV,0
5fuf,C,307,324,17,TSVIFGIVPAIICNFAV,0
5fuf,C,336,356,20,DVWALHGVGGFVGNFMTGLF,0
5fuf,C,357,358,1,A,0
5fuf,C,359,365,6,YVAMID,0
5fuf,C,366,381,15,TEIDGGWMNHHWKQL,0
5fuf,C,382,406,24,YQLAGSCAVAAWSFTVTSIILLAM,0
3ne5,I,-6,3,9,HHHHHMGIE,0
3ne5,I,5,11,6,IRRSVA,0
3ne5,I,12,15,3,RFL,0
3ne5,I,16,32,16,LMGALFLSIWGTWTII,0
3ne5,I,339,356,17,GKLLEEFIVVAVVCALF,0
3ne5,I,357,363,6,WHVRSA,0
3ne5,I,364,384,20,VAIISLPLGLCIAFIVMHFQ,0
3ne5,I,393,409,16,GGIAIAVGAMVDAAIV,0
3ne5,I,410,449,39,IENAHKRLEEWQHQHPDATLDNKTRWQVITDASVEVGPA,0
3ne5,I,450,466,16,FISLLIITLSFIPIFT,0
3ne5,I,478,497,19,AFTKTYAMAGAALLAIVVI,0
3ne5,I,498,504,6,ILMGYW,0
3ne5,I,505,516,11,RGKIPPESSNP,0
3ne5,I,518,532,14,RFLIRVYHPLLLKV,0
3ne5,I,533,539,6,HWPKTT,0
3ne5,I,540,555,15,LVAALSVLTVLWPLN,0
3ne5,I,873,890,17,LMVPMTLMIIFVLLYLA,0
3ne5,I,891,897,6,RRVGEA,0
3ne5,I,898,918,20,LIISSVPFALVGGIWLLWWM,0
3ne5,I,927,943,16,TGFIALAGVAAEFGVV,0
3ne5,I,944,984,40,LMYLRHAIEAVPSLNNPQTFSEQKLDEALYHGAVLRVRPK,0
3ne5,I,985,1001,16,MTVAVIIAGLLPILWG,0
3ne5,I,1010,1028,18,RIAAPMIGGMITAPLLSL,0
3ne5,I,1029,1043,14,IIPAAYKLMWLHRH,0
3ne5,I,1044,1047,3,VRK,0
4ev6,E,-21,0,21,HHHHHHSSGVDLGTENLYFQS,0
4ev6,E,1,260,259,ITVIAIAKDGSIVEPKLDEISFEDYRLIWIDCYDPKDEELYKLSKKIGISVSDLQIGLDEQEIPRVEEDEDFYLIIYKAPLFEEDITTTSLGIYIKNNLLLTIHSDKIKAIGRLHKLISTKKPRIVFERGIGFLLYHILNEITRSYSRILMNLEDELEELEDKLLAGYDREVMEKILGLRKTLVYFHKSLIANRDVLVLLKRKYLPITTKEDRENFEDLYYDTLQLIDMSATYREVLTSMMDITLSLENIKMNQIMKIL,0
4ev6,E,261,281,20,MVTTIFAVPMWITGIYGMNF,0
4ev6,E,292,311,19,FWLVMALMVVIIMIFVYIF,0
4ev6,E,312,317,5,RSGWI,0
2jag,C,1,21,20,SITSVPGVVDAGVLGAQSAA,0
2jag,C,36,52,16,VALAGIAILVFVYMGR,0
2jag,C,53,61,8,IRPGRPRL,0
2jag,C,62,78,16,WGATLMIPLVSISSYL,0
2jag,C,109,124,15,LTWALSTPMILLALG,0
2jag,C,125,132,7,LADVDLG,0
2jag,C,133,149,16,LFTVIAADIGMCVTGL,0
2jag,C,164,180,16,YAISCAFFVVVLSALV,0
2jag,C,181,198,17,DWAASASSAGTAEIFDT,0
2jag,C,199,215,16,RVLVVVLWLGYPIVWA,0
2jag,C,233,251,18,YSVLDVFAKYVFAFILLR,0
2jag,C,252,263,11,VANNERTVAVA,0
2jag,C,264,274,10,QTLGTMSSDD,0
2m0b,A,647,668,21,TGMVGALLLLLVVALGIGLFM,0
2m0b,A,669,677,8,RRHIVRKR,0
2mfr,A,21,42,21,GPLIFVFLFSVVIGSIYLFLR,0
2mfr,A,43,57,14,RQPDGPLEHHHHHH,0
3qdc,A,1,4,3,VGL,0
3qdc,A,5,27,22,TLFWLGAIGMLVGTLAFAWAGR,0
3qdc,A,35,60,25,YYVTLVGISGIAAVAYVVMALGVGW,0
3qdc,A,61,68,7,PVAERTV,0
3qdc,A,69,91,22,APRYIDWILTTPLIVYFLGLLA,0
3qdc,A,96,118,22,EFGIVITLNTVVMLAGFAGAMV,0
3qdc,A,119,122,3,GIE,0
3qdc,A,123,146,23,YALFGMGAVAFLGLVYYLVGPMT,0
3qdc,A,160,184,24,VRLRNLTVILWAIYPFIWLLGPPG,0
3qdc,A,185,191,6,ALLTPT,0
3qdc,A,192,215,23,DVALIVYLDLVTKVGFGFIALDA,0
3qdc,A,220,239,19,AEHGESLAGVDTDAPAVAD,0
2wx5,M,1,54,53,EYQNIFSQVQVRGPADLGMTEDVNLANRSGVGPFSTLLGWFGNAQLGPIYLGS,0
2wx5,M,55,72,17,GVLSLFSGLMWFFTIGI,0
2wx5,M,82,87,5,AVFLR,0
2wx5,M,117,134,17,ASFFMFVAVWSWWGRTY,0
2wx5,M,135,145,10,RAQALGMGKH,0
2wx5,M,146,164,18,AWAFLSAIWLWMVLGFIR,0
2wx5,M,179,192,13,FSHLDWTNNFSLV,0
2wx5,M,201,221,20,HGLSIAFLYGSALLFAMHGA,0
2wx5,M,222,267,45,ILAVSRFGGERELEQIADRGTAAERAALFWRWTMGFNATMEGIHR,0
2wx5,M,268,286,18,AIWMAVLVTLTGGIGILL,0
2wx5,M,294,300,6,YVWGQN,0
2wx5,M,303,307,4,APLN,0
1nkz,S,20,37,17,VFLGLALVAHFLAFSAT,0
1nkz,S,38,41,3,WLH,0
5kkz,G,9,13,4,TRRD,0
5kkz,G,14,32,18,LYYATAGAGAVATGAAVW,0
5irz,C,434,455,21,YFNFFVYCLYMIIFTAAAYYR,0
5irz,C,456,472,16,VEGLPPYKLKNTVGDY,0
5irz,C,473,497,24,RVTGEILSVSGGVYFFFRGIQYFL,0
5irz,C,511,532,21,SEILFFVQSLFMLVSVVLYFS,0
5irz,C,533,536,3,RKE,0
5irz,C,537,556,19,VASMVFSLAMGWTNMLYYT,0
5irz,C,560,568,8,QMGIYAVM,0
5irz,C,569,598,29,EKMILRDLCRFMFVYLVFLFGFSTAVVTL,0
5irz,C,599,629,30,EDGKYNS,0
5irz,C,630,649,19,YSTCLELFKFTIGMGDLEF,0
5irz,C,650,655,5,ENYDF,0
5irz,C,656,682,26,AVFIILLLAYVILTYILLLNMLIALM,0
5irz,C,690,709,19,QESKNIWKLQRAITILDTE,0
2ntu,C,1,4,3,AQI,0
2ntu,C,5,10,5,GRPEW,0
2ntu,C,11,33,22,WLALGTALMGLGTLYFLVKGMG,0
2ntu,C,40,62,22,KFYAITTLVPAIAFTMYLSMLL,0
2ntu,C,63,79,16,YGLTMVPFGGEQNPIY,0
2ntu,C,80,100,20,ARYADWLFTTPLLLLDLALL,0
2ntu,C,106,127,21,TILALVGADGIMIGTGLVGAL,0
2ntu,C,128,133,5,KVYSY,0
2ntu,C,134,156,22,FVWWAISTAAMLYILYVLFFGF,0
2ntu,C,157,161,4,SKAE,0
2ntu,C,171,192,21,KVLRNVTVVLWSAYPVVWLIG,0
2ntu,C,193,203,10,EGAGIVPLNI,0
2ntu,C,204,226,22,TLLFMVLDVSAKVGFGLILLRS,0
2ntu,C,232,249,17,AEAPEPSAGDGAAATSD,0
4xnw,A,54,79,25,PAVYILVFIIGFLGNSVAIWMFVFH,0
4xnw,A,80,85,5,KPWSG,0
4xnw,A,86,108,22,SVYMFNLALADFLYVLTLPALI,0
4xnw,A,123,150,27,CKLQRFIFHVNLYGSILFLTCISAHRY,0
4xnw,A,151,167,16,GVVYPLKSLGRLKKKN,0
4xnw,A,168,190,22,ICISVLVWLIVVVAISPILFYS,0
4xnw,A,214,242,28,FIYSMCTTVAMFCVPLVLILGCYGLIVR,0
4xnw,A,243,257,14,LIYKMKKYTCTVCGYIYNPEDGDPDNGVNPGTDFKDIPDDWVCPLCGVGKDQFEEVEEPLRRK,0
4xnw,A,258,282,24,IYLVIIVLTVFAVSYIPFHVMKTM,0
4xnw,A,306,328,22,QVTRGLASLNSCVNPILYFLAG,0
4xnw,A,329,334,5,TFRRR,0
1kyl,E,14,20,6,NVVDLA,0
1kyl,E,21,37,16,GVIIGAAFGKIVSSLV,0
1kyl,E,44,71,27,LGLLIGGIDFKQFAVTLRDAQGDIPAV,0
1kyl,E,78,94,16,IQNVFDFLIVAFAIFM,0
1kyl,E,95,96,1,I,0
2wu2,L,1,10,9,VSNASALGR,0
2wu2,L,15,35,20,FILVRATAIVLTLYIIYMVG,0
2wu2,L,36,56,20,FATSGELTYEVWIGFFASAF,0
2wu2,L,57,80,23,KVFTLLALFSILIHAWIGMWQVL,0
2wu2,L,89,110,21,RLMLQLVIVVALVVYVIYGFV,0
2wu2,L,111,115,4,VWGV,0
4qim,A,187,189,2,GT,0
4qim,A,230,253,23,HSYIAAFGAVTGLCTLFTLATFV,0
4qim,A,254,263,9,DWRNSNRYP,0
4qim,A,264,290,26,VILFYVNACFFVGSIGWLAQFMDGAR,0
4qim,A,312,340,28,SCVIIFVIVYYALMAGVVWFVVLTYAWH,0
4qim,A,341,346,5,SFKAL,0
4qim,A,347,352,5,TTYQP,0
4qim,A,353,356,3,SGK,0
4qim,A,357,383,26,SYFHLLTWSLPFVLTVAILAVAQVDG,0
4qim,A,398,424,26,YRAGFVLAPIGLVLIVGGYFLIRGVM,0
4qim,A,425,451,26,LFSIKSNHADLEDNWETLNDNLKVIEKADNAAQVKDALTKMRAAALDAQKATPPKLEDKSPDSPEMKDFRHGFDILVGQIDDALKLANEGKVKEAQAAAEQLKTTRNAYIQKYLAASKINETMLR,0
4qim,A,452,474,22,GIFGFLAFGFVLITFSCHFYDF,0
4qim,A,516,538,22,VEKINLFAMFGTGIAMSTWVWT,0
4qim,A,539,552,13,ATLLIWRRTWCRL,0
4qim,A,554,555,1,Q,0
1p8u,C,1,4,3,AQI,0
1p8u,C,5,11,6,GRPEWI,0
1p8u,C,12,28,16,LALGTALMGLGTLYFL,0
1p8u,C,47,62,15,LAPAIAFTMYLSMLL,0
1p8u,C,63,79,16,YGLTMVPFGGEQNPIY,0
1p8u,C,80,94,14,ARYADWLFTTPLLL,0
1p8u,C,111,127,16,VGADGIMIGTGLVGAL,0
1p8u,C,128,133,5,KVYSY,0
1p8u,C,134,150,16,FVWWAISTAAMLYILY,0
1p8u,C,157,161,4,SKAE,0
1p8u,C,178,192,14,VVLWSAYPVVWLIG,0
1p8u,C,193,203,10,EGAGIVPLNI,0
1p8u,C,204,221,17,TLLFMVLDVSAKVGFGL,0
1p8u,C,232,249,17,AEAPEPSAGDGAAATSD,0
1ne0,A,31,54,23,LLPPLYSLVFIFGFVGNMLVILI,0
1ne0,A,55,69,14,INCKRLKSMTDIYL,0
1ne0,A,70,92,22,NLAISDLFFLLTVPFWAHYAAA,0
1ne0,A,103,124,21,LTGLYFIGFFSGIFFIILLTI,0
1ne0,A,125,150,25,RYLAVVHAVFALKARTVTFGVVTSV,0
1ne0,A,151,169,18,TWVVAVFASLPGIIFTRS,0
1ne0,A,193,218,25,QTLKIVILGLVLPLLVMVICYSGIL,0
1ne0,A,219,239,20,TLLRCRNEKKRHRAVRLIFT,0
1ne0,A,240,263,23,MIVYFLFWAPYNIVLLLNTFQEF,0
1ne0,A,277,300,23,AMQVTETLGMTHCCINPIIYAFV,0
1ne0,A,301,352,51,EKFRNYLLVFFQKHIAKRFCKCCSIFQQEAPERASSVYTRSTGEQEISVGL,0
1et2,S,168,193,25,ECVKFLTNETREREVFDRLGMIYTV,0
1et2,S,194,208,14,YSVSLASLTVAVLI,0
1et2,S,228,241,13,SFMLRAVSIFVKD,0
1et2,S,242,276,34,VLYSGATLDEAERLTEEELRAIAQAPPPPATAAA,0
1et2,S,277,290,13,YAGCRVAVTFFLY,0
1et2,S,323,336,13,FTVFGWGLPAVFV,0
1et2,S,337,367,30,VWVSVRATLANTGCWDLSSGNKKWIIQVPI,0
1et2,S,368,381,13,ASIVLNFILFINI,0
1et2,S,413,428,15,MPLFGVHYIVFMATP,0
1et2,S,429,449,20,TEVSGTLWQVQMHYEMLFNS,0
1et2,S,450,464,14,QGFFVAIIYCFCNG,0
3h1j,W,5,12,7,LRQAYSA,0
3h1j,W,13,18,5,FRRTS,0
3h1j,W,19,40,21,FALTVVLGAVLFERAFDQGAD,0
3h1j,W,63,64,1,E,0
5gpj,B,3,13,10,AILPDLGTEI,0
5gpj,B,14,28,14,IPVCAVIGIAFALF,0
5gpj,B,93,110,17,KYVGIFMVAFAILIFLF,0
5gpj,B,111,141,30,GSVEGFSTSPQACSYDKTKTCKPALATAIF,0
5gpj,B,142,160,18,TVSFLLGGVTSLVSGFLG,0
5gpj,B,192,209,17,MGFLLAANGLLVLYIAI,0
5gpj,B,210,227,17,LFKIYYGDDWGGLFEAI,0
5gpj,B,228,244,16,GYGLGGSSMALFGRVG,0
5gpj,B,290,306,16,MGSDLFGSYAESSCAA,0
5gpj,B,307,327,20,VVASISSFGLNHELTAMLYP,0
5gpj,B,328,344,16,IVSSVGILVCLLTTLF,0
5gpj,B,363,379,16,QLVISTVLMTIGVAVV,0
5gpj,B,380,405,25,FVALPTSFTIFNFGVQKDVKSWQLF,0
5gpj,B,406,422,16,CVAVGLWAGLIIGFVT,0
5gpj,B,456,473,17,KSVIIPIFAIAISIFVS,0
5gpj,B,474,482,8,TFAAMYGI,0
5gpj,B,483,500,17,VAALGMLSTIATGLAID,0
5gpj,B,540,556,16,KGFAIGSAALVSLALF,0
5gpj,B,557,575,18,AFVSRASITTVDVLTPKV,0
5gpj,B,576,593,17,IGLIVGAMLPYWFSAMT,0
5gpj,B,643,659,16,PPGALVMLTPLVVGIL,0
5gpj,B,660,664,4,GVET,0
5gpj,B,665,684,19,SGVLAGSLVSGVQIAISAS,0
5gpj,B,734,751,17,PSLNILIKLMAVESLVF,0
5gpj,B,752,757,5,PFFAT,0
5gpj,B,758,766,8,GGLLFKIF,0
4a97,E,11,210,199,VDVSVSIFINKIYGVNTLEQTYKVDGYIVAQWTGKPRKTPGDKPLIVENTQIERWINNGLWVPALEFINVVGSPDTGNKRLMLFPDGRVIYNARFLGSFSNDMDFRLFPFDRQQFVLELEPFSYNNQQLRFSDIQVYTENIDNEEIDEWWIRGKASTHISDIRYDHLSSVQPNQNEFSRITVRIDAVRNPSYYLWSFIL,0
4a97,E,211,225,14,LGLIIAASWSVFWL,0
4a97,E,230,245,15,RLQTSFTLMLTVVAY,0
4a97,E,246,265,19,FYTSNILPRLPYTTVIDQM,0
4a97,E,266,282,16,IAGYGSIFAAILLIIF,0
4a97,E,300,315,15,RLAFPLGFLAIGCVL,0
4a97,E,316,317,1,I,0
3vou,D,-2,0,2,GS,0
3vou,D,2,18,16,SFILTLKRMLKACLRA,0
3vou,D,26,45,19,LFVLTFLTLTSGTIFYSTV,0
3vou,D,46,50,4,GLRP,0
3vou,D,51,67,16,DALYFSVVTLTTVGDG,0
3vou,D,68,75,7,FSPQTDF,0
3vou,D,76,95,19,KVFTILYIFIGIGLVFGFI,0
3vou,D,101,103,2,VQ,0
3vou,D,140,145,5,SLVPR,0
5nmi,X,22,36,14,LWGAVGAVGLVSAT,0
4d2b,A,1,5,4,EDKG,0
4d2b,A,6,19,13,TFFGQPLGLSTLF,0
4d2b,A,20,34,14,TEMWERFSYYGMRA,0
4d2b,A,59,74,15,MAIYASMVYLSGTIG,0
4d2b,A,75,88,13,FVADRIIGARPAV,0
4d2b,A,89,104,15,WGGVLIMLGHIVLAL,0
4d2b,A,111,127,16,FGSIILIIIGTGFLKP,0
4d2b,A,128,150,22,VSTLVGTLYDEHDRRRDAGFSI,0
4d2b,A,151,166,15,VFGINLGAFIAPLIV,0
4d2b,A,179,193,14,SLAAIGMFIGLLVY,0
4d2b,A,194,224,30,FGGKKTLDPHYLRPTDPLAPEEVKPLLVKV,0
4d2b,A,225,240,15,LAVAGFIAIIVVMNL,0
4d2b,A,249,266,17,INLLTIVAIAIPVFYFA,0
4d2b,A,267,270,3,MIS,0
4d2b,A,271,279,8,VKVTSTEH,0
4d2b,A,280,285,5,RVVSY,0
4d2b,A,286,304,18,PLFIAAVLFWAIEEQGSV,0
4d2b,A,324,342,18,QSLNPLFIMLYTPFFAWL,0
4d2b,A,343,345,2,TA,0
4d2b,A,346,348,2,KK,0
4d2b,A,349,353,4,QPSS,0
4d2b,A,354,369,15,TKFAVGLMFAGLSFL,0
4d2b,A,391,407,16,SWALVILGEMLISPVG,0
4d2b,A,408,412,4,SVTT,0
4d2b,A,413,422,9,LAPKAFNSQ,0
4d2b,A,423,426,3,MSM,0
4d2b,A,427,441,14,FLSSSVGSALNAQL,0
4d2b,A,458,472,14,LGSVVLGIVLVFLS,0
4d2b,A,473,491,18,RIQGLMQGVEGSENLYFQ,0
2ksb,A,2,33,31,NVLPVDSDLSPNISTNTSEPNQFVQPAWQIV,0
2ksb,A,34,58,24,WAAAYTVIVVTSVVGNVVVMWIIL,0
2ksb,A,70,93,23,LVNLAFAEASMAAFNTVVNFTYA,0
2ksb,A,94,103,9,HNEWYYGLF,0
2ksb,A,104,127,23,CKFHNFFPIAAVFASIYSMTAVA,0
2ksb,A,149,174,25,VICVIWVLALLLAFPQGYYSTTETM,0
2ksb,A,175,191,16,SRVVCMIEWPEHPNKI,0
2ksb,A,192,217,25,EKVYHICVTVLIYFLPLLVIGYAYT,0
2ksb,A,250,274,24,IVVVCTFAICWLPFHIFFLLPYIN,0
2ksb,A,275,285,10,DLYLKKFIQQ,0
2ksb,A,286,308,22,YLAIMWLAMSSTMYNPIIYCCL,0
2ksb,A,310,320,10,RFRLGFKHAF,0
4mmc,A,1,4,3,EVK,0
4mmc,A,5,12,7,EHWATRL,0
4mmc,A,13,31,18,LILAMAGYAVDLGNFLRF,0
4mmc,A,45,63,18,PYIIAFLLVGIPLMWIEW,0
4mmc,A,64,89,25,MGRYGGAQGHGTTPAIFYLLWRNRF,0
4mmc,A,90,121,31,KILGVFGLWIPLVVAIYYVYIESWTLGFAIK,0
4mmc,A,132,134,2,,0
4mmc,A,167,184,17,AYIVFLITMFINVSILI,0
4mmc,A,185,190,5,GISKG,0
4mmc,A,191,211,20,ERFAKIAMPTLFILAVFLVI,0
4mmc,A,223,231,8,ADGLNFLW,0
4mmc,A,245,266,21,AAVGQIFFSLGLGFGAIITFA,0
4mmc,A,267,276,9,YVRKDQDIV,0
4mmc,A,277,295,18,SGLTAATLNEKAEVILGG,0
4mmc,A,319,324,5,FNLGF,0
4mmc,A,326,331,5,LPAIF,0
4mmc,A,343,364,21,WFFLLFFAGLTSSIAGMQPMI,0
4mmc,A,365,379,14,FLEDELKLSRKHAV,0
4mmc,A,380,396,16,WTAAIVFFSAHLVMFL,0
4mmc,A,400,426,26,DEMDFWAGTIGVVFFGLTELIIFFWI,0
4mmc,A,427,428,1,G,0
4mmc,A,429,437,8,DKAWEEIN,0
4mmc,A,438,444,6,GGIIKV,0
4mmc,A,445,468,23,RIYYYVMRYITPAFLAVLLVVWA,0
4mmc,A,469,477,8,EYIPKIME,0
4mmc,A,484,500,16,ITRFYIIGLFLFLTFL,0
4mmc,A,501,511,10,FLAERRRNHE,0
4mmc,A,512,519,7,AGTLVPR,0
2yoe,E,11,210,199,VDVSVSIFINKIYGVNTLEQTYKVDGYIVAQWTGKPRKTPGDKPLIVENTQIERWINNGLWVPALEFINVVGSPDTGNKRLMLFPDGRVIYNARFLGSFSNDMDFRLFPFDRQQFVLELEPFSYNNQQLRFSDIQVYTENIDNEEIDEWWIRGKASTHISDIRYDHLSSVQPNQNEFSRITVRIDAVRNPSYYLWSFIL,0
2yoe,E,211,225,14,LGLIIAASWSVFWL,0
2yoe,E,230,245,15,RLQTSFTLMLTVVAY,0
2yoe,E,246,265,19,FYTSNILPRLPYTTVIDQM,0
2yoe,E,266,282,16,IAGYGSIFAAILLIIF,0
2yoe,E,300,315,15,RLAFPLGFLAIGCVL,0
2yoe,E,316,317,1,I,0
2g2a,A,49,67,18,LYYMIFVIGFAVNIVVVS,0
2g2a,A,68,82,14,FCCQKGPKKVSSIY,0
2g2a,A,83,102,19,FNLAVADLLLLATLPLWAT,0
2g2a,A,119,137,18,FGSFLTLNMFASIFFITC,0
2g2a,A,138,163,25,SVDRYQSVIYPFLSQRRNPWQASYV,0
2g2a,A,164,183,19,PLVWCMACLSSLPTFYFRD,0
2g2a,A,211,228,17,ALMKNILGFIIPLIFIA,0
2g2a,A,229,259,30,CYFGIRKHLLKTNSYGKNRITRDQVLKMAA,0
2g2a,A,260,278,18,VVLAFIICWLPFHVLTFL,0
2g2a,A,301,320,19,FAILLGFTNSCVNPFLYCF,0
2g2a,A,321,363,42,GNRFQQKLRSVFRVPITWLQGKRETMSCRKSSSLREMDTFVS,0
4cbc,H,126,129,3,SHM,0
4cbc,H,135,153,18,ALLTVVFYIAAVMATNLY,0
4cbc,H,154,163,9,ATFPEWFGD,0
4cbc,H,164,186,22,SKSLYTLFQVMTLESWSMGIVR,0
4cbc,H,187,193,6,VMNVHP,0
4cbc,H,194,214,20,AWVFFIPFIMLTTFTVLNLF,0
4cbc,H,223,274,51,ITKEQEEEAKTGHHQEPISQTLLHLGDRLDRIEKQLAQNNELLQRQQPQKK,0
3ddl,A,4,19,15,LPTLTPGQYSLVFNM,0
3ddl,A,20,41,21,SFTVATMTASFVFFVLARNNV,0
3ddl,A,46,65,19,ISMMVSALVVFIAGYHYFR,0
3ddl,A,66,91,25,TSSWEAAYALQNGMYQPTGELFNDA,0
3ddl,A,92,112,20,RYVDWLLTVPLLTVELVLVM,0
3ddl,A,121,141,20,LAAKLGFLAALMIVLGYPGE,0
3ddl,A,142,148,6,SENAAL,0
3ddl,A,149,173,24,GTRGLWGFLSTIPFVWILYILFTQ,0
3ddl,A,188,209,21,LGNARLLLLATWGFYPIAYMI,0
3ddl,A,210,211,1,M,0
3ddl,A,218,230,12,SNTPGTIVALQV,0
3ddl,A,231,252,21,YTIADVLAKAGYGVLIYNIAK,0
4xtn,B,24,47,23,YQFTSHILTLGYAVMLAGLLYFI,0
4xtn,B,48,61,13,TIKNVDKKFQMSN,0
4xtn,B,62,85,23,LSAVVMVSAFLLLYAQAQNWTSS,0
4xtn,B,105,124,19,NGYRYLNWLIDVPMLLFQI,0
4xtn,B,125,137,12,FVVSLTTSKFSS,0
4xtn,B,138,160,22,RNQFWFSGAMMIITGYIGQFYE,0
4xtn,B,165,187,22,AFLVWGAISSAFFFHILWVMKK,0
4xtn,B,188,205,17,INEGKEGISPAGQKILS,0
4xtn,B,206,229,23,IWILFLISWTLYPGAYLMPYLTG,0
4xtn,B,238,261,23,GVMARQLVYTIADVSSKVIYGVL,0
4xtn,B,262,270,8,GNLAITLS,0
4xtn,B,274,275,1,L,0
4zlj,C,1,10,9,PNFFIDRPI,0
4zlj,C,11,27,16,AWVIAIIIMLAGGLAI,0
4zlj,C,341,357,16,KTLVEAIILVFLVMYL,0
4zlj,C,358,365,7,LQNFRAT,0
4zlj,C,366,386,20,IPTIAVPVVLLGTFAVLAAF,0
4zlj,C,395,410,15,FGMVLAIGLLVDDAI,0
4zlj,C,411,442,31,VVENVERVMAEEGLPPKEATRKSMGQIQGAL,0
4zlj,C,443,458,15,GIAMVLSAVFVPMAF,0
4zlj,C,471,489,18,ITIVSAMALSVLVALILT,0
4zlj,C,490,511,21,ALCATMLKPIAKGDHGEGKKG,0
4zlj,C,512,535,23,FGWFNRMFEKSTHHYTDSVGGIL,0
4zlj,C,536,541,5,STGRY,0
4zlj,C,542,557,15,VLYLIIVVGMAYLFV,0
4zlj,C,874,891,17,SLYAISLIVVFLCLAAL,0
4zlj,C,892,898,6,ESWSIP,0
4zlj,C,899,919,20,SVMLVVPLGVIGALLAATFR,0
4zlj,C,927,943,16,QVGLLTTIGLSAKNAI,0
4zlj,C,944,975,31,IVEFAKDLMDKEGKGLIEATLDAVRMRLRPI,0
4zlj,C,976,992,16,MTSLAFILGVMPLVIS,0
4zlj,C,1002,1019,17,VGTGVMGGMVTATVLAI,0
4zlj,C,1020,1031,11,FVPVFFVVVRR,0
4zlj,C,1032,1034,2,FS,0
4mm5,A,1,4,3,EVK,0
4mm5,A,5,13,8,EHWATRLG,0
4mm5,A,14,32,18,ILAMAGYAVDLGNFLRFP,0
4mm5,A,42,62,20,FMIPYIIAFLLVGIPLMWIE,0
4mm5,A,63,92,29,AMGRYGGAQGHGTTPAIFYLLWRNRFAKI,0
4mm5,A,93,120,27,GVFGLWIPLVVASYYVYIESWTLGFAI,0
4mm5,A,132,134,2,,0
4mm5,A,167,184,17,AYIVFLITMFINVSILI,0
4mm5,A,185,190,5,GISKG,0
4mm5,A,191,212,21,ERFAKIAMPTLFILAVFLVIR,0
4mm5,A,223,231,8,ADGLNFLW,0
4mm5,A,242,265,23,VWIAAVGQIFFSLGLGFGVLITF,0
4mm5,A,266,279,13,SYVRKDQDIVLSG,0
4mm5,A,280,297,17,TAATLNEKASVILGGSI,0
4mm5,A,319,324,5,FNLGF,0
4mm5,A,326,331,5,LPAIF,0
4mm5,A,343,364,21,WFFLLFFAGLTSSIAGMQGMI,0
4mm5,A,365,378,13,FLEDELKLSRKHA,0
4mm5,A,379,396,17,LWTAAIVFFSAHLVMFL,0
4mm5,A,400,421,21,DEMDFWATGIGVVFFGLTELI,0
4mm5,A,422,428,6,FFWIFG,0
4mm5,A,429,437,8,DKAWEEIN,0
4mm5,A,438,450,12,GGIIKVPRIYYY,0
4mm5,A,451,471,20,MRYITPAFLAVLLVVWAREY,0
4mm5,A,472,478,6,PKIMEE,0
4mm5,A,484,500,16,ITRFYIIGLFLFLTFL,0
4mm5,A,501,511,10,FLAERRRNHE,0
4mm5,A,512,519,7,AGTLVPR,0
5lwe,B,51,74,23,PPLYWLVFIVGALGNSLVILVYW,0
5lwe,B,75,83,8,CARAKTAT,0
5lwe,B,84,108,24,MFLLNLAIADLLFLVTLPFWAIAA,0
5lwe,B,119,143,24,KVVNSMYKMNFYSCVLLIMCICVD,0
5lwe,B,144,164,20,YIAIAQAMRAHTWREKRLLY,0
5lwe,B,165,185,20,KMVCFTIWVLAAALCIPEIL,0
5lwe,B,214,239,25,LALKVILGFFLPFVVMACCYTIIIH,0
5lwe,B,240,253,13,LIQAKKSSKHKAL,0
5lwe,B,254,279,25,ATITVLTVFVLSQFPYNCILLVQTI,0
5lwe,B,299,321,22,QVTQAIAFFHSCLNPVLYVFVG,0
5lwe,B,322,323,1,R,0
5lwe,B,324,343,19,RRDLVKTLKNLGAISQAAA,0
1gzm,C,43,66,23,FLLIMLGFPINFLTLYVTVQHKK,0
1gzm,C,67,68,1,R,0
1gzm,C,69,92,23,PLNYILLNLAVADLFMVFGGFTT,0
1gzm,C,114,136,22,FATLGGEIALWSLVVLAIERYV,0
1gzm,C,137,150,13,VCKPMSNFRFGEN,0
1gzm,C,151,170,19,AIMGVAFTWVMALACAAPP,0
1gzm,C,203,225,22,IYMFVVHFIIPLIVIFFCYGQL,0
1gzm,C,226,250,24,FTVKEAAAQQQESATTQKAEKEVT,0
1gzm,C,251,274,23,MVIIMVIAFLICWLPYAGVAFYI,0
1gzm,C,291,310,19,FFAKTSAVYNPVIYIMMNK,0
1gzm,C,311,322,11,FRNCMVTTLCC,0
1gzm,C,323,326,3,KNP,0
1gzm,C,327,329,2,GD,0
1gzm,C,330,331,1,E,0
1gzm,C,332,348,16,STTVSKTETSQVAPA,0
3s3b,C,2,4,2,EK,0
3s3b,C,5,28,23,KGALAVILVLTLTILVFWLGVYA,0
4tl3,B,1,7,6,NLESLL,0
4tl3,B,8,26,18,WIYVAGMTIGALHFWSLS,0
4tl3,B,38,54,16,VAMFIPIWSGLAYMAM,0
4tl3,B,55,57,2,ID,0
4tl3,B,58,66,8,GKVEAAGQ,0
4tl3,B,67,69,2,AH,0
4tl3,B,70,87,17,ARYIDWMVTTPLLLLSL,0
4tl3,B,103,120,17,FLMSTQIVVITSGLIAD,0
4tl3,B,121,126,5,SERDW,0
4tl3,B,127,146,19,RYLWYICGVCAFLIILWGI,0
4tl3,B,169,186,17,TYFTVLWIGYPIVWIIG,0
4tl3,B,187,198,11,SGFGWINQTID,0
4tl3,B,199,218,19,FLFCLLPFFSKVGFSFLEL,0
3m78,C,1,6,5,NITKP,0
3m78,C,7,9,2,PL,0
3m78,C,10,27,17,TGYFDIPLGLAALSLAW,0
3m78,C,41,64,23,DVLGIVASAVWILFILMYAYKLR,0
3m78,C,65,66,1,Y,0
3m78,C,67,75,8,EEVRAEYH,0
3m78,C,76,80,4,PVRF,0
3m78,C,81,97,16,FIALIPITTMLVGDIL,0
3m78,C,105,128,23,EVLIWIGTIGQLLFSTLRVSELW,0
3m78,C,129,139,10,GGVFEQKSTH,0
3m78,C,140,154,14,SFYLPAVAANFTSA,0
3m78,C,166,186,20,YLFFGAGMIAWIIFEPVLLQ,0
3m78,C,187,199,12,LRISSLEPQFRA,0
3m78,C,200,215,15,MGIVLAPAFVCVSAY,0
3m78,C,227,246,19,KILWGYGFLQLFFLLRLFP,0
3m78,C,247,253,6,IVEKGL,0
3m78,C,254,271,17,IGLWAFSGGLASMANSA,0
3m78,C,284,309,25,IFAFVFSNVMIGLLVLMTIYKLTKG,0
3m78,C,310,313,3,FFL,0
4aw6,B,1,9,8,GMWASLDA,0
4aw6,B,19,38,19,FGAVLLFSWTVYLWETFLA,0
4aw6,B,39,79,40,RQRRIYKTTTHVPPELGQIMDSETFEKSRLYQLDKSTFSF,0
4aw6,B,80,96,16,SGLYSETEGTLILLFG,0
4aw6,B,97,107,10,IPYLWRLSGR,0
4aw6,B,109,115,6,GYAGFG,0
4aw6,B,118,141,23,EITQSLVFLLLATLFSALAGLPW,0
4aw6,B,142,168,26,LYNTFVIEEKHGFNQQTLGFFMKDAI,0
4aw6,B,169,190,21,KFVVTQCILLPVSSLLLYIIK,0
4aw6,B,196,215,19,FIYAWLFTLVVSLVLVTIY,0
4aw6,B,216,285,69,DYIAPLFDKFTPLPEGKLKEEIEVMAKSIDFPLTKVYVVEGSKRSSHSNAYFYGFFKNKRIVLFDTLLE,0
4aw6,B,286,321,35,YSVLNKDIQEDSGMEPRNEEEGNSEEIKAKVKNKK,0
4aw6,B,322,345,23,GCKNEEVLAVLGHELGHWKLGHT,0
4aw6,B,346,364,18,KNIIISQMNSFLCFFLFA,0
4aw6,B,384,394,10,LIGLLIIFQF,0
4aw6,B,396,411,15,SPYNEVLSFCLTVLS,0
4aw6,B,412,449,37,RFEFQADAFAKKLGKAKDLYSALIKLNKDNLGFPVSD,0
4aw6,B,450,455,5,LFSMW,0
4aw6,B,456,472,16,YSHPPLLERLQALKTM,0
4aw6,B,473,482,9,QHAENLYFQ,0
1wpe,A,57,77,20,EDLLVRILLLAACISFVLAW,0
1wpe,A,78,85,7,EEGEETI,0
1wpe,A,86,104,18,AFVEPFVILLILIANAIV,0
1wpe,A,257,274,17,EQLSKVISLICVAVWLI,0
1wpe,A,275,295,20,IGHFNDPVHGGSWIRGAIYY,0
1wpe,A,296,311,15,KIAVALAVAAIPEGL,0
1wpe,A,761,780,19,RYLISSNVGEVVCIFLTAA,0
1wpe,A,781,786,5,GLPEA,0
1wpe,A,787,807,20,IPVQLLWVNLVTDGLPATAL,0
1wpe,A,832,851,19,LFFRYMAIGGYVGAATVGA,0
1wpe,A,852,898,46,AWWFMYAEDGPGVTYHQLTHFMQCTEDHPHFEGLDCEIFEAPEPMT,0
1wpe,A,899,915,16,ALSVLVTIEMCNALNS,0
1wpe,A,932,950,18,LLGSICLSMSLHFLILYV,0
1wpe,A,951,964,13,PLPMIFKLKALDL,0
1wpe,A,965,987,22,QWLMVLKISLPVIGLDEILKFI,0
2na5,A,11,14,3,DAS,0
2na5,A,15,32,17,EELNRYYASLRHYLNLV,0
2na5,A,35,37,2,RY,0
5but,J,15,18,3,PPQ,0
5but,J,19,37,18,LAIGFFLTIIIGAVLLML,0
5but,J,48,64,16,DALFTAASATTVTGLA,0
5but,J,75,95,20,GQTVIMGLIQIGGLGFMTFA,0
5but,J,96,133,37,LIVMILAAAIGLKERMLVQEALNQPTIGGVIGLVKVL,0
5but,J,134,153,19,LFSISIELIAALILSIRLV,0
5but,J,162,180,18,FASLFHAISAFNNAGFSL,0
5but,J,192,209,17,TVNLVITFLFITGGIGF,0
5but,J,210,217,7,VLFDVMK,0
5but,J,218,231,13,RRFKTFSLHTALM,0
5but,J,232,249,17,TGTLMLNAIAMLTVFIL,0
5but,J,267,283,16,ASYFQAVTPRTAGFNS,0
5but,J,292,308,16,TIVFTLLLMFIGAGSA,0
5but,J,310,324,14,ASGIKLTTFIVILT,0
5but,J,325,352,27,VIAYLRGKKETVIFRRSIKYPIIIKAL,0
5but,J,353,372,19,VSVTSLFIVFLGIFALTIT,0
5but,J,378,394,16,QIVFETFSAFGTVGLT,0
5but,J,404,424,20,GKCIIIVIMFIGRIGPLTFV,0
5but,J,425,443,18,SFAATEQSNIRYPDGEVF,0
5but,J,444,445,1,G,0
1l0n,K,1,21,20,LTRFLGPRYRQLARNWVPTA,0
1l0n,K,22,38,16,LWGAVGAVGLVSATDS,0
1l0n,K,50,56,6,KFKKDD,0
3tlm,A,57,78,21,EDLLVRILLLAACISFVLAWF,0
3tlm,A,79,86,7,EGEETVT,0
3tlm,A,87,104,17,FVEPFVILLILIANAIV,0
3tlm,A,258,276,18,QLSKVISLICVAVWLINI,0
3tlm,A,277,292,15,HFNDPVHGGSWIRGA,0
3tlm,A,293,311,18,YYFKIAVALAVAAIPEGL,0
3tlm,A,759,780,21,IRYLISSNVGEVVCIFLTAAL,0
3tlm,A,781,785,4,LPEA,0
3tlm,A,786,806,20,IPVQLLWVNLVTDGLPATAL,0
3tlm,A,832,851,19,FFRYMAIGGYVGAATVGAA,0
3tlm,A,852,875,23,WWFLYAEDGPHVTYSQLTHFMKC,0
3tlm,A,876,880,4,EHSP,0
3tlm,A,881,897,16,FEGVDCEVFEAPQPMT,0
3tlm,A,898,915,17,ALSVLVTIEMCNALNSL,0
3tlm,A,930,947,17,WLVGSIGLSMSLHFLIL,0
3tlm,A,948,966,18,VDPLPMIFKLQALDLYHW,0
3tlm,A,967,986,19,MVLKISLPVIGLDEILKFV,0
4m58,A,1,5,4,HIPE,0
4m58,A,6,10,4,YLSP,0
4m58,A,11,28,17,TCAVMGAAMVPVLTVAA,0
4m58,A,44,60,16,IGSAFAFTIMMFNVPI,0
4m58,A,61,63,2,GG,0
4m58,A,64,76,12,TAHAIGATLLAT,0
4m58,A,81,101,20,AASISLTLALFIQALLFGDG,0
4m58,A,103,128,25,LALGANSFNMAFIAPFVGYGIYRLM,0
4m58,A,137,158,21,SSAIGGYVGINAAALATAIEL,0
4m58,A,159,183,24,LQPLLFHTANGTPLYFPYGLNVAI,0
4m58,A,184,205,21,AMMFAHLTVAGIVEAVITGLV,0
4m58,A,228,238,10,NRLEHHHHHH,0
5er7,F,19,24,5,IGKIW,0
5er7,F,25,50,25,TVLFIFRIMILVVAAKEVWGDEQAD,0
5er7,F,66,90,24,HYFPISHIRLWALQLIFVSTPALL,0
5er7,F,91,95,4,AMHV,0
5er7,F,135,138,3,YTS,0
5er7,F,139,159,20,IFFRVIFEAAFMYVFYVMYD,0
5er7,F,184,208,24,PTEKTVFTVFMIAVSGICILLNVT,0
5er7,F,209,213,4,LSYL,0
5i20,A,2,8,6,RSSATL,0
5i20,A,9,21,12,GFTAILLWSTLA,0
5i20,A,33,53,20,LLTALTFTIGGAVGIAAGLA,0
5i20,A,54,56,2,GV,0
5i20,A,59,68,9,VLRQPWPVW,0
5i20,A,69,86,17,HGIGGLFGYHFFYFSAL,0
5i20,A,94,107,13,GLVAYLWPLLIVL,0
5i20,A,108,121,13,SAFLPGERLRPAH,0
5i20,A,122,136,14,AGALMGLAGTVVLL,0
5i20,A,151,167,16,GYLAAAACAVIWSVYS,0
5i20,A,168,179,11,ASRRFARVPTE,0
5i20,A,180,198,18,VAGFCLATAALSALCHIL,0
5i20,A,213,229,16,VALGIGPVGIAFYTWD,0
5i20,A,230,239,9,GMKRGDVRL,0
5i20,A,240,254,14,GVLSYAAPVLSTLL,0
5i20,A,267,281,14,AIACALIVGGAAVA,0
5i20,A,282,290,8,LLARRLES,0
1lda,D,1,5,4,SQTS,0
1lda,D,11,28,17,IAEFLGTGLLIFFGVGC,0
1lda,D,29,42,13,AALKVAGASFGQW,0
1lda,D,43,60,17,ISVIWGLGVAMAIYLTA,0
1lda,D,64,77,13,AHLNPAVTIALWL,0
1lda,D,86,107,21,IPFIVSQVAGAFCAAALVYGL,0
1lda,D,108,148,40,YNLFFDFEQTHHIVRGSVESVDLAGTFSTYPNPHINFVQA,0
1lda,D,149,166,17,AVEMVITAILMGLILAL,0
1lda,D,179,195,16,PLLIGLLIAVIGASMG,0
1lda,D,196,198,2,LT,0
1lda,D,199,213,14,FAMNPARDFGPKVF,0
1lda,D,214,233,19,WLAGWGNVAFTGGRDIPYF,0
1lda,D,234,255,21,VPLFGPIVGAIVGAFAYRKLI,0
1lda,D,260,281,21,CDICVVEEKETTTPSEQKASL,0
4oye,C,14,30,16,KILIGLILGAIVGLIL,0
4oye,C,31,39,8,HYGYAHAV,0
4oye,C,40,63,23,TYVKPFGDLFVRLLKMLVMPIVF,0
4oye,C,83,107,24,KIVVYYLLTSAFAVTLGIIMARLF,0
4oye,C,108,121,13,PGAGIHLAVGGQQ,0
4oye,C,127,128,1,P,0
4oye,C,129,140,11,LVHILLDIVPT,0
4oye,C,141,150,9,PFGALANGQ,0
4oye,C,151,158,7,LPTIFFA,0
4oye,C,176,201,25,RKSAETLLDAINGLAEAMYKIVNGV,0
4oye,C,202,218,16,QYAPIGVFALIAYVMA,0
4oye,C,219,231,12,QGVHVVGELAKV,0
4oye,C,232,250,18,AAVYVGLTLQILLVYFVL,0
4oye,C,258,264,6,ISFIKH,0
4oye,C,267,285,18,AMLTAFVTRSSSGTLPVT,0
4oye,C,302,320,18,LPLGATINMDGTALYQGV,0
4oye,C,321,342,21,TFFIANALGSHLTVGQQLTIV,0
4oye,C,343,359,16,TAVLASIGTAGVPGAG,0
4oye,C,360,390,30,IMLAMVLHSVGLPLTDPNVAAAYAMILGID,0
4oye,C,391,408,17,ILDMGATMVNVTGDLTG,0
5nc5,G,2,22,20,ELLKSLVFAVIMVPVVMAII,0
5nc5,G,23,34,11,GLIYGLGEVFN,0
5nc5,G,35,36,1,F,0
4m64,B,1,12,11,SISMTTKLSYG,0
4m64,B,13,34,21,GAFGKDFAIGIVYMYLMYYYT,0
4m64,B,43,62,19,VGTLFLVARIWDAINDPIM,0
4m64,B,63,80,17,WIVNATRSRWGKFKPWI,0
4m64,B,81,101,20,IGTLTNSLVLFLLFSAHLFE,0
4m64,B,106,128,22,VFVCVTYILWGMTYTIMDIPFW,0
4m64,B,129,149,20,LVPTITLDKREREQLVPFPR,0
4m64,B,150,171,21,FASLAGFVTAGITLPFVSYVG,0
4m64,B,176,195,19,FGFQMFTLVLIAFFIASTI,0
4m64,B,196,209,13,TLRNVHEVYSSDN,0
4m64,B,210,232,22,VTAGRPHLTLKTIVGLIYKNDQ,0
4m64,B,233,236,3,SCL,0
4m64,B,237,258,21,GMALAYNIASNIINGFAIYYF,0
4m64,B,268,286,18,PYYLSYAGAANLLTLIVF,0
4m64,B,287,299,12,RLVKMLSRRILW,0
4m64,B,300,316,16,GASVMPVLSCAGLFAM,0
4m64,B,326,343,17,IVAAGIFLNIGTALFWV,0
4m64,B,344,369,25,QVIMVADTVDYGEFKLNIRCESIAY,0
4m64,B,370,387,17,VQTMVVKGGSAFAAFFI,0
4m64,B,388,393,5,LVLGL,0
4m64,B,409,428,19,MQFIMIVLPVLFFMMTLVL,0
4m64,B,429,449,20,FRYYRLNGDMLRKIQIHLLD,0
4m64,B,450,486,36,YRKTPPFVEQPDSPAISVVATSDVKAHHHHHHHHHH,0
5era,F,18,24,6,SIGKIW,0
5era,F,25,48,23,TVLFIFRIMILVVAAKEVWGDEQ,0
5era,F,70,87,17,ISHIRLWALQLIFVSTP,0
5era,F,88,96,8,LLVAMHVA,0
5era,F,135,139,4,YTSS,0
5era,F,140,159,19,FFRVIFEAAFMYVFYVMYD,0
5era,F,185,208,23,TEKTVFTVFMIAVSGICILLNVT,0
5era,F,209,215,6,LSYLLI,0
4av3,B,-8,1,9,RGSHHHHHH,0
4av3,B,7,21,14,FLIPLVALGFAAAN,0
4av3,B,22,54,32,AAVVRKPEGTERMKEISSYIRSGADSFLAHET,0
4av3,B,55,68,13,AIFKVAIVIAILL,0
4av3,B,78,94,16,AFLLGAVMSASAGIVG,0
4av3,B,95,113,18,KMATRANVRVAEAARTTK,0
4av3,B,115,127,12,GPALKVAYQGGS,0
4av3,B,128,143,15,MGLSVGGFALLGLVL,0
4av3,B,177,192,15,GYALGCSIIAMFDRV,0
4av3,B,193,211,18,GGVYTKAADMAADLVGKT,0
4av3,B,212,220,8,LNLPEDDP,0
4av3,B,221,238,17,NPATIADNVGDNVGDVA,0
4av3,B,239,254,15,LGADLLESFVGAIVS,0
4av3,B,292,308,16,FALVGLGCSMLGILYV,0
4av3,B,309,322,13,VKKPSDNPQRELN,0
4av3,B,323,336,13,SLWTSALLTVVLT,0
4av3,B,365,380,15,AIIGIFSGILIGFWA,0
4av3,B,381,414,33,YYTSYRYKPTQFLGKSSIEGTGMVISNGLSLGM,0
4av3,B,415,431,16,SVFPPTLTLVLGILFA,0
4av3,B,441,456,15,IAALGMLSFVATSVS,0
4av3,B,457,498,41,DSYGPIADNAGGISEMCELDPEVRKITDHLDAVGNTTAAIG,0
4av3,B,499,514,15,GFAIGSAIFAALSLF,0
4av3,B,545,559,14,AGALLGAAITYYFS,0
4av3,B,560,590,30,YLISAVTKAAMKMVDEIRRQAREIPGLLEG,0
4av3,B,591,598,7,AKPDYNR,0
4av3,B,599,611,12,IEITSDNALKQM,0
4av3,B,612,628,16,YPAFIAILTPLVTGFL,0
4av3,B,634,651,17,GGVLIGTVLSGAMLAIL,0
4av3,B,652,699,47,ANSGGAWDNAKKYLEAGNLEGYGKGSEPHKALVIGDTVGDPLKDTVG,0
4av3,B,700,716,16,SLDILIKIMSVVSVIA,0
4av3,B,717,723,6,SIFKHV,0
2n7r,A,7,30,23,ITLTVGFGILIFSLIVTYCINAK,0
2n7r,A,31,46,15,DVLFIAPREPGAVSY,0
2n9y,B,692,716,24,ILVVLLSVMGAILLIGLAPLLIWK,0
2n9y,B,717,727,10,LITIHDRKEF,0
4mm4,B,1,4,3,EVK,0
4mm4,B,14,32,18,ILAMAGYAVDLGNFLRFP,0
4mm4,B,33,43,10,QAAENGGGAF,0
4mm4,B,44,63,19,IPYIIAFLLVGIPLMWIEW,0
4mm4,B,90,117,27,KILGVFGLWIPLVVASYYVYIESWTLG,0
4mm4,B,118,131,13,AIKFLVGLVPEPP,0
4mm4,B,132,134,2,,0
4mm4,B,135,168,33,DPDSILRPFKEFLYSYIGVPKGDEPILKPSLFA,0
4mm4,B,169,185,16,IVFLITMFINVSILIR,0
4mm4,B,191,211,20,ERFAKIAMPTLFILAVFLVI,0
4mm4,B,212,222,10,VFLLETPNGT,0
4mm4,B,223,231,8,ADGLNFLW,0
4mm4,B,232,244,12,PDFEKLKDPGVW,0
4mm4,B,245,265,20,AAVGQIFFSLGLGFGVLITF,0
4mm4,B,279,297,18,LTAATLNEKASVILGGSI,0
4mm4,B,298,317,19,IPAAVAFFGVANAVAIAKA,0
4mm4,B,318,324,6,AFNLGF,0
4mm4,B,326,331,5,LPAIF,0
4mm4,B,332,342,10,QTAGGTFLGF,0
4mm4,B,343,367,24,WFFLLFFAGLTSSIAGMQGMIAFL,0
4mm4,B,378,394,16,VLWTAAIVFFSAHLVM,0
4mm4,B,395,402,7,LNKSLDE,0
4mm4,B,403,425,22,DFWATGIGVVFFGLTELIIFFW,0
4mm4,B,429,437,8,DKAWEEIN,0
4mm4,B,448,468,20,YYVMRYITPAFLAVLLVVWA,0
4mm4,B,469,473,4,EYIP,0
4mm4,B,474,478,4,IMEE,0
4mm4,B,479,485,6,HWTVWI,0
4mm4,B,486,502,16,RFYIIGLFLFLTFLVF,0
4mm4,B,512,519,7,AGTLVPR,0
5uz7,R,145,171,26,YVLYYLAIVGHSLSIFTLVISLGIFV,0
5uz7,R,172,182,10,FRSLGCQRVT,0
5uz7,R,183,205,22,HKNMFLTYILNSMIIIIHLVEV,0
5uz7,R,218,245,27,CKILHFFHQYMMACNYFWMLCEGIYLH,0
5uz7,R,246,260,14,LIVVAVFTEKQRLR,0
5uz7,R,261,284,23,YYLLGWGFPLVPTTIHAITRAVY,0
5uz7,R,295,321,26,HLLYIIHGPVMAALVVNFFFLLNIVR,0
5uz7,R,322,331,9,LVTKMRETH,0
5uz7,R,337,342,5,YLKAV,0
5uz7,R,343,360,17,ATMILVPLLGIQFVVFP,0
5uz7,R,367,394,27,LGKIYDYVMHSLIHFQGFFVATIYCFC,0
5uz7,R,396,417,21,EVQTTVKRQWAQFKIQWNQRW,0
3s3c,C,7,27,20,ALAVILVLTLTILVFWLGVY,0
3s3c,C,28,34,6,VFFARG,0
3tcu,E,18,20,2,AK,0
3tcu,E,25,45,20,VLFVLTILTLISGTIFYSTV,0
3tcu,E,46,50,4,GLRP,0
3tcu,E,51,67,16,DALYFSVVTLTTVGYG,0
3tcu,E,68,74,6,FSPQTD,0
3tcu,E,75,99,24,GKIFTILYIFIGIGLVFGFIHKLA,0
3tcu,E,103,110,7,LPSILSN,0
3s0x,B,494,497,3,SHG,0
3s0x,B,498,501,3,GSM,0
3s0x,B,502,520,18,EYIIGALGLIIASVQDFR,0
3s0x,B,525,542,17,DYIWIFLAVFGVLFAIY,0
3s0x,B,543,556,13,SITLLDYSILINS,0
3s0x,B,557,577,20,SGFVICFILGYMMFLSGIGG,0
3s0x,B,579,591,12,GKMLIGLGALVP,0
3s0x,B,592,611,19,FQMPIYTSLGTLLNLNYVP,0
3s0x,B,612,635,23,FPIMVFINGIFFMVFLPFVILFR,0
3s0x,B,645,649,4,GKEF,0
3s0x,B,659,698,39,VNVAKEQKRLIMGQNDKINFFPAADDEDFSKYSNNEEIW,0
3s0x,B,703,717,14,PLIIPITLSYLVTP,0
3s0x,B,718,721,3,IGD,0
3s0x,B,722,727,5,ILDFL,0
3s0x,B,729,730,1,F,0
3d38,M,54,71,17,GIAAFAFGSTAILIILF,0
3d38,M,72,80,8,MAAEVHFD,0
3d38,M,81,86,5,LQFFR,0
3d38,M,87,114,27,FFWLGLYPPKAQYGMGIPPLHDGGWWL,0
3d38,M,115,131,16,AGLFMTLSLGSWWIRV,0
3d38,M,145,162,17,WNFAAAIFFVLCIGCIH,0
3d38,M,163,176,13,TLVGSWSEGVPFG,0
3d38,M,177,190,13,WPHIDWLTAFSIR,0
3d38,M,191,197,6,GNFYYC,0
3d38,M,198,216,18,WHGFSIGFAYGCGLLFAA,0
3d38,M,267,284,17,WFFSLMVMVSASVGILL,0
3d38,M,285,291,6,GTFVDN,0
3d38,M,292,298,6,YLWCVK,0
3d38,M,299,323,24,GAAPDYPAYLPATPDPASLPGAPK,0
3cap,B,40,63,23,AAYMFLLIMLGFPINFLTLYVTV,0
3cap,B,64,74,10,HKKLRTPLNY,0
3cap,B,75,95,20,LLNLAVADLFMVFGGFTTTL,0
3cap,B,113,133,20,GFFATLGGEIALWSLVVLAI,0
3cap,B,134,154,20,RYVVVCKPMSNFRFGENHAI,0
3cap,B,155,172,17,GVAFTWVMALACAAPPL,0
3cap,B,202,221,19,FVIYMFVVHFIIPLIVIFF,0
3cap,B,222,255,33,YGQLVFTVKEAAAQQQESATTQKAEKEVTRMVI,0
3cap,B,256,277,21,MVIAFLICWLPYAGVAFYIFT,0
3cap,B,289,309,20,IPAFFAKTSAVYNPVIYIMM,0
3cap,B,311,321,10,QFRNCMVTTL,0
3cap,B,322,326,4,CGKN,0
3cap,B,327,348,21,LGDDEASTTVSKTETSQVAPA,0
2yn6,E,1,10,9,PADNAADAR,0
2yn6,E,11,210,199,VDVSVSIFINKIYGVNTLEQTYKVDGYIVAQWTGKPRKTPGDKPLIVENTQIERWINNGLWVPALEFINVVGSPDTGNKRLMLFPDGRVIYNARFLGSFSNDMDFRLFPFDRQQFVLELEPFSYNNQQLRFSDIQVYTENIDNEEIDEWWIRGKASTHISDIRYDHLSSVQPNQNEFSRITVRIDAVRNPSYYLWSFIL,0
2yn6,E,211,225,14,LGLIIAASWSVFWL,0
2yn6,E,230,245,15,RLQTSFTLMLTVVAY,0
2yn6,E,246,265,19,FYTSNILPRLPYTTVIDQM,0
2yn6,E,266,282,16,IAGYGSIFAAILLIIF,0
2yn6,E,298,315,17,RCRLAFPLGFLAIGCVL,0
2yn6,E,316,317,1,I,0
2yn6,E,318,322,4,GITL,0
4xto,B,24,48,24,YQFTSHILTLGYAVMLAGLLYFIL,0
4xto,B,49,61,12,IKNVDKKFQMSN,0
4xto,B,62,85,23,LSAVVMVSAFLLLYAQAQNWTSS,0
4xto,B,105,124,19,NGYRYLNWLIDVPMLLFQI,0
4xto,B,125,137,12,FVVSLTTSKFSS,0
4xto,B,138,160,22,RNQFWFSGAMMIITGYIGQFYE,0
4xto,B,165,187,22,AFLVWGAISSAFFFHILWVMKK,0
4xto,B,188,206,18,INEGKEGISPAGQKILSN,0
4xto,B,207,229,22,WILFLISWTLYPGAYLMPYLTG,0
4xto,B,238,261,23,GVMARQLVYTIADVSSKVIYGVL,0
4xto,B,262,270,8,GNLAITLS,0
3t53,I,-6,3,9,HHHHHHMIE,0
3t53,I,4,15,11,IIRRSVANRFL,0
3t53,I,16,32,16,LMGALFLSIWGTWTII,0
3t53,I,339,356,17,GKLLEEFIVVAVVCALF,0
3t53,I,357,363,6,WHVRSA,0
3t53,I,364,384,20,VAIISLPLGLCIAFIVMHFQ,0
3t53,I,393,409,16,GGIAIAVGAMVDAAIV,0
3t53,I,410,449,39,IENAHKRLEEWQHQHPDATLDNKTRWQVITDASVEVGPA,0
3t53,I,450,466,16,FISLLIITLSFIPIFT,0
3t53,I,477,497,20,LAFTKTYAMAGAALLAIVVI,0
3t53,I,498,504,6,ILMGYW,0
3t53,I,505,516,11,RGKIPPESSNP,0
3t53,I,517,518,1,N,0
3t53,I,519,525,6,FLIRVY,0
3t53,I,526,539,13,PLLLKVLHWPKTT,0
3t53,I,540,555,15,LVAALSVLTVLWPLN,0
3t53,I,873,890,17,LMVPMTLMIIFVLLYLA,0
3t53,I,891,894,3,RRV,0
3t53,I,895,918,23,EALLIISSVPFALVGGIWLLWWM,0
3t53,I,926,943,17,GTGFIALAGVAAEFGVV,0
3t53,I,944,984,40,LMYLRHAIEAVPSLNNPQTFSEQKLDEALYHGAVLRVRPK,0
3t53,I,985,1000,15,MTVAVIIAGLLPILW,0
3t53,I,1010,1028,18,RIAAPMIGGMITAPLLSL,0
3t53,I,1029,1043,14,IIPAAYKLMWLHRH,0
3t53,I,1044,1047,3,VRK,0
4s0f,B,171,187,16,IFLASLLYTALGIAGS,0
4s0f,B,188,213,25,YIKFLFDDLIKFEKLNDLHIISAGF,0
4s0f,B,214,227,13,VIFLLQIFLNYYR,0
4s0f,B,289,302,13,DTIMAVIGGILLY,0
4s0f,B,303,308,5,QNSSL,0
4s0f,B,309,322,13,FISFIIILLYGII,0
4s0f,B,394,407,13,LTGIVAGLGGIVI,0
4s0f,B,408,429,21,WAGAYNVIKGNMSGGQLLAFN,0
4s0f,B,430,443,13,LLAYFLTPVKNLI,0
4mmb,A,1,4,3,EVK,0
4mmb,A,5,13,8,EHWATRLG,0
4mmb,A,14,35,21,ILAMAGYAVDLGNFLRFPVQA,0
4mmb,A,42,63,21,FMIPYIIAFLLVGIPLMWIEW,0
4mmb,A,64,88,24,MGRYGGAQGHGTTPAIFYLLWRNR,0
4mmb,A,89,124,35,AKILGVFGLWIPLVVAIYYVYIESWTLGFAIKFLV,0
4mmb,A,132,134,2,,0
4mmb,A,167,184,17,AYIVFLITMFINVSILI,0
4mmb,A,185,190,5,GISKG,0
4mmb,A,191,214,23,ERFAKIAMPTLFILAVFLVIRVF,0
4mmb,A,223,231,8,ADGLNFLW,0
4mmb,A,242,265,23,VWIAAVGQIFFSLGLGFGAIITF,0
4mmb,A,266,278,12,SYVRKDQDIVLS,0
4mmb,A,279,298,19,LTAATLNEKAEVILGGSIS,0
4mmb,A,319,324,5,FNLGF,0
4mmb,A,326,331,5,LPAIF,0
4mmb,A,340,367,27,GFLWFFLLFFAGLTSSIAGMQPMIAFL,0
4mmb,A,368,377,9,DELKLSRKH,0
4mmb,A,378,396,18,VLWTAAIVFFSAHLVMFL,0
4mmb,A,400,426,26,DEMDFWAGTIGVVFFGLTELIIFFWI,0
4mmb,A,427,428,1,G,0
4mmb,A,429,437,8,DKAWEEIN,0
4mmb,A,438,447,9,GGIIKVPRI,0
4mmb,A,448,469,21,YYVMRYITPAFLAVLLVVWAR,0
4mmb,A,470,477,7,YIPKIME,0
4mmb,A,484,502,18,ITRFYIIGLFLFLTFLVF,0
4mmb,A,503,511,8,AERRRNHE,0
4mmb,A,512,519,7,AGTLVPR,0
5lv6,B,634,647,13,GCPTNGPKIPSIA,0
5lv6,B,648,671,23,GMVGALLLLLVVALGIGLFMRRR,0
4d2c,A,1,5,4,EDKG,0
4d2c,A,6,19,13,TFFGQPLGLSTLF,0
4d2c,A,20,36,16,TEMWERFSYYGMRAIL,0
4d2c,A,59,74,15,MAIYASMVYLSGTIG,0
4d2c,A,75,88,13,FVADRIIGARPAV,0
4d2c,A,89,103,14,WGGVLIMLGHIVLA,0
4d2c,A,111,126,15,FGSIILIIIGTGFLK,0
4d2c,A,127,152,25,NVSTLVGTLYDEHDRRRDAGFSIFV,0
4d2c,A,153,167,14,GINLGAFIAPLIVG,0
4d2c,A,179,193,14,SLAAIGMFIGLLVY,0
4d2c,A,194,224,30,FGGKKTLDPHYLRPTDPLAPEEVKPLLVKV,0
4d2c,A,225,240,15,LAVAGFIAIIVVMNL,0
4d2c,A,249,263,14,INLLTIVAIAIPVF,0
4d2c,A,264,267,3,FAW,0
4d2c,A,268,284,16,ISSVKVTSTEHLRVVS,0
4d2c,A,285,286,1,I,0
4d2c,A,287,306,19,LFIAAVLFWAIEEQGSVVL,0
4d2c,A,324,339,15,QSLNPLFIMLYTPFF,0
4d2c,A,340,346,6,WLWTAW,0
4d2c,A,347,351,4,KNQP,0
4d2c,A,352,355,3,SPT,0
4d2c,A,356,370,14,FAVGLMFAGLSFLL,0
4d2c,A,390,404,14,GSWALVILGEMLIS,0
4d2c,A,405,406,1,V,0
4d2c,A,407,422,15,LSVTTKLAPKAFNSQ,0
4d2c,A,423,427,4,MSMW,0
4d2c,A,428,442,14,LSSSVGSALNAQLV,0
4d2c,A,455,471,16,YFGLGSVVLGIVLVFL,0
4d2c,A,473,491,18,RIQGLMQGVEGSENLYFQ,0
4a96,E,11,210,199,VDVSVSIFINKIYGVNTLEQTYKVDGYIVAQWTGKPRKTPGDKPLIVENTQIERWINNGLWVPALEFINVVGSPDTGNKRLMLFPDGRVIYNARFLGSFSNDMDFRLFPFDRQQFVLELEPFSYNNQQLRFSDIQVYTENIDNEEIDEWWIRGKASTHISDIRYDHLSSVQPNQNEFSRITVRIDAVRNPSYYLWSFIL,0
4a96,E,211,225,14,LGLIIAASWSVFWL,0
4a96,E,230,245,15,RLQTSFTLMLTVVAY,0
4a96,E,246,265,19,FYTSNILPRLPYTTVIDQM,0
4a96,E,266,282,16,IAGYGSIFAAILLIIF,0
4a96,E,300,315,15,RLAFPLGFLAIGCVL,0
4a96,E,316,317,1,I,0
3h1k,W,5,12,7,LRQAYSA,0
3h1k,W,13,19,6,FRRTST,0
3h1k,W,20,36,16,ALTVVLGAVLFERAFD,0
3h1k,W,63,64,1,E,0
4a82,B,1,16,15,IKRYLQFVKPYKYRI,0
4a82,B,17,33,16,ATIIVGIIKFGIPMLI,0
4a82,B,66,81,15,LFIFVIVRPPIEFIR,0
4a82,B,82,140,58,YLAQWTSNKILYDIRKKLYNHLQALSARFYANNQVGQVISRVINDVEQTKDFILTGLM,0
4a82,B,141,154,13,IWLDCITIIIALS,0
4a82,B,164,177,13,LAALFIFPFYILT,0
4a82,B,178,248,70,YVFFGRLRKLTRERSQALAEVQGFLHERVQGISVVKSFAIEDNEAKNFDKKNTNFLTRALKHTRWNAYSF,0
4a82,B,249,262,13,AINTVTDIGPIIV,0
4a82,B,286,298,12,LELLFGPLRRLV,0
4a82,B,299,578,279,SFTTLTQSFASMDRVFQLIDEDYDIKNGVGAQPIEIKQGRIDIDHVSFQYNDNEAPILKDINLSIEKGETVAFVGMSGGGKSTLINLIPRFYDVTSGQILIDGHNIKDFLTGSLRNQIGLVQQDNILFSDTVKENILLGRPTATDEEVVEAAKMANAHDFIMNLPQGYDTEVGERGVKLSGGQKQRLSIARIFLNNPPILILDEATSALDLESESIIQEALDVLSKDRTTLIVAHRLSTITHADKIVVIENGHIVETGTHRELIAKQGAYEHLYSIQNL,0
2k1a,A,963,985,22,IPIWWVLVGVLGGLLLLTILVL,0
2k1a,A,986,998,12,MWKVGFFKRNRP,0
5eik,C,11,24,13,HDTLIDAGGYVQK,0
5eik,C,30,47,17,FDAAHYVLTCLSVRHDL,0
5eik,C,48,54,6,PDAISF,0
5eik,C,55,77,22,RKHPFSCWLSCMLMSFAGSFLS,0
5eik,C,96,111,15,LGSIVWYLVFYSPFD,0
5eik,C,113,135,22,FRLATWFPVKLGLSVLKEVQRT,0
5eik,C,158,179,21,VGVAKGAGSGVVKIVEQLARG,0
5eik,C,180,191,11,WHPTNHEILRP,0
5eik,C,192,204,12,FTTKACVIASIV,0
5eik,C,224,237,13,VVGFFIYFKLASL,0
5eik,C,238,243,5,LSVHD,0
5ej1,B,532,543,11,SRLVERPATPA,0
5ej1,B,698,712,14,GGMLGLAWISAAIA,0
5ej1,B,713,720,7,GFVLRTR,0
1et3,S,168,193,25,ECVKFLTNETREREVFDRLGMIYTV,0
1et3,S,194,207,13,YSVSLASLTVAVL,0
1et3,S,228,242,14,SFMLRAVSIFVKDA,0
1et3,S,243,277,34,LYSGATLDEAERLTEEELRAIAQAPPPPATAAAG,0
1et3,S,278,292,14,AGCRVAVTFFLYFL,0
1et3,S,321,334,13,WGFTVFGWGLPAV,0
1et3,S,335,370,35,VAVWVSVRATLANTGCWDLSSGNKKWIIQVPILAS,0
1et3,S,371,385,14,VLNFILFINIVRVL,0
1et3,S,412,423,11,LMPLFGVHYIV,0
1et3,S,426,451,25,TPYTEVSGTLWQVQMHYEMLFNSFQ,0
1et3,S,452,465,13,FFVAIIYCFCNGE,0
3hd6,C,-4,0,4,PSSP,0
3hd6,C,1,11,10,AWNTNLRWRL,0
3hd6,C,12,28,16,LTCLLLQVIMVILFGV,0
3hd6,C,35,52,17,ADAHWWSERTHKNLSDM,0
3hd6,C,61,78,17,SFQDVHVMVFVGFGFLM,0
3hd6,C,79,88,9,FLQRYGFSA,0
3hd6,C,89,109,20,GFNFLLAAFGIQWALLMQGW,0
3hd6,C,125,142,17,INADFCVASVCVAFGAV,0
3hd6,C,143,148,5,GKVSP,0
3hd6,C,149,169,20,QLLIMTFFQVTLFAVNEFIL,0
3hd6,C,178,196,18,GGSMTIHTFGAYFGLTVT,0
3hd6,C,197,220,23,ILYRRNLEQSKERQNSVYQSDLF,0
3hd6,C,221,238,17,MIGTLFLWMYWPSFNSA,0
3hd6,C,250,267,17,INTYCSLAACVLTSVAI,0
3hd6,C,268,281,13,SALHKKGKLDMVH,0
3hd6,C,282,297,15,QNATLAGGVAVGTAA,0
3hd6,C,304,321,17,GALIIGFVCGIISTLGF,0
3hd6,C,322,332,10,YLTPFLESRL,0
3hd6,C,333,338,5,IQDTC,0
3hd6,C,339,358,19,INNLHGIPGIIGGIVGAVT,0
3hd6,C,362,383,21,SLEVYGKEGLVHSFDFQGFNG,0
3hd6,C,395,416,21,YGLLVTLAMALMGGIIVGLIL,0
3hd6,C,417,443,26,LPFWGQPSDENCFEDAVYWEMPEGNS,0
3hd6,C,444,485,41,VYIPEDPTFKPSGPSVPSVPMVSPLPMASSVPLVPGGLVPR,0
2ei4,C,1,14,13,AGFDLLNDGRPET,0
2ei4,C,15,34,19,WLGIGTLLMLIGTFYFIAR,0
2ei4,C,49,66,17,TILVPGIASAAYLAMFF,0
2ei4,C,67,83,16,IGVTEVELASGTVLDI,0
2ei4,C,84,101,17,YARYADWLFTTPLLLLD,0
2ei4,C,115,132,17,LIGVDALMIVTGLIGAL,0
2ei4,C,133,138,5,KTPLA,0
2ei4,C,139,158,19,YTWWLFSTIAFLFVLYYLL,0
2ei4,C,180,197,17,ALVAVLWTAYPILWIVG,0
2ei4,C,198,208,10,EGAGVVGLGI,0
2ei4,C,209,227,18,TLAFMVLDVTAKVGFGFV,0
2ei4,C,239,253,14,APEPSAGADASAAD,0
5k2d,A,-2,6,8,GAPPIMGS,0
5k2d,A,7,29,22,VYITVELAIAVLAILGNVLVCW,0
5k2d,A,45,67,22,VSLAAADIAVGVLAIPFAITIS,0
5k2d,A,68,75,7,GFCAACH,0
5k2d,A,76,98,22,CLFIACFVLVLTQSSIFSLLAI,0
5k2d,A,123,144,21,IIAICWVLSFAIGLTPMLGWN,0
5k2d,A,145,172,27,CGQPKEGKNHSQGCGEGQVACLFEDVV,0
5k2d,A,173,195,22,MNYMVYFNFFACVLVPLLLMLG,0
5k2d,A,236,259,23,IIVGLFALCWLPLHIINCFTFFC,0
5k2d,A,260,265,5,DCSHA,0
5k2d,A,266,288,22,LWLMYLAIVLSHTNSVVNPFIY,0
5k2d,A,293,306,13,EFRQTFRKIIRSH,0
5edl,A,10,31,21,IMSVISIVFAVVYLLFTHFGN,0
5edl,A,32,39,7,LAGMFGP,0
5edl,A,40,59,19,AYEPIYGIWFIVSVIAAYM,0
5edl,A,64,84,20,AALVSEIIAALVECLLGNPS,0
5edl,A,86,105,19,MVIVIGIVQGLGAEAVFLA,0
5edl,A,114,135,21,VLMLAGMGSSVASFIYDLFVS,0
5edl,A,136,142,6,YAAYSP,0
5edl,A,143,171,28,YLLIMLVIRLISGALLAGLLGKAVSDSL,0
4qe9,D,21,41,20,RILLLVLAVIIYGTAGFHFI,0
4qe9,D,42,46,4,GESW,0
4qe9,D,47,63,16,VSLYWTFVTIATVGYG,0
4qe9,D,64,70,6,YSPHTP,0
4qe9,D,71,99,28,GMYFTCTLIVLGIGTFAVAVERLLEFLI,0
4xnv,A,39,56,17,FKCALTKTGFQFYYLPA,0
4xnv,A,57,80,23,YILVFIIGFLGNSVAIWMFVFHM,0
4xnv,A,86,108,22,SVYMFNLALADFLYVLTLPALI,0
4xnv,A,109,122,13,YYFNKTDWIFGDA,0
4xnv,A,123,150,27,CKLQRFIFHVNLYGSILFLTCISAHRY,0
4xnv,A,168,190,22,ICISVLVWLIVVVAISPILFYS,0
4xnv,A,191,213,22,TGVRKNKTITCYDTTSDEYLRS,0
4xnv,A,214,242,28,FIYSMCTTVAMFCVPLVLILGCYGLIVR,0
4xnv,A,256,282,26,KSIYLVIIVLTVFAVSYIPFHVMKTM,0
4xnv,A,283,308,25,LRARLDFQTPAMCAFNDRVYATYQV,0
4xnv,A,309,331,22,RGLASLNSCVNPILYFLAGDTF,0
3zuw,M,53,71,18,SLGVLSLFSGLMWFFTIG,0
3zuw,M,72,81,9,WFWYQAGWN,0
3zuw,M,82,87,5,AVFLR,0
3zuw,M,88,117,29,LFFFSLEPPAPEYGLSFAAPLKEGGLWLI,0
3zuw,M,118,135,17,SFFMFVAVWSWWGRTYL,0
3zuw,M,145,163,18,TAWAFLSAIWLWMVLGFI,0
3zuw,M,164,178,14,PILMGSWSEAVPYG,0
3zuw,M,179,192,13,FSHLDWTNNFSLV,0
3zuw,M,193,200,7,GNLFYNP,0
3zuw,M,201,221,20,HGLSIAFLYGSALLFAMHGA,0
3zuw,M,268,285,17,AIWMAVLVTLTGGIGIL,0
3zuw,M,286,293,7,SGTVVDN,0
3zuw,M,294,299,5,YVWGQ,0
3zuw,M,300,302,2,HG,0
3zuw,M,303,307,4,APLN,0
3omi,B,30,60,30,EIIGRPQPGGTGFQPSASPVATQIHWLDGF,0
3omi,B,61,81,20,LVIIAAITIFVTLLILYAVW,0
3omi,B,99,117,18,LEIAWTIVPIVILVAIGA,0
3omi,B,118,285,167,SLPVLFNQQEIPEADVTVKVTGYQWYWGYEYPDEEISFESYMIGSPATGGDNRMSPEVEQQLIEAGYSRDEFLLATDTAMVVPVNKTVVVQVTGADVIHSWTVPAFGVKQDAVPGRLAQLWFRAEREGIFFGQCSELCGISHAYMPITVKVVSEEAYAAWLEQHHHH,0
2nwx,C,1,11,10,GLYRKYIEYP,0
2nwx,C,15,28,13,ILIGLILGAIVGL,0
2nwx,C,29,42,13,LGHYGYAHAVHTY,0
2nwx,C,43,60,17,KPFGDLFVRLLKMLVMP,0
2nwx,C,83,100,17,KIVVYYLLTSAFAVTLG,0
2nwx,C,101,123,22,IMARLFNPGAGIHLAVGGQQFQ,0
2nwx,C,124,127,3,HQA,0
2nwx,C,128,130,2,PL,0
2nwx,C,131,140,9,HILLDIVPT,0
2nwx,C,141,150,9,PFGALANGQ,0
2nwx,C,151,158,7,LPTIFFA,0
2nwx,C,202,217,15,QYAPIGVFALIAYVM,0
2nwx,C,218,235,17,EQGVHVVGELAKVTAAV,0
2nwx,C,236,250,14,VGLTLQILLVYFVL,0
2nwx,C,267,285,18,AMLTAFVTRSSSGTLPVT,0
2nwx,C,303,317,14,PLGATINMDGTALY,0
2nwx,C,318,345,27,GVCTFFIANALGSHLTVGQQLTIVLTA,0
2nwx,C,346,359,13,LASIGTAGVPGAG,0
2nwx,C,360,391,31,IMLAMVLHSVGLPLTDPNVAAAYAMILGIDA,0
2nwx,C,392,408,16,LDMGRTMVNVTGDLTG,0
2nwx,C,417,422,5,TLVPR,0
3uso,B,1,4,3,EVK,0
3uso,B,14,35,21,ILAMAGNAVGLGNFLRFPVQA,0
3uso,B,36,41,5,ENGGG,0
3uso,B,42,63,21,FMIPYIIAFLLVGIPLMWIEW,0
3uso,B,89,124,35,AKILGVFGLWIPLVVAIYYVYIESWTLGFAIKFLV,0
3uso,B,125,131,6,LVPEPP,0
3uso,B,132,134,2,,0
3uso,B,135,166,31,DPDSILRPFKEFLYSYIGVPKGDEPILKPSL,0
3uso,B,167,185,18,AYIVFLITMFINVSILIR,0
3uso,B,191,214,23,ERFAKIAMPTLFILAVFLVIRVF,0
3uso,B,215,222,7,LETPNGT,0
3uso,B,223,231,8,ADGLNFLW,0
3uso,B,232,241,9,PDFEKLKDP,0
3uso,B,242,265,23,VWIAAVGQIFFTLSLGFGAIITY,0
3uso,B,278,298,20,GLTAATLNEKAEVILGGSIS,0
3uso,B,299,308,9,PAAVAFFGV,0
3uso,B,309,317,8,NAVAIAKA,0
3uso,B,319,324,5,FNLGF,0
3uso,B,326,331,5,LPAIF,0
3uso,B,332,339,7,QTAGGTF,0
3uso,B,340,367,27,GFLWFFLLFFAGLTSSIAIMQPMIAFL,0
3uso,B,377,396,19,AVLWTAAIVFFSAHLVMFL,0
3uso,B,397,399,2,KS,0
3uso,B,400,425,25,DEMDFWAGTIGVVFFGLTELIIFFW,0
3uso,B,429,437,8,DKAWEEIN,0
3uso,B,445,472,27,RIYYYVMRYITPAFLAVLLVVWAREYI,0
3uso,B,473,483,10,KIMEETHWTV,0
3uso,B,484,502,18,ITRFYIIGLFLFLTFLVF,0
3uso,B,602,610,8,SAGTLVPR,0
2j7a,F,1,13,12,SEEKSRNGPARL,0
2j7a,F,17,33,16,GGATLGVVALATVAFG,0
2j7a,F,34,74,40,KYTDQRPFCTSCHIMNPVGVTHKLSGHANISCNDCHAPHN,0
2j7a,F,75,94,19,LAKLPFKAIAGARDVYMNT,0
2j7a,F,95,158,63,GHPGDLILAGMETKEVVNANCKACHTMTNVEVASMEAKKYCTDCHRNVQHMRMKPISTREVAD,0
5ckr,B,20,23,3,YIT,0
5ckr,B,24,41,17,RSFTAVLIAFFLTLVLS,0
5ckr,B,78,93,15,IVILIVVTLSTLLLM,0
5ckr,B,94,98,4,WDIK,0
5ckr,B,99,116,17,TWVVLLSFLSFGTIGFW,0
5ckr,B,131,148,17,TKFLLQVLSASLISVLI,0
5ckr,B,149,172,23,YWADIDTILYFPFFKELYVDLGV,0
5ckr,B,173,193,20,YLPFAVFVIVGSANAVNLTD,0
5ckr,B,198,214,16,AIGPAMTTATALGVVA,0
5ckr,B,215,236,21,AVGHSKIAQYLNIPYVPYAGE,0
5ckr,B,237,253,16,TVFCFALVGAGLGFLW,0
5ckr,B,266,283,17,GSLSIGASLATVALLTK,0
5ckr,B,285,304,19,FIFAVAAGVFVFETISVIL,0
5ckr,B,305,312,7,IIYFRWT,0
5ckr,B,339,355,16,RMWIISILLAIIAISM,0
5ckr,B,356,359,3,KLR,0
4iar,A,30,37,7,GTCSAKD,0
4iar,A,38,51,13,IYQDSISLPWKVL,0
4iar,A,52,72,20,VMLLALITLATTLSNAFVIA,0
4iar,A,89,107,18,SLAVTDLLVSILVMPIST,0
4iar,A,108,120,12,YTVTGRWTLGQV,0
4iar,A,121,142,21,CDFWLSSDITCCTASIWHLCV,0
4iar,A,170,186,16,ALVWVFSISISLPPFF,0
4iar,A,187,190,3,RQA,0
4iar,A,191,196,5,AEEEV,0
4iar,A,197,205,8,ECVVNTDH,0
4iar,A,206,226,20,LYTVYSTVGAFYFPTLLLIA,0
4iar,A,317,336,19,IILGAFIVCWLPFFIISLV,0
4iar,A,337,339,2,PI,0
4iar,A,340,344,4,KDAC,0
4iar,A,345,350,5,FHLAI,0
4iar,A,351,371,20,DFFTWLGYLNSLINPIIYTM,0
4iar,A,374,383,9,DFKQAFHKL,0
4iar,A,388,390,2,TS,0
1o5w,A,-7,9,16,GHHHHHHMTDLEKPNL,0
1o5w,A,10,494,484,GHMFDVVVIGGGISGLAAAKLLSEYKINVLVLEARDRVGGRTYTVRNEHVKWVDVGGAYVGPTQNRILRLSKELGIETYKVNVNERLVQYVKGKTYPFRGAFPPVWNPLAYLDYNNLWRTMDEMGKEIPVDAPWQARHAQEWDKMTMKDLIDKICWTKTAREFAYLFVNINVTSEPHEVSALWFLWYVRQCGGTARIFSVTNGGQERKFVGGSGQVSEQIMGLLGDKVKLSSPVTYIDQTDDNIIVETLNHEHYECKYVISAIPPILTAKIHFKPELPPERNQLIQRLPMGAVIKCMVYYKEAFWKKKDYCGCMIIEDEEAPIAITLDDTKPDGSLPAIMGFILARKADRLAKLHKDIRKRKICELYAKVLGSQEALYPVHYEEKNWCEEQYSGGCYTAYFPPGIMTQYGRVIRQPVGRIYFAGTETATQWSGYMEGAVEAGERAAREVLNALGKVAKKDIWVEEPESKDVPAIEITHTFLERN,0
1o5w,A,495,517,22,PSVPGLLKITGVSTSVALLCFV,0
1o5w,A,521,526,5,KKLPC,0
5are,W,10,12,2,TP,0
5are,W,13,26,13,ILGLPLVTLIVLF,0
5are,W,77,89,12,FIGSTNLLGLLP,0
5are,W,90,95,5,SFTPT,0
5are,W,96,110,14,QLSMNLGMAIPLWA,0
5are,W,150,169,19,IQPMALAVRLTANITAGHL,0
5are,W,170,193,23,IHLIGGATLALMSISTTTALITF,0
5are,W,194,212,18,ILILLTILEFAVAMIQAY,0
2jaf,C,1,21,20,SITSVPGVVDAGVLGAQSAA,0
2jaf,C,33,52,19,WVNVALAGIAILVFVYMGR,0
2jaf,C,53,61,8,IRPGRPRL,0
2jaf,C,62,79,17,WGATLMIPLVSISSYLG,0
2jaf,C,107,124,17,RYLTWALSTPMILLALG,0
2jaf,C,125,132,7,LADVDLG,0
2jaf,C,133,151,18,LFTVIAADIGMCVTGLAA,0
2jaf,C,163,180,17,FYAISCAFFVVVLSALV,0
2jaf,C,181,198,17,DWAASASSAGTAEIFDT,0
2jaf,C,199,216,17,RVLVVVLWLGYPIVWAV,0
2jaf,C,231,251,20,WAYSVLDVFAKYVFAFILLR,0
2jaf,C,252,263,11,VANNERTVAVA,0
2jaf,C,264,274,10,QTLGTMSSDD,0
3nd0,B,1,25,24,AADFETSNRRWLDKLPRNLTDSAR,0
3nd0,B,26,32,6,LHPRTL,0
3nd0,B,33,57,24,AAIVVGLITGVLGAGFKSAVNNML,0
3nd0,B,77,93,16,TALISGGMVALSFWLM,0
3nd0,B,94,124,30,RFAPDTSGSGIPQIEGHLEGKLPLVWQRVL,0
3nd0,B,125,138,13,IKLVGGFLSLGAG,0
3nd0,B,140,152,12,AGFEGPTIQMGG,0
3nd0,B,153,175,22,IGQMTGGWFKATQENQRILIAV,0
3nd0,B,176,198,22,AGAGLATAFNAPLAGVALIGEE,0
3nd0,B,199,210,11,HPRFRSQTLAY,0
3nd0,B,211,227,16,SLLFGCVMATIILRMI,0
3nd0,B,248,272,24,MFIILGILFGVMGYTFNRGLFKVL,0
3nd0,B,273,282,9,WFDRLPPLA,0
3nd0,B,283,297,14,KWKGFLLGSIIGIL,0
3nd0,B,330,343,13,GRFLLTLICYGSG,0
3nd0,B,345,357,12,GGIFAPMLGIAS,0
3nd0,B,385,407,22,MGALVAATVRAPLTAILLTIEM,0
3nd0,B,415,431,16,PLLVTCLVASVVAEAL,0
3nd0,B,432,450,18,GKPIYTVLLERTLAKQNR,0
3nd0,B,451,466,15,SLVPRGSGGHHHHHH,0
4kt0,M,13,29,16,VALLPAFLAFRLSTEL,0
4kt0,M,30,31,1,K,0
4il4,E,1,4,3,QDM,0
4il4,E,5,194,189,SPPPPIADEPLTVNTGIYLIECYSLDDKAETFKVNAFLSLSWKDRRLAFDPVRSGVRVKTYEPEAIWIPEIRFVNVENARDADVVDISVSPDGTVQYLERFSARVLSPLDFRRYPFDSQTLHIYLIVRSVDTRNIVLAVDLEKVGKNDDVFLTGWDIESFTAVVKPANFALEDRLESKLDYQLRISRQY,0
4il4,E,195,217,22,SYIPNIILPMLFILFISWTAFW,0
4il4,E,223,244,21,NVTLVVSTLIAHIAFNILVET,0
4il4,E,245,251,6,LPKTPY,0
4il4,E,252,275,23,TYTGAIIFMIYLFYFVAVIEVTV,0
4il4,E,295,315,20,RIAFPVVFLLANIILAFLFF,0
4il4,E,316,317,1,F,0
5hvd,D,0,9,9,MSRKIRDLI,0
5hvd,D,13,34,21,FQNVITAIIVLNGAVLGLLTD,0
5hvd,D,35,40,5,TLSAS,0
5hvd,D,41,65,24,QNLLERVDQLCLTIFIVEISLKIY,0
5hvd,D,73,91,18,RSGWNLFDFVIVAIALMP,0
5hvd,D,101,118,17,FRIFRVMRLVSVIPTMR,0
5hvd,D,120,153,33,VQGMLLALPGVGSVAALLTVVFYIAAVMATNLY,0
5hvd,D,154,163,9,ATFPEWFGD,0
5hvd,D,164,182,18,SKSLYTLFQVMTLESWSM,0
5hvd,D,183,191,8,IVRPVMNV,0
5hvd,D,192,194,2,PN,0
5hvd,D,195,222,27,WVFFIPFIMLTTFTVLNLFIGICVDAM,0
5te5,A,38,63,25,MLAAYMFLLIMLGFPINFLTLYVTV,0
5te5,A,64,73,9,HKKLRTPLN,0
5te5,A,74,99,25,ILLNLAVADLFMVFGGFTTTLYTSL,0
5te5,A,109,133,24,CNLEGFFATLGGEIALWSLVVLAI,0
5te5,A,134,153,19,RYVVVCKPMSNFRFGENHA,0
5te5,A,154,176,22,MGVAFTWVMALACAAPPLVGWS,0
5te5,A,200,225,25,ESFVIYMFVVHFIIPLIVIFFCYGQ,0
5te5,A,226,252,26,VFTVKEAAAQQQESATTQKAEKEVTR,0
5te5,A,253,277,24,VIIMVIAFLICWLPYAGVAFYIFT,0
5te5,A,287,309,22,MTIPAFFAKTSAVYNPVIYIMM,0
5te5,A,311,322,11,QFRNCMVTTLC,0
5te5,A,323,348,25,GKNPLGDDEASTTVSKTETSQVAPA,0
5d59,A,5,18,13,KTFFGQPLGLSTL,0
5d59,A,19,36,17,MTEMWERFSYYGMRAIL,0
5d59,A,59,74,15,MAIYASMVYLSGTIG,0
5d59,A,75,86,11,FVADRIIGARP,0
5d59,A,87,103,16,VFWGGVLIMLGHIVLA,0
5d59,A,112,127,15,GSIILIIIGTGFLKP,0
5d59,A,128,151,23,VSTLVGTLYDEHDRRRDAGFSIF,0
5d59,A,152,167,15,FGINLGAFIAPLIVG,0
5d59,A,179,195,16,SLAAIGMFIGLLVYYF,0
5d59,A,196,221,25,GKKTLDPHYLRPTDPLAPEEVKPLL,0
5d59,A,222,238,16,KVSLAVAGFIAIIVVM,0
5d59,A,249,266,17,INLLTIVAIAIPVFYFA,0
5d59,A,267,269,2,MI,0
5d59,A,275,286,11,STEHLRVVSYI,0
5d59,A,287,307,20,LFIAAVLFWAIEEQGSVVLA,0
5d59,A,323,339,16,FQSLNPLFIMLYTPFF,0
5d59,A,340,355,15,WLWTAWKKNQPSSPT,0
5d59,A,356,371,15,FAVGLMFAGLSFLLM,0
5d59,A,388,404,16,LVGSWALVILGEMLIS,0
5d59,A,423,425,2,MS,0
5d59,A,426,442,16,WFLSSSVGSALNAQLV,0
5d59,A,455,471,16,YFGLGSVVLGIVLVFL,0
5d59,A,472,475,3,KRI,0
1vcr,A,1,54,53,KSATTKKVASSGSPWYGPDRVKYLGPFSGESPSYLTGEFPGDYGWDTAGLSAD,0
1vcr,A,58,81,23,SKNRELEVIHSRWAMLGALGCVF,0
1vcr,A,82,89,7,ELLSRNG,0
1vcr,A,90,122,32,KFGEAVWFKAGSQIFSEGGLDYLGNPSLVHAQ,0
1vcr,A,123,130,7,ILAIWAT,0
1vcr,A,131,143,12,VILMGAVEGYRI,0
1vcr,A,144,169,25,GGPLGEVVDPLYPGGSFDPLGLADD,0
1vcr,A,176,197,21,KVKELKNGRLAMFSMFGFFVQ,0
1vcr,A,198,205,7,IVTGKGP,0
1vcr,A,206,212,6,ENLADH,0
1vcr,A,213,214,1,A,0
1vcr,A,215,232,17,PVNNNAWSYATNFVPGK,0
2ht3,B,1,17,16,KTDTPSLETPQAARLR,0
2ht3,B,37,57,20,MAAVVGTLVGLAAVAFDKGV,0
2ht3,B,58,83,25,WLQNQRMGALVHTADNYPLLLTVAF,0
2ht3,B,84,97,13,CSAVLAMFGYFLV,0
2ht3,B,128,142,14,PVKFFGGLGTLGGG,0
2ht3,B,144,159,15,LGREGPTVQIGGNIG,0
2ht3,B,180,204,24,GAAAGLAAAFNAPLAGILFIIEEM,0
2ht3,B,216,229,13,AVFIGVIMSTIMY,0
2ht3,B,230,255,25,IFNHEVALIDVGKLSDAPLNTLWLY,0
2ht3,B,256,277,21,ILGIIFGIFGPIFNKWVLGMQ,0
2ht3,B,290,303,13,WVLMGGAIGGLCG,0
2ht3,B,304,337,33,LGFVAPATSGGGFNLIPIATAGNFSMGMLVFIF,0
2ht3,B,338,351,13,ARVITTLLCFSSG,0
2ht3,B,353,364,11,GGIFAPMLALG,0
2ht3,B,365,392,27,VLGTAFGMVAVELFPQYHLEAGTFAIA,0
2ht3,B,393,414,21,MGALLAASIRAPLTGIILVLE,0
2ht3,B,415,422,7,TDNYQLI,0
2ht3,B,423,439,16,PMIITGLGATLLAQFT,0
2ht3,B,459,473,14,QLARSKAASASENT,0
3pcq,X,1,6,5,TKSAK,0
3pcq,X,7,12,5,TYAFR,0
3pcq,X,13,30,17,FWAVLLLAINFLVAAYY,0
4wfe,B,28,32,4,STTL,0
4wfe,B,33,51,18,ALLALVLLYLVSGALVFR,0
4wfe,B,117,133,16,SAFFFSGTIITTIGYG,0
4wfe,B,141,162,21,GRLFCIFYALVGIPLFGILLA,0
4wfe,B,163,185,22,VGDRLGSSLRHGIGHIEAIFLK,0
4wfe,B,186,202,16,HVPPELVRVLSAMLFL,0
4wfe,B,203,221,18,IGCLLFVLTPTFVFCYME,0
4wfe,B,225,237,12,LEAIYFVIVTLT,0
4wfe,B,255,280,25,AYQPLVWFWILLGLAYFASVLTTIG,0
4wfe,B,281,286,5,WLRVV,0
2xqu,P,1,13,12,ESNLTTAASVIA,0
2xqu,P,14,33,19,ALAVGIGSIGPGLGQGQAA,0
2xqu,P,56,74,18,SLAFMEALTIYGLVVALV,0
2xqu,P,75,82,7,LFANPFV,0
2xq4,E,0,6,6,QDMVSP,0
2xq4,E,198,214,16,NIILPMLFILFISWTA,0
2xq4,E,215,224,9,WSTSYEANV,0
2xq4,E,225,240,15,LVVSTLIAHIAFNIL,0
2xq4,E,255,271,16,AIIFMIYLFYFVAVIE,0
2xq4,E,272,294,22,TVQHYLKVESQPARAASITRAS,0
2xq4,E,295,312,17,IAFPVVFLLANIILAFL,0
3p4r,P,12,37,25,FWGLFGAGGMWSAIIAPVMILLVGI,0
3p4r,P,38,61,23,LPLGLFPGDALSYERVLAFAQSF,0
3p4r,P,62,86,24,GRVFLFLMIVLPLWCGLHRMHHAM,0
3p4r,P,94,116,22,AGKWVFYGLAAILTVVTLIGVV,0
3p4r,P,117,118,1,I,0
1v54,Z,17,34,17,GLSVTFLSFLLPAGWVL,0
1v54,Z,35,43,8,HLDNYKKS,0
1v54,Z,44,46,2,AA,0
4ilb,E,-3,4,7,SAAAQDM,0
4ilb,E,5,201,196,SPPPPIADEPLTVNTGIYLIECYSLDDKAETFKVNAFLSLSWKDRRLAFDPVRSGVRVKTYEPEAIWIPEIRFVNVENARDADVVDISVSPDGTVQYLERFSARVLSPLDFRRYPFDSQTLHIYLIVRSVDTRNIVLAVDLEKVGKNDDVFLTGWDIESFTAVVKPANFALEDRLESKLDYQLRISRQYFSYIPNI,0
4ilb,E,202,218,16,LPMLFILFISWTAFWS,0
4ilb,E,222,239,17,ANVTLVVSTLIAHIFFN,0
4ilb,E,240,257,17,LVETNLPKTPYMTYTGA,0
4ilb,E,258,275,17,IFMIYLFYFVAVIEVTV,0
4ilb,E,293,312,19,ASRIAFPVVFLLANIILAF,0
4ilb,E,313,315,2,FF,0
5cfb,E,224,239,15,IQMYIPSLLIVILSW,0
5cfb,E,240,255,15,SFWINMDAAPARVAL,0
5cfb,E,256,271,15,ITTVLTMTTQSSGSR,0
5cfb,E,283,299,16,DIWMAVCLLFVFSALL,0
5cfb,E,300,329,29,YAAVNFVSRAGTKVFIDRAKKIDTISRAC,0
5cfb,E,330,344,14,PLAFLIFNIFYWVI,0
4wgv,A,70,87,17,ILISSLAAMLLQSMTVR,0
4wgv,A,88,95,7,GIATGKD,0
4wgv,A,96,101,5,AQMTR,0
4wgv,A,102,107,5,FLSKP,0
4wgv,A,108,132,24,AIIFWIIAELAIIATDIAEVIGSA,0
4wgv,A,146,157,11,ALITVFDVFLL,0
4wgv,A,159,178,19,IMRFGFRKIEAIVGTLIFT,0
4wgv,A,218,234,16,GIIGATIMPHNLYLHS,0
4wgv,A,235,255,20,IVQSRKYDRHDNEEKAQAIK,0
4wgv,A,256,272,16,ATIDSNLQLSIAFVVN,0
4wgv,A,322,342,20,LLASGQNSTITGTLAGQIVM,0
4wgv,A,343,351,8,GFLRLSIP,0
4wgv,A,352,369,17,WLRRLITRSLAVIPVII,0
4wgv,A,386,405,19,FSQVFLSIALPFSLIPLQL,0
4wgv,A,406,414,8,TSNKKLMG,0
4wgv,A,415,436,21,FINKTWVNIISWTLIVILSGL,0
2dwd,F,22,24,2,AL,0
2dwd,F,25,50,25,WRAAGAATVLLVIVLLAGSYLAVLA,0
2dwd,F,63,78,15,RALWWSVETATTVGY,0
2dwd,F,87,114,27,GRCVAVVVMVAGITSFGLVTAALATWF,0
2dwd,F,115,124,9,GREQERRGH,0
5svs,C,21,28,7,TIGIINR,0
5svs,C,29,47,18,VQLLIISYFVGWVFLHEK,0
5svs,C,316,343,27,NIIPTIISSVAAFTSVGVGTVLCDIIL,0
5svs,C,344,346,2,NF,0
1z65,A,1,4,3,KNR,0
1z65,A,5,25,20,GTWWVAILCMLLASHLSTVK,0
3ldd,D,24,41,17,LLVLAVIIYGTAGFHFI,0
3ldd,D,42,46,4,GESW,0
3ldd,D,47,63,16,VSLYWTFVTIATVGYG,0
3ldd,D,64,70,6,YSPRTP,0
3ldd,D,71,92,21,GMYFTCTLIVLGIGTFAVAVE,0
3ldd,D,93,98,5,LLEFL,0
1t9t,C,1,6,5,PNFFI,0
1t9t,C,13,25,12,VIAIIIMLAGGL,0
1t9t,C,26,341,315,ILKLPVAQYPTIAPPAVTISASYPGADAKTVQDTVTQVIEQNMNGIDNLMYMSSNSDSTGTVQITLTFESGTDADIAQVQVQAKLQLAMPLLPQEVQQQGVSVEKSSSSFLMVVGVINTDGTMTQEDISDYVAANMKDAISRTSGVGDVQLFGSQYAMRIWMNPNELNKFQLTPVDVITAIKAQNAQVAAGQLGGTPPVKGQQLNASIIAQTRLTSTEEFGKILLKVNQDGSRVLLRDVAKIELGGENYDIIAEFNGQPASGLGIKLATGANALDTAAAIRAELAKMEPFFPSGLKIVYPYDTTPFVKISIHEVV,0
1t9t,C,342,354,12,TLVEAIILVFLV,0
1t9t,C,369,382,13,IAVPVVLLGTFAV,0
1t9t,C,383,397,14,AAFGFSINTLTMFG,0
1t9t,C,398,409,11,VLAIGLLVDDA,0
1t9t,C,444,457,13,IAMVLSAVFVPMA,0
1t9t,C,458,469,11,FGGSTGAIYRQ,0
1t9t,C,472,485,13,TIVSAMALSVLVA,0
1t9t,C,499,512,13,IAKGDHGEGKKGF,0
1t9t,C,544,556,12,YLIIVVGMAYLF,0
1t9t,C,557,861,304,RLPSSFLPDEDQGVFMTMVQLPAGATQERTQKVLNEVTHYYLTKEKNNVESVFAVNGFGFAGRGQNTGIAFVSLKDWADRPGEENKVEAITMRATRAFSQIKDAMVFAFNLPAIVELGTATGFDFELIDQAGLGHEKLTQARNQLLAEAAKHPDMLTSVRPNGLEDTPQFKIDIDQEKAQALGVSINDINTTLGAAWGGSYVNDFIDRGRVKKVYVMSEAKYRMLPDDIGDWYVRAADGQMVPFSAFSSSRWEYGSPRLERYNGLPSMEILGQAAPGKSTGEAMELMEQLASKLPTGVGYDWTG,0
1t9t,C,863,874,11,YQERLSGNQAP,0
1t9t,C,875,888,13,LYAISLIVVFLCL,0
1t9t,C,902,916,14,LVVPLGVIGALLAA,0
1t9t,C,917,928,11,FRGLTNDVYFQ,0
1t9t,C,929,941,12,GLLTTIGLSAKN,0
1t9t,C,978,992,14,SLAFILGVMPLVIS,0
1t9t,C,993,1003,10,GAGSGAQNAV,0
1t9t,C,1004,1018,14,TGVMGGMVTATVLA,0
1t9t,C,1026,1032,6,VVVRRR,0
1t9t,C,1037,1049,12,EDIEHSHTVDHH,0
3ud0,E,13,31,18,ISTIGLLGAGIGIAIVFA,0
3ud0,E,32,51,19,LINGVSRNPSIKDTVFPMA,0
3ud0,E,52,71,19,LGFALSEATGLFCLMVSFL,0
3ud0,E,75,76,1,V,0
1vz1,A,1,23,22,QAVDNLTSAPGNTSLCTRDYKI,0
1vz1,A,24,43,19,QVLFPLLYTVLFFVGLITN,0
1vz1,A,60,83,23,IFLKNTVISDLLMILTFPFKILS,0
1vz1,A,84,98,14,AKLGTGPLRTFVCQ,0
1vz1,A,99,123,24,TSVIFYFTMYISISFLGLITIDRY,0
1vz1,A,144,161,17,SVVIWAFMFLLSLPNMI,0
1vz1,A,162,189,27,TNRQPRDKNVKKCSFLKSEFGLVWHEI,0
1vz1,A,190,212,22,NYICQVIFWINFLIVIVCYTLI,0
1vz1,A,236,259,23,KVFIIIAVFFICFVPFHFARIPY,0
1vz1,A,260,272,12,LSQTRDVFDCTA,0
1vz1,A,273,302,29,NTLFYVKESTLWLTSLNACLDPFIYFFLC,0
1vz1,A,303,313,10,SFRNSLISML,0
1ov0,A,1,35,34,NGTEGPNFYVPFSNKTGVVRSPFEAPQYYLAEPW,0
1ov0,A,36,60,24,FSMLAAYMFLLIMLGFPINFLTLY,0
1ov0,A,75,99,24,LLNLAVADLFMVFGGFTTTLYTSL,0
1ov0,A,100,108,8,GYFVFGPT,0
1ov0,A,109,133,24,CNLEGFFATLGGEIALWSLVVLAI,0
1ov0,A,152,176,24,AIMGVAFTWVMALACAAPPLVGWS,0
1ov0,A,177,199,22,YIPEGMQCSCGIDYYTPHEETN,0
1ov0,A,200,222,22,ESFVIYMFVVHFIIPLIVIFFC,0
1ov0,A,254,279,25,IIMVIAFLICWLPYAGVAFYIFTHQ,0
1ov0,A,280,286,6,SDFGPI,0
1ov0,A,287,309,22,MTIPAFFAKTSAVYNPVIYIMM,0
1ov0,A,311,322,11,QFRNCMVTTLC,0
4bgn,E,1,26,25,SHIHERHSQLKHPIEAWCDWLVNHP,0
4bgn,E,27,31,4,FTSA,0
4bgn,E,32,47,15,IVLIVINAIVVGMET,0
4bgn,E,49,55,6,GIYQPY,0
4bgn,E,58,75,17,FYLIDRMILWVFTAEII,0
4bgn,E,76,94,18,KLVATRPRYHFFKDSWNV,0
4bgn,E,95,112,17,DFLIVASGHLFVGAQFV,0
4bgn,E,114,129,15,LRVLRVLRLLRAVTV,0
4bgn,E,131,136,5,SLRRL,0
4bgn,E,138,145,7,ALLYTIP,0
4bgn,E,146,147,1,L,0
4bgn,E,148,165,17,NIMLLMGLIFYIFGVMG,0
4bgn,E,184,197,13,ITLFQVVTLESWA,0
4bgn,E,213,230,17,YFVAFILVGTFVIFNLF,0
4bgn,E,231,247,16,GVIVSNVERAETEDAE,0
4bgn,E,248,298,50,EEGQREERQGLFEGDGSSVSAEEIAKLRQEIKELRQLLKELKDHHSQSST,0
5a2o,B,32,56,24,SAAMILCIEAVERLTTLGIGVNLV,0
5a2o,B,57,68,11,YLTGTMHLGNA,0
5a2o,B,69,89,20,AANTVTNFLGTSFMLCLLGG,0
5a2o,B,100,120,20,TIAIFAAIQATGVSILTLST,0
5a2o,B,121,123,2,IP,0
5a2o,B,142,143,1,G,0
5a2o,B,144,172,28,QLTVLYLALYLTALGTGGVKASVSGFGS,0
5a2o,B,186,209,23,TYFFNRFFFCINVGSLLAVTVLV,0
5a2o,B,210,217,7,VQDDVGR,0
5a2o,B,218,239,21,WGYGICAFAIVLALSVFLAGT,0
5a2o,B,343,364,21,PIWATCILFWTVHAQLTTLSV,0
5a2o,B,365,382,17,QSETLDRSIGSFEIPPA,0
5a2o,B,383,411,28,MAVFYVGGLLLTTAVYDRVAIRLCKKLF,0
5a2o,B,416,438,22,LRPLQRIGLGLFFGSMAMAVAA,0
5a2o,B,439,451,12,VELKRLRTAHAH,0
5a2o,B,461,466,5,FYLLI,0
5a2o,B,467,486,19,QYLIVGIGEALIYTGQLDF,0
5a2o,B,501,525,24,LLLSTLALGFFFSSVLVTIVEKFT,0
5a2o,B,526,543,17,KAHPWIADDLNKGRLYN,0
5a2o,B,544,564,20,YWLVAVLVALNFLIFLVFSK,0
2h8a,C,1,8,7,DLKQLMD,0
2h8a,C,9,13,4,EVLM,0
2h8a,C,14,33,19,FTSYATIILAKMMFLSSAT,0
2h8a,C,44,61,17,NPEDCAGFGKGENAKKF,0
2h8a,C,75,94,19,LNDLENIVPFLGIGLLYSL,0
2h8a,C,95,102,7,GPDLSTA,0
2h8a,C,103,122,19,IHFRIFVGARIYHTIAYLT,0
2h8a,C,127,146,19,NRGLAFFVGYGVTLSMAYR,0
2h8a,C,148,154,6,RSRLYL,0
5sxu,E,207,225,18,FILPLGLIIAASWSVFWL,0
5sxu,E,226,230,4,SFSE,0
5sxu,E,231,248,17,LQTSFTLMLTVVAYAFY,0
5sxu,E,265,282,17,IIAGYGSIFAAILLIIF,0
5sxu,E,283,299,16,HHRQANGVEDDLLIQR,0
5sxu,E,300,316,16,RLAFPLGFLAIGCVLV,0
2q6h,A,1,2,1,E,0
2q6h,A,16,35,19,AMAGNAVGLGNFLRFPVQA,0
2q6h,A,36,41,5,ENGGG,0
2q6h,A,42,62,20,FMIPYIIAFLLVGIPLMWIE,0
2q6h,A,93,120,27,GVFGLWIPLVVAIYYVYIESWTLGFAI,0
2q6h,A,121,132,11,FLVGLVPEPPP,0
2q6h,A,133,134,1,A,0
2q6h,A,135,167,32,DPDSILRPFKEFLYSYIGVPKGDEPILKPSLF,0
2q6h,A,168,185,17,YIVFLITMFINVSILIR,0
2q6h,A,191,212,21,ERFAKIAMPTLFILAVFLVIR,0
2q6h,A,213,222,9,FLLETPNGT,0
2q6h,A,223,230,7,ADGLNFL,0
2q6h,A,231,238,7,TPDFEKL,0
2q6h,A,239,265,26,DPGVWIAAVGQIFFTLSLGFGAIITY,0
2q6h,A,279,297,18,LTAATLNEKAEVILGGSI,0
2q6h,A,298,308,10,IPAAVAFFGV,0
2q6h,A,309,317,8,NAVAIAKA,0
2q6h,A,318,325,7,AFNLGFI,0
2q6h,A,326,332,6,LPAIFS,0
2q6h,A,333,342,9,TAGGTFLGF,0
2q6h,A,343,364,21,WFFLLFFAGLTSSIAIMQPMI,0
2q6h,A,377,396,19,AVLWTAAIVFFSAHLVMFL,0
2q6h,A,397,399,2,KS,0
2q6h,A,400,421,21,DEMDFWAGTIGVVFFGLTELI,0
2q6h,A,429,437,8,DKAWEEIN,0
2q6h,A,451,473,22,MRYITPAFLAVLLVVWAREYIP,0
2q6h,A,474,483,9,IMEETHWTV,0
2q6h,A,484,500,16,ITRFYIIGLFLFLTFL,0
2q6h,A,602,603,1,R,0
3nsb,C,1,5,4,AQIT,0
3nsb,C,10,31,21,IWLALGTALMGLGTLYFLVKG,0
3nsb,C,32,43,11,GVSDPDAKKFY,0
3nsb,C,44,62,18,ITTLVPAIAFTMYLSMLL,0
3nsb,C,80,97,17,ARYADWLFTTPLLLLDL,0
3nsb,C,98,108,10,LLVDADQGTI,0
3nsb,C,109,127,18,ALVGADGIMIGTGLVGAL,0
3nsb,C,134,153,19,FVWWAISTAAMLYILYVLF,0
3nsb,C,154,155,1,G,0
3nsb,C,156,158,2,TS,0
3nsb,C,159,173,14,AESMRPEVASTFKV,0
3nsb,C,174,192,18,RNVTVVLWSAYPVVWLIG,0
3nsb,C,203,224,21,ETLLFMVLDVSAKVGFGLILL,0
3nsb,C,225,231,6,SRAIFG,0
3nsb,C,232,248,16,AEAPEPSAGDGAAATS,0
4npp,E,1,4,3,QDM,0
4npp,E,199,218,19,NIILPMLFILFISWTAFWS,0
4npp,E,219,221,2,SY,0
4npp,E,222,240,18,ANVTLVVSTLIAHIAFNI,0
4npp,E,256,275,19,AIIFMIYLFYFVAVIEVTV,0
4npp,E,276,291,15,HYLKVESQPARAASI,0
4npp,E,292,313,21,RASRIAFPVVFLLANIILAFL,0
4npp,E,316,329,13,FGGHHHHHHHHHH,0
5vdh,E,228,244,16,IPSLLIVILSWVSFWI,0
5vdh,E,245,248,3,MDA,0
5vdh,E,249,268,19,PARVALGITTVLTMTTQSS,0
5vdh,E,285,305,20,WMAVCLLFVFSALLEYAAVN,0
5vdh,E,306,322,16,VSRAGTKVFIDRAKKI,0
5vdh,E,323,344,21,TISRACFPLAFLIFNIFYWVI,0
4ea3,A,-73,46,119,YKDDDDGAPADLEDNWETLNDNLKVIEKADNAAQVKDALTKMRAAALDAQKATPPKLEDKSPDSPEMKDFRHGFDILVGQIDDALKLANEGKVKEAQAAAEQLKTTRNAYIQKYLGAFL,0
4ea3,A,47,50,3,LGL,0
4ea3,A,51,74,23,VTIVGLYLAVCVGGLLGNCLVMY,0
4ea3,A,90,111,21,FNLALADTLVLLTLPFQGTDI,0
4ea3,A,112,118,6,LGFWPF,0
4ea3,A,119,143,24,NALCKTVIAIDYYNMFTSTFTLTA,0
4ea3,A,156,162,6,RALDVR,0
4ea3,A,171,190,19,VAIWALASVVGVPVAIMGS,0
4ea3,A,191,208,17,QVEDEEIECLVEIPTPQ,0
4ea3,A,209,232,23,YWGPVFAICIFLFSFIVPVLVIS,0
4ea3,A,267,292,25,VVAVFVGCWTPVQVFVLAQGLGVQP,0
4ea3,A,293,296,3,SET,0
4ea3,A,297,320,23,VAILRFCTALGYVNSCLNPILYA,0
4ea3,A,324,330,6,NFKACF,0
4ea3,A,332,360,28,FCCASALGRPLEVLFQGPHHHHHHHHHH,0
5a3q,A,49,56,7,WELVIEQ,0
5a3q,A,62,77,15,RILLLAACISFVLAW,0
5a3q,A,78,87,9,EEGEETITA,0
5a3q,A,88,101,13,VEPFVILLILIAN,0
5a3q,A,260,275,15,SKVISLICVAVWLIN,0
5a3q,A,276,292,16,GHFNDPVHGGSWIRGA,0
5a3q,A,293,311,18,YYFKIAVALAVAAIPEGL,0
5a3q,A,764,780,16,ISSNVGEVVCIFLTAA,0
5a3q,A,781,786,5,GLPEA,0
5a3q,A,787,804,17,IPVQLLWVNLVTDGLPA,0
5a3q,A,835,851,16,RYMAIGGYVGAATVGA,0
5a3q,A,852,865,13,AWWFMYAEDGPGV,0
5a3q,A,867,898,31,HQLTHFMQCTEDHPHFEGLDCEIFEAPEPMT,0
5a3q,A,899,915,16,ALSVLVTIEMCNALNS,0
5a3q,A,932,950,18,LLGSICLSMSLHFLILYV,0
5a3q,A,951,957,6,PLPMIF,0
5a3q,A,958,970,12,LKALDLTQWLMV,0
5a3q,A,971,987,16,KISLPVIGLDEILKFI,0
1z8e,A,1,21,20,AADLGPWNDTINGTWDGDEL,0
1z8e,A,22,35,13,YRCRFNEDFKYVL,0
1z8e,A,36,56,20,PVSYGVVCVLGLCLNAVALY,0
1z8e,A,70,92,22,YMFHLAVSDALYAASLPLLVYY,0
1z8e,A,93,107,14,ARGDHWPFSTVLCK,0
1z8e,A,108,129,21,VRFLFYTNLYCSILFLTCISV,0
1z8e,A,152,170,18,VAGAVWVLVLACQAPVLY,0
1z8e,A,171,198,27,VTTSARGGRVTCHDTSAPELFSRFVAY,0
1z8e,A,199,222,23,SVMLGLLFAVPFAVILVCYVLMA,0
1z8e,A,246,266,20,IAVVLAVFALCFLPFHVTRT,0
1z8e,A,267,290,23,YYSFRSLDLSCHTLNAINMAYKV,0
1z8e,A,291,309,18,RPLASANSCLDPVLYFLA,0
1z8e,A,311,377,66,RLVRFARDAKPPTGPSPATPARRRLGLRRSDRTDMQRIEDVLGSSEDSRRTESTPAGSENTKDIRL,0
1ott,B,1,17,16,KTDTPSLETPQAARLR,0
1ott,B,37,58,21,MAAVVGTLVGLAAVAFDKGVA,0
1ott,B,59,83,24,LQNQRMGALVHTADNYPLLLTVAF,0
1ott,B,84,97,13,CSAVLAMFGYFLV,0
1ott,B,129,142,13,VKFFGGLGTLGGG,0
1ott,B,144,156,12,LGRAGPTVQIGG,0
1ott,B,181,203,22,AAAGLAAAFNAPLAGILFIIEE,0
1ott,B,216,231,15,AVFIGVIMSTIMYRI,0
1ott,B,232,252,20,NHEVALIDVGKLSDAPLNTL,0
1ott,B,253,274,21,LYLILGIIFGIFGPIFNKWVL,0
1ott,B,290,304,14,WVLMGGAIGGLCGL,0
1ott,B,305,317,12,GFVAPATSGGGF,0
1ott,B,318,325,7,LIPIATA,0
1ott,B,326,337,11,NFSMGMLVFIF,0
1ott,B,338,351,13,ARVITTLLCFSSG,0
1ott,B,353,365,12,GGIFAPMLALGT,0
1ott,B,366,392,26,LGTAFGMVAVELFPQYHLEAGTFAIA,0
1ott,B,393,415,22,MGALLAASIRAPLTGIILVLEM,0
1ott,B,416,422,6,DNYQLI,0
1ott,B,423,439,16,PMIITGLGATLLAQFT,0
1ott,B,459,465,6,QLARSK,0
1oyd,C,1,6,5,PNFFI,0
1oyd,C,11,27,16,AWVIAIIIMLAGGLAI,0
1oyd,C,28,340,312,KLPVAQYPTIAPPAVTISASYPGADAKTVQDTVTQVIEQNMNGIDNLMYMSSNSDSTGTVQITLTFESGTDADIAQVQVQNKLQLAMPLLPQEVQQQGVSVEKSSSSFLMVVGVINTDGTMTQEDISDYVAANMKDAISRTSGVGDVQLFGSQYAMRIWMNPNELNKFQLTPVDVITAIKAQNAQVAAGQLGGTPPVKGQQLNASIIAQTRLTSTEEFGKILLKVNQDGSRVLLRDVAKIELGGENYDIIAEFNGQPASGLGIKLATGANALDTAAAIRAELAKMEPFFPSGLKIVYPYDTTPFVKISIHEV,0
1oyd,C,341,357,16,KTLVEAIILVFLVMYL,0
1oyd,C,366,386,20,IPTIAVPVVLLGTFAVLAAF,0
1oyd,C,387,394,7,FSINTLT,0
1oyd,C,395,411,16,FGMVLAIGLLVDDAIV,0
1oyd,C,443,458,15,GIAMVLSAVFVPMAF,0
1oyd,C,459,468,9,GGSTGAIYR,0
1oyd,C,469,489,20,FSITIVSAMALSVLVALILT,0
1oyd,C,499,512,13,IAKGDHGEGKKGF,0
1oyd,C,514,524,10,WFNRMFEKST,0
1oyd,C,526,536,10,YTDSVGGILR,0
1oyd,C,542,557,15,VLYLIIVVGMAYLFV,0
1oyd,C,558,710,152,LPSSFLPDEDQGVFMTMVQLPAGATQERTQKVLNEVTHYYLTKEKNNVESVFAVNGFGFAGRGQNTGIAFVSLKDWADRPGEENKVEAITMRATRAFSQIKDAMVFAFNLPAIVELGTATGFDFELIDQAGLGHEKLTQARNQLLAEAAKHP,0
1oyd,C,712,859,147,LTSVRPNGLEDTPQFKIDIDQEKAQALGVSINDINTTLGAAWGGSYVNDFIDRGRVKKVYVMSEAKYRMLPDDIGDWYVRAADGQMVPFSAFSSSRWEYGSPRLERYNGLPSMEILGQAAPGKSTGEAMELMEQLASKLPTGVGYDW,0
1oyd,C,860,868,8,GMSYQERL,0
1oyd,C,869,873,4,GNQA,0
1oyd,C,874,891,17,SLYAISLIVVFLCLAAL,0
1oyd,C,899,919,20,SVMLVVPLGVIGALLAATFR,0
1oyd,C,920,926,6,LTNDVY,0
1oyd,C,927,943,16,QVGLLTTIGLSAKNAI,0
1oyd,C,976,993,17,MTSLAFILGVMPLVIST,0
1oyd,C,994,1000,6,AGSGAQ,0
1oyd,C,1001,1019,18,AVGTGVMGGMVTATVLAI,0
1oyd,C,1026,1032,6,VVVRRR,0
1oyd,C,1037,1049,12,EDIEHSHTVDHH,0
5tr1,B,37,46,9,WLKRKLFCV,0
5tr1,B,47,71,24,EDWYFLTVLGVLMALISFTMSFTV,0
5tr1,B,98,112,14,YPVALVSFSSGFSQ,0
5tr1,B,113,143,30,ITPFSGGSGIPELKTILSGVVLEDYLDIKN,0
5tr1,B,144,159,15,GAKAVGLTCTLASGS,0
5tr1,B,161,177,16,FLGKVGPFVHLSVMIA,0
5tr1,B,178,184,6,YLGRVR,0
5tr1,B,193,202,9,KSKRNEMLV,0
5tr1,B,203,227,24,GAAVGVATVFAAPFSGVLFCIEVV,0
5tr1,B,228,233,5,SHFSV,0
5tr1,B,234,253,19,DYWRGFFAATCGAFMFRLL,0
5tr1,B,280,303,23,EIFFFVALGAICGVASCAYLFCQ,0
5tr1,B,304,312,8,KFLGFVKT,0
5tr1,B,314,322,8,VLSKLMAT,0
5tr1,B,324,339,15,PLYSALAALVLASVT,0
5tr1,B,354,361,7,REYLDSL,0
5tr1,B,404,420,16,FLVMKFWMLILATTIP,0
5tr1,B,422,437,15,AGYFMPIFIFGAAIG,0
5tr1,B,467,480,13,LAGAAAFSGAVTH,0
5tr1,B,482,492,10,STALLAFELT,0
5tr1,B,498,513,15,LPVLMAVLAANAIAQ,0
5tr1,B,514,605,91,CQPSFYDGTIIVKKLPYLPWIRGRKISSHRVTVEHFMNRAITTLAKDTPQEEVVKVVTSTDMAEYPLVASTESQTLVGTMRRAQLVQALQA,0
5tr1,B,618,683,65,QDILAEGCPVEPVTLKLSPETSLHQAHNLFELLNLQSLFVTSQGRAVGFVSWVELEKAISKLTNP,0
4rng,C,12,31,19,IIAGAITTSALIPQALKIY,0
4rng,C,32,39,7,TKSARDV,0
4rng,C,40,59,19,LAMFIFMAIGITLWFFYGV,0
4rng,C,65,85,20,VILANLISLILIFLIIFMKI,0
4rng,C,86,88,2,YG,0
1t9y,C,1,6,5,PNFFI,0
1t9y,C,11,27,16,AWVIAIIIMLAGGLAI,0
1t9y,C,28,340,312,KLPVAQYPTIAPPAVTISASYPGADAKTVQDTVTQVIEQNMNGIDNLMYMSSNSDSTGTVQITLTFESGTDADIAQVQVQAKLQLAMPLLPQEVQQQGVSVEKSSSSFLMVVGVINTDGTMTQEDISDYVAANMKDAISRTSGVGDVQLFGSQYAMRIWMNPNELNKFQLTPVDVITAIKAQNAQVAAGQLGGTPPVKGQQLNASIIAQTRLTSTEEFGKILLKVNQDGSRVLLRDVAKIELGGENYDIIAEFNGQPASGLGIKLATGANALDTAAAIRAELAKMEPFFPSGLKIVYPYDTTPFVKISIHEV,0
1t9y,C,341,357,16,KTLVEAIILVFLVMYL,0
1t9y,C,366,386,20,IPTIAVPVVLLGTFAVLAAF,0
1t9y,C,387,394,7,FSINTLT,0
1t9y,C,395,411,16,FGMVLAIGLLVDDAIV,0
1t9y,C,442,458,16,VGIAMVLSAVFVPMAF,0
1t9y,C,459,469,10,GGSTGAIYRQ,0
1t9y,C,470,489,19,SITIVSAMALSVLVALILT,0
1t9y,C,499,512,13,IAKGDHGEGKKGF,0
1t9y,C,514,524,10,WFNRMFEKST,0
1t9y,C,526,536,10,YTDSVGGILR,0
1t9y,C,541,557,16,LVLYLIIVVGMAYLFV,0
1t9y,C,558,873,315,LPSSFLPDEDQGVFMTMVQLPAGATQERTQKVLNEVTHYYLTKEKNNVESVFAVNGFGFAGRGQNTGIAFVSLKDWADRPGEENKVEAITMRATRAFSQIKDAMVFAFNLPAIVELGTATGFDFELIDQAGLGHEKLTQARNQLLAEAAKHPDMLTSVRPNGLEDTPQFKIDIDQEKAQALGVSINDINTTLGAAWGGSYVNDFIDRGRVKKVYVMSEAKYRMLPDDIGDWYVRAADGQMVPFSAFSSSRWEYGSPRLERYNGLPSMEILGQAAPGKSTGEAMELMEQLASKLPTGVGYDWTGMSYQERLSGNQA,0
1t9y,C,874,891,17,SLYAISLIVVFLCLAAL,0
1t9y,C,898,919,21,FSVMLVVPLGVIGALLAATFR,0
1t9y,C,920,926,6,LTNDVY,0
1t9y,C,927,943,16,QVGLLTTIGLSAKNAI,0
1t9y,C,975,993,18,LMTSLAFILGVMPLVIST,0
1t9y,C,994,1000,6,AGSGAQ,0
1t9y,C,1001,1021,20,AVGTGVMGGMVTATVLAIFF,0
1t9y,C,1026,1032,6,VVVRRR,0
1t9y,C,1037,1049,12,EDIEHSHTVDHH,0
2xfq,A,1,2,1,S,0
2xfq,A,3,108,105,KCDVVVVGGGISGMAAAKLLHDSGLNVVVLEARDRVGGRTYTLRNQKVKYVDLGGSYVGPTQNRILRLAKELGLETYKVNEVERLIHHVKGKSYPFRGPFPPVWN,0
2xfq,A,109,126,17,ITYLDHNNFWRTMDDMG,0
2xfq,A,127,485,358,EIPSDAPWKAPLAEEWDNMTMKELLDKLCWTESAKQLATLFVNLCVTAETHEVSALWFLWYVKQCGGTTRIISTTNGGQERKFVGGSGQVSERIMDLLGDRVKLERPVIYIDQTRENVLVETLNHEMYEAKYVISAIPPTLGMKIHFNPPLPMMRNQMITRVPLGSVIKCIVYYKEPFWRKKDYCGTMIIDGEEAPVAYTLDDTKPEGNYAAIMGFILAHKARKLARLTKEERLKKLCELYAKVLGSLEALEPVHYEEKNWCEEQYSGGCYTTYFPPGILTQYGRVLRQPVDRIYFAGTETATHWSGYMEGAVEAGERAAREILHAMGKIPEDEIWQSEPESVDVPAQPITTTFLERH,0
2xfq,A,486,498,12,PSVPGLLRLIGL,0
2xfq,A,502,520,18,SATALGFLAHKRGLLVRV,0
4l35,C,1,7,6,PAPEGE,0
4l35,C,8,30,22,IWLWLGTAGMFLGMLYFIARGW,0
4l35,C,40,60,20,YIATILITAIAFVNYLAMAL,0
4l35,C,61,77,16,FGLTIVEIAGEQRPIY,0
4l35,C,78,96,18,ARYSDWLFTTPLLLYDLG,0
4l35,C,106,126,20,SSLVSLDVLMIGTGLVATLS,0
4l35,C,127,137,10,GSGVLSAGAE,0
4l35,C,138,158,20,LVWWGISTAFLLVLLYFLFS,0
4l35,C,177,196,19,LRNLVTVVWLVYPVWWLVG,0
4l35,C,197,206,9,EGIGLVGIG,0
4l35,C,207,229,22,ETAGFMVIDLVAKVGFGIILLR,0
4l35,C,245,250,5,TATAD,0
2j8c,M,1,54,53,EYQNIFSQVQVRGPADLGMTEDVNLANRSGVGPFSTLLGWFGNAQLGPIYLGS,0
2j8c,M,55,72,17,GVLSLFSGLMWFFTIGI,0
2j8c,M,82,87,5,AVFLR,0
2j8c,M,117,134,17,ASFFMFVAVWSWWGRTY,0
2j8c,M,135,146,11,RAQALGMGKHT,0
2j8c,M,147,164,17,WAFLSAIWLWMVLGFIR,0
2j8c,M,179,192,13,FSHLDWTNNFSLV,0
2j8c,M,200,221,21,FHGLSIAFLYGSALLFAMHGA,0
2j8c,M,222,267,45,ILAVSRFGGERELEQIADRGTAAERAALFWRWTMGFNATMEGIHR,0
2j8c,M,268,286,18,AIWMAVLVTLTGGIGILL,0
2j8c,M,294,299,5,YVWGQ,0
2j8c,M,303,307,4,APLN,0
5d5b,A,29,31,2,EV,0
5d5b,A,32,57,25,VVGMGIVMSLIVLAIVFGNVLVITA,0
5d5b,A,70,95,25,FITSLACADLVMGLAVVPFGAAHIL,0
5d5b,A,96,104,8,KMWTFGNF,0
5d5b,A,105,130,25,CEFWTSIDVLCVTASIETLCVIAVD,0
5d5b,A,151,174,23,VIILMVWIVSGLTSFLPIQMHWY,0
5d5b,A,175,178,3,ATH,0
5d5b,A,179,186,7,EAINCYA,0
5d5b,A,187,195,8,ETCCDFFT,0
5d5b,A,196,221,25,QAYAIASSIVSFYVPLVIMVFVYSR,0
5d5b,A,274,298,24,LGIIMGTFTLCWLPFFIVNIVHVI,0
5d5b,A,299,305,6,DNLIRK,0
5d5b,A,306,327,21,VYILLNWIGYVNSGFNPLIYC,0
5d5b,A,330,339,9,DFRIAFQEL,0
5t1a,A,37,43,6,KQIGAQ,0
5t1a,A,44,68,24,LPPLYSLVFIFGFVGNMLVVLILI,0
5t1a,A,80,100,20,LLNLAISDLLFLITLPLWAH,0
5t1a,A,101,111,10,AANEWVFGNA,0
5t1a,A,112,136,24,CKLFTGLYHIGYFGGIFFIILLTI,0
5t1a,A,159,179,20,TSVITWLVAVFASVPGIIFT,0
5t1a,A,180,197,17,CQKEDSVYVCGPYFPRG,0
5t1a,A,198,222,24,NNFHTIMRNILGLVLPLLIMVICY,0
5t1a,A,245,270,25,FTIMIVYFLFWTPYNIVILLNTFQE,0
5t1a,A,271,286,15,FGLSNCESTSQLDQA,0
5t1a,A,287,308,21,QVTETLGMTHCCINPIIYAFV,0
5t1a,A,310,319,9,KFRRYLSVF,0
4il9,E,-3,4,7,SAAAQDM,0
4il9,E,5,194,189,SPPPPIADEPLTVNTGIYLIECYSLDDKAETFKVNAFLSLSWKDRRLAFDPVRSGVRVKTYEPEAIWIPEIRFVNVENARDADVVDISVSPDGTVQYLERFSARVLSPLDFRRYPFDSQTLHIYLIVRSVDTRNIVLAVDLEKVGKNDDVFLTGWDIESFTAVVKPANFALEDRLESKLDYQLRISRQY,0
4il9,E,195,217,22,SYIPNIILPMLFILFISWTAFW,0
4il9,E,223,244,21,NVTLVVSTLIAHIFFNILVET,0
4il9,E,245,251,6,LPKTPY,0
4il9,E,252,275,23,TYTGAIIFMIYLFYFVAVIEVTV,0
4il9,E,295,315,20,RIAFPVVFLLANIILAFLFF,0
2cfq,A,8,31,23,FWMFGLFFFFYFFIMGAYFPFFP,0
2cfq,A,32,43,11,WLHDINHISKS,0
2cfq,A,44,64,20,TGIIFAAISLFSLLFQPLFG,0
2cfq,A,75,91,16,LLWIITGMLVMFAPFF,0
2cfq,A,92,94,2,FI,0
2cfq,A,95,100,5,GPLLQ,0
2cfq,A,101,105,4,NILV,0
2cfq,A,106,129,23,SIVGGIYLGFCFNAGAPAVEAFI,0
2cfq,A,142,160,18,ARMFGCVGWALGASIVGI,0
2cfq,A,161,169,8,FTINNQFV,0
2cfq,A,170,188,18,WLGSGCALILAVLLFFAK,0
2cfq,A,210,216,6,KLALEL,0
2cfq,A,225,244,19,SLYVIGVSCTYDVFDQQFA,0
2cfq,A,245,259,14,FFTSFFATGEQGTR,0
2cfq,A,260,279,19,FGYVTTMGELLNASIMFFA,0
2cfq,A,280,286,6,LIINRI,0
2cfq,A,291,309,18,LLLAGTIMSVRIIGSSFA,0
2cfq,A,310,313,3,SAL,0
2cfq,A,314,333,19,VVILKTLHMFEVPFLLVGC,0
2cfq,A,352,373,21,CFCFFKQLAMIFMSVLAGNMY,0
2cfq,A,374,378,4,SIGF,0
2cfq,A,379,399,20,GAYLVLGLVALGFTLISVFT,0
4ryn,A,7,27,20,IIVFFLTYGLFYVSSVLFPI,0
4ryn,A,29,34,5,TWYDA,0
4ryn,A,35,41,6,EKPSWT,0
4ryn,A,42,66,24,PGMTIGMIWAVLFGLIALSVAIIY,0
4ryn,A,75,96,21,FWFLFLLNYIFNQAFSYFQFS,0
4ryn,A,97,100,3,KNL,0
4ryn,A,101,122,21,LATVDCLLVAITTLLLIMFSS,0
4ryn,A,127,148,21,SAWLLIPYFLWSAFATYLSWT,0
4ryn,A,149,153,4,YSIN,0
4wfh,B,28,31,3,STT,0
4wfh,B,32,51,19,LALLALVLLYLVSGALVFR,0
4wfh,B,117,133,16,SAFFFSGTIITTIGYG,0
4wfh,B,141,165,24,GRLFCIFYALVGIPLFGILLAGVG,0
4wfh,B,166,185,19,RLGSSLRHGIGHIEAIFLK,0
4wfh,B,186,199,13,HVPPELVRVLSAM,0
4wfh,B,200,220,20,FLLIGCLLFVLTPTFVFCYM,0
4wfh,B,225,237,12,LEAIYFVIVTLT,0
4wfh,B,255,274,19,AYQPLVWFWILLGLAYFAS,0
2xq9,E,0,6,6,QDMVSP,0
2xq9,E,198,215,17,NIILPMLFILFISWTAF,0
2xq9,E,216,222,6,STSYDA,0
2xq9,E,223,240,17,VTLVVSTLIAHIAFNIL,0
2xq9,E,255,273,18,AIIFMIYLFYFVAVIEVT,0
2xq9,E,274,294,20,QHYLKVESQPARAASITRAS,0
2xq9,E,295,312,17,IAFPVVFLLANIILAFL,0
5doq,C,771,784,13,PMVVVALSVVAAF,0
5doq,C,785,795,10,VGLKDVHVNE,0
5arh,W,10,20,10,TPVILGLPLV,0
5arh,W,81,95,14,TNLLGLLPHSFTPT,0
5arh,W,97,106,9,LSMNLGMAI,0
5arh,W,158,179,21,RLTANITAGHLLIHLIGGATL,0
5arh,W,180,184,4,LMSI,0
5arh,W,185,204,19,TTTALITFTILILLTILEF,0
5j4i,B,17,32,15,MVSGNIMGSGVFLLP,0
5j4i,B,33,41,8,NLASTGGI,0
5j4i,B,42,57,15,IYGWLVTIIGALGLS,0
5j4i,B,92,113,21,YWLACWIGNIAMVVIGVGYLS,0
5j4i,B,114,123,9,FFPILKDPL,0
5j4i,B,124,140,16,LTITCVVVLWIFVLLN,0
5j4i,B,148,171,23,RVQAVATVLALIPIVGIAVFGWF,0
5j4i,B,172,174,2,FR,0
5j4i,B,175,180,5,ETYMA,0
5j4i,B,181,190,9,WNVSGLGTF,0
5j4i,B,191,209,18,AIQSTLNVTLWSFIGVES,0
5j4i,B,229,246,17,GGVLIAAVCYVLSTTAI,0
5j4i,B,247,262,15,GMIPNAALRVSASPF,0
5j4i,B,263,269,6,DAARMA,0
5j4i,B,270,276,6,GDTAGA,0
5j4i,B,277,297,20,VSFCAAAGCLGSLGGWTLLA,0
5j4i,B,328,342,14,IVGILMTIFQLSSI,0
5j4i,B,343,346,3,PNA,0
5j4i,B,347,366,19,KEFGLVSSVSVIFTLVPYL,0
5j4i,B,390,407,17,TTIAFLYCIWAVVGSGA,0
5j4i,B,409,423,14,VMWSFVTLMVITAM,0
4brb,C,-8,28,36,HHHHHHELANNTTGFTRIIKAAGYSWKGLRAAWINE,0
4brb,C,34,48,14,GVAVLLCVVIAAWL,0
4brb,C,49,52,3,VDA,0
4brb,C,53,68,15,TRVLLISSVMLVMIV,0
4brb,C,102,117,15,IAIIDAVITWAILLW,0
4brb,C,118,121,3,HFG,0
2m3b,E,2,14,12,KVQYLTRSAIRR,0
2m3b,E,31,49,18,FINFCLILICLLLICIIV,0
2m3b,E,50,52,2,LL,0
2vrl,A,1,2,1,S,0
2vrl,A,3,108,105,KCDVVVVGGGISGMAAAKLLHDSGLNVVVLEARDRVGGRTYTLRNQKVKYVDLGGSYVGPTQNRILRLAKELGLETYKVNEVERLIHHVKGKSYPFRGPFPPVWN,0
2vrl,A,109,126,17,ITYLDHNNFWRTMDDMG,0
2vrl,A,127,485,358,EIPSDAPWKAPLAEEWDNMTMKELLDKLCWTESAKQLATLFVNLCVTAETHEVSALWFLWYVKQCGGTTRIISTTNGGQERKFVGGSGQVSERIMDLLGDRVKLERPVIYIDQTRENVLVETLNHEMYEAKYVISAIPPTLGMKIHFNPPLPMMRNQMITRVPLGSVIKCIVYYKEPFWRKKDYCGTMIIDGEEAPVAYTLDDTKPEGNYAAIMGFILAHKARKLARLTKEERLKKLCELYAKVLGSLEALEPVHYEEKNWCEEQYSGGCYTTYFPPGILTQYGRVLRQPVDRIYFAGTETATHWSGYMEGAVEAGERAAREILHAMGKIPEDEIWQSEPESVDVPAQPITTTFLERH,0
2vrl,A,486,501,15,PSVPGLLRLIGLTTI,0
2vrl,A,502,520,18,SATALGFLAHKRGLLVRV,0
4nef,D,2,12,10,ELRSIAFSRA,0
4nef,D,13,30,17,FAEFLATLLFVFFGLGS,0
4nef,D,43,60,17,IAMAFGLGIGTLVQALG,0
4nef,D,61,63,2,IS,0
4nef,D,64,77,13,AHINPAVTVACLV,0
4nef,D,78,86,8,CHVSVLRA,0
4nef,D,87,104,17,FYVAAQLLGAVAGAALL,0
4nef,D,131,148,17,TVELFLTLQLVLCIFAS,0
4nef,D,149,159,10,DERRGENPGT,0
4nef,D,160,175,15,ALSIGFSVALGHLLG,0
4nef,D,182,191,9,MNPARSLAP,0
4nef,D,202,219,17,VFWIGPLVGAILGSLLY,0
4nef,D,220,233,13,YVLFPPAKSLSER,0
4nef,D,234,242,8,AVLKGLEP,0
2m20,B,61,64,3,IPS,0
2m20,B,65,89,24,ATGLVGALLLLLVVALGIGLFIRR,0
3kzi,Z,1,10,9,TILFQLALA,0
3kzi,Z,11,26,15,LVILSFVMVIGVPVA,0
3kzi,Z,37,53,16,QLIFLGSGLWIALVLV,0
3kzi,Z,54,62,8,GVLNFFVV,0
4pov,A,5,11,6,FNVRLL,0
4pov,A,12,31,19,EIAFMAALAFIISLIPNTV,0
4pov,A,36,49,13,VEIACIPILLLSL,0
4pov,A,50,53,3,RGL,0
4pov,A,54,73,19,AGLVGGLIWGILSMITGHA,0
4pov,A,79,96,17,QAFLEYLVAPVSLGIAG,0
4pov,A,97,110,13,FRQKTAPLKLAPV,0
4pov,A,111,130,19,LGTFVAVLLKYFFHFIAGI,0
4pov,A,148,169,21,AVNGISGILTAIAAFVILIIF,0
4pov,A,170,182,12,KKFPKLFIHSNY,0
3tx3,A,-2,4,6,YVMQKA,0
3tx3,A,5,35,30,YSNSGLAYIGRGLELIRTKGLRRYVVVPIL,0
3tx3,A,36,53,17,NLILFSLAFTWLYGEVD,0
3tx3,A,56,70,14,NRFMSWLPDFFQWL,0
3tx3,A,76,97,21,LAVITIIALFSFIFSTIMHLI,0
3tx3,A,98,129,31,APFNGLLAEKVERYESGESLGDEGFLGLFKD,0
3tx3,A,130,157,27,PRTLKREMQKLMYYIPRALGFFLLSLV,0
3tx3,A,159,185,26,VIGQVLWYIFVCWMMSIQYLDYPFDN,0
3tx3,A,186,246,60,KLSFPRMRSELHQQRSKTLGFGFGVTVLTMIPLINLIIMPLAVCGATSLWVDHYRRSALS,0
3f3a,B,1,4,3,EVK,0
3f3a,B,14,32,18,ILAMAGNAVGLGNFLRFP,0
3f3a,B,33,41,8,QAAENGGG,0
3f3a,B,42,63,21,FMIPYIIAFLLVGIPLMWIEW,0
3f3a,B,89,124,35,AKILGVFGLWIPLVVAIYYVYIESWTLGFAIKFLV,0
3f3a,B,125,131,6,LVPEPP,0
3f3a,B,132,134,2,,0
3f3a,B,135,166,31,DPDSILRPFKEFLYSYIGVPKGDEPILKPSL,0
3f3a,B,167,184,17,AYIVFLITMFINVSILI,0
3f3a,B,191,212,21,ERFAKIAMPTLFILAVFLVIR,0
3f3a,B,213,222,9,FLLETPNGT,0
3f3a,B,223,231,8,ADGLNFLW,0
3f3a,B,232,241,9,PDFEKLKDP,0
3f3a,B,242,265,23,VWIAAVGQIFFTLSLGFGAIITY,0
3f3a,B,278,297,19,GLTAATLNEKAEVILGGSI,0
3f3a,B,298,318,20,IPAAVAFFGVANAVAIAKAG,0
3f3a,B,319,324,5,FNLGF,0
3f3a,B,326,331,5,LPAIF,0
3f3a,B,332,339,7,QTAGGTF,0
3f3a,B,340,367,27,GFLWFFLLFFAGLTSSIAIMQPMIAFL,0
3f3a,B,378,396,18,VLWTAAIVFFSAHLVMFL,0
3f3a,B,397,399,2,KS,0
3f3a,B,400,426,26,DEMDFWAGTIGVVFFGLTELIIFFWI,0
3f3a,B,429,437,8,DKAWEEIN,0
3f3a,B,445,469,24,RIYYYVMRYITPAFLAVLLVVWAR,0
3f3a,B,470,471,1,Y,0
3f3a,B,472,477,5,PKIME,0
3f3a,B,478,483,5,THWTV,0
3f3a,B,484,502,18,ITRFYIIGLFLFLTFLVF,0
3f3a,B,605,608,3,VPR,0
2loq,A,-8,0,8,TSLYKKVG,0
2loq,A,2,37,35,KESGWDSGRAAVAAVVGGVVAVGTVLVALSAMGFT,0
2loq,A,39,48,9,GIAASSIAA,0
2loq,A,49,58,9,MMSTAAIAN,0
2loq,A,59,91,32,GGVAAGSLVAILQSVGAAGLSVTSKVIGGFAG,0
2iqs,A,50,73,23,FVTLGVISLLENILVIVAIAKNK,0
2iqs,A,74,78,4,LHSP,0
2iqs,A,79,99,20,YFFICSLAVADMLVSVSNGS,0
2iqs,A,125,149,24,DSVICSSLLASICSLLSIAVDRYF,0
2iqs,A,150,163,13,IFYALQYHNIMTV,0
2iqs,A,164,187,23,RVGIIISCIWAACTVSGILFIIY,0
2iqs,A,193,217,24,IICLITMFFTMLALMASLYVHMFL,0
2iqs,A,218,240,22,ARLHIKRIAVLPGTGAIRQGAN,0
2iqs,A,241,263,22,KGAITLTILIGVFVVCWAPFFL,0
2iqs,A,288,308,20,ILIMCNSIIDPLIYALRSQE,0
2iqs,A,309,317,8,RKTFKEII,0
2iqs,A,318,321,3,CYP,0
2b6v,A,1,10,9,INSTSTQPP,0
2b6v,A,11,21,10,ESCSQNLLIT,0
2b6v,A,22,45,23,QIIPVLYCMVFIAGILLNGVSGW,0
2b6v,A,60,83,23,KNIVIADFVMSLTFPFKILGDSG,0
2b6v,A,84,92,8,GPWQLNVF,0
2b6v,A,93,114,21,CRVSAVLFYVNMYVSIVFFGL,0
2b6v,A,140,161,21,LSVIVWMLMLLLAVPNIILTN,0
2b6v,A,162,181,19,SVREVTQIKCIELKSELGR,0
2b6v,A,182,204,22,WHKASNYIFVAIFWIVFLLLIV,0
2b6v,A,238,259,21,VFVFFVCFVPYHIARIPYTKS,0
2b6v,A,260,275,15,TEAHYSCQSKEILRY,0
2b6v,A,276,295,19,KEFTLLLSAANVCLDPIIY,0
2b6v,A,300,308,8,PFREILCK,0
2b6v,A,310,338,28,HIPLKAQNDLDISRIKRGNTTLESTDTL,0
3zum,M,55,72,17,GVLSLFSGLMWFFTIGI,0
3zum,M,73,81,8,FWYQAGWN,0
3zum,M,82,87,5,AVFLR,0
3zum,M,88,117,29,LFFFSLEPPAPEYGLSFAAPLKEGGLWLI,0
3zum,M,118,133,15,SFFMFVAVWSWWGRT,0
3zum,M,147,163,16,WAFLSAIWLWMVLGFI,0
3zum,M,164,178,14,PILMGSWSEAVPYG,0
3zum,M,179,192,13,FSHLDWTNNFSLV,0
3zum,M,193,200,7,GNLFYNP,0
3zum,M,201,221,20,HGLSIAFLYGSALLFAMHGA,0
3zum,M,269,285,16,IWMAVLVTLTGGIGIL,0
3zum,M,286,301,15,SGTVVDNWYVWGQNH,0
3zum,M,302,307,5,MAPLN,0
5wzy,C,36,38,2,FT,0
5wzy,C,39,55,16,ALVIAYVIGYVCVYNK,0
5wzy,C,331,352,21,KFNIIPTLLNIGAGLALLGLV,0
5wzy,C,353,359,6,VICDWI,0
4zud,A,1002,29,-973,LEDNWETLNDNLKVIEKADNAAQVKDALTKMRAAALDAQKATPPKLEDKSPDSPEMKDFRHGFDILVGQIDDALKLANEGKVKEAQAAAEQLKTTRNAYIQKYLILNSSDCPKAGRHNYIFV,0
4zud,A,30,55,25,IPTLYSIIFVVGIFGNSLVVIVIYF,0
4zud,A,63,86,23,SVFLLNLALADLCFLLTLPLWAV,0
4zud,A,87,102,15,TAMEYRWPFGNYLCK,0
4zud,A,103,127,24,ASASVSFNLYASVFLLTCLSIDRY,0
4zud,A,143,164,21,VAKVTCIIIWLLAGLASLPAI,0
4zud,A,165,185,20,HRNVFFIENTNITVCAFHYE,0
4zud,A,189,194,5,TLPIG,0
4zud,A,195,217,22,GLTKNILGFLFPFLIILTSYTL,0
4zud,A,239,262,23,KIIMAIVLFFFFSWIPHQIFTFL,0
4zud,A,263,283,20,VLIQLGIIRDCRIADIVDTA,0
4zud,A,284,304,20,PITICIAYFNNCLNPLFYGF,0
5e1j,B,1,31,30,EDPLIGRDSLGGGGTDRVRRSEAITHGTPF,0
5e1j,B,54,61,7,SSFGESA,0
5e1j,B,78,94,16,FALLFLNFFEQPLWCE,0
5e1j,B,95,113,18,NPKPSCKDRDYYYLGELP,0
5e1j,B,114,134,20,LTNAESIIYEVITLAILLVH,0
5e1j,B,156,173,17,VACVVILFVDVLVDFLY,0
5e1j,B,174,183,9,SPLAFDFLP,0
5e1j,B,185,199,14,IAPYVRVIIFILSI,0
5e1j,B,214,237,23,TYLNILALWMLFLLFASWIAFVM,0
5e1j,B,238,254,16,EDTQQGLTVFTSYGAT,0
5e1j,B,255,268,13,YQMFILFTTSNNP,0
5e1j,B,269,280,11,VWIPAYKSSRW,0
5e1j,B,281,304,23,SVFFVLYVLIGVYFVTNLILAVV,0
5e1j,B,403,414,11,VPSLFEHFPQI,0
5e1j,B,437,454,17,FILIINFIAVVVETTLD,0
5e1j,B,455,460,5,EESSA,0
5e1j,B,461,479,18,KPWQVAEFVFGWIYVLEM,0
5e1j,B,500,518,18,FLVTWVIVIGETATFITP,0
5e1j,B,519,523,4,ENTF,0
5e1j,B,525,542,17,NGEWIRYLLLARMLRLI,0
5e1j,B,566,586,20,PYLGTIFCVLCIYCSIGVQV,0
5e1j,B,587,590,3,GGL,0
5e1j,B,591,594,3,NAG,0
5e1j,B,595,616,21,KKLFETELAEDDYLLFNFNDY,0
5e1j,B,617,633,16,NGMVTLFNLLVMGNWQ,0
5e1j,B,634,647,13,WMESYKDLTGTWW,0
5e1j,B,648,669,21,ITYFVSFYVITILLLLNLVVA,0
5e1j,B,687,741,54,QGQDSQEKRNRRRSAGSKSRSQRVDTLLHHMLGDELSKPECSTSDTSTAGLVPR,0
5eh4,B,74,96,22,LIIFGVIAGVIGTILLISYGIR,0
1y36,A,1,38,37,TEVLWPAVPNGTDAAFLAGPGSSWGNSTVASTAAVSS,0
1y36,A,39,53,14,FKCALTKTGFQFYY,0
1y36,A,54,77,23,PAVYILVFIIGFLGNSVAIWMFV,0
1y36,A,87,109,22,VYMFNLALADFLYVLTLPALIF,0
1y36,A,110,125,15,YFNKTDWIFGDAMCK,0
1y36,A,126,147,21,QRFIFHVNLYGSILFLTCISA,0
1y36,A,169,193,24,CISVLVWLIVVVAISPILFYSGTG,0
1y36,A,194,215,21,RKNKTITCYDTTSDEYLRSYF,0
1y36,A,216,238,22,YSMCTTVAMFCVPLVLILGCYG,0
1y36,A,261,282,21,VIIVLTVFAVSYIPFHVMKTM,0
1y36,A,283,306,23,LRARLDFQTPAMCAFNDRVYATY,0
1y36,A,307,327,20,VTRGLASLNSCVDPILYFLA,0
1y36,A,329,339,10,TFRRRLSRAT,0
1y36,A,342,373,31,SRRSEANLQSKSEDMTLNILPEFKQNGDTSL,0
1n3m,C,1,38,37,NGTEGPNFYVPFSNKTGVVRSPFEAPQYYLAEPWQFS,0
1n3m,C,39,63,24,LAAYMFLLIMLGFPINFLTLYVTV,0
1n3m,C,72,99,27,NYILLNLAVADLFMVFGGFTTTLYTSL,0
1n3m,C,100,108,8,GYFVFGPT,0
1n3m,C,109,137,28,CNLEGFFATLGGEIALWSLVVLAIERYV,0
1n3m,C,152,176,24,AIMGVAFTWVMALACAAPPLVGWS,0
1n3m,C,177,202,25,YIPEGMQCSCGIDYYTPHEETNNES,0
1n3m,C,203,228,25,VIYMFVVHFIIPLIVIFFCYGQLVF,0
1n3m,C,251,274,23,RMVIIMVIAFLICWLPYAGVAFY,0
1n3m,C,275,288,13,FTHQGSDFGPIFM,0
1n3m,C,289,310,21,IPAFFAKTSAVYNPVIYIMMN,0
1n3m,C,311,321,10,QFRNCMVTTL,0
5uni,D,7,20,13,YFVVAILFIVGLK,0
5uni,D,21,31,10,MAHPTTAKSG,0
5uni,D,32,45,13,VWAGWGMVLAVLA,0
5uni,D,60,73,13,ALLLGSVVAWWAA,0
5uni,D,74,84,10,RVAMTDMPQM,0
5uni,D,85,100,15,AIYNGMGGGAAATIA,0
5uni,D,118,137,19,ILGGLIGSVAFTGSLIAFA,0
5uni,D,138,152,14,LQGIMKSRPILFPG,0
5uni,D,153,169,16,KAVNALVLALTVVIGL,0
5uni,D,183,196,13,FLLALLFGVLMTL,0
5uni,D,197,209,12,IGGGDMPVAISF,0
5uni,D,210,223,13,NAFTGMAVGFEGF,0
5uni,D,228,242,14,ALMVAGTLVGAAGT,0
5uni,D,243,261,18,LTVLMARAMNRSVWISVL,0
3qjs,C,2,4,2,EK,0
3qjs,C,5,25,20,KGALAVILVLTLTILVFWLG,0
5bn2,D,48,66,18,SGEFVGTFLFLWSAFVIA,0
5bn2,D,67,86,19,IANQAPETPDGGSNPAQLI,0
5bn2,D,87,104,17,ISFGFGFGVMVGVFITY,0
5bn2,D,108,121,13,GNLNPAVTLALVL,0
5bn2,D,131,148,17,LMAFTQIVAGMAAAGAA,0
5bn2,D,149,169,20,AMTPGEIAFANALGGGASRT,0
5bn2,D,170,189,19,GLFLEAFGTAILCLTVLML,0
5bn2,D,200,216,16,PFVIGIALLIAHLICI,0
5bn2,D,217,221,4,YTGA,0
5bn2,D,222,234,12,LNPARSFGPAVA,0
5bn2,D,235,242,7,RSFPNYH,0
5bn2,D,243,260,17,IYWLGPILGAFLAYSIW,0
5ul7,B,18,21,3,HRN,0
5ul7,B,22,35,13,LIVLADVALFLAL,0
5ul7,B,51,64,13,LAFIAVLWLTEAL,0
5ul7,B,66,76,10,TVTAILVPVM,0
5ul7,B,92,107,15,ANSIIFLFLGGFALA,0
5ul7,B,108,190,82,AMHHQGLDKVIADKVLAMAQGKMSVAVFMLFGVTALLSMWISNTATAAMMLPLVLGVLSKVDADKQRSTYVFVLLGVAYSAS,0
5ul7,B,191,209,18,GGIATLVGSPPNAIAAAE,0
5ul7,B,213,231,18,FTDWMKFGLPTAMMMLPM,0
5ul7,B,232,266,34,IAILYFLLKPTLNGMFELDRAPVNWDKGKVVTLG,0
5ul7,B,267,278,11,FGLTVFLWIFS,0
5ul7,B,292,306,14,TLVALGAILMLSFA,0
5ul7,B,307,310,3,VVH,0
5ul7,B,311,317,6,KEIQKT,0
5ul7,B,319,332,13,WGVLLLFGGGLCL,0
5ul7,B,341,349,8,SVFLANAL,0
5ul7,B,363,376,13,VVATFVVFLTEFA,0
5ul7,B,378,388,10,TASAALLIPV,0
5ul7,B,404,414,10,VLIAVAASCA,0
5ul7,B,415,443,28,MLPVATPPNAIVFASGHIKQSEMMRVGL,0
5ul7,B,444,460,16,LNIACIGLLTAIAMLF,0
1nd8,A,33,55,22,PPLYSLVFIFGFVGNMLVILIL,0
1nd8,A,56,68,12,NCKRLKSMTDIY,0
1nd8,A,69,90,21,LNLAISDLFFLLTVPFWAHYA,0
1nd8,A,104,125,21,TGLYFIGFFSGIFFIILLTID,0
1nd8,A,126,149,23,YLAVVHAVFALKARTVTFGVVTS,0
1nd8,A,150,168,18,ITWVVAVFASLPGIIFTR,0
1nd8,A,193,218,25,QTLKIVILGLVLPLLVMVICYSGIL,0
1nd8,A,219,239,20,TLLRCRNEKKRHRAVRLIFT,0
1nd8,A,240,263,23,MIVYFLFWAPYNIVLLLNTFQEF,0
1nd8,A,277,300,23,AMQVTETLGMTHCCINPIIYAFV,0
1nd8,A,301,352,51,EKFRNYLLVFFQKHIAKRFCKCCSIFQQEAPERASSVYTRSTGEQEISVGL,0
5wtr,C,5,25,20,ELLNIIGIIAFTISGSLKGT,0
5wtr,C,26,29,3,KGL,0
5wtr,C,30,52,22,IFGVVTLGVITSYAGGIIADIL,0
5wtr,C,59,80,21,ILKELNYLLLSVGISIFVFYF,0
5wtr,C,81,91,10,KWLQTNPIKM,0
5wtr,C,92,110,18,IAISDAVGLSTFATLGAS,0
5wtr,C,120,143,23,SVGLIAAIVGTGGGVIRDVLVNE,0
5wtr,C,145,167,22,MVLTKEIYATAALLSGFIYYFT,0
5wtr,C,175,193,18,LFVAFLGSFLLRILSIKY,0
5wtr,C,194,196,2,FN,0
3sph,D,36,40,4,ARRK,0
3sph,D,62,68,6,PQRYIA,0
3sph,D,70,76,6,FTTCVD,0
3sph,D,78,104,26,WRYMLLLFSLAFLVSWLLFGLIFWLI,0
3sph,D,105,130,25,LIHGDLENPGGDDTFKPCVLQVNGF,0
3sph,D,131,147,16,AAFLFSIETQTTIGYG,0
3sph,D,148,155,7,RCVTEEC,0
3sph,D,156,184,28,LAVFMVVVQSIVGCIIDSFMIGAIMAKM,0
3sph,D,187,192,5,KKRAQ,0
3sph,D,373,378,5,EVLFQ,0
3vmq,A,7,40,33,GSSHHHHHHSSGLVPRGSHMQPVGKPPKKKKSK,0
3vmq,A,45,59,14,ILLTILIIIALFIG,0
3vmq,A,60,111,51,MYFLSTRDNVDELRKIENKSSFVSADNMPEYVKGAFISMEDERFYNHHGFD,0
3vmq,A,112,117,5,KGTTR,0
3vmq,A,118,122,4,LFST,0
3vmq,A,123,128,5,SDRDV,0
3vmq,A,129,269,140,GGSTITQQVVKNYFYDNDRSFTRKVKELFVAHRVEKQYNKNEILSFYLNNIYFGDNQYTLEGAANHYFGTTVNKNSTTMSHITVLQSAILASKVNAPSVYNINNMSENFTQRVSTNLEKMKQQNYINETQYQQAMSQLNR,0
3aoc,C,11,27,16,AWVIAIIIMLAGGLAI,0
3aoc,C,28,341,313,KLPVAQYPTIAPPAVTISASYPGADAKTVQDTVTQVIEQNMNGIDNLMYMSSNSDSTGTVQITLTFESGTDADIAQVQVQNKLQLAMPLLPQEVQQQGVSVEKSSSSFLMVVGVINTDGTMTQEDISDYVAANMKDAISRTSGVGDVQLFGSQYAMRIWMNPNELNKFQLTPVDVITAIKAQNAQVAAGQLGGTPPVKGQQLNASIIAQTRLTSTEEFGKILLKVNQDGSRVLLRDVAKIELGGENYDIIAEFNGQPASGLGIKLATGANALDTAAAIRAELAKMEPFFPSGLKIVYPYDTTPFVKISIHEVV,0
3aoc,C,342,357,15,TLVEAIILVFLVMYL,0
3aoc,C,366,386,20,IPTIAVPVVLLGTFAVLAAF,0
3aoc,C,387,395,8,FSINTLTM,0
3aoc,C,396,411,15,GMVLAIGLLVDDAIV,0
3aoc,C,430,436,6,TRKSMG,0
3aoc,C,443,458,15,GIAMVLSAVFVPMAF,0
3aoc,C,459,470,11,GGSTGAIYRQF,0
3aoc,C,471,489,18,ITIVSAMALSVLVALILT,0
3aoc,C,499,512,13,IAKGDHGEGKKGF,0
3aoc,C,518,527,9,MFEKSTHHY,0
3aoc,C,541,557,16,LVLYLIIVVGMAYLFV,0
3aoc,C,558,873,315,LPSSFLPDEDQGVFMTMVQLPAGATQERTQKVLNEVTHYYLTKEKNNVESVFAVNGFGFAGRGQNTGIAFVSLKDWADRPGEENKVEAITMRATRAFSQIKDAMVFAFNLPAIVELGTATGFDFELIDQAGLGHEKLTQARNQLLAEAAKHPDMLTSVRPNGLEDTPQFKIDIDQEKAQALGVSINDINTTLGAAWGGSYVNDFIDRGRVKKVYVMSEAKYRMLPDDIGDWYVRAADGQMVPFSAFSSSRWEYGSPRLERYNGLPSMEILGQAAPGKSTGEAMELMEQLASKLPTGVGYDWTGMSYQERLSGNQA,0
3aoc,C,874,891,17,SLYAISLIVVFLCLAAL,0
3aoc,C,899,919,20,SVMLVVPLGVIGALLAATFR,0
3aoc,C,920,927,7,LTNDVYF,0
3aoc,C,928,943,15,VGLLTTIGLSAKNAI,0
3aoc,C,976,991,15,MTSLAFILGVMPLVI,0
3aoc,C,992,1003,11,TGAGSGAQNAV,0
3aoc,C,1004,1019,15,TGVMGGMVTATVLAI,0
3aoc,C,1020,1030,10,FVPVFFVVVR,0
3aoc,C,1037,1053,16,EDIEHSHTVDHHHHHH,0
4al0,C,1,6,5,PAHSL,0
4al0,C,14,35,21,AFLLCSTLLVIKMYVVAIITG,0
4al0,C,36,46,10,VRLRKKAFAN,0
4al0,C,47,52,5,EDALR,0
4al0,C,53,68,15,GGPQYCRSDPDVERC,0
4al0,C,69,90,21,RAHRNDMETIYPFLFLGFVYS,0
4al0,C,98,119,21,AWMHFLVFLVGRVAHTVAYLG,0
4al0,C,120,124,4,LRAP,0
4al0,C,125,149,24,RSVTYTLAQLPCASMALQILWEAA,0
5nx2,A,29,141,112,VSLWETVQKWREYRRQCQRSLTEDPPPATDLFCNRTFDEYACWPDGEPGSFVNVSCPWYLPWASSVPQGHVYRFCTAEGLWLQKDNSSLPWRDLSECEESKRGERSSPEEQL,0
5nx2,A,142,168,26,FLYIIYTVGYALSFSALVIASAILLG,0
5nx2,A,176,199,23,NYIHLNLFASFILRALSVFIKDA,0
5nx2,A,200,228,28,LKWMYSEAAQAHQWRGLLSYQDSLSCRL,0
5nx2,A,229,253,24,FLFMQYCVAANYYWLLVEGVYLYT,0
5nx2,A,264,286,22,IFRLYVSIGWGVPLLFVVPWGI,0
5nx2,A,287,304,17,KYLYEDEACWARNSNMN,0
5nx2,A,305,329,24,WLIIRLPILFAIGVNFLIFVRVIA,0
5nx2,A,347,372,25,RLAKSTLTLIALLATVEVIFAFVMD,0
5nx2,A,373,378,5,HARGT,0
5nx2,A,379,406,27,RFIKLFTELSFTSFQGLMVAILYCFAN,0
5nx2,A,407,416,9,EVQLEFRKS,0
5wua,H,38,51,13,LLFITFPILFIGW,0
5wua,H,52,53,1,S,0
5wua,H,63,71,8,TWLHFPGH,0
5wua,H,72,86,14,LRWILTFILLFVLV,0
5wua,H,114,126,12,MAAITSVVYYHN,0
5wua,H,127,135,8,ETSNFPKL,0
5wua,H,136,148,12,IALLIYWTLAFI,0
5wua,H,173,188,15,LLVILYGMLLLVEVN,0
5wua,H,189,213,24,IRVRRYIFFKTPREVKPPEDLQDL,0
5wua,H,223,273,50,LLSKGTYWWMNAFIKTAHKKPIDLRAIGKLPIAMRALTNYQRLCVAFDAQ,0
5wua,H,285,303,18,AIWRALCHAFGRRLILSS,0
5wua,H,304,317,13,FRILADLLGFAGP,0
5wua,H,362,376,14,FLALLLQRTFLQAS,0
5wua,H,377,439,62,YVAIETGINLRGAIQTKIYNKIMHLSTSNLSMGEMTAGQICNLVAIDTNQLMWFFFLCPNLW,0
5wua,H,440,451,11,MPVQIIVGVIL,0
5wua,H,462,474,12,GAAVIILLAPVQ,0
5wua,H,475,542,67,FVATKLSQAQRSTLEHSNERLKQTNEMLRGMKLLKLYAWESIFCSRVEVTRRKEMTSLRAFAVYTSI,0
5wua,H,543,555,12,IFMNTAIPIAAV,0
5wua,H,580,594,14,SLFHILVTPLFLLS,0
5wua,H,595,621,26,VVRSTVKALVSVKKLSEFLSSAEIRE,0
5wua,H,673,743,70,ADNFCVQIIGGFFTWTPDGIPTLSNITIRIPRGQLTMIVGQVGCGKSSLLLATLGEMQKVSGAVFWNSNL,0
5wua,H,769,931,162,VAYASQKPWLLNATVEENITFESPFNKQRYKMVIEACSLQPDIDILPHGDQTQIGERGINLSGGQRQRISVARALYQQTNVVFLDDPFSALDVHLSDHLMQAGILELLRDDKRTVVLVTHKLQYLPHADWIIAMKDGTIQREGTLKDFQRSECQLFEHWKTL,0
5wua,H,998,1011,13,RACTKYLSSAGIL,0
5wua,H,1012,1027,15,LSLLVFSQLLKHMVL,0
5wua,H,1072,1085,13,SLGIVLCLVTSVT,0
5wua,H,1086,1141,55,EWTGLKVAKRLHRSLLNRIILAPMRFFETTPLGSILNRFSSDCNTIDQHIPSTLE,0
5wua,H,1142,1158,16,LSRSTLLCVSALTVIS,0
5wua,H,1165,1178,13,VALLPLAVVCYFI,0
5wua,H,1179,1249,70,KYFRVASRDLQQLDDTTQLPLLSHFAETVEGLTTIRAFRYEARFQQKLLEYTDSNNIASLFLTAANRWLE,0
5wua,H,1250,1263,13,RMEYIGACVVLIA,0
5wua,H,1287,1299,12,ALMVSNYLNWMV,0
5wua,H,1300,1322,22,NLADMEIQLGAVKRIHALLKTE,0
5wua,H,1344,1472,128,IQIQNLSVRYDSSLKPVLKHVNALISPGQKIGICGRTGSGKSSFSLAFFRMVDMFEGRIIIDGIDIAKLPLHTLRSRLSIILQDPVLFSGTIRFNLDPEKKCSDSTLWEALEIAQLKLVVKALPGGLD,0
5wua,H,1479,1581,102,ENFSQGQRQLFCLARAFVRKTSIFIMDEATASIDMATENILQKVVMTAFADRTVVTIAHRVHTILSADLVMVLKRGAILEFDKPETLLSQKDSVFASFVRAD,0
4o6m,B,-27,0,27,HHHHHHHHHHSSGVDLGTENLYFQSNA,0
4o6m,B,1,155,154,RLAYVKNHEIYGEKLLGLTLRERIEKTLQRAGFDVRFFDELSLEEAEDYLIILEPVLILERDLLLEGRKILVSDGFTVGYFFGGDFRTVFDGNLQSSIEKYLSLNNLESYEIWAIKLSNDNLKTAEKLLLSSLIKAKRTGLKPAYYDGWIAREI,0
4o6m,B,156,167,11,RKVSLRISRLL,0
4o6m,B,168,178,10,DTSVTPNQIT,0
4o6m,B,179,193,14,FSFFLSLVGSALFL,0
4o6m,B,200,214,14,LLAGVIIQLHSIID,0
4o6m,B,215,237,22,CDGEIARLKFMESKYGAWLDGV,0
4o6m,B,238,252,14,DRYSDFIIVFSITY,0
4o6m,B,263,277,14,IGFLAAFASLMIAY,0
4o6m,B,278,296,18,GDKFVAAYMRTYSPEGFA,0
4o6m,B,297,317,20,PITRDFRLLIIFACSVVNLP,0
4o6m,B,319,334,15,ALVIIALLGNFEALR,0
4o6m,B,335,341,6,IVALRS,0
4o6m,B,342,344,2,TN,0
2k1l,B,536,548,12,PPVSRGLTGGEI,0
2k1l,B,549,572,23,AVIFGLLLGAALLLGILVFRSRR,0
5prc,H,12,30,18,AQLVWYAQWLVIWTVVLL,0
5prc,H,31,257,226,LRREDRREGYPLVEPLGLVKLAPEDGQVYELPYPKTFVLPHGGTVTVPRRRPETRELKLAQTDGFEGAPLQPTGNPLVDAVGPASYAERAEVVDATVDGKAKIVPLRVATDFSIAEGDVDPRGLPVVAADGVEAGTVTDLWVDRSEHYFRYLELSVAGSARTALIPLGFCDVKKDKIVVTSILSEQFANVPRLQSRDQITLREEDKVSAYYAGGLLYATPERAESL,0
3t6d,M,1,46,45,DYQTIYTQIQARGPHITVSGEWGDNDRIGKPFYSYWLGKIGDAQI,0
3t6d,M,47,70,23,PIYLGASGIAAFAFGATAILIIG,0
3t6d,M,81,87,6,LQFFRQ,0
3t6d,M,116,135,19,GLFMTLSLGSWWIRVYSRA,0
3t6d,M,136,141,5,ALGLG,0
3t6d,M,142,162,20,HIAWNFAAAIFFVLCIGCIH,0
3t6d,M,177,190,13,WPHIDWLTAFSIR,0
3t6d,M,198,222,24,WHGFSIGFAYGCGLLFAAHGATIL,0
3t6d,M,223,231,8,VARFGGDR,0
3t6d,M,232,237,5,IEQIT,0
3t6d,M,238,262,24,RGTAVERAALFWRWTIGFNATIES,0
3t6d,M,263,284,21,HRWGWFFSLMVMVSASVGILL,0
3t6d,M,292,298,6,YLWCVK,0
5g2d,A,-1,16,17,SMKNIESLFDYSAGQFE,0
5g2d,A,17,39,22,IDHLLTMGVGVHFAALIFFLVV,0
5g2d,A,50,73,23,TALSCIVMVSAGLILNSQAVMWT,0
5g2d,A,74,90,16,AYAYVDGSYQLQDLTF,0
5g2d,A,91,114,23,NGYRYVNWMANIPCLLLQLLIVL,0
5g2d,A,120,143,23,LFSTATWLILAAWGMIITGYVGQ,0
5g2d,A,144,153,9,YEVDDIAQL,0
5g2d,A,154,177,23,IWGAVSTAFFVVMNWIVGTKIFK,0
5g2d,A,190,210,20,TKVFWLMMFAWTLYPIAYLV,0
5g2d,A,211,220,9,AFMNNADGV,0
5g2d,A,221,244,23,LRQLLFTIADISSKVIYGLMITY,0
1py6,C,1,4,3,AQI,0
1py6,C,5,9,4,GRPE,0
1py6,C,10,33,23,IWLALGTALMGLGTLYFLVKGMG,0
1py6,C,41,62,21,FYAITTLVPAIAFTMYLSMLL,0
1py6,C,63,79,16,YGLTMVPFGGEQNPIY,0
1py6,C,80,99,19,ARYADWLFTTPLLLLDLAL,0
1py6,C,106,127,21,TILALVGADGIMIGTGLVGAL,0
1py6,C,128,133,5,KVYSY,0
1py6,C,134,157,23,FVWWAISTAAMLYILYVLFFGFT,0
1py6,C,171,192,21,KVLRNVTVVLWSAYPVVWLIG,0
1py6,C,193,202,9,EGAGIVPLN,0
1py6,C,203,225,22,ETLLFMVLDVSAKVGFGLILLR,0
1py6,C,232,249,17,AEAPEPSAGDGAAATSD,0
3s38,C,2,4,2,EK,0
3s38,C,5,27,22,KGALAVILVLTLTILVFWLGVY,0
1kme,A,1,4,3,AQI,0
1kme,A,5,9,4,GRPE,0
1kme,A,10,33,23,IWLALGTALMGLGTLYFLVKGMG,0
1kme,A,41,66,25,FYAITTLVPAIAFTMYLSMLLGYGL,0
1kme,A,67,78,11,MVPFGGEQNPI,0
1kme,A,79,100,21,WARYADWLFTTPLLLLDLALL,0
1kme,A,104,127,23,QGTILALVGADGIMIGTGLVGAL,0
1kme,A,128,133,5,KVYSY,0
1kme,A,134,157,23,FVWWAISTAAMLYILYVLFFGFT,0
1kme,A,171,192,21,KVLRNVTVVLWSAYPVVWLIG,0
1kme,A,193,202,9,EGAGIVPLN,0
1kme,A,203,226,23,ETLLFMVLDVSAKVGFGLILLRS,0
3ayn,A,1,8,7,GRDLRDN,0
3ayn,A,9,35,26,TWWYNPSIVVHPHWREFDQVPDAVYY,0
3ayn,A,36,57,21,LGIFIGICGIIGCGGNGIVIY,0
3ayn,A,72,94,22,IINLAFSDFTFSLVNGFPLMTI,0
3ayn,A,95,109,14,CFLKKWIFGFAACK,0
3ayn,A,110,131,21,YGFIGGIFGFMSIMTMAMISI,0
3ayn,A,153,172,19,IMIIFVWLWSVLWAIGPIF,0
3ayn,A,173,199,26,WGAYTLEGVLCNCSFDYISRDSTTRS,0
3ayn,A,200,222,22,ILCMFILGFFGPILIIFFCYFN,0
3ayn,A,263,282,19,IVIVSQFLLSWSPYAVVAL,0
3ayn,A,283,297,14,AQFGPLEWVTPYAA,0
3ayn,A,298,317,19,LPVMFAKASAIHNPMIYSV,0
3ayn,A,320,329,9,KFREAISQT,0
3ayn,A,359,448,89,SDAAPSADAAQMKEMMAMMQKMQQQQAAYPPQGYAPPPQGYPPQGYPPQGYPPQGYPPQGYPPPPQGAPPQGAPPAAPPQGVDNQAYQA,0
1pxs,C,1,4,3,AQI,0
1pxs,C,5,9,4,GRPE,0
1pxs,C,10,33,23,IWLALGTALMGLGTLYFLVKGMG,0
1pxs,C,41,62,21,FYAITTLVPAIAFTAYLSMLL,0
1pxs,C,63,78,15,YGLTMVPFGGEQNPI,0
1pxs,C,79,100,21,WARYADWLFTTPLLLLDLALL,0
1pxs,C,106,127,21,TILALVGADGIMIGTGLVGAL,0
1pxs,C,128,133,5,KVYSY,0
1pxs,C,134,157,23,FVWWAISTAAMLYILYVLFFGFT,0
1pxs,C,171,192,21,KVLRNVTVVLWSAYPVVWLIG,0
1pxs,C,193,202,9,EGAGIVPLN,0
1pxs,C,203,226,23,ETLLFMVLDVSAKVGFGLILLRS,0
1pxs,C,232,249,17,AEAPEPSAGDGAAATSD,0
3m9i,A,11,31,20,AIFAEFFATLFYVFFGLGAS,0
3m9i,A,32,41,9,RWAPGPLHV,0
3m9i,A,42,60,18,QVALAFGLALATLVQAVG,0
3m9i,A,63,78,15,GAHVNPAVTFAFLVG,0
3m9i,A,84,107,23,RAICYVVAQLLGAVAGAAVLYSV,0
3m9i,A,108,127,19,PPAVRGNLALNTLHPGVSV,0
3m9i,A,128,149,21,QATIVEIFLTLQFVLCIFATY,0
3m9i,A,158,176,18,SVALAVGFSLTLGHLFGM,0
3m9i,A,177,179,2,YT,0
3m9i,A,180,194,14,AGMNPARSFAPAIL,0
3m9i,A,195,201,6,RNFTNH,0
3m9i,A,202,220,18,VYWVGPVIGAGLGSLLYD,0
1yq4,D,9,28,19,WTSERAVSALLLGLLPAAY,0
1yq4,D,29,34,5,YPGPA,0
1yq4,D,35,55,20,DYSLAAALTLHGHWGLGQVI,0
1yq4,D,67,87,20,ANTGLYVLSAITFTGLCYFN,0
1yq4,D,88,92,4,YDVG,0
1yq4,D,93,100,7,CKAVAML,0
1yq4,D,101,103,2,SI,0
4mm9,A,1,4,3,EVK,0
4mm9,A,5,13,8,EHWATRLG,0
4mm9,A,14,35,21,ILAMAGYAVDLGNFLRFPVQA,0
4mm9,A,41,63,22,AFMIPYIIAFLLVGIPLMWIEW,0
4mm9,A,64,88,24,MGRYGGAQGHGTTPAIFYLLWRNR,0
4mm9,A,89,124,35,AKILGVFGLWIPLVVASYYVYIESWTLGFAIKFLV,0
4mm9,A,132,134,2,,0
4mm9,A,167,185,18,AYIVFLITMFINVSILIR,0
4mm9,A,186,190,4,ISKG,0
4mm9,A,191,214,23,ERFAKIAMPTLFILAVFLVIRVF,0
4mm9,A,223,231,8,ADGLNFLW,0
4mm9,A,242,265,23,VWIAAVGQIFFSLGLGFGVLITF,0
4mm9,A,266,278,12,SYVRKDQDIVLS,0
4mm9,A,279,298,19,LTAATLNEKASVILGGSIS,0
4mm9,A,319,324,5,FNLGF,0
4mm9,A,326,331,5,LPAIF,0
4mm9,A,340,367,27,GFLWFFLLFFAGLTSSIAGMQGMIAFL,0
4mm9,A,368,376,8,DELKLSRK,0
4mm9,A,377,396,19,AVLWTAAIVFFSAHLVMFL,0
4mm9,A,400,426,26,DEMDFWATGIGVVFFGLTELIIFFWI,0
4mm9,A,427,428,1,G,0
4mm9,A,429,437,8,DKAWEEIN,0
4mm9,A,438,447,9,GGIIKVPRI,0
4mm9,A,448,472,24,YYVMRYITPAFLAVLLVVWAREYI,0
4mm9,A,475,479,4,MEET,0
4mm9,A,484,502,18,ITRFYIIGLFLFLTFLVF,0
4mm9,A,503,511,8,AERRRNHE,0
4mm9,A,512,519,7,AGTLVPR,0
3sfe,D,41,60,19,HWTGERVVSVLLLGLLPAA,0
3sfe,D,61,68,7,LNPCSAM,0
3sfe,D,69,89,20,YSLAAALTLHGHWGIGQVVT,0
3sfe,D,98,118,20,KAAKAGLLALSAFTFAGLCY,0
3sfe,D,119,125,6,NYHDVG,0
3sfe,D,126,134,8,CKAVAMLW,0
3sfe,D,135,136,1,L,0
3zot,A,94,110,16,PVTWVMMIACVVVFIA,0
3zot,A,111,115,4,QILG,0
3zot,A,116,123,7,QEVMLWL,0
3zot,A,124,135,11,WPFDPTLKFEF,0
3zot,A,136,145,9,RYFTHALMH,0
3zot,A,146,147,1,S,0
3zot,A,148,163,15,MHILFNLLWWWYLGG,0
3zot,A,172,187,15,KLIVITLISALLSGY,0
3zot,A,188,198,10,QQKFSGPWFG,0
3zot,A,199,214,15,LSGVVYALMGYVWLR,0
3zot,A,228,241,13,LIIFALIWIVAGW,0
3zot,A,242,247,5,DLFGM,0
3zot,A,248,249,1,M,0
3zot,A,250,251,1,N,0
3zot,A,252,267,15,AHIAGLAVGLAMAFV,0
2uxm,M,1,52,51,EYQNIFSQVQVRGPADLGMTEDVNLANRSGVGPFSTLLGWFGNAQLGPIYL,0
2uxm,M,53,71,18,SLGVLSLFSGLMWFFTIG,0
2uxm,M,82,87,5,AVFLR,0
2uxm,M,118,135,17,SFFMFVAVWSWWGRTYL,0
2uxm,M,136,144,8,AQALGMGK,0
2uxm,M,145,163,18,TAWAFLSAIWLWMVLGFI,0
2uxm,M,179,192,13,FSHLDWTNNFSLV,0
2uxm,M,201,221,20,HGLSIAFLYGSALLFAMHGA,0
2uxm,M,222,266,44,ILAVSRFGGERELEQIADRGTAAERAALFWRWTMGFNATMEGIH,0
2uxm,M,267,285,18,WAIWMAVLVTLTGGIGIL,0
2uxm,M,294,299,5,YVWGQ,0
2uxm,M,303,307,4,APLN,0
4d1b,A,1,10,9,NSTPIEEAR,0
4d1b,A,27,40,13,GPFSLAAIWFAMA,0
4d1b,A,41,68,27,QVAIFIAAGQMTSSFQVWQVIVAIAAG,0
4d1b,A,69,81,12,TIAVILLFFTQS,0
4d1b,A,104,122,18,IPITLKALLSLFWFGFQT,0
4d1b,A,123,144,21,LGALALDEITRLLTGFTNLPL,0
4d1b,A,145,160,15,IVIFGAIQVVTTFYG,0
4d1b,A,162,173,11,FIRWMNVFASP,0
4d1b,A,174,217,43,LLAMGVYMVYLMLDGADVSLGEVMSMGGENPGMPFSTAIMIFV,0
4d1b,A,218,235,17,GWIAVVVSIHDIVKECK,0
4d1b,A,247,261,14,ADARYATAQWLGMV,0
4d1b,A,262,308,46,ASIIFGFIGAASMVLVGEWNPVIAITEVVGGVSIPMAILFQVFVLL,0
4d1b,A,309,326,17,TWSTNPAANLLSPAYTL,0
4d1b,A,337,352,15,TGVIVSAVVGLLMMP,0
4d1b,A,353,365,12,QFAGVLNTFLNL,0
4d1b,A,366,379,13,ASALGPLAGIMIS,0
4d1b,A,412,425,13,AVYAVALAVSFLT,0
4d1b,A,426,428,2,DL,0
4d1b,A,429,442,13,FVTGLIAALLLHI,0
4d1b,A,467,495,28,PIGPVAPADESATANTKEQNGSENLYFQ,0
2ksy,A,6,27,21,LFWLGAIGMLVGTLAFAWAGR,0
2ksy,A,28,35,7,AGSGERR,0
2ksy,A,36,59,23,YVTLVGISGIAAVAYAVMALGVG,0
2ksy,A,69,89,20,VPRYIDWILTTPLIVYFLGL,0
2ksy,A,90,95,5,AGLDS,0
2ksy,A,96,117,21,EFGIVITLNTVVMLAGFAGAM,0
2ksy,A,124,145,21,ALFGMGAVAFIGLVYYLVGPM,0
2ksy,A,146,159,13,ESASQRSSGIKSL,0
2ksy,A,160,181,21,VRLRNLTVVLWAIYPFIWLLG,0
2ksy,A,192,214,22,DVALIVYLDLVTKVGFGFIALD,0
2ksy,A,215,247,32,AATLRAEHGESLAGVDTDTPAVADLEHHHHHH,0
5g36,C,20,29,9,AAVRENALL,0
5g36,C,30,49,19,SSLWVNVALAGIAILVFVY,0
5g36,C,66,82,16,LMIPLVSISSYLGLLS,0
5g36,C,83,105,22,LTVGMIEMPAGHALAGEMVRSQ,0
5g36,C,106,120,14,GRYLTWALSTPMIL,0
5g36,C,136,154,18,VIAADIGMCVTGLAAAMT,0
5g36,C,155,159,4,SALL,0
5g36,C,160,177,17,RWAFYAISCAFFVVVLS,0
5g36,C,203,221,18,VVLWLGYPIVWAVGVEGL,0
5g36,C,222,229,7,LVQSVGV,0
5g36,C,230,247,17,SWAYSVLDVFAKYVFAF,0
3m74,C,1,7,6,NITKPF,0
3m74,C,8,11,3,LPT,0
3m74,C,12,27,15,YFGIPLGLAALSLAW,0
3m74,C,41,61,20,DVLGIVASAVWILFILMYAY,0
3m74,C,62,66,4,LRYY,0
3m74,C,67,75,8,EEVRAEYH,0
3m74,C,76,81,5,PVRFS,0
3m74,C,82,97,15,IALIPITTMLVGDIL,0
3m74,C,105,125,20,EVLIWIGTIGQLLFSTLRVS,0
3m74,C,126,140,14,LWQGGVFEQKSTHP,0
3m74,C,141,154,13,FYLPAVAANFTSA,0
3m74,C,167,185,18,LFFGAGMIAWIIFEPVLL,0
3m74,C,186,200,14,HLRISSLEPQFRAT,0
3m74,C,201,215,14,GIVLAPAFVCVSAY,0
3m74,C,227,245,18,KILWGYGFLQLFFLLRLF,0
3m74,C,246,255,9,WIVEKGLNI,0
3m74,C,256,271,15,LWAFSLGLASMANSA,0
3m74,C,284,307,23,IFAFVFSNVMIGLLVLMTIYKLT,0
3m74,C,308,313,5,GQFFL,0
4zbm,E,26,45,19,LFVLTILTLISGTIFYSTV,0
4zbm,E,46,50,4,GLRP,0
4zbm,E,51,70,19,DALYFSVVTLTTVGETPTP,0
4zbm,E,71,73,2,TD,0
4zbm,E,74,95,21,GKIFTILYIFIGIGLVFGFIH,0
4zbm,E,102,110,8,LPSILSNL,0
1ixf,C,1,4,3,AQI,0
1ixf,C,5,9,4,GRPE,0
1ixf,C,10,29,19,IWLALGTALMGLGTLYFLV,0
1ixf,C,45,62,17,TTLVPAIAFTMYLSMLL,0
1ixf,C,63,78,15,YGLTMVPFGGEQNPI,0
1ixf,C,79,95,16,WARYADWLFTTPLLLL,0
1ixf,C,110,128,18,LVGADGIMIGTGLVGALT,0
1ixf,C,129,133,4,VYSY,0
1ixf,C,134,152,18,FVWWAISTAAMLYILYVL,0
1ixf,C,175,192,17,NVTVVLWSAYPVVWLIG,0
1ixf,C,193,202,9,EGAGIVPLN,0
1ixf,C,203,222,19,ETLLFMVLDVSAKVGFGLI,0
1ixf,C,232,248,16,AEAPEPSAGDGAAATS,0
3tlw,E,-3,4,7,SAAAQDM,0
3tlw,E,5,202,197,SPPPPIADEPLTVNTGIYLIESYSLDDCAETFKVNAFLSLSWKDRRLAFDPVRSGVRVKTYEPEAIWIPEIRFVNVENARDADVVDISVSPDGTVQYLERFSARVLSPLDFRRYPFDSQTLHIYLIVRSVDTRNIVLAVDLEKVGKNDDVFLTGWDIESFTAVVKPANFALEDRLESKLDYQLRISRQYFSYIPNII,0
3tlw,E,203,218,15,PMLFILFISWTAFWS,0
3tlw,E,222,239,17,ANVTLVVSTLIAHIAFN,0
3tlw,E,240,257,17,LVETCLPKTPYMTYTGA,0
3tlw,E,258,275,17,IFMIYLFYFVAVIEVTV,0
3tlw,E,292,310,18,RASRIAFPVVFLLANIIL,0
3tlw,E,311,315,4,FLFF,0
3tlw,E,316,317,1,F,0
4z7f,A,12,31,19,LMGVLIAVVVVFSRFFAYE,0
4z7f,A,32,35,3,TFL,0
4z7f,A,36,48,12,ISFTFIPESLIG,0
4z7f,A,54,72,18,WAGIGTAVADVVGMLLFP,0
4z7f,A,73,76,3,AGY,0
4z7f,A,77,92,15,PGFTLNAFLAGAIYG,0
4z7f,A,106,125,19,LATLLVTVLINIILTPLWL,0
4z7f,A,126,139,13,LMYGVNLANFAWW,0
4z7f,A,140,160,20,PRLIKTVIFFPIQVIATYYL,0
4m5c,A,1,5,4,HIPE,0
4m5c,A,6,10,4,YLSP,0
4m5c,A,11,28,17,TCAVMGAAMVPVLTVAA,0
4m5c,A,44,58,14,IGSAFAFTIMMFNV,0
4m5c,A,59,64,5,IPGGT,0
4m5c,A,65,76,11,AHAIGATLLAT,0
4m5c,A,81,101,20,AASISLTLALFIQALLFGDG,0
4m5c,A,103,125,22,LALGANSFNMAFIAPFVGYGIY,0
4m5c,A,137,158,21,SSAIGGYVGINAAALATAIEL,0
4m5c,A,159,186,27,LQPLLFHTANGTPLYFPYGLNVAIPAM,0
4m5c,A,187,206,19,FAHLTVAGIVEAVITGLVV,0
4m5c,A,215,217,2,HH,0
3m7b,C,1,4,3,NIT,0
3m7b,C,5,11,6,PFPLPT,0
3m7b,C,12,27,15,YFGIPLGLAALSLAW,0
3m7b,C,41,60,19,DVLGIVASAVWILFILMYA,0
3m7b,C,61,66,5,KLRYY,0
3m7b,C,67,75,8,EEVRAEYH,0
3m7b,C,76,81,5,PVRFS,0
3m7b,C,82,97,15,IALIPITTMLVGDIL,0
3m7b,C,105,125,20,EVLIWIGTIGQLLFSTLRVS,0
3m7b,C,126,140,14,LWQGGVFEQKSTHP,0
3m7b,C,141,154,13,FYLPAVAANFTSA,0
3m7b,C,166,182,16,YLFFGAGMIAWIIFEP,0
3m7b,C,183,200,17,LLQHLRISSLEPQFRAT,0
3m7b,C,201,215,14,GIVLAPAFVCVSAY,0
3m7b,C,227,245,18,KILWGYGFLQLFFLLRLF,0
3m7b,C,246,257,11,WIVEKGLNIGL,0
3m7b,C,258,271,13,AFSFGLASMANSA,0
3m7b,C,284,304,20,IFAFVFSNVMIGLLVLMTIY,0
3m7b,C,305,313,8,LTKGQFFL,0
1gu8,A,2,5,3,GLT,0
1gu8,A,6,26,20,LFWLGAIGMLVGTLAFAWAG,0
1gu8,A,36,56,20,YVTLVGISGIAAVAYVVMAL,0
1gu8,A,57,69,12,VGWVPVAERTVF,0
1gu8,A,70,91,21,PRYIDWILTTPLIVYFLGLLA,0
1gu8,A,96,115,19,EFGIVITLNTVVMLAGFAG,0
1gu8,A,116,125,9,MVPGIERYA,0
1gu8,A,126,146,20,FGMGAVAFLGLVYYLVGPMT,0
1gu8,A,160,179,19,VRLRNLTVILWAIYPFIWL,0
1gu8,A,180,193,13,GPPGVALLTPTVD,0
1gu8,A,194,214,20,ALIVYLDLVTKVGFGFIALD,0
1gu8,A,220,239,19,AEHGESLAGVDTDAPAVAD,0
2uwu,M,1,54,53,EYQNIFSQVQVRGPADLGMTEDVNLANRSGVGPFSTLLGWFGNAQLGPIYLGS,0
2uwu,M,55,72,17,GVLSLFSGLMWFFTIGI,0
2uwu,M,82,87,5,AVFLR,0
2uwu,M,117,133,16,ASFFMFVAVWSWWGRT,0
2uwu,M,134,146,12,LRAQALGMGKHT,0
2uwu,M,147,164,17,WAFLSAIWLWMVLGFIR,0
2uwu,M,179,192,13,FSHLDWTNNFSLV,0
2uwu,M,200,221,21,FHGLSIAFLYGSALLFAMHGA,0
2uwu,M,222,268,46,ILAVSRFGGERELEQIADRGTAAERAALFWRWTMGFNATMEGIHRW,0
2uwu,M,269,286,17,IWMAVLVTLTGGIGILL,0
2uwu,M,294,300,6,YVWGQN,0
2uwu,M,303,307,4,APLN,0
2wlj,D,-7,22,29,TGGMKPPARKPRILNSDGSSNITRLGLEK,0
2wlj,D,36,70,34,HYHDLLTVSWPVFITLITGLYLVTNALFALAYLA,0
2wlj,D,71,86,15,GDVIENARPGSFTDA,0
2wlj,D,87,99,12,FFSVQTMATIGY,0
2wlj,D,100,107,7,KLIPIGP,0
2wlj,D,108,135,27,ANTLVTLEALCGMLGLAVAASLIYARF,0
2wlj,D,300,301,1,H,0
2na9,A,430,439,9,KRSWDTESV,0
2na9,A,440,462,22,AMWVLALIVIFLTIAVLLALRF,0
4tnv,E,1,102,101,DSKILAHLFTSGYDFRVRPPTDNGGPVVVSVNMLLRTISKIDVVNMEYSAQLTLRESWIDKRLSYGVKGDGQPDFVILTVGHQIWMPDTFFPNEKQAYKHT,0
4tnv,E,103,105,2,DK,0
4tnv,E,106,216,110,NVLIRIHNDGTVLYSVRISLVLSCPMYLQYYPMDVQQCSIDLASYAYTTKDIEYLWKEHSPLQLKVGLSSSLPSFQLTNTSTTYCTSVTNTGIYSCLRTTIQLKREFSFY,0
4tnv,E,217,237,20,LQLYIPSCMLVIVSWVSFWF,0
4tnv,E,242,264,22,PARVTLGVTTLLTMTAQSAGIN,0
4tnv,E,265,275,10,QLPPVSYIKA,0
4tnv,E,276,299,23,DVWIGACMTFIFCALLEFALVNH,0
4tnv,E,315,339,24,DLISRALFPVLFFVFNILYWSRFG,0
4tnv,E,341,347,6,HHHHHH,0
2na8,A,437,459,22,SVLPMWVLALIVIFLTIAVLLA,0
2na8,A,460,473,13,RFCGIYGYRLRRK,0
2wlk,D,1,10,9,TGGMKPPAR,0
2wlk,D,35,41,6,DHYHDL,0
2wlk,D,48,71,23,FITLITGLYLVTNALFALAYLAC,0
2wlk,D,72,83,11,DVIENARPGSF,0
2wlk,D,84,100,16,DAFFFSVQTMATIGYG,0
2wlk,D,101,107,6,LIPIGP,0
2wlk,D,108,128,20,ANTLVTLEALCGMLGLAVAA,0
2wlk,D,135,136,1,T,0
2uwt,M,1,52,51,EYQNIFSQVQVRGPADLGMTEDVNLANRSGVGPFSTLLGWFGNAQLGPIYL,0
2uwt,M,53,71,18,SLGVLSLFSGLMWFFTIG,0
2uwt,M,82,87,5,AVFLR,0
2uwt,M,118,135,17,SFFMFVAVWSWWGRTYL,0
2uwt,M,136,144,8,AQALGMGK,0
2uwt,M,145,163,18,TAWAFLSAIWLWMVLGFI,0
2uwt,M,179,192,13,FSHLDWTNNFSLV,0
2uwt,M,201,221,20,HGLSIAFLYGSALLFAMHGA,0
2uwt,M,222,265,43,ILAVSRFGGERELEQIADRGTAAERAALFWRWTMGFNATMEGI,0
2uwt,M,266,283,17,RWAIWMAVLVTLTGGIG,0
2uwt,M,294,299,5,YVWGQ,0
2uwt,M,303,307,4,APLN,0
4tnw,E,1,216,215,DSKILAHLFTSGYDFRVRPPTDNGGPVVVSVNMLLRTISKIDVVNMEYSAQLTLRESWIDKRLSYGVKGDGQPDFVILTVGHQIWMPDTFFPNEKQAYKHTIDKPNVLIRIHNDGTVLYSVRISLVLSCPMYLQYYPMDVQQCSIDLASYAYTTKDIEYLWKEHSPLQLKVGLSSSLPSFQLTNTSTTYCTSVTNTGIYSCLRTTIQLKREFSFY,0
4tnw,E,217,237,20,LQLYIPSCMLVIVSWVSFWF,0
4tnw,E,242,264,22,PARVTLGVTTLLTMTAQSAGIN,0
4tnw,E,265,275,10,QLPPVSYIKA,0
4tnw,E,276,299,23,DVWIGACMTFIFCALLEFALVNH,0
4tnw,E,315,338,23,DLISRALFPVLFFVFNILYWSRF,0
4tnw,E,339,340,1,H,0
4tnw,E,341,347,6,HHHHHH,0
2n7i,A,204,214,10,SFTMNDTTVW,0
2n7i,A,215,237,22,SVAVLSAVICLIIVWAVALKGY,0
4atv,B,1,9,8,KHLHRFFS,0
4atv,B,14,31,17,GIILIIAAILAMIMANS,0
4atv,B,32,34,2,AT,0
4atv,B,35,42,7,GWYHDFL,0
4atv,B,43,59,16,TPVQLRVGSLEINKNM,0
4atv,B,60,77,17,LWINDALMAVFFLLVGL,0
4atv,B,99,116,17,AAIGGMIVPTLLYLAFN,0
4atv,B,117,123,6,ADPITR,0
4atv,B,124,140,16,GWAIPAATDIAFALGV,0
4atv,B,158,176,18,LAIIDDLGAIIIIALFYT,0
4atv,B,177,181,4,DLSM,0
4atv,B,182,199,17,SLGVAAVAIAVLAVLNL,0
4atv,B,206,222,16,VYILVGVVLWTAVLKS,0
4atv,B,224,237,13,HATLAGVIVGFFI,0
4atv,B,247,255,8,AKRLEHVL,0
4atv,B,256,276,20,PWVAYLILPLFAFANAGVSL,0
4atv,B,277,288,11,GVTLDGLTSIL,0
4atv,B,289,307,18,LGIIAGMLIGKPLGISLF,0
4atv,B,330,349,19,VGILCGIGFTMSIFIASLA,0
4atv,B,350,358,8,GSVDPELI,0
4atv,B,359,378,19,WAKLGILVGSISSAVIGYS,0
4atv,B,384,401,17,RPSVEFRVPGSENLYFQ,0
3m7c,C,1,5,4,NITK,0
3m7c,C,6,11,5,FPLPT,0
3m7c,C,12,27,15,YFGIPLGLAALSLAW,0
3m7c,C,41,60,19,DVLGIVASAVWILFILMYA,0
3m7c,C,61,66,5,KLRYY,0
3m7c,C,67,75,8,EEVRAEYH,0
3m7c,C,76,81,5,PVRFS,0
3m7c,C,82,97,15,IALIPITTMLVGDIL,0
3m7c,C,105,125,20,EVLIWIGTIGQLLFSTLRVS,0
3m7c,C,126,140,14,LWQGGVFEQKSTHP,0
3m7c,C,141,154,13,FYLPAVAANFTSA,0
3m7c,C,167,182,15,LFFGAGMIAWIIFEP,0
3m7c,C,183,200,17,LLQHLRISSLEPQFRAT,0
3m7c,C,201,215,14,GIVLAPAFVCVSAY,0
3m7c,C,227,245,18,KILWGYGFLQLFFLLRLF,0
3m7c,C,246,257,11,WIVEKGLNIGL,0
3m7c,C,258,271,13,AFSFGLASMANSA,0
3m7c,C,284,304,20,IFAFVFSNVMIGLLVLMTIY,0
3m7c,C,305,309,4,LTKG,0
3m7c,C,310,314,4,FFLK,0
4xyd,B,14,34,20,YGGSLFFILIFVGLSVHSHR,0
4xyd,B,35,150,115,IVTTSTDAATLTAEVEHGKHLWEIHGCVNCHSILGEGAYFAPELGNVMTRWGVEDDPDAAFEALKGWMDAMPTGIEGRRQMPNFGLNDEEYRALSDFLLWTNTIRNQDWPPNDAG,0
1bha,A,2,12,10,QITGRPEWIW,0
1bha,A,13,33,20,ALGTALMGLGTLYFLVKGMG,0
1bha,A,35,36,1,D,0
1bha,A,42,61,19,YAITTLVPAIAFTMYLSML,0
1bha,A,62,70,8,GYGLTMVP,0
2i1x,C,1,4,3,AQI,0
2i1x,C,5,10,5,GRPEW,0
2i1x,C,11,28,17,WLALGTALMGLGTLYFL,0
2i1x,C,47,62,15,LVPAIAFTMYLSMLL,0
2i1x,C,63,79,16,YGLTMVPFGGEQNPIY,0
2i1x,C,80,94,14,ARYADWLFTTPLLL,0
2i1x,C,112,127,15,GADGIMIGTGLVGAL,0
2i1x,C,128,133,5,KVYSY,0
2i1x,C,134,149,15,FVWWAISTAAMLYIL,0
2i1x,C,157,161,4,SKAE,0
2i1x,C,178,192,14,VVLWSAYPVVWLIG,0
2i1x,C,193,203,10,EGAGIVPLNI,0
2i1x,C,204,220,16,TLLFMVLDVSAKVGFG,0
2i1x,C,232,249,17,AEAPEPSAGDGAAATSD,0
4m5b,A,1,5,4,HIPE,0
4m5b,A,11,28,17,TCAVMGAAMVPVLTVAA,0
4m5b,A,29,46,17,KVNKSFDKKDVPAMAIG,0
4m5b,A,47,59,12,AFAFTIMMFNVP,0
4m5b,A,65,76,11,AHAIGATLLAT,0
4m5b,A,77,80,3,LGP,0
4m5b,A,81,101,20,AASISLTLALFIQALLFGDG,0
4m5b,A,103,128,25,LALGANSFNMAFIAPFVGYGIYRLM,0
4m5b,A,129,136,7,SLKLNKV,0
4m5b,A,137,157,20,SSAIGGYVGINAAALATAIE,0
4m5b,A,187,205,18,FAHLTVAGIVEAVITGLV,0
4m5b,A,206,214,8,YYLLEHHH,0
4m5b,A,215,217,2,HH,0
3dh4,B,58,73,15,SLIAANISAEQFIGM,0
3dh4,B,74,84,10,GSGYSIGLAI,0
3dh4,B,85,98,13,SYEWMSAITLIIV,0
3dh4,B,130,150,20,AVFWISLYIFVNLTSVLYLG,0
3dh4,B,151,166,15,LALETILGIPLMYSI,0
3dh4,B,167,178,11,GLALFALVYSI,0
3dh4,B,179,184,5,GGLSA,0
3dh4,B,186,201,15,WTDVIQVFFLVLGGF,0
3dh4,B,202,249,47,TTYMAVSFIGGTDGWFAGVSKMVDAAPGHFEMILDQSNPQYMNLPGI,0
3dh4,B,250,268,18,VLIGGLWVANLYYWGFNQ,0
3dh4,B,287,301,14,VFAAFLKLIVPFLV,0
3dh4,B,302,336,34,LPGIAAYVITSDPQLMASLGDIAATNLPSAANAD,0
3dh4,B,337,343,6,AYPWLT,0
3dh4,B,344,352,8,FLPVGVKG,0
3dh4,B,353,377,24,VFAALAAAIVSSLASMLNSTATIF,0
3dh4,B,400,414,14,TAAVVALIIACLIA,0
3dh4,B,415,424,9,MLGGIGQAF,0
3dh4,B,425,441,16,YIQEYTGLVSPGILAV,0
3dh4,B,459,472,13,VVASIPFALFLKF,0
3dh4,B,473,478,5,PLSMP,0
3dh4,B,479,494,15,MDQMLYTLLFTMVVI,0
3dh4,B,527,541,14,AYGIMIVLAVLYTL,0
3dh4,B,542,547,5,WVLYK,0
3dh4,B,548,559,11,GGSPGHHHHHH,0
3m75,C,1,7,6,NITKPF,0
3m75,C,8,9,1,L,0
3m75,C,10,27,17,TGYFGIPLGLAALSLAW,0
3m75,C,41,64,23,DVLGIVASAVWILFILMYAYKLR,0
3m75,C,65,66,1,Y,0
3m75,C,67,75,8,EEVRAEYH,0
3m75,C,76,80,4,PVRF,0
3m75,C,81,97,16,FIALIPITTMLVGDIL,0
3m75,C,105,126,21,EVLIWIGTIGQLLFSTLRVSE,0
3m75,C,127,139,12,WQGGVFEQKSTH,0
3m75,C,140,154,14,SFYLPAVAANFTSA,0
3m75,C,166,186,20,YLFFGAGMIAWIIFEPVLLQ,0
3m75,C,187,199,12,LRISSLEPQFRA,0
3m75,C,200,215,15,MGIVLAPAFVCVSAY,0
3m75,C,227,246,19,KILWGYGFLQLFFLLRLFP,0
3m75,C,247,253,6,IVEKGL,0
3m75,C,254,271,17,IGLWAFSVGLASMANSA,0
3m75,C,284,308,24,IFAFVFSNVMIGLLVLMTIYKLTK,0
3m75,C,309,313,4,QFFL,0
5lxg,A,121,129,8,RACFKSIF,0
5lxg,A,136,158,22,NIWTHLLGFVLFLFLGILTMLR,0
5lxg,A,159,169,10,NMYFMAPLQE,0
5lxg,A,170,192,22,VVFGMFFLGAVLCLSFSWLFHT,0
5lxg,A,204,228,24,SKLDYSGIALLIMGSFVPWLYYSF,0
5lxg,A,229,234,5,CSPQP,0
5lxg,A,235,259,24,LIYLSIVCVLGISAIIVAQWDRFA,0
5lxg,A,265,287,22,TRAGVFLGLGLSGVVPTMHFTI,0
5lxg,A,288,290,2,EG,0
5lxg,A,291,296,5,VKATT,0
5lxg,A,297,298,1,G,0
5lxg,A,299,322,23,MGWFFLMAVMYITGAGLYAARIP,0
5lxg,A,334,358,24,QSHQIFHVLVVAAAFVHFYGVSNL,0
5lxg,A,359,368,9,EFRYGLEGG,0
3jd8,A,268,283,15,YVIMWITYMAFLLVF,0
3jd8,A,284,288,4,GAFF,0
3jd8,A,330,358,28,FEGCLRRLFTRWGSFCVRNPGCVIFFSL,0
3jd8,A,359,372,13,FITACSSGLVFVR,0
3jd8,A,623,637,14,VVISYAIMFLYISL,0
3jd8,A,638,646,8,LGHMKSCR,0
3jd8,A,647,668,21,LLVDSKVSLGIAGILIVLSSV,0
3jd8,A,675,689,14,SYIGLPLTLIVIEV,0
3jd8,A,690,723,33,PFLVLAVGVDNIFILVQAYQRDERLQGETLDQQ,0
3jd8,A,724,737,13,GRVLGEVAPSMFL,0
3jd8,A,743,758,15,VAFFLGALSVMPAVH,0
3jd8,A,759,772,13,FSLFAGLAVFIDF,0
3jd8,A,805,829,24,DGTSVQASESCLFRFFKNSYSPLL,0
3jd8,A,830,831,1,K,0
3jd8,A,832,846,14,WMRPIVIAIFVGVL,0
3jd8,A,1100,1115,15,NLGVSLGAIFLVTMV,0
3jd8,A,1116,1123,7,LGCELWS,0
3jd8,A,1124,1141,17,VIMCATIAMVLVNMFGV,0
3jd8,A,1156,1169,13,LVMSCGISVEFCS,0
3jd8,A,1170,1198,28,ITRAFTVSMKGSRVERAEEALAHMGSSV,0
3jd8,A,1199,1215,16,SGITLTKFGGIVVLAF,0
3jd8,A,1227,1247,20,MYLAMVLLGATHGLIFLPVL,0
3jd8,A,1248,1251,3,SYI,0
3cll,D,-18,26,44,SHHHHHHSSGLVPRGSHMMSKEVSEEAQAHQHGKDYVDPPPAPF,0
3cll,D,41,58,17,IAEFIATLLFLYITVAT,0
3cll,D,59,75,16,IGHSKETVVCGSVGLL,0
3cll,D,76,93,17,IAWAFGGMIFVLVYCTA,0
3cll,D,97,110,13,GHINPAVTFGLFL,0
3cll,D,119,137,18,LVYMIAQCLGAICGVGLV,0
3cll,D,138,141,3,AFM,0
3cll,D,142,147,5,GPYNQ,0
3cll,D,148,162,14,GGGANSVALGYNKG,0
3cll,D,163,182,19,ALGAEIIGTFVLVYTVFSA,0
3cll,D,198,214,16,PLPIGFAVFMVHLATI,0
3cll,D,215,218,3,ITG,0
3cll,D,219,232,13,GINPARSFGAAVI,0
3cll,D,233,242,9,NSNKVWDDQ,0
3cll,D,243,260,17,IFWVGPFIGAAVAAAYH,0
3cll,D,268,281,13,IKALGSFRSNPTN,0
3tlv,E,-3,4,7,SAAAQDM,0
3tlv,E,5,198,193,SPPPPIADEPLTVNTGIYLIESYSLDDCAETFKVNAFLSLSWKDRRLAFDPVRSGVRVKTYEPEAIWIPEIRFVNVENARDADVVDISVSPDGTVQYLERFSARVLSPLDFRRYPFDSQTLHIYLIVRSVDTRNIVLAVDLEKVGKNDDVFLTGWDIESFTAVVKPANFALEDRLESKLDYQLRISRQYFSYI,0
3tlv,E,199,218,19,NIILPMLFILFISWTAFWS,0
3tlv,E,222,242,20,ANVTLVVSTLIAHIAFNILV,0
3tlv,E,243,255,12,TNCPKTPYMTYT,0
3tlv,E,256,275,19,AIIFMIYLFYFVAVIEVTV,0
3tlv,E,292,313,21,RASRIAFPVVFLLANIILAFL,0
3tlv,E,314,315,1,F,0
3tlv,E,316,317,1,F,0
2uxl,M,1,52,51,EYQNIFSQVQVRGPADLGMTEDVNLANRSGVGPFSTLLGWFGNAQLGPIYL,0
2uxl,M,53,71,18,SLGVLSLFSGLMWFFTIG,0
2uxl,M,82,87,5,AVFLR,0
2uxl,M,118,134,16,SFFMFVAVWSWWGRTY,0
2uxl,M,135,145,10,RAQALGMGKH,0
2uxl,M,146,163,17,AWAFLSAIWLWMVLGFI,0
2uxl,M,179,191,12,FSHLDWTNNFSL,0
2uxl,M,201,221,20,HGLSIAFLYGSALLFAMHGA,0
2uxl,M,222,267,45,ILAVSRFGGERELEQIADRGTAAERAALFWRWTMGFNATMEGIHR,0
2uxl,M,268,285,17,AIWMAVLVTLTGGIGIL,0
2uxl,M,294,300,6,YVWGQN,0
2uxl,M,303,307,4,APLN,0
5kpj,A,35,68,33,LTMFRYAGWLDRLYMLVGTLAAIIHGVALPLMM,0
5kpj,A,69,117,48,IFGDMTDSFASVGNVSKNSTNMSEADKRAMFAKLEEEMTTYAYYYTGI,0
5kpj,A,118,139,21,AGVLIVAYIQVSFWCLAAGRQ,0
5kpj,A,180,204,24,GIGDKIGMFFQAMATFFGGFIIGF,0
5kpj,A,205,210,5,RGWKL,0
5kpj,A,211,232,21,LVILAISPVLGLSAGIWAKIL,0
5kpj,A,289,311,22,TANISMGAAFLLIYASYALAFW,0
5kpj,A,312,330,18,GTSLVISKEYSIGQVLTV,0
5kpj,A,331,352,21,FSVLIGAFSVGQASPNIEAFA,0
5kpj,A,693,700,7,WRILKLN,0
5kpj,A,705,728,23,YFVVGIFCAIINGGLQPAFSVIF,0
5kpj,A,729,752,23,KVVGVFTNGGPPETQRQNSNLFS,0
5kpj,A,753,774,21,LFLILGIISFITFFLQGFTFG,0
5kpj,A,826,847,21,SRLAVIFQNIANLGTGIIISL,0
5kpj,A,848,854,6,YGWQLT,0
5kpj,A,855,879,24,LLLAIVPIIAIAGVVEMKMLSGQA,0
5kpj,A,925,950,25,NAMKKAHVFGITFSFTQAMMYFSYA,0
5kpj,A,951,972,21,CFRFGAYLVTQQLMTFENVLL,0
5kpj,A,973,992,19,FSAIVFGAMAVGQVSSFAP,0
2ks9,A,2,33,31,NVLPVDSDLSPNISTNTSEPNQFVQPAWQIV,0
2ks9,A,34,58,24,WAAAYTVIVVTSVVGNVVVMWIIL,0
2ks9,A,70,93,23,LVNLAFAEASMAAFNTVVNFTYA,0
2ks9,A,94,103,9,HNEWYYGLF,0
2ks9,A,104,127,23,CKFHNFFPIAAVFASIYSMTAVA,0
2ks9,A,149,174,25,VICVIWVLALLLAFPQGYYSTTETM,0
2ks9,A,175,191,16,SRVVCMIEWPEHPNKI,0
2ks9,A,192,217,25,EKVYHICVTVLIYFLPLLVIGYAYT,0
2ks9,A,250,274,24,IVVVCTFAICWLPFHIFFLLPYIN,0
2ks9,A,275,285,10,DLYLKKFIQQ,0
2ks9,A,286,308,22,YLAIMWLAMSSTMYNPIIYCCL,0
2ks9,A,310,320,10,RFRLGFKHAF,0
4d1c,A,1,10,9,NSTPIEEAR,0
4d1c,A,31,46,15,LAAIWFAMAIQVAIF,0
4d1c,A,47,62,15,AAGQMTSSFQVWQVI,0
4d1c,A,63,77,14,AIAAGCTIAVILLF,0
4d1c,A,106,130,24,ITLKALLSLFWFGFQTWLGALALD,0
4d1c,A,131,141,10,ITRLLTGFTN,0
4d1c,A,142,157,15,PLWIVIFGAIQVVTT,0
4d1c,A,164,180,16,RWMNVFASPVLLAMGV,0
4d1c,A,181,209,28,MVYLMLDGADVSLGEVMSMGGENPGMPF,0
4d1c,A,210,227,17,TAIMIFVGGWIAVVVSI,0
4d1c,A,254,268,14,AQWLGMVPASIIFG,0
4d1c,A,269,303,34,IGAASMVLVGEWNPVIAITEVVGGVSIPMAILFQ,0
4d1c,A,304,322,18,FVLLATWSTNPAANLLSP,0
4d1c,A,341,355,14,VSAVVGLLMMPWQF,0
4d1c,A,356,359,3,GVL,0
4d1c,A,360,375,15,TFLNLLASALGPLAG,0
4d1c,A,415,439,24,AVALAVSFLTPDLMFVTGLIAALL,0
4d1c,A,467,495,28,PIGPVAPADESATANTKEQNGSENLYFQ,0
1bgy,W,1,14,13,LTRFLGPRYRQLA,0
1bgy,W,15,21,6,NWVPTA,0
1bgy,W,22,36,14,LWGAVGAVGLVSAT,0
1bgy,W,37,56,19,SRLILDWVPYINGKFKKDD,0
3sfd,D,41,60,19,HWTGERVVSVLLLGLLPAA,0
3sfd,D,61,68,7,LNPCSAM,0
3sfd,D,69,88,19,YSLAAALTLHGHWGIGQVV,0
3sfd,D,100,118,18,AKAGLLALSAFTFAGLCY,0
3sfd,D,119,125,6,NYHDVG,0
3sfd,D,126,134,8,CKAVAMLW,0
3sfd,D,135,136,1,L,0
4mm8,B,1,4,3,EVK,0
4mm8,B,14,32,18,ILAMAGYAVDLGNFLRFP,0
4mm8,B,33,41,8,QAAENGGG,0
4mm8,B,42,63,21,FMIPYIIAFLLVGIPLMWIEW,0
4mm8,B,90,120,30,KILGVFGLWIPLVVASYYVYIESWTLGFAI,0
4mm8,B,121,131,10,FLVGLVPEPP,0
4mm8,B,132,134,2,,0
4mm8,B,135,166,31,DPDSILRPFKEFLYSYIGVPKGDEPILKPSL,0
4mm8,B,167,184,17,AYIVFLITMFINVSILI,0
4mm8,B,191,212,21,ERFAKIAMPTLFILAVFLVIR,0
4mm8,B,213,222,9,FLLETPNGT,0
4mm8,B,223,231,8,ADGLNFLW,0
4mm8,B,232,244,12,PDFEKLKDPGVW,0
4mm8,B,245,265,20,AAVGQIFFSLGLGFGVLITF,0
4mm8,B,278,297,19,GLTAATLNEKASVILGGSI,0
4mm8,B,298,318,20,IPAAVAFFGVANAVAIAKAG,0
4mm8,B,319,324,5,FNLGF,0
4mm8,B,326,331,5,LPAIF,0
4mm8,B,332,342,10,QTAGGTFLGF,0
4mm8,B,343,366,23,WFFLLFFAGLTSSIAGMQGMIAF,0
4mm8,B,378,394,16,VLWTAAIVFFSAHLVM,0
4mm8,B,395,399,4,LNKS,0
4mm8,B,400,425,25,DEMDFWATGIGVVFFGLTELIIFFW,0
4mm8,B,429,437,8,DKAWEEIN,0
4mm8,B,448,469,21,YYVMRYITPAFLAVLLVVWAR,0
4mm8,B,470,472,2,YI,0
4mm8,B,473,478,5,KIMEE,0
4mm8,B,479,484,5,HWTVW,0
4mm8,B,485,502,17,TRFYIIGLFLFLTFLVF,0
4mm8,B,512,519,7,AGTLVPR,0
3zmj,A,92,93,1,A,0
3zmj,A,94,113,19,PVTWVMMIACVVVFIAMQI,0
3zmj,A,116,123,7,QEVMLWL,0
3zmj,A,133,146,13,EFWRYFTHALMHF,0
3zmj,A,148,163,15,MHILFNLLWWWYLGG,0
3zmj,A,164,171,7,VEKRLGS,0
3zmj,A,172,191,19,KLIVITLISALLSGYVQQK,0
3zmj,A,198,213,15,GLSGVVYALMGYVWL,0
3zmj,A,214,227,13,GERDPQSGIYLQR,0
3zmj,A,228,244,16,LIIFALIWIVAGWFDL,0
3zmj,A,247,267,20,SMANGAHIAGLAVGLAMAFV,0
3zmj,A,268,270,2,SL,0
1pxr,C,1,5,4,AQIT,0
1pxr,C,6,9,3,RPE,0
1pxr,C,10,33,23,IWLALGTALMGLGTLYFLVKGMG,0
1pxr,C,41,62,21,FYAITTLVAAIAFTMYLSMLL,0
1pxr,C,63,78,15,YGLTMVPFGGEQNPI,0
1pxr,C,79,100,21,WARYADWLFTTPLLLLDLALL,0
1pxr,C,106,128,22,TILALVGADGIMIGTGLVGALT,0
1pxr,C,129,133,4,VYSY,0
1pxr,C,134,157,23,FVWWAISTAAMLYILYVLFFGFT,0
1pxr,C,171,195,24,KVLRNVTVVLWSAYPVVWLIGSEG,0
1pxr,C,196,202,6,GIVPLN,0
1pxr,C,203,226,23,ETLLFMVLDVSAKVGFGLILLRS,0
1pxr,C,232,249,17,AEAPEPSAGDGAAATSD,0
4c7r,C,30,55,25,ENPTNLEGKLADAAAAIILEGEDTQ,0
4c7r,C,56,63,7,SLNWSVI,0
4c7r,C,64,76,12,PALVIVLATVVW,0
4c7r,C,81,98,17,DSFTNFASSALSAVVDN,0
4c7r,C,99,112,13,GWAFILFGTVFVF,0
4c7r,C,113,145,32,IVVIAASKFGTIRLGRIDEAPEFRTVSWISMM,0
4c7r,C,146,158,12,AAGMGIGLMFYG,0
4c7r,C,183,197,14,TTMFHWTLHPWAIY,0
4c7r,C,198,240,42,IVGLAIAYSTFRVGRKQLLSSAFVPLIGEKGAEGWLGKLIDI,0
4c7r,C,241,258,17,AIIATVFGTACSLGLGA,0
4c7r,C,281,294,13,IVSVLTLAFIFSA,0
4c7r,C,295,297,2,SG,0
4c7r,C,298,304,6,GKGIQY,0
4c7r,C,305,322,17,SNANMVLAALLAIFVFV,0
4c7r,C,367,381,14,IFYWAWWISWSPFV,0
4c7r,C,382,402,20,MFLARISRGRSIREFILGVL,0
4c7r,C,403,416,13,VPAGVSTVWFSIF,0
4c7r,C,436,445,9,EEQLFGLLH,0
4c7r,C,456,473,17,AMILLGTFFITSADSAS,0
4c7r,C,474,492,18,VMGTMSQHGQLEANKWVT,0
4c7r,C,493,506,13,AWGVATAAIGLTL,0
4c7r,C,519,534,15,NVTIVAATPFLFVVI,0
4c7r,C,535,561,26,LMFALVKDLSNDVIYLEYREQQRFNA,0
4c7r,C,562,595,33,LARERRVHNEHRKRELAAKRRRERKASGAGKRR,0
3t4z,E,18,20,2,AK,0
3t4z,E,25,45,20,VLFVLTILTLISGTIFYSTV,0
3t4z,E,46,50,4,GLRP,0
3t4z,E,51,67,16,DALWFSVVTLTTVGYG,0
3t4z,E,68,74,6,FSPQTD,0
3t4z,E,75,99,24,GKIFTILYIFIGIGLVFGFIHKLA,0
3t4z,E,103,109,6,LPSILS,0
2ih1,F,1,21,20,APMLSGLLARLVKLLLGRHG,0
2ih1,F,22,25,3,ALH,0
2ih1,F,26,50,24,RAAGAATVLLVIVLLAGSYLAVLA,0
2ih1,F,63,79,16,RALWWACETATTVAYG,0
2ih1,F,87,111,24,GRLVAVVVMVAGITSFGLVTAALA,0
2ih1,F,112,122,10,WFVGREQERR,0
4ov0,C,7,9,2,PE,0
4ov0,C,10,32,22,IWLALGTALMGLGTLYFLVKGM,0
4ov0,C,42,62,20,YAITTLVPAIAFTMYLSMLL,0
4ov0,C,63,79,16,YGLTMVPFGGEQNPIY,0
4ov0,C,80,98,18,ARYADWLFTTPLLLLDLA,0
4ov0,C,107,127,20,ILALVGADGIMIGTGLVGAL,0
4ov0,C,128,133,5,KVYSY,0
4ov0,C,134,154,20,FVWWAISTAAMLYILYVLFF,0
4ov0,C,173,192,19,LRNVTVVLWSAYPVVWLIG,0
4ov0,C,193,202,9,EGAGIVPLN,0
4ov0,C,203,225,22,ETLLFMVLDVSAKVGFGLILLR,0
3t6e,M,1,49,48,DYQTIYTQIQARGPHITVSGEWGDNDRVGKPFYSYWLGKIGDAQIGPI,0
3t6e,M,50,70,20,LGASGIAAFAFGSTAILIIL,0
3t6e,M,81,87,6,LQFFRQ,0
3t6e,M,116,134,18,GLFMTLSLGSWWIRVYSR,0
3t6e,M,135,142,7,RALGLGT,0
3t6e,M,143,161,18,IAWNFAAAIFFVLCIGCI,0
3t6e,M,177,190,13,WPHIDWLTAFSIR,0
3t6e,M,199,219,20,HGFSIGFAYGCGLLFAAHGA,0
3t6e,M,220,263,43,ILAVARFGGDREIEQITDRGTAVERAALFWRWTIGFNATIESV,0
3t6e,M,264,283,19,RWGWFFSLMVMVSASVGIL,0
3t6e,M,292,298,6,YLWCVK,0
3s39,C,2,9,7,EKPKGAL,0
3s39,C,10,23,13,VILVLTLTILVFW,0
2ein,Z,14,35,21,QAIGLSVTFLSFLLPAGWVLY,0
2ein,Z,36,43,7,LDNYKKS,0
2ein,Z,44,46,2,AA,0
1brx,C,1,5,4,QITG,0
1brx,C,6,9,3,PEW,0
1brx,C,10,32,22,WLALGTALMGLGTLYFLVKGMG,0
1brx,C,41,62,21,YAITTLVPAIAFTMYLSMLLG,0
1brx,C,63,78,15,GLTMVPFGGEQNPIY,0
1brx,C,79,100,21,ARYADWLFTTPLLLLDLALLV,0
1brx,C,106,127,21,ILALVGADGIMIGTGLVGALT,0
1brx,C,128,133,5,VYSYR,0
1brx,C,134,152,18,VWWAISTAAMLYILYVLF,0
1brx,C,153,166,13,GFTSKAESMRPEV,0
1brx,C,171,192,21,VLRNVTVVLWSAYPVVWLIGS,0
1brx,C,193,202,9,GAGIVPLNI,0
1brx,C,203,226,23,TLLFMVLDVSAKVGFGLILLRSR,0
1brx,C,229,248,19,GEAEAPEPSAGDGAAATS,0
4x5m,C,6,28,22,TGLFAAFFTTFAFAPQSIKTIR,0
4x5m,C,29,35,6,RNTEGI,0
4x5m,C,36,55,19,VVMYIMFLTGVISWIAYGI,0
4x5m,C,61,82,21,VLIANIVTLFLAAPVLVITLI,0
4x5m,C,83,94,11,RRKKHVLESSG,0
4hea,H,2,13,11,WSYPVDPYWMV,0
4hea,H,14,28,14,LKALLVVVGLLTAF,0
4hea,H,58,66,8,PLADAIKS,0
4hea,H,91,103,12,FALLAFGLIPFG,0
4hea,H,104,120,16,PGSFFGYQPWVINLDL,0
4hea,H,121,132,11,ILYLFAVSELA,0
4hea,H,164,176,12,GLGLALLAPVLL,0
4hea,H,177,181,4,GSLN,0
4hea,H,182,191,9,NDIVNWQKE,0
4hea,H,192,193,1,G,0
4hea,H,194,207,13,LFLYAFPAFLVYL,0
4hea,H,239,250,11,KWALFQMAEYI,0
4hea,H,251,272,21,FITASALIPTLFLGGWTMPVL,0
4hea,H,274,287,13,PYLWMFLKIAFFL,0
4hea,H,314,327,13,PLALLWFLVTALV,0
4hea,H,328,335,7,ALDLPRT,0
4hea,H,336,348,12,LLYLSALSFLVL,0
4hea,H,355,365,10,PKPARKGGGA,0
2bl2,J,16,35,19,LAMATATIFSGIGSAKGVG,0
2bl2,J,36,60,24,TGEAAAALTTSQPEKFGQALILQL,0
2bl2,J,61,78,17,PGTQGLYGFVIAFLIFI,0
2bl2,J,93,110,17,GASLPIAFTGLFSGIAQ,0
2bl2,J,111,136,25,KVAAAGIQILAKKPEHATKGIIFAA,0
2bl2,J,137,154,17,VETYAILGFVISFLLVL,0
3aob,C,1,10,9,PNFFIDRPI,0
3aob,C,11,27,16,AWVIAIIIMLAGGLAI,0
3aob,C,341,357,16,KTLVEAIILVFLVMYL,0
3aob,C,358,365,7,LQNFRAT,0
3aob,C,366,386,20,IPTIAVPVVLLGTFAVLAAF,0
3aob,C,395,411,16,FGMVLAIGLLVDDAIV,0
3aob,C,412,442,30,VENVERVMAEEGLPPKEATRKSMGQIQGAL,0
3aob,C,443,458,15,GIAMVLSAVFVPMAF,0
3aob,C,471,489,18,ITIVSAMALSVLVALILT,0
3aob,C,490,498,8,ALCATMLK,0
3aob,C,499,512,13,IAKGDHGEGKKGF,0
3aob,C,513,518,5,GWFNR,0
3aob,C,519,530,11,FEKSTHHYTDS,0
3aob,C,531,541,10,GGILRSTGRY,0
3aob,C,542,558,16,VLYLIIVVGMAYLFVR,0
3aob,C,874,891,17,SLYAISLIVVFLCLAAL,0
3aob,C,892,898,6,ESWSIP,0
3aob,C,899,919,20,SVMLVVPLGVIGALLAATFR,0
3aob,C,927,943,16,QVGLLTTIGLSAKNAI,0
3aob,C,944,975,31,IVEFAKDLMDKEGKGLIEATLDAVRMRLRPI,0
3aob,C,976,992,16,MTSLAFILGVMPLVIS,0
3aob,C,1001,1019,18,AVGTGVMGGMVTATVLAI,0
3aob,C,1021,1032,11,VPVFFVVVRRR,0
3aob,C,1033,1036,3,SRK,0
3aob,C,1037,1053,16,EDIEHSHTVDHHHHHH,0
1nek,L,1,2,1,V,0
1nek,L,16,35,19,ILVRATAIVLTLYIIYMVG,0
1nek,L,36,56,20,FATSGELTYEVWIGFFASAF,0
1nek,L,57,80,23,KVFTLLALFSILIHAWIGMWQVL,0
1nek,L,89,110,21,RLMLQLVIVVALVVYVIYGFV,0
1nek,L,111,115,4,VWGV,0
2rh1,A,-6,28,34,YKDDDAMGQPGNGSAFLLAPNRSHAPDHDVTQQR,0
2rh1,A,32,59,27,VVGMGIVMSLIVLAIVFGNVLVITAIA,0
2rh1,A,60,69,9,FERLQTVTN,0
2rh1,A,70,95,25,FITSLACADLVMGLAVVPFGAAHIL,0
2rh1,A,105,129,24,CEFWTSIDVLCVTASIETLCVIAV,0
2rh1,A,130,150,20,RYFAITSPFKYQSLLTKNKA,0
2rh1,A,151,175,24,VIILMVWIVSGLTSFLPIQMHWYR,0
2rh1,A,179,186,7,EAINCYA,0
2rh1,A,194,220,26,TNQAYAIASSIVSFYVPLVIMVFVYS,0
2rh1,A,221,274,53,VFQEAKRQLNIFEMLRIDEGLRLKIYKDTEGYYTIGIGHLLTKSPSLNAAKSELDKAIGRNTNGVITKDEAEKLFNQDVDAAVRGILRNAKLKPVYDSLDAVRRAALINMVFQMGETGVAGFTNSLRMLQQKRWDEAAVNLAKSRWYNQTPNRAKRVITTFRTGTWDAYKFCLKEHKALKT,0
2rh1,A,275,299,24,GIIMGTFTLCWLPFFIVNIVHVIQ,0
2rh1,A,303,327,24,RKEVYILLNWIGYVNSGFNPLIYC,0
2rh1,A,328,329,1,S,0
2rh1,A,330,339,9,DFRIAFQEL,0
2rh1,A,340,342,2,CL,0
2rh1,A,343,365,22,RSSLKAYGNGYSSNGNTGEQSG,0
4al1,C,1,9,8,PAHSLVMS,0
4al1,C,16,33,17,LLCSTLLVIKMYVVAII,0
4al1,C,34,71,37,GQVRLRKKAFANPEDALRHGGPQYCRSDPDVERCLRA,0
4al1,C,72,89,17,RNDMETIYPFLFLGFVY,0
4al1,C,99,116,17,WMHFLVFLVGRVAHTVA,0
4al1,C,117,126,9,LGKLRAPIR,0
4al1,C,127,146,19,VTYTLAQLPCASMALQILW,0
3spi,D,36,40,4,ARRK,0
3spi,D,41,61,20,RNRFVKKNGQCNVEFTNMDD,0
3spi,D,62,68,6,PQRYIA,0
3spi,D,70,76,6,FTTCVD,0
3spi,D,78,104,26,WRYMLLLFSLAFLVSWLLFGLIFWLI,0
3spi,D,131,147,16,AAFLFSIETQTTIGYG,0
3spi,D,156,184,28,LAVFMVVVQSIVGCIIDSFMIGAIMAKM,0
3spi,D,185,186,1,R,0
3spi,D,187,192,5,KKRAQ,0
3spi,D,193,372,179,LLFSHNAVVAMRDGKLCLMWRVGNLRKSHIVEAHVRAQLIKPRITEEGEYIPLDQIDIDVGFDKGLDRIFLVSPITILHEINEDSPLFGISRQDLETDDFEIVVILEGMVEATAMTTQARSSYLASEILWGHRFEPVLFEEKNQYKVDYSHFHKTYEVPSTPRCSAKDLVENKFLLSNS,0
3spi,D,373,378,5,EVLFQ,0
3tt1,B,1,4,3,EVK,0
3tt1,B,14,32,18,ILAMAGNAVGLGNFLRFP,0
3tt1,B,33,41,8,QAAENGGG,0
3tt1,B,42,63,21,FMIPYIIAFLLVGIPLMWIEW,0
3tt1,B,90,124,34,KILGVFGLWIPLVVAIYFVYIESWTLGFAIKFLV,0
3tt1,B,125,129,4,LVPE,0
3tt1,B,130,134,4,PPNA,0
3tt1,B,135,166,31,DPDSILRPFKEFLYSYIGVPKGDEPILKPSL,0
3tt1,B,167,185,18,AYIVFLITMFINVSILIR,0
3tt1,B,191,214,23,ERFAKIAMPTLFILAVFLVIRVF,0
3tt1,B,215,222,7,LETPNGT,0
3tt1,B,223,230,7,ADGLNFL,0
3tt1,B,231,241,10,TPDFEKLKDP,0
3tt1,B,242,265,23,VWIAAVGQIFFTLSLGFGAIITY,0
3tt1,B,278,298,20,GLTAATLNEAAEVILGGSIS,0
3tt1,B,299,318,19,PAAVAFFGVANAVAIAKAG,0
3tt1,B,319,324,5,FNLGF,0
3tt1,B,326,331,5,LPAIF,0
3tt1,B,332,339,7,QTAGGTF,0
3tt1,B,340,367,27,GFLWFFLLFFAGLTSSIAIMQPMIAFL,0
3tt1,B,377,396,19,AVLWTAAIVFFSAHLVMFL,0
3tt1,B,397,399,2,KS,0
3tt1,B,400,425,25,DEMDFWAGTIGVVFFGLTELIIFFW,0
3tt1,B,429,437,8,DKAWEEIN,0
3tt1,B,448,472,24,YYVMRYITPAFLAVLLVVWAREYI,0
3tt1,B,473,483,10,KIMEETHWTV,0
3tt1,B,484,502,18,ITRFYIIGLFLFLTFLVF,0
3tt1,B,508,519,11,NHESAGTLVPR,0
3aou,J,17,38,21,AMATATIFSGIGSAKGVGMTG,0
3aou,J,39,59,20,AAAALTTSQPEKFGQALILQ,0
3aou,J,60,78,18,LPGTQGLYGFVIAFLIFI,0
3aou,J,94,114,20,ASLPIAFTGLFSGIAQGKVA,0
3aou,J,115,133,18,AGIQILAKKPEHATKGII,0
3aou,J,134,154,20,AAMVQTYAILGFVISFLLVL,0
2l6x,A,18,19,1,G,0
2l6x,A,30,54,24,VSFWLVTAALLASTVFFFVERDRV,0
2l6x,A,55,61,6,AKWKTS,0
2l6x,A,62,85,23,TVSGLVTGIAFWHYMYMRGVWIE,0
2l6x,A,90,111,21,TVFRYIDWLLTVPLLICEFYL,0
2l6x,A,112,120,8,LAAATNVA,0
2l6x,A,121,142,21,SLFKKLLVGSLVMLVFGYMGE,0
2l6x,A,148,170,22,WPAFIIGCLAWVYMIYELWAGE,0
2l6x,A,171,183,12,KSACNTASPAVQ,0
2l6x,A,184,206,22,AYNTMMYIIIFGWAIYPVGYFT,0
2l6x,A,219,244,25,NLIYNLADFVNKILFGLIIWNVAVK,0
2l6x,A,245,252,7,SSNAPGG,0
3qjr,C,5,25,20,KGALAVILVLTLTILVFWLG,0
3qjr,C,26,34,8,YAVFFARG,0
5unh,A,1001,1105,104,DLEDNWETLNDNLKVIEKADNAAQVKDALTKMRAAALDAQKATPPKLEDKSPDSPEMKDFRHGFDILVGQIDDALKLANEGKVKEAQAAAEQLKTTRNAYIQKY,0
5unh,A,39,45,6,SDKHLD,0
5unh,A,46,68,22,IPILYYIIFVIGFLVNIVVVTL,0
5unh,A,83,104,21,FNLAVADLLLLATLPLWATYY,0
5unh,A,105,110,5,YRYDW,0
5unh,A,111,140,29,FGPVMCKVFGSFLTLNMFASIFFITCMSV,0
5unh,A,163,183,20,VPLVWCMACLSSLPTFYFRD,0
5unh,A,184,207,23,RTIEYLGVNACIMAFPPEKYAQW,0
5unh,A,208,233,25,AGIALMKNILGFIIPLIFIATCYFG,0
5unh,A,256,281,25,MAAAVVLAFIICWLPFHVLTFLDAL,0
5unh,A,282,299,17,WMGVINSCEVIAVIDLA,0
5unh,A,300,321,21,PFAILLGFTNSCVNPFLYCFV,0
2l8s,A,1,17,16,GLPGRVPLWVILLSAF,0
2l8s,A,18,40,22,GLLLLMLLILALWKIGFFKRPL,0
2l8s,A,47,54,7,EHHHHHH,0
4o9t,D,6,20,14,AYFVVAILFIVGLK,0
4o9t,D,21,32,11,MAHPTTAKSGI,0
4o9t,D,33,46,13,WAGWGMVLAVLAT,0
4o9t,D,59,73,14,LALLLGSVVAWWAA,0
4o9t,D,74,84,10,RVAMTDMPQM,0
4o9t,D,85,100,15,AIYNGMGGGAAATIA,0
4o9t,D,118,137,19,ILGGLIGSVAFTGSLIAFA,0
4o9t,D,138,150,12,LQGIMKSRPILF,0
4o9t,D,151,166,15,GQKAVNALVLALTVV,0
4o9t,D,183,196,13,FLLALLFGVLMTL,0
4o9t,D,197,207,10,IGGGDMPVAI,0
4o9t,D,208,223,15,FYNAFTGMAVGFEGF,0
4o9t,D,228,242,14,ALMVAGTLVGAAGT,0
4o9t,D,243,260,17,LTVLMARAMNRSVWSVL,0
4o9t,D,261,283,22,GGFGVEQEAGEVKGHHHHHHHH,0
5u76,D,79,84,5,LKLFF,0
5u76,D,93,113,20,IRLFNFSLKLLTCLLYIVRV,0
5u76,D,114,117,3,LDN,0
5u76,D,140,153,13,INWSHIFWVDRKL,0
5u76,D,154,175,21,LWAVQVSIALISFLETMLLIY,0
5u76,D,183,207,24,EQIFRISFILEMINTVPFIITIFW,0
5u76,D,208,213,5,PLRNL,0
5u76,D,214,232,18,IPVFLNCWLAKYALENMI,0
5u76,D,248,271,23,QVLILICTLLCLVFTGTCGIQHL,0
5u76,D,272,280,8,RAGEKLSL,0
5u76,D,281,297,16,KSFYFCIVTFSTVGYG,0
5u76,D,298,305,7,VTPKIWP,0
5u76,D,306,328,22,QLLVVIMICVALVVLPLQFEEL,0
5ir6,C,771,784,13,PMVVVALSVVAAF,0
5ir6,C,785,795,10,VGLKDVHVNE,0
3om3,B,30,60,30,EIIGRPQPGGTGFQPSASPVATQIHWLDGF,0
3om3,B,61,80,19,LVIIAAITIFVTLLILYAV,0
3om3,B,99,117,18,LEIAWTIVPIVILVAIGA,0
3om3,B,118,285,167,SLPVLFNQQEIPEADVTVKVTGYQWYWGYEYPDEEISFESYMIGSPATGGDNRMSPEVEQQLIEAGYSRDEFLLATDTAMVVPVNKTVVVQVTGADVIHSWTVPAFGVKQDAVPGRLAQLWFRAEREGIFFGQCSELCGISHAYMPITVKVVSEEAYAAWLEQHHHH,0
3fgo,A,49,56,7,WELVIEQ,0
3fgo,A,61,78,17,VRILLLAACISFVLAWF,0
3fgo,A,79,86,7,EGEETIT,0
3fgo,A,87,103,16,FVEPFVILLILIANAI,0
3fgo,A,260,277,17,SKVISLICVAVWLINIG,0
3fgo,A,278,292,14,FNDPVHGGSWIRGA,0
3fgo,A,293,314,21,YYFKIAVALAVAAIPEGLPAV,0
3fgo,A,763,783,20,LISSNVGEVVCIFLTAALGL,0
3fgo,A,784,785,1,E,0
3fgo,A,786,806,20,LIPVQLLWVNLVTDGLPATA,0
3fgo,A,835,852,17,RYMAIGGYVGAATVGAA,0
3fgo,A,853,897,44,WWFMYAEDGPGVTYHQLTHFMQCTEDHPHFEGLDCEIFEAPEPM,0
3fgo,A,898,916,18,MALSVLVTIEMCNALNSL,0
3fgo,A,931,950,19,WLLGSICLSMSLHFLILYV,0
3fgo,A,951,967,16,PLPMIFKLKALDLTQW,0
3fgo,A,968,987,19,MVLKISLPVIGLDEILKFI,0
5b5e,z,8,25,17,LAALVILSFVMVIGVPV,0
5b5e,z,26,39,13,YASPQDWDRSKQL,0
5b5e,z,40,54,14,FLGSGLWIALVLVV,0
2lop,A,-8,0,8,TSLYKKVG,0
2lop,A,1,10,9,DLIGFGYAA,0
2lop,A,11,42,31,VTFGSIFGYKRRGGVPSLIAGLFVGCLAGYG,0
2lop,A,54,69,15,VSLFTAFFLATIMGV,0
2lop,A,70,77,7,FKRSKKI,0
2lop,A,78,96,18,PAGLVAGLSLMMILRLVL,0
1ry5,H,1,10,9,VGVTAFGNF,0
1ry5,H,16,32,16,IYSFWIFLAGLIYYLQ,0
1ry5,H,33,249,216,ENMREGYPLENEDGTPAANQGPFPLPKPKTFILPHGRGTLTVPGPESEDRPIALARTAVSEGFPHAPTGDPMKDGVGPASWVARRDLPELDGHGHNKIKPMKAAAGFHVSAGKNPIGLPVRGCDLEIAGKVVDIWVDIPEQMARFLEVELKDGSTRLLPMQMVKVQSNRVHVNALSSDLFAGIPTIKSPTEVTLLEEDKICGYVAGGLMYAAPKRK,0
1ry5,H,250,260,10,VVAAMLAEYA,0
2rdd,F,21,44,23,SLILMLVVFGLIFYFMILRPQQK,0
2rdd,F,45,55,10,TKEHKKLMDS,0
2iqr,A,50,73,23,FVTLGVISLLENILVIVAIAKNK,0
2iqr,A,74,78,4,LHSP,0
2iqr,A,79,98,19,YFFICSLAVADMLVSVSNG,0
2iqr,A,125,149,24,DSVICSSLLASICSLLSIAVDRYF,0
2iqr,A,150,163,13,IFYALQYHNIMTV,0
2iqr,A,164,185,21,RVGIIISCIWAACTVSGILFI,0
2iqr,A,192,216,24,VIICLITMFFTMLALMASLYVHMF,0
2iqr,A,217,242,25,MARLHIKRIAVLPGTGAIRQGANMK,0
2iqr,A,243,266,23,AITLTILIGVFVVCWAPFFLHLI,0
2iqr,A,287,308,21,LILIMCNSIIDPLIYALRSQE,0
2iqr,A,309,317,8,RKTFKEII,0
2iqr,A,318,321,3,CYP,0
2zfe,C,-12,4,16,LELLPTAVEGVSQAQI,0
2zfe,C,5,11,6,GRPEWI,0
2zfe,C,12,29,17,LALGTALMGLGTLYFLV,0
2zfe,C,45,61,16,TTLVPAIAFTMYLSML,0
2zfe,C,62,79,17,GYGLTMVPFGGEQNPIY,0
2zfe,C,80,95,15,ARYADWLFTTPLLLL,0
2zfe,C,110,126,16,LVGADGIMIGTGLVGA,0
2zfe,C,127,134,7,TKVYSYR,0
2zfe,C,135,153,18,VWWAISTAAMLYILYVLF,0
2zfe,C,175,192,17,NVTVVLWSAYPVVWLIG,0
2zfe,C,193,203,10,EGAGIVPLNI,0
2zfe,C,204,222,18,TLLFMVLDVSAKVGFGLI,0
2zfe,C,232,249,17,AEAPEPSAGDGAAATSD,0
2vrm,A,1,2,1,S,0
2vrm,A,3,485,482,KCDVVVVGGGISGMAAAKLLHDSGLNVVVLEARDRVGGRTYTLRNQKVKYVDLGGSYVGPTQNRILRLAKELGLETYKVNEVERLIHHVKGKSYPFRGPFPPVWNPITYLDHNNFWRTMDDMGREIPSDAPWKAPLAEEWDNMTMKELLDKLCWTESAKQLATLFVNLCVTAETHEVSALWFLWYVKQCGGTTRIISTTNGGQERKFVGGSGQVSERIMDLLGDRVKLERPVIYIDQTRENVLVETLNHEMYEAKYVISAIPPTLGMKIHFNPPLPMMRNQMITRVPLGSVIKCIVYYKEPFWRKKDYCGTMIIDGEEAPVAYTLDDTKPEGNYAAIMGFILAHKARKLARLTKEERLKKLCELYAKVLGSLEALEPVHYEEKNWCEEQYSGGCYTTYFPPGILTQYGRVLRQPVDRIYFAGTETATHWSGYMEGAVEAGERAAREILHAMGKIPEDEIWQSEPESVDVPAQPITTTFLERH,0
2vrm,A,486,501,15,PSVPGLLRLIGLTTI,0
2vrm,A,502,520,18,SATALGFLAHKRGLLVRV,0
5mg3,C,57,206,149,GKLISVKTDVLDLTINTRGGDVEQALLPAYPKELNSTQPFQLLETSPQFIYQAQSGLTGRDGPDNPANGPRPLYNVEKDAYVLAEGQNELQVPMTYTDAAGNTFTKTFVLKRGDYAVNVNYNVQNAGEKPLEISSFGQLKQSITLPPHL,0
5mg3,C,217,323,106,FRGAAYSTPDAAYAAYAFDTIADNENLNISSKGGWVAMLQQYFATAWIPHNDGTNNFYTANLGNGIAAIGYKSQPVLVQPGQTGAMNSTLWVGPEIQDKMAAVAPH,0
5mg3,C,335,338,3,ISQ,0
5mg3,C,339,348,9,LFKLLKWIH,0
5mg3,C,349,362,13,FVGNWGFSIIIIT,0
5mg3,C,363,381,18,IVRGIMYPLTKAQYTSMA,0
5mg3,C,420,434,14,GGCFPLLIQMPIFL,0
5mg3,C,435,466,31,LYYMLMGSVELRQAPFALWIHDLSAQDPYYI,0
5mg3,C,467,483,16,PILMGVTMFFIQKMSP,0
5mg3,C,492,507,15,KIMTFMPVIFTVFFL,0
5mg3,C,508,517,9,FPSGLVLYY,0
5mg3,C,518,530,12,VSNLVTIIQQQL,0
4p9p,F,126,130,4,SHMG,0
4p9p,F,136,153,17,LLTVVFYIAAVMATNLY,0
4p9p,F,154,163,9,ATFPEWFGD,0
4p9p,F,164,185,21,SKSLYTLFQVMTLESWSMGIV,0
4p9p,F,186,191,5,PVMNV,0
4p9p,F,192,193,1,P,0
4p9p,F,194,214,20,AWVFFIPFIMLTTFTVLNLF,0
4p9p,F,221,274,53,MAITKEQEEEAKTGHHQEPISQTLLHLGDRLDRIEKQLAQNNELLQRQQPQKK,0
5hxc,A,7,24,17,YFLLGLILLYYGSDWFV,0
5hxc,A,25,39,14,GSERIARHFNVSNF,0
5hxc,A,40,59,19,IGATVMAIGTSLPEILTSA,0
5hxc,A,72,92,20,NAIGSCICNIGLVLGLSAII,0
5hxc,A,93,103,10,PIIVDKNLQK,0
5hxc,A,104,120,16,ILVYLLFVIFAAVIGI,0
5hxc,A,127,143,16,GVVLLILFIIYLRWTV,0
5hxc,A,144,151,7,NGSAEIE,0
5hxc,A,156,165,9,NNPSVVFSL,0
5hxc,A,166,186,20,LLIIGLIGVLVGAELFVDGA,0
5hxc,A,205,222,17,AFGTSLPELMVSLAAAK,0
5hxc,A,223,228,5,NLGGM,0
5hxc,A,229,248,19,LGNVIGSNIADIGGALAVG,0
5hxc,A,259,275,16,QMAVLVIMSLLLYLFA,0
5hxc,A,276,280,4,YSKI,0
5hxc,A,281,299,18,RWQGILFLALYIIAIASL,0
4rwd,B,51,77,26,ITALYSAVCAVGLLGNVLVMFGIVRY,0
4rwd,B,78,80,2,KM,0
4rwd,B,81,106,25,TATNIYIFNLALADALATSTLPFQS,0
4rwd,B,124,149,25,LSIDYYNMFTSIFTLTMMSVDRYIA,0
4rwd,B,150,152,2,CH,0
4rwd,B,153,158,5,VKALD,0
4rwd,B,159,181,22,RTPAKAKLINICIWVLASGVGV,0
4rwd,B,215,237,22,CVFLFAFVVPILIITVCYGLML,0
4rwd,B,238,259,21,RLRSVRLLSGSKEKDRSLRRI,0
4rwd,B,260,282,22,RMVLVVVGAFVVCWAPIHIFVI,0
4rwd,B,299,322,23,LHLCIALGYANSSLNPVLYAFLD,0
4rwd,B,323,331,8,NFKRCFRQ,0
5ari,W,10,12,2,TP,0
5ari,W,13,26,13,ILGLPLVTLIVLF,0
5ari,W,77,89,12,FIGSTNLLGLLP,0
5ari,W,90,95,5,SFTPT,0
5ari,W,96,111,15,QLSMNLGMAIPLWAG,0
5ari,W,144,168,24,ETISLFIQPMALAVRLTANITAGH,0
5ari,W,169,194,25,LIHLIGGATLALMSISTTTALITFT,0
5ari,W,195,212,17,LILLTILEFAVAMIQAY,0
2hyn,E,1,24,23,EKVQYLTRSAIRRASTIEMPQQA,0
2hyn,E,25,50,25,QKLQNLFINFCLILICLLLICIIVM,0
5tj6,D,1,13,12,ASSSSTSCEPGD,0
5tj6,D,14,20,6,QWYSFL,0
5tj6,D,21,37,16,SSLVTFGSGLVVIIIY,0
5tj6,D,45,78,33,RKKKCIQVSNPVPTARTTSLDQKSFMKNSDPEI,0
5tj6,D,102,118,16,VGLVFLLSIASLIIYF,0
5tj6,D,119,124,5,DASTN,0
5tj6,D,125,133,8,SVETCLPW,0
5tj6,D,134,141,7,SSTTQQV,0
5tj6,D,142,157,15,LAFNVFFMIYFFIRF,0
5tj6,D,164,183,19,WFWVELFSFVDYFTIPPSF,0
5tj6,D,184,194,10,AIYLDRNWLG,0
5tj6,D,195,206,11,RFLRALRLMSI,0
5tj6,D,228,242,14,VSFVSLWLTAAGFL,0
5tj6,D,243,266,23,LLENSGDPFFDFGNAQHLTYWEC,0
5tj6,D,267,279,12,YFLMVTMSTVGF,0
5tj6,D,280,288,8,DIFATTVL,0
5tj6,D,289,308,19,RTFVVIFIMIFIGLFASFI,0
5tj6,D,562,566,4,EDTR,0
5tj6,D,622,705,83,PLAMFKKGAAAVLALQRTPGLAVEPDGEANDKDKSRGTSTSKAVTSFPEKRKPQSRRKPSTTLKSKSPSEDSVPPPPPPVDEP,0
5tj6,D,857,881,24,MGLIQSSNFVPGGFSPLHENKRSQ,0
5tj6,D,1032,1036,4,SVRS,0
5tj6,D,1066,1070,4,ITNH,0
1q16,F,5,28,23,MFFFDIYPYIAGAVFLIGSWLRY,0
1q16,F,29,47,18,YGQYTWRAASSQMLDRKG,0
1q16,F,48,73,25,NLASNLFHIGILGIFVGHFFGMLTP,0
1q16,F,87,114,27,KMAMFAGGASGVLCLIGGVLLLKRRLF,0
1q16,F,116,121,5,RVRAT,0
1q16,F,122,124,2,TG,0
1q16,F,125,145,20,DILILSLLVIQCALGLLTIP,0
1q16,F,183,204,21,FRLHLVLGMTLFLLFPFSRLI,0
1q16,F,205,225,20,IWSVPVEYLTRKYQLVRARH,0
3lsv,E,1,4,3,QDM,0
3lsv,E,5,194,189,SPPPPIADEPLTVNTGIYLIECYSLDDKAETFKVNAFLSLSWKDRRLAFDPVRSGVRVKTYEPEAIWIPEIRFVNVENARDADVVDISVSPDGTVQYLERFSARVLSPLDFRRYPFDSQTLHIYLIVRSVDTRNIVLAVDLEKVGKNDDVFLTGWDIESFTAVVKPANFALEDRLESKLDYQLRISRQY,0
3lsv,E,195,217,22,SYIPNIILPMLFILFISWTAFW,0
3lsv,E,222,244,22,ANVTLVVSTLIAHIFFNILVET,0
3lsv,E,245,251,6,LPKTPY,0
3lsv,E,252,275,23,TYTGAIIFMIYLFYFVAVIEVTV,0
3lsv,E,295,315,20,RIAFPVVFLLANIILAFLFF,0
3lsv,E,316,317,1,F,0
2xq8,E,0,6,6,QDMVSP,0
2xq8,E,198,215,17,NIILPMLFILFISWTAF,0
2xq8,E,216,222,6,STSYEA,0
2xq8,E,223,240,17,VTLVVSTLIAHIAFNIL,0
2xq8,E,255,273,18,AIIFMIYLFYFVAVIEVT,0
2xq8,E,274,294,20,QHYLKVESQPARAASITRAS,0
2xq8,E,295,312,17,IAFPVVFLLANIILAFL,0
4pb1,C,-5,1,6,PAVPRM,0
4pb1,C,4,17,13,MSCCGMAVLLGIA,0
4pb1,C,18,33,15,LLSSNRKAINLRTVG,0
4pb1,C,34,47,13,AFAIQFSLGAFIL,0
4pb1,C,50,78,28,WGQELLRGFSDAVSNVINYGNDGTSFLF,0
4pb1,C,103,118,15,TLIFFSALISVLYYL,0
4pb1,C,120,136,16,MQWVIRILGGGLQKAL,0
4pb1,C,137,178,41,TSRAESMSAAANIFVGQTEAPLVVRPFVPKMTQSELFAVMC,0
4pb1,C,179,192,13,GLASIAGGVLAGY,0
4pb1,C,202,216,14,VAASFMAAPGGLLF,0
4pb1,C,217,229,12,KLMMPETEKPQD,0
4pb1,C,230,240,10,EDITLDGGDD,0
4pb1,C,241,244,3,PAN,0
4pb1,C,245,274,29,IDAAAGGASAGLQLALNVGAMLIAFIGLI,0
4pb1,C,275,286,11,LINGMLGGIGG,0
4pb1,C,359,372,13,SFALCGFANLSSI,0
4pb1,C,373,398,25,ILLGGLGSLAPKRRGDIARMGVKAV,0
4pb1,C,399,415,16,AGTLSNLMAATIAGFF,0
4pb1,C,417,418,1,F,0
4ryo,A,9,27,18,VFFLTYGLFYVSSVLFPI,0
4ryo,A,29,34,5,TWYDA,0
4ryo,A,35,45,10,EKPSWTPPGM,0
4ryo,A,46,65,19,IGMIWAVLFGLIALSVAII,0
4ryo,A,76,96,20,WFLFLLNYIFNQAFSYFQFS,0
4ryo,A,97,101,4,KNLF,0
4ryo,A,102,122,20,ATVDCLLVAITTLLLIMFSS,0
4ryo,A,127,147,20,SAWLLIPYFLWSAFATYLSW,0
4ryo,A,148,153,5,IYSIN,0
2mk9,A,4,26,22,PFELFFMINTSILLIFIFIVLL,0
2mk9,A,27,34,7,HFEGWRI,0
2cfp,A,9,31,22,WMFGLFFFFYFFIMGAYFPFFP,0
2cfp,A,32,46,14,WLHDINHISKSDTG,0
2cfp,A,47,67,20,IFAAISLFSLLFQPLFGLLS,0
2cfp,A,74,91,17,YLLWIITGMLVMFAPFF,0
2cfp,A,92,108,16,FIFGPLLQYNILVGSI,0
2cfp,A,109,129,20,GGIYLGFCFNAGAPAVEAFI,0
2cfp,A,144,160,16,MFGCVGWALGASIVGI,0
2cfp,A,161,169,8,FTINNQFV,0
2cfp,A,170,188,18,WLGSGCALILAVLLFFAK,0
2cfp,A,210,216,6,KLALEL,0
2cfp,A,223,244,21,FLSLYVIGVSCTYDVFDQQFA,0
2cfp,A,245,259,14,FFTSFFATGEQGTR,0
2cfp,A,260,279,19,FGYVTTMGELLNASIMFFA,0
2cfp,A,280,286,6,LIINRI,0
2cfp,A,290,309,19,ALLLAGTIMSVRIIGSSFA,0
2cfp,A,310,313,3,SAL,0
2cfp,A,314,333,19,VVILKTLHMFEVPFLLVGC,0
2cfp,A,350,370,20,LVCFCFFKQLAMIFMSVLAG,0
2cfp,A,371,381,10,MYESIGFQGA,0
2cfp,A,382,400,18,LVLGLVALGFTLISVFTL,0
5cfy,F,6,13,7,YIEYPVL,0
5cfy,F,14,32,18,KILIGLILGAIVGLILGH,0
5cfy,F,36,63,27,HAVHTYVKPFGDLFVRLLKMLVMPIVF,0
5cfy,F,64,82,18,SLVVGAASISPARLGRVG,0
5cfy,F,83,107,24,KIVVYYLLTSAFAVTLGIIMARLF,0
5cfy,F,128,140,12,PLVHILLDIVPT,0
5cfy,F,141,150,9,PFGALANGQ,0
5cfy,F,151,158,7,LPTIFFA,0
5cfy,F,159,175,16,ILGIAITYLMNSENEK,0
5cfy,F,176,200,24,RKSAETLLDAINGLAEAMYKIVNG,0
5cfy,F,202,221,19,QYAPIGVFALIAYVMAEQG,0
5cfy,F,230,250,20,VTAAVYVGLTLQILLVYFVL,0
5cfy,F,251,266,15,KIYGIDPISFIKHAK,0
5cfy,F,267,286,19,AMLTAFVTRSSSGTLPVTM,0
5cfy,F,287,301,14,VAKEMGISEGIYSF,0
5cfy,F,302,321,19,LPLGATINMDGTALYQGVC,0
5cfy,F,339,362,23,TIVLTAVLASIGTAGVPGAGAIM,0
5cfy,F,390,408,18,AILDMGATMVNVTGDLTG,0
5cfy,F,409,416,7,AIVAKTE,0
4wd7,E,24,25,1,I,0
4wd7,E,26,42,16,RLLLNVLMSIIAIISY,0
4wd7,E,49,64,15,IHLTVAPFSLLGIAI,0
4wd7,E,65,218,153,IFLGFRNSASYSRFVEARNLWGTVLIAERTLVRQLRNILPAEHDAHRRIVSYLVAFSWSLKHQLRKTDPTADLRRLLPEERVTEILASSMPTNRILLLAGNEIGQLREAGKLSDITYGLMDNKLDELAHVLGGCERLATTPVPFAYTLILQRT,0
4wd7,E,219,234,15,YLFCTLLPFALVGDL,0
4wd7,E,236,249,13,MTPFVSVFISYTF,0
4wd7,E,250,293,43,SWDSLAEELEDPFGTAANDLPLNAMCNTIERNLLDMTGQHPLP,0
4p6h,C,1,6,5,GLYRK,0
4p6h,C,7,12,5,IEYPV,0
4p6h,C,13,27,14,QKILIGLILGAIVG,0
4p6h,C,44,66,22,PFGDLFVRLLCMLVMPIVFASL,0
4p6h,C,67,90,23,VGAASISPARLGRVGVKIVVYYL,0
4p6h,C,91,107,16,TSAFAVTLGIIMARLF,0
4p6h,C,134,140,6,LDIVPT,0
4p6h,C,141,150,9,PFGALANGQ,0
4p6h,C,151,161,10,LPTIFFAIIL,0
4p6h,C,162,173,11,IAITYLMNSEN,0
4p6h,C,174,197,23,KVRKSAETLLDAINGLAEAMYKI,0
4p6h,C,198,214,16,NGVMQYAPIGVFALIA,0
4p6h,C,226,246,20,ELAKVTAAVYVGLTLQILLV,0
4p6h,C,247,311,64,FVLLKIYGIDPISFIKHAKDAMLTAFVTRSSSGTLPVTMRVAKEMGISEGIYSFTLPLGATINM,0
4p6h,C,312,325,13,GTALYQGVATFFI,0
4p6h,C,336,352,16,QQLTIVLTAVLASIGT,0
4p6h,C,353,356,3,GVP,0
4p6h,C,357,370,13,AGAIMLCMVLHSV,0
4p6h,C,384,397,13,MILGIDAILDMGR,0
4p6h,C,398,416,18,MVNVTGDLTGTAIVAKTE,0
4p6h,C,417,422,5,TLVPR,0
4g7v,S,79,100,21,RGSHHHHHHGVDDGRMEIPTT,0
4g7v,S,105,113,8,QFRVRAVI,0
4g7v,S,121,138,17,GVFLIFLDIILMIIDLS,0
4g7v,S,139,148,9,PGKSESSQS,0
4g7v,S,149,167,18,YDGMALALSCYFMLDLGL,0
4g7v,S,183,204,21,VADGLIIVVTFVVTIFYTVLD,0
4g7v,S,205,209,4,YVQE,0
4g7v,S,210,234,24,GADGLGELVVLARLLRVVRLARIF,0
4g7v,S,237,263,26,QQMKASSRRTISQNKRRYRKDGFKLN,0
5mkf,D,215,218,3,YLK,0
5mkf,D,219,242,23,VLRELVTYLLFLIVLCILTYGMM,0
5mkf,D,470,497,27,FFLAACEIIFCFFIFYYVVEEILEIRI,0
5mkf,D,498,502,4,KLHY,0
5mkf,D,503,529,26,RSFWNCLDVVIVVLSVVAIGINIYRT,0
5mkf,D,555,580,25,IQFNNIAAVTVFFVWIKLFKFINFN,0
5mkf,D,582,593,11,MSQLSTTMSRC,0
5mkf,D,594,620,26,KDLFGFAIMFFIIFLAYAQLAYLVFG,0
5mkf,D,626,641,15,STFQECIFTQFRIIL,0
5mkf,D,646,652,6,AEIEEA,0
5mkf,D,654,681,27,VLGPIYFTTFVFFMFFILLNMFLAIIN,0
5mkf,D,682,695,13,TYSEVKSDLAQQK,0
3e83,E,19,22,3,KDK,0
3e83,E,23,25,2,FQ,0
3e83,E,26,45,19,LFVLTILTLISGTIFYSTV,0
3e83,E,51,67,16,DALYFSVVTLTTVGDG,0
3e83,E,75,96,21,GKIFTILYIFIGIGLVFGFIH,0
3e83,E,97,103,6,LAVNVQ,0
3e83,E,104,110,6,PSILSN,0
3e83,E,111,113,2,VP,0
2xfp,A,1,2,1,S,0
2xfp,A,3,108,105,KCDVVVVGGGISGMAAAKLLHDSGLNVVVLEARDRVGGRTYTLRNQKVKYVDLGGSYVGPTQNRILRLAKELGLETYKVNEVERLIHHVKGKSYPFRGPFPPVWN,0
2xfp,A,109,126,17,ITYLDHNNFWRTMDDMG,0
2xfp,A,127,485,358,EIPSDAPWKAPLAEEWDNMTMKELLDKLCWTESAKQLATLFVNLCVTAETHEVSALWFLWYVKQCGGTTRIISTTNGGQERKFVGGSGQVSERIMDLLGDRVKLERPVIYIDQTRENVLVETLNHEMYEAKYVISAIPPTLGMKIHFNPPLPMMRNQMITRVPLGSVIKCIVYYKEPFWRKKDYCGTMIIDGEEAPVAYTLDDTKPEGNYAAIMGFILAHKARKLARLTKEERLKKLCELYAKVLGSLEALEPVHYEEKNWCEEQYSGGCYTTYFPPGILTQYGRVLRQPVDRIYFAGTETATHWSGYMEGAVEAGERAAREILHAMGKIPEDEIWQSEPESVDVPAQPITTTFLERH,0
2xfp,A,486,498,12,PSVPGLLRLIGL,0
2xfp,A,502,520,18,SATALGFLAHKRGLLVRV,0
2ahy,D,2,16,14,SFLLTLKRMLRACL,0
2ahy,D,17,26,9,AWKDKEFQV,0
2ahy,D,27,45,18,FVLTILTLISGTIFYSTV,0
2ahy,D,51,67,16,DALYFSVVTLTTVGDG,0
2ahy,D,75,94,19,GKIFTILYIFIGIGLVFGF,0
2ahy,D,95,103,8,HKLAVNVQ,0
2ahy,D,104,110,6,PSILSN,0
1zcd,C,1,8,7,KHLHRFF,0
1zcd,C,15,29,14,IILIIAAILAMIMA,0
1zcd,C,30,34,4,SGAT,0
1zcd,C,35,41,6,GWYHDF,0
1zcd,C,42,60,18,ETPVQLRVGSLEINKNML,0
1zcd,C,61,80,19,WINDALMAVFFLLVGLEVK,0
1zcd,C,98,115,17,IAAIGGMIVPALLYLAF,0
1zcd,C,116,124,8,YADPITRE,0
1zcd,C,125,140,15,WAIPAATDIAFALGV,0
1zcd,C,158,174,16,LAIIDDLGAIIIIALF,0
1zcd,C,175,183,8,TNDLSMAS,0
1zcd,C,184,200,16,GVAAVAIAVLAVLNLC,0
1zcd,C,205,220,15,GVYILVGVVLWTAVL,0
1zcd,C,221,222,1,S,0
1zcd,C,223,237,14,VHATLAGVIVGFFI,0
1zcd,C,247,255,8,AKRLEHVL,0
1zcd,C,256,274,18,PWVAYLILPLFAFANAGV,0
1zcd,C,275,293,18,LQGVTLDGLTSILPLGII,0
1zcd,C,294,311,17,GLLIGKPLGISLFCWLA,0
1zcd,C,330,348,18,VGILCGIGFTMSIFIASL,0
1zcd,C,349,361,12,FGSVDPELINWA,0
1zcd,C,362,377,15,LGILVGSISSAVIGY,0
1zcd,C,385,388,3,PSV,0
3gwu,B,1,4,3,EVK,0
3gwu,B,14,32,18,ILAMAGNAVGLGNFLRFP,0
3gwu,B,33,43,10,QAAENGGGAF,0
3gwu,B,44,63,19,IPYIIAFLLVGIPLMWIEW,0
3gwu,B,90,124,34,KILGVFGLWIPLVVAIYYVYIESWTLGFAIKFLV,0
3gwu,B,125,132,7,LVPEPPP,0
3gwu,B,133,134,1,A,0
3gwu,B,135,166,31,DPDSILRPFKEFLYSYIGVPKGDEPILKPSL,0
3gwu,B,167,184,17,AYIVFLITMFINVSILI,0
3gwu,B,191,212,21,ERFAKIAMPTLFILAVFLVIR,0
3gwu,B,213,222,9,FLLETPNGT,0
3gwu,B,223,231,8,ADGLNFLW,0
3gwu,B,232,241,9,PDFEKLKDP,0
3gwu,B,242,265,23,VWIAAVGQIFFTLSLGFGAIITY,0
3gwu,B,278,298,20,GLTAATLNEKAEVILGGSIS,0
3gwu,B,299,325,26,PAAVAFFGVANAVAIAKAGAFNLGFI,0
3gwu,B,326,331,5,LPAIF,0
3gwu,B,332,339,7,QTAGGTF,0
3gwu,B,340,366,26,GFLWFFLLFFAGLTSSIAIMQPMIAF,0
3gwu,B,378,396,18,VLWTAAIVFFSAHLVMFL,0
3gwu,B,397,399,2,KS,0
3gwu,B,400,425,25,DEMDFWAGTIGVVFFGLTELIIFFW,0
3gwu,B,429,437,8,DKAWEEIN,0
3gwu,B,445,469,24,RIYYYVMRYITPAFLAVLLVVWAR,0
3gwu,B,470,483,13,YIPKIMEETHWTV,0
3gwu,B,484,502,18,ITRFYIIGLFLFLTFLVF,0
1oye,C,1,6,5,PNFFI,0
1oye,C,11,27,16,AWVIAIIIMLAGGLAI,0
1oye,C,28,340,312,KLPVAQYPTIAPPAVTISASYPGADAKTVQDTVTQVIEQNMNGIDNLMYMSSNSDSTGTVQITLTFESGTDADIAQVQVQNKLQLAMPLLPQEVQQQGVSVEKSSSSFLMVVGVINTDGTMTQEDISDYVAANMKDAISRTSGVGDVQLFGSQYAMRIWMNPNELNKFQLTPVDVITAIKAQNAQVAAGQLGGTPPVKGQQLNASIIAQTRLTSTEEFGKILLKVNQDGSRVLLRDVAKIELGGENYDIIAEFNGQPASGLGIKLATGANALDTAAAIRAELAKMEPFFPSGLKIVYPYDTTPFVKISIHEV,0
1oye,C,341,357,16,KTLVEAIILVFLVMYL,0
1oye,C,366,386,20,IPTIAVPVVLLGTFAVLAAF,0
1oye,C,387,394,7,FSINTLT,0
1oye,C,395,411,16,FGMVLAIGLLVDDAIV,0
1oye,C,442,458,16,VGIAMVLSAVFVPMAF,0
1oye,C,459,468,9,GGSTGAIYR,0
1oye,C,469,489,20,FSITIVSAMALSVLVALILT,0
1oye,C,499,512,13,IAKGDHGEGKKGF,0
1oye,C,514,524,10,WFNRMFEKST,0
1oye,C,526,536,10,YTDSVGGILR,0
1oye,C,542,557,15,VLYLIIVVGMAYLFV,0
1oye,C,558,710,152,LPSSFLPDEDQGVFMTMVQLPAGATQERTQKVLNEVTHYYLTKEKNNVESVFAVNGFGFAGRGQNTGIAFVSLKDWADRPGEENKVEAITMRATRAFSQIKDAMVFAFNLPAIVELGTATGFDFELIDQAGLGHEKLTQARNQLLAEAAKHP,0
1oye,C,712,859,147,LTSVRPNGLEDTPQFKIDIDQEKAQALGVSINDINTTLGAAWGGSYVNDFIDRGRVKKVYVMSEAKYRMLPDDIGDWYVRAADGQMVPFSAFSSSRWEYGSPRLERYNGLPSMEILGQAAPGKSTGEAMELMEQLASKLPTGVGYDW,0
1oye,C,860,868,8,GMSYQERL,0
1oye,C,869,873,4,GNQA,0
1oye,C,874,891,17,SLYAISLIVVFLCLAAL,0
1oye,C,898,919,21,FSVMLVVPLGVIGALLAATFR,0
1oye,C,920,926,6,LTNDVY,0
1oye,C,927,943,16,QVGLLTTIGLSAKNAI,0
1oye,C,976,993,17,MTSLAFILGVMPLVIST,0
1oye,C,994,1003,9,AGSGAQNAV,0
1oye,C,1004,1019,15,TGVMGGMVTATVLAI,0
1oye,C,1026,1032,6,VVVRRR,0
1oye,C,1037,1049,12,EDIEHSHTVDHH,0
1t9x,C,1,6,5,PNFFI,0
1t9x,C,11,27,16,AWVIAIIIMLAGGLAI,0
1t9x,C,28,340,312,KLPVAQYPTIAPPAVTISASYPGADAKTVQDTVTQVIEQNMNGIDNLMYMSSNSDSTGTVQITLTFESGTDADIAQVQVQAKLQLAMPLLPQEVQQQGVSVEKSSSSFLMVVGVINTDGTMTQEDISDYVAANMKDAISRTSGVGDVQLFGSQYAMRIWMNPNELNKFQLTPVDVITAIKAQNAQVAAGQLGGTPPVKGQQLNASIIAQTRLTSTEEFGKILLKVNQDGSRVLLRDVAKIELGGENYDIIAEFNGQPASGLGIKLATGANALDTAAAIRAELAKMEPFFPSGLKIVYPYDTTPFVKISIHEV,0
1t9x,C,341,357,16,KTLVEAIILVFLVMYL,0
1t9x,C,366,386,20,IPTIAVPVVLLGTFAVLAAF,0
1t9x,C,387,394,7,FSINTLT,0
1t9x,C,395,411,16,FGMVLAIGLLVDDAIV,0
1t9x,C,442,458,16,VGIAMVLSAVFVPMAF,0
1t9x,C,459,469,10,GGSTGAIYRQ,0
1t9x,C,472,489,17,TIVSAMALSVLVALILT,0
1t9x,C,499,512,13,IAKGDHGEGKKGF,0
1t9x,C,514,524,10,WFNRMFEKST,0
1t9x,C,526,536,10,YTDSVGGILR,0
1t9x,C,541,557,16,LVLYLIIVVGMAYLFV,0
1t9x,C,558,861,303,LPSSFLPDEDQGVFMTMVQLPAGATQERTQKVLNEVTHYYLTKEKNNVESVFAVNGFGFAGRGQNTGIAFVSLKDWADRPGEENKVEAITMRATRAFSQIKDAMVFAFNLPAIVELGTATGFDFELIDQAGLGHEKLTQARNQLLAEAAKHPDMLTSVRPNGLEDTPQFKIDIDQEKAQALGVSINDINTTLGAAWGGSYVNDFIDRGRVKKVYVMSEAKYRMLPDDIGDWYVRAADGQMVPFSAFSSSRWEYGSPRLERYNGLPSMEILGQAAPGKSTGEAMELMEQLASKLPTGVGYDWTG,0
1t9x,C,863,873,10,YQERLSGNQA,0
1t9x,C,874,891,17,SLYAISLIVVFLCLAAL,0
1t9x,C,898,919,21,FSVMLVVPLGVIGALLAATFR,0
1t9x,C,920,926,6,LTNDVY,0
1t9x,C,927,943,16,QVGLLTTIGLSAKNAI,0
1t9x,C,975,993,18,LMTSLAFILGVMPLVIST,0
1t9x,C,994,1000,6,AGSGAQ,0
1t9x,C,1001,1021,20,AVGTGVMGGMVTATVLAIFF,0
1t9x,C,1026,1032,6,VVVRRR,0
1t9x,C,1037,1049,12,EDIEHSHTVDHH,0
3bhs,C,2,7,5,VAPAE,0
3bhs,C,19,36,17,SINILAMLLVGFGFLMV,0
3bhs,C,37,44,7,VRRYGFS,0
3bhs,C,45,63,18,TTGTYLVVATGLPLYILL,0
3bhs,C,82,99,17,YAEFAVATGLIAMGAVL,0
3bhs,C,100,104,4,RLRV,0
3bhs,C,105,122,17,QYALLALFIVPVYLLNE,0
3bhs,C,141,159,18,SIAIHAFGAYFGLGVSIA,0
3bhs,C,160,178,18,TTAAQRAQPIESDATSDR,0
3bhs,C,179,195,16,SMLGSMVLWLFWPSFA,0
3bhs,C,209,226,17,NTLLALCGATLATYFLS,0
3bhs,C,227,237,10,LFHKGKASIV,0
3bhs,C,238,254,16,MANAALAGGVAIGSVC,0
3bhs,C,260,277,17,GAFVIGLLGGAISVVGF,0
3bhs,C,278,292,14,FIQPMLESKAKTID,0
3bhs,C,293,313,20,CGVHNLHGLPGLLGGFSAIL,0
3bhs,C,323,347,24,TGIGITLALALIGGVIAGALIKLT,0
3bhs,C,348,386,38,TTKQAYEDSHEFIHLAGPEDEHKAERLVLEAKTEIQGL,0
3bhs,C,387,407,20,NRIDAAVLSAKSEGNALVPR,0
3r65,D,24,41,17,LLVLAVIIYGTAGFHFI,0
3r65,D,42,46,4,GESW,0
3r65,D,47,63,16,VSLYWTFVTIATVGYG,0
3r65,D,64,70,6,YSPHTP,0
3r65,D,71,92,21,GMYFTCTLIVLGIGTFAVAVQ,0
3r65,D,93,98,5,LLEFL,0
1ddd,7,289,295,6,VYATYQ,0
1ddd,7,296,316,20,TRGLASLNSCVDPILYFLAG,0
4gx2,F,4,16,12,QRGSAYFLRGRA,0
4gx2,F,21,41,20,VLLLYCAFLLVMLLAYASIF,0
4gx2,F,42,55,13,YLMWHLEGRAYSF,0
4gx2,F,56,72,16,AGIYWTITVMTTLGFG,0
4gx2,F,73,80,7,ITFESDA,0
4gx2,F,81,105,24,YLFASIVTVSGVIFLDIILPFGFV,0
4gx2,F,565,568,3,VPR,0
2agv,A,49,55,6,WELVIE,0
2agv,A,57,76,19,EDLLVRILLLAACISFVLA,0
2agv,A,77,88,11,FEEGEETITAF,0
2agv,A,89,104,15,EPFVILLILIANAIV,0
2agv,A,258,276,18,QLSKVISLICVAVWLINI,0
2agv,A,277,295,18,HFNDPVHGGSWIRGAIYY,0
2agv,A,296,314,18,KIAVALAVAAIPEGLPAV,0
2agv,A,761,781,20,RYLISSNVGEVVCIFLTAAL,0
2agv,A,782,785,3,LPE,0
2agv,A,786,807,21,LIPVQLLWVNLVTDGLPATAL,0
2agv,A,835,851,16,RYMAIGGYVGAATVGA,0
2agv,A,852,899,47,AWWFMYAEDGPGVTYHQLTHFMQCTEDHPHFEGLDCEIFEAPEPMTM,0
2agv,A,900,916,16,LSVLVTIEMCNALNSL,0
2agv,A,927,948,21,WVNIWLLGSICLSMSLHFLIL,0
2agv,A,949,951,2,VD,0
2agv,A,952,957,5,LPMIF,0
2agv,A,958,970,12,LKALDLTQWLMV,0
2agv,A,971,987,16,KISLPVIGLDEILKFI,0
1otu,B,1,17,16,KTDTPSLETPQAARLR,0
1otu,B,37,58,21,MAAVVGTLVGLAAVAFDKGVA,0
1otu,B,59,83,24,LQNQRMGALVHTADNYPLLLTVAF,0
1otu,B,84,97,13,CSAVLAMFGYFLV,0
1otu,B,129,142,13,VKFFGGLGTLGGG,0
1otu,B,144,156,12,LGRQGPTVQIGG,0
1otu,B,181,203,22,AAAGLAAAFNAPLAGILFIIEE,0
1otu,B,216,231,15,AVFIGVIMSTIMYRI,0
1otu,B,232,252,20,NHEVALIDVGKLSDAPLNTL,0
1otu,B,253,274,21,LYLILGIIFGIFGPIFNKWVL,0
1otu,B,290,304,14,WVLMGGAIGGLCGL,0
1otu,B,305,318,13,GFVAPATSGGGFN,0
1otu,B,319,325,6,IPIATA,0
1otu,B,326,337,11,NFSMGMLVFIF,0
1otu,B,338,351,13,ARVITTLLCFSSG,0
1otu,B,353,365,12,GGIFAPMLALGT,0
1otu,B,366,392,26,LGTAFGMVAVELFPQYHLEAGTFAIA,0
1otu,B,393,415,22,MGALLAASIRAPLTGIILVLEM,0
1otu,B,416,422,6,DNYQLI,0
1otu,B,423,439,16,PMIITGLGATLLAQFT,0
1otu,B,459,465,6,QLARSK,0
1s00,H,1,10,9,VGVTAFGNF,0
1s00,H,16,32,16,IYSFWIFLAGLIYYLQ,0
1s00,H,33,256,223,ENMREGYPLENEDGTPAANQGPFPLPKPKTFILPHGRGTLTVPGPESEDRPIALARTAVSEGFPHAPTGDPMKDGVGPASWVARRDLPELDGHGHNKIKPMKAAAGFHVSAGKNPIGLPVRGCDLEIAGKVVDIWVDIPEQMARFLEVELKDGSTRLLPMQMVKVQSNRVHVNALSSDLFAGIPTIKSPTEVTLLEEDKICGYVAGGLMYAAPKRKSVVAAML,0
1s00,H,257,260,3,EYA,0
4rai,E,25,45,20,VLFVLTILTLISGTIFYSTV,0
4rai,E,51,70,19,DALYFSVVTLTTVGETPPP,0
4rai,E,74,101,27,GKIFTILYIFIGIGLVFGFIHKLAVNV,0
4rai,E,102,112,10,LPSILSNLVP,0
5jtb,A,-1,4,5,APPIM,0
5jtb,A,5,28,23,SSVYITVELAIAVLAILGNVLVC,0
5jtb,A,45,68,23,VSLAAADIAVGVLAIPFAITIST,0
5jtb,A,69,74,5,FCAAC,0
5jtb,A,75,97,22,GCLFIACFVLVLTQSSIFSLLA,0
5jtb,A,124,144,20,IAICWVLSFAIGLTPMLGWN,0
5jtb,A,145,171,26,CGQPKEGKNHSQGCGEGQVACLFEDV,0
5jtb,A,172,195,23,PMNYMVYFNFFACVLVPLLLMLG,0
5jtb,A,237,259,22,IVGLFALCWLPLHIINCFTFFC,0
5jtb,A,260,264,4,DCSH,0
5jtb,A,265,287,22,PLWLMYLAIVLSHTNSVVNPFI,0
5jtb,A,293,306,13,EFRQTFRKIIRSH,0
5jwy,A,1,4,3,RSI,0
5jwy,A,5,27,22,RRTAVGAALLLVMPVAVWISGW,0
5jwy,A,38,68,30,KAAFWVTETVTQPWGVITHLILFGWFLWCL,0
5jwy,A,69,75,6,FRIKAA,0
5jwy,A,76,100,24,VLFAILAAAILVGQGVKSWIKDKV,0
5jwy,A,145,154,9,YLRSHWQKE,0
5jwy,A,159,179,20,PSGHTMFAASWALLAVGLLW,0
5jwy,A,180,182,2,RR,0
5jwy,A,183,203,20,TLTIAILLVWATGVMGSRLL,0
5jwy,A,207,230,23,WPRDLVVATLISWALVAVATWLA,0
5jwy,A,231,240,9,RICGPLTPP,0
5jwy,A,241,258,17,EENREIAQREQESLEHH,0
2q7m,C,1,11,10,DQETVGNVVL,0
2q7m,C,12,34,22,AIVTLISVVQNGFFAHKVEHES,0
2q7m,C,54,75,21,TANQNCVDAYPTFLAVLWSAG,0
2q7m,C,76,82,6,LCSQVP,0
2q7m,C,83,103,20,AFAGLMYLFVRQKYFVGYLG,0
2q7m,C,109,128,19,PGYIFGKRIILFLFLMSVA,0
2q7m,C,129,149,20,IFNYYLIFFFGSDFENYIAT,0
2q7m,C,150,161,11,STTISPLLLIP,0
4r50,E,22,24,2,EF,0
4r50,E,25,45,20,VLFVLTILTLISGTIFYSTV,0
4r50,E,51,67,16,DALYFSVVTLTTVGET,0
4r50,E,74,98,24,GKIFTILYIFIGIGLVFGFIHKLA,0
4r50,E,99,101,2,NV,0
4r50,E,102,109,7,LPSILSN,0
5vdi,E,8,224,216,SPSDFLDKLMGRTSGYDARIRPNFKGPPVQVTCNIFINSFGSIAETTMDYRVNIFLRQKWNDPRLAYSEYPDDSLDLDPSMLDSIWKPDLFFANEKGANFHEVTTDNKLLRIFKNGNVLYSIRLTLTLSCPMDLKNFPMDVQTCIMQLESFGYTMNDLIFEWQDEAPVQVAEGLTLPQFLLKEEKDLRYCTKHYNTGKFTCIEVRFHLERQMGYYL,0
5vdi,E,225,244,19,QMYIPSLLIVILSWVSFWI,0
5vdi,E,249,269,20,PARVALGITTVLTMTTQSSG,0
5vdi,E,270,283,13,RASLPKVSYVKAI,0
5vdi,E,284,305,21,IWMAVCLLFVFSALLEYAAVN,0
5vdi,E,323,344,21,TISRACFPLAFLIFNIFYWVI,0
1s2y,A,1,2,1,S,0
1s2y,A,3,108,105,KCDVVVVGGGISGMAAAKLLHDSGLNVVVLEARDRVGGRTYTLRNQKVKYVDLGGSYVGPTQNRILRLAKELGLETYKVNEVERLIHHVKGKSYPFRGPFPPVWN,0
1s2y,A,109,126,17,ITYLDHNNFWRTMDDMG,0
1s2y,A,127,490,363,EIPSDAPWKAPLAEEWDNMTMKELLDKLCWTESAKQLATLFVNLCVTAETHEVSALWFLWYVKQCGGTTRIISTTNGGQERKFVGGSGQVSERIMDLLGDRVKLERPVIYIDQTRENVLVETLNHEMYEAKYVISAIPPTLGMKIHFNPPLPMMRNQMITRVPLGSVIKCIVYYKEPFWRKKDYCGTMIIDGEEAPVAYTLDDTKPEGNYAAIMGFILAHKARKLARLTKEERLKKLCELYAKVLGSLEALEPVHYEEKNWCEEQYSGGCYTTYFPPGILTQYGRVLRQPVDRIYFAGTETATHWSGYMEGAVEAGERAAREILHAMGKIPEDEIWQSEPESVDVPAQPITTTFLERHLPSVP,0
1s2y,A,491,501,10,LLRLIGLTTI,0
1s2y,A,502,520,18,SATALGFLAHKRGLLVRV,0
3eam,E,1,4,3,QDM,0
3eam,E,5,198,193,SPPPPIADEPLTVNTGIYLIECYSLDDKAETFKVNAFLSLSWKDRRLAFDPVRSGVRVKTYEPEAIWIPEIRFVNVENARDADVVDISVSPDGTVQYLERFSARVLSPLDFRRYPFDSQTLHIYLIVRSVDTRNIVLAVDLEKVGKNDDVFLTGWDIESFTAVVKPANFALEDRLESKLDYQLRISRQYFSYI,0
3eam,E,199,218,19,NIILPMLFILFISWTAFWS,0
3eam,E,222,240,18,ANVTLVVSTLIAHIAFNI,0
3eam,E,241,255,14,VETNLPKTPYMTYT,0
3eam,E,256,275,19,AIIFMIYLFYFVAVIEVTV,0
3eam,E,292,313,21,RASRIAFPVVFLLANIILAFL,0
3eam,E,314,315,1,F,0
3eam,E,316,317,1,F,0
5hld,A,73,75,2,IV,0
5hld,A,76,93,17,AVLIAIYGVYLDQKIRS,0
5hld,A,270,277,7,QLVKNLF,0
5sxv,E,211,225,14,LGLIIAASWSVFWL,0
5sxv,E,226,229,3,SFS,0
5sxv,E,230,245,15,RLQTSFTLMLTVVAY,0
5sxv,E,266,282,16,IAGYGSIFAAILLIIF,0
5sxv,E,283,299,16,HHRQANGVEDDLLIQR,0
5sxv,E,300,315,15,RLAFPLGFLAIGCVL,0
4u2q,D,8,388,380,SIQIGGLFPRGADQEYSAFRVGMVQFSTSEFRLTPHIDNLEVANSFAVTNAFCSQFSRGVYAIFGFYDKKSVNTITSFCGTLHVSFITPSFPTDGTHPFVIQMRPDLKGALLSLIEYYQWDKFAYLYDSDRGLSTLQAVLDSAAEKKWQVTAINVGNINNDKKDETYRSLFQDLELKKERRVILDCERDKVNDIVDQVITIGKHVKGYHYIIANLGFTDGDLLKIQFGGAEVSGFQIVDYDDSLVSKFIERWSTLEEKEYPGAHTATIKYTSALTYDAVQVMTEAFRNLRKQRIEISRRGNAGDCLANPAVPWGQGVEIERALKQVQVEGLSGNIKFDQNGKRINYTINIMELKTNGPRKIGYWSEVDKMVVTLTEDDTS,0
4u2q,D,392,525,133,KTVVVTTILESPYVMMKKNHEMLEGNERYEGYCVDLAAEIAKHCGFKYKLTIVGDGKYGARDADTKIWNGMVGELVYGKADIAIAPLTITLVREEVIDFSKPFMSLGISIMIKKPQKSKPGVFSFLDPLAYEI,0
4u2q,D,526,543,17,MAIVFAYIGVSVVLFLV,0
4u2q,D,595,614,19,LSARIVAGVWWFFTLIIIS,0
4u2q,D,615,629,14,YTANLAAFLTVERM,0
4u2q,D,633,777,144,ESAEDLSKQTEIAYGTLDSGSTKEFFRRSKIAVFDKMWTYMRSAEPSVFVRTTAEGVARVRKSKGKYAYLLESTMNEYIEQRKPCDTMKVGGNLDSKGYGIATPKGSSLGTPVNLAVLKLSEQGVLDKLKNKWWYDKGECGAKD,0
4u2q,D,782,792,10,KTSALSLSNV,0
4u2q,D,793,812,19,GVFYILVGGLGLAMLVALI,0
2a06,W,5,12,7,TARLYSL,0
2a06,W,19,39,20,FALTIVVGALFFERAFDQGA,0
2a06,W,40,62,22,AIYEHINEGKLWKHIKHKYENK,0
4iu8,A,1,11,10,ALQNEKNSRY,0
4iu8,A,38,54,16,SVSCLLLAFCVWMLFS,0
4iu8,A,55,76,21,VTVNLNKIGFNFTTDQLFLLT,0
4iu8,A,77,91,14,LPSVSGALLRVPYS,0
4iu8,A,103,118,15,VFSTAILIIPCVWLG,0
4iu8,A,119,132,13,AVQNPNTPFGIFI,0
4iu8,A,133,149,16,IALLCGFAGANFASSM,0
4iu8,A,167,183,16,NGGLGNLGVSVMQLVA,0
4iu8,A,184,212,28,LVIFVPVFAFLGVNGVPQADGSVMSLAN,0
4iu8,A,213,228,15,AWIWVPLLAIATIAA,0
4iu8,A,237,253,16,SRASIADQLPVLQRLH,0
4iu8,A,255,274,19,LLSLLYLATFGSFIGFSAG,0
4iu8,A,275,292,17,AMLAKTQFPDVNILRLA,0
4iu8,A,293,310,17,FGPFIGAIARSVGGAIS,0
4iu8,A,314,331,17,GVRVTLINFIFMAIFSA,0
4iu8,A,332,350,18,LFLTLPGTGSGNFIAFYA,0
4iu8,A,351,370,19,FMGLFLTAGLGSGSTFQMI,0
4iu8,A,387,390,3,SDE,0
4iu8,A,405,420,15,FISAIGAVGGFFIPQ,0
4iu8,A,421,438,17,FGMSLNMTGSPVGAMKV,0
4iu8,A,439,454,15,LIFYIVCVLLTWLVY,0
4iu8,A,455,468,13,RRKFSQKLEVLFQ,0
4gx0,F,4,17,13,QRGSAYFLRGRAR,0
4gx0,F,21,41,20,VLLLYCAFLLVMLLAYASIF,0
4gx0,F,42,55,13,YLMWHLEGRAYSF,0
4gx0,F,56,71,15,AGIYWTITVMTTLGF,0
4gx0,F,72,82,10,DITFESDAGY,0
4gx0,F,83,105,22,FASIVTVSGVIFLDIILPFGFV,0
4gx0,F,565,568,3,VPR,0
4knf,E,0,20,20,GKLLLILGSAIALPSFAAAG,0
4knf,E,21,32,11,DLDISDTVGVS,0
4knf,E,33,50,17,WLVTAGMLAATVFFFVE,0
4knf,E,61,77,16,LTVSGLITGIAFWHYL,0
4knf,E,78,93,15,MRGVWIDTGDTPTVF,0
4knf,E,94,110,16,YINWLLTVPLLVVEFY,0
4knf,E,123,139,16,FKKLLAGSLVMLGAGF,0
4knf,E,140,150,10,GEAGLAPVLP,0
4knf,E,151,169,18,FIIGMAGWLYMIYELYMG,0
4knf,E,189,206,17,MMIIVVGWAIYPAGYAA,0
4knf,E,207,212,5,YLMGG,0
4knf,E,213,214,1,G,0
4knf,E,215,220,5,YASNL,0
4knf,E,221,240,19,LIYNLADFVNKILFGLIIW,0
4knf,E,253,260,7,EHHHHHH,0
4pxk,C,3,8,5,PGSEG,0
4pxk,C,9,31,22,WLWLGTAGMFLGMLYFIARGWG,0
4pxk,C,39,60,21,FYIATILITAIAFVNYLAMAL,0
4pxk,C,61,76,15,FGLTFIEFGGEQHPI,0
4pxk,C,77,98,21,WARYTDWLFTTPLLLYNLGLL,0
4pxk,C,104,126,22,TIYSLVSLDVLMIGTGVVATLS,0
4pxk,C,127,137,10,GSGVLSAGAE,0
4pxk,C,138,160,22,LVWWGISTAFLLVLLYFLFSSL,0
4pxk,C,175,196,21,KTLRNLVTVVWLVYPVWWLVG,0
4pxk,C,197,207,10,EGLGLVGIGI,0
4pxk,C,208,229,21,TAGFMVIDLVAKVGFGIILLR,0
5a3r,A,51,77,26,LVIEQFEDLLVRILLLAACISFVLAW,0
5a3r,A,78,85,7,EEGEETI,0
5a3r,A,86,106,20,AFVEPFVILLILIANAIVGV,0
5a3r,A,254,274,20,EFGEQLSKVISLICVAVWLI,0
5a3r,A,275,296,21,IGHFNDPVHGGSWIRGAIYYF,0
5a3r,A,297,317,20,IAVALAVAAIPEGLPAVITT,0
5a3r,A,759,778,19,FIRYLISSNVGEVVCIFLT,0
5a3r,A,779,786,7,ALGLPEA,0
5a3r,A,787,807,20,IPVQLLWVNLVTDGLPATAL,0
5a3r,A,830,852,22,GWLFFRYMAIGGYVGAATVGAA,0
5a3r,A,853,897,44,WWFMYAEDGPGVTYHQLTHFMQCTEDHPHFEGLDCEIFEAPEPM,0
5a3r,A,898,916,18,MALSVLVTIEMCNALNSL,0
5a3r,A,932,954,22,LLGSICLSMSLHFLILYVDPLP,0
5a3r,A,955,961,6,IFKLKA,0
5a3r,A,962,987,25,DLTQWLMVLKISLPVIGLDEILKFI,0
5vex,A,136,145,9,PEEQLLFLY,0
5vex,A,146,169,23,IYTVGYALSFSALVIASAILLGF,0
5vex,A,176,199,23,NYIHLNLFASFILRALCVFFKDA,0
5vex,A,200,203,3,LKW,0
5vex,A,218,227,9,SYQDSLACR,0
5vex,A,265,287,22,FRLYVAIGWGVPLLFVVPWGIV,0
5vex,A,288,304,16,YLYEDEGCWTRNSNMN,0
5vex,A,305,332,27,WLIIRLPILFACIVNFLIFVRVICIVV,0
5vex,A,347,370,23,RLAKSTLTLIPLLCTHEVIFAFV,0
5vex,A,371,372,1,D,0
5vex,A,380,386,6,FIKLFT,0
5vex,A,387,407,20,LSFTSFQGLMVAILYCFVNN,0
5vex,A,408,421,13,VQLEFRKSWERWR,0
3gww,B,1,4,3,EVK,0
3gww,B,13,32,19,LILAMAGNAVGLGNFLRFP,0
3gww,B,33,43,10,QAAENGGGAF,0
3gww,B,44,63,19,IPYIIAFLLVGIPLMWIEW,0
3gww,B,90,124,34,KILGVFGLWIPLVVAIYYVYIESWTLGFAIKFLV,0
3gww,B,125,131,6,LVPEPP,0
3gww,B,132,136,4,NATD,0
3gww,B,137,166,29,DSILRPFKEFLYSYIGVPKGDEPILKPSL,0
3gww,B,167,185,18,AYIVFLITMFINVSILIR,0
3gww,B,191,212,21,ERFAKIAMPTLFILAVFLVIR,0
3gww,B,213,222,9,FLLETPNGT,0
3gww,B,223,230,7,ADGLNFL,0
3gww,B,231,241,10,TPDFEKLKDP,0
3gww,B,242,265,23,VWIAAVGQIFFTLSLGFGAIITY,0
3gww,B,278,297,19,GLTAATLNEKAEVILGGSI,0
3gww,B,298,325,27,IPAAVAFFGVANAVAIAKAGAFNLGFI,0
3gww,B,326,331,5,LPAIF,0
3gww,B,332,339,7,QTAGGTF,0
3gww,B,340,366,26,GFLWFFLLFFAGLTSSIAIMQPMIAF,0
3gww,B,378,396,18,VLWTAAIVFFSAHLVMFL,0
3gww,B,397,399,2,KS,0
3gww,B,400,425,25,DEMDFWAGTIGVVFFGLTELIIFFW,0
3gww,B,429,437,8,DKAWEEIN,0
3gww,B,445,469,24,RIYYYVMRYITPAFLAVLLVVWAR,0
3gww,B,470,471,1,Y,0
3gww,B,472,477,5,PKIME,0
3gww,B,478,483,5,THWTV,0
3gww,B,484,502,18,ITRFYIIGLFLFLTFLVF,0
3gww,B,602,605,3,AGT,0
5ah3,C,4,32,28,FTGTGTGGDVFKVDLNEQFDRADMVWIG,0
5ah3,C,33,50,17,ASVLVWIMIPGVGLLYS,0
5ah3,C,62,84,22,WAALMAACVAAFQWFWWGYSLV,0
5ah3,C,85,120,35,AHNGSVFLGTLQNFCLKDVLGAPSIVKTVPDILFC,0
5ah3,C,121,139,18,YQGMFAAVTAILMAGAGC,0
5ah3,C,145,166,21,PMMVFLFIWLTVVYCPIAYWT,0
5ah3,C,167,180,13,GGNGWLVSLGALD,0
5ah3,C,181,201,20,AGGGPVHENSGFAALAYSLW,0
5ah3,C,224,242,18,IVMGTIFLWFGWYGFNGG,0
5ah3,C,243,254,11,TGNSSMRSWYA,0
5ah3,C,255,275,20,VNTNLAAATGGLTWMLVDWF,0
5ah3,C,284,301,17,GLCMGAIAGLVGITPAA,0
5ah3,C,302,306,4,YVPV,0
5ah3,C,307,324,17,TSVIFGIVPAIICNFAV,0
5ah3,C,336,356,20,DVWALHGVGGFVGNFMTGLF,0
5ah3,C,357,381,24,ADYVAMIDGTEIDGGWMNHHWKQL,0
5ah3,C,382,409,27,YQLAGSCAVAAWSFTVTSIILLAMDRI,0
5fn5,C,11,26,15,VAFGPAFALFLITVA,0
5fn5,C,27,32,5,DPLRV,0
5fn5,C,33,52,19,ILVAGAFFWLVSLLLASVV,0
5fn5,C,77,91,14,VSVLLQEVFRFAYY,0
5fn5,C,92,119,27,LLKKADEGLASLSEDGRSPISIRQMAY,0
5fn5,C,120,134,14,SGLSFGIISGVFSV,0
5fn5,C,162,178,16,LTAAIILLHTFWGVVF,0
5fn5,C,179,187,8,DACERRRY,0
5fn5,C,188,202,14,ALGLVVGSHLLTSG,0
5fn5,C,216,229,13,IYAVTVSMGLWAF,0
5fn5,C,230,235,5,TAGGS,0
5fn5,C,236,242,6,RSIQRS,0
5fn5,C,243,244,1,L,0
5svj,C,21,27,6,TIGIIN,0
5svj,C,28,47,19,VVQLLIISYFVGWVFLHEK,0
5svj,C,316,343,27,NIIPTIISSVAAFTSVGVGTVLCDIIL,0
5svj,C,344,346,2,NF,0
3e8g,E,19,22,3,KDK,0
3e8g,E,23,25,2,FQ,0
3e8g,E,26,45,19,LFVLTILTLISGTIFYSTV,0
3e8g,E,51,67,16,DALYFSVVTLTTVGDG,0
3e8g,E,75,96,21,GKIFTILYIFIGIGLVFGFIH,0
3e8g,E,97,103,6,LAVNVQ,0
3e8g,E,104,110,6,PSILSN,0
3e8g,E,111,113,2,VP,0
4lep,B,1,9,8,TLGTNQVS,0
4lep,B,10,18,8,THSFMTVS,0
4lep,B,19,33,14,IELWERFGYYGMQA,0
4lep,B,55,69,14,ACAALIYVSPAIGG,0
4lep,B,70,81,11,VGDKILGTKRT,0
4lep,B,82,96,14,LLGAGILSVGYALM,0
4lep,B,109,122,13,LGVIVVGNGLFKP,0
4lep,B,123,146,23,AGNLVRKIYEGDDSKIDSAFTIY,0
4lep,B,147,161,14,MAVNVGSTFSMLLT,0
4lep,B,183,198,15,VCCVGILVGLGNYAL,0
4lep,B,199,208,9,HKSLANYGS,0
4lep,B,209,213,4,PDTR,0
4lep,B,214,220,6,VNKKSL,0
4lep,B,221,238,17,IVLALAALSVVASAIIL,0
4lep,B,244,261,17,RVFVYAAGVAVLGIFFH,0
4lep,B,262,265,3,IRT,0
4lep,B,266,267,1,E,0
4lep,B,268,277,9,SERAGLIAA,0
4lep,B,278,295,17,ILTVQTVFFFIFYQQMS,0
4lep,B,311,316,5,VFGTH,0
4lep,B,325,340,15,QALNPIWIMVLSPVL,0
4lep,B,341,343,2,WS,0
4lep,B,344,354,10,SWAGRNNKDF,0
4lep,B,355,358,3,IAA,0
4lep,B,359,373,14,FALGFAVVAIGFFI,0
4lep,B,393,408,15,GYASYSLGELLVSGL,0
4lep,B,409,415,6,LAMIAR,0
4lep,B,416,421,5,VPARM,0
4lep,B,422,427,5,GFMMG,0
4lep,B,428,441,13,YFVASGISQYLGG,0
4lep,B,471,484,13,VAAVVCTIIALAV,0
4lep,B,485,491,6,PLMRRL,0
4lep,B,492,523,31,ESHHAHSSIENNAAASLRDVKAEQAENLYFQ,0
3eml,A,-14,2,16,YKDDDDAMGQPVGAPP,0
3eml,A,8,30,22,YITVELAIAVLAILGNVLVCWA,0
3eml,A,31,41,10,WLNSNLQNVT,0
3eml,A,42,66,24,YFVVSLAAADIAVGVLAIPFAITI,0
3eml,A,79,103,24,IACFVLVLTQSSIFSLLAIAIDRY,0
3eml,A,104,120,16,AIRIPLRYNGLVTGTR,0
3eml,A,121,143,22,KGIIAICWVLSFAIGLTPMLGW,0
3eml,A,149,155,6,KEGKNH,0
3eml,A,176,202,26,MVYFNFFACVLVPLLLMLGVYLRIFL,0
3eml,A,203,232,29,ARRQLNIFEMLRIDEGLRLKIYKDTEGYYTIGIGHLLTKSPSLNAAKSELDKAIGRNTNGVITKDEAEKLFNQDVDAAVRGILRNAKLKPVYDSLDAVRRAALINMVFQMGETGVAGFTNSLRMLQQKRWDEAAVNLAKSRWYNQTPNRAKRVITTFRTGTWDAYRSTLQKEVHAA,0
3eml,A,233,254,21,SLAIIVGLFALCWLPLHIINC,0
3eml,A,270,291,21,YLAIVLSHTNSVVNPFIYAYR,0
3eml,A,293,305,12,EFRQTFRKIIRS,0
3eml,A,306,310,4,VLRQ,0
3eml,A,311,326,15,EPFKAHHHHHHHHHH,0
1c8s,C,5,11,6,GRPEWI,0
1c8s,C,12,28,16,LALGTALMGLGTLYFL,0
1c8s,C,48,62,14,VPAIAFTMYLSMLL,0
1c8s,C,63,79,16,YGLTMVPFGGEQNPIY,0
1c8s,C,80,93,13,ARYADWLFTTPLL,0
1c8s,C,112,127,15,GADGIMIGTGLVGAL,0
1c8s,C,128,133,5,KVYSY,0
1c8s,C,134,149,15,FVWWAISTAAMLYIL,0
1c8s,C,178,192,14,VVLWSAYPVVWLIG,0
1c8s,C,193,203,10,EGAGIVPLNI,0
1c8s,C,204,220,16,TLLFMVLDVSAKVGFG,0
4r8c,E,28,45,17,VLTILTLISGTIFYSTV,0
4r8c,E,46,50,4,GLRP,0
4r8c,E,51,70,19,DALYFSVVTLTTVGETPPP,0
4r8c,E,71,73,2,TD,0
4r8c,E,74,94,20,GKIFTILYIFIGIGLVFGFI,0
1at9,C,2,9,7,ITGRPEW,0
1at9,C,10,32,22,WLALGTALMGLGTLYFLVKGMG,0
1at9,C,42,66,24,AITTLVPAIAFTMYLSMLLGYGLT,0
1at9,C,67,78,11,VPFGGEQNPIY,0
1at9,C,79,98,19,ARYADWLFTTPLLLLDLAL,0
1at9,C,106,128,22,ILALVGADGIMIGTGLVGALTK,0
1at9,C,129,133,4,YSYR,0
1at9,C,134,156,22,VWWAISTAAMLYILYVLFFGFT,0
1at9,C,172,193,21,LRNVTVVLWSAYPVVWLIGSE,0
1at9,C,194,202,8,AGIVPLNI,0
1at9,C,203,225,22,TLLFMVLDVSAKVGFGLILLRS,0
1at9,C,232,248,16,EAPEPSAGDGAAATS,0
5hwy,A,7,27,20,YFLLGLILLYYGSDWFVLGS,0
5hwy,A,28,39,11,RIARHFNVSNF,0
5hwy,A,40,58,18,IGATVMAIGTSLPEILTS,0
5hwy,A,74,93,19,IGSCICNIGLVLGLSAIIS,0
5hwy,A,94,102,8,IIVDKNLQ,0
5hwy,A,103,120,17,NILVYLLFVIFAAVIGI,0
5hwy,A,127,144,17,GVVLLILFIIYLRWTVK,0
5hwy,A,145,162,17,GSAEIEENNDKNNPSVV,0
5hwy,A,163,183,20,SLVLLIIGLIGVLVGAELFV,0
5hwy,A,206,222,16,FGTSLPELMVSLAAAK,0
5hwy,A,223,226,3,NLG,0
5hwy,A,227,247,20,MVLGNVIGSNIADIGGALAV,0
5hwy,A,259,275,16,QMAVLVIMSLLLYLFA,0
5hwy,A,276,280,4,YSKI,0
5hwy,A,281,299,18,RWQGILFLALYIIAIASL,0
2zjs,E,1,11,10,FARLIRYFQE,0
2zjs,E,12,31,19,RAELARVTWPTREQVVEGT,0
2zjs,E,32,52,20,AILLFTLAFMVILGLYDTVF,0
2zjs,E,58,60,2,LR,0
4p6j,B,5,22,17,AHALFSALFALSELYIA,0
4yk5,C,7,15,8,MSSPALPA,0
4yk5,C,16,32,16,LLCSTLLVIKMYVVAI,0
4yk5,C,73,90,17,NDMETIYPFLFLGFVYS,0
4yk5,C,91,97,6,LGPNPF,0
4yk5,C,98,115,17,AWMHFLVFLVGRVAHTV,0
4yk5,C,129,146,17,YTLAQLPCASMALQILW,0
4yk5,C,147,152,5,AARHL,0
2jlo,A,1,9,8,NSTPIEEA,0
2jlo,A,31,45,14,LAAIWFAMAIQVAI,0
2jlo,A,46,62,16,IAAGQMTSSFQVWQVI,0
2jlo,A,63,76,13,AIAAGCTIAVILL,0
2jlo,A,109,130,21,KALLSLFWFGFQTWLGALALD,0
2jlo,A,131,142,11,ITRLLTGFTNL,0
2jlo,A,143,157,14,LWIVIFGAIQVVTT,0
2jlo,A,164,179,15,RWMNVFASPVLLAMG,0
2jlo,A,180,210,30,YMVYLMLDGADVSLGEVMSMGGENPGMPFS,0
2jlo,A,211,227,16,AIMIFVGGWIAVVVSI,0
2jlo,A,254,268,14,AQWLGMVPASIIFG,0
2jlo,A,269,304,35,IGAASMVLVGEWNPVIAITEVVGGVSIPMAILFQV,0
2jlo,A,305,322,17,VLLATWSTNPAANLLSP,0
2jlo,A,341,356,15,VSAVVGLLMMPWQFA,0
2jlo,A,357,361,4,VLNT,0
2jlo,A,362,375,13,LNLLASALGPLAG,0
2jlo,A,416,437,21,VALAVSFLTPDLMFVTGLIAA,0
2jlo,A,471,501,30,VAPADESATANTKEQNQPAGGRGSHHHHHH,0
2htk,B,1,17,16,KTDTPSLETPQAARLR,0
2htk,B,18,39,21,RQLIRQLLERDKTPLAILFMA,0
2htk,B,40,61,21,VVGTLVGLAAVAFDKGVAWLQ,0
2htk,B,83,97,14,LCSAVLAMFGYFLV,0
2htk,B,98,128,30,KYAPEAGGSGIPEIEGALEDQRPVRWWRVL,0
2htk,B,129,142,13,VKFFGGLGTLGGG,0
2htk,B,144,155,11,LGREGPTVQIG,0
2htk,B,156,180,24,NIGRMVLDIFRLKGDEARHTLLAT,0
2htk,B,181,203,22,AAAGLAAAFNAPLAGILFIIEE,0
2htk,B,204,215,11,RPQFRYTLISI,0
2htk,B,216,232,16,AVFIGVIMSTIMYRIF,0
2htk,B,253,273,20,LYLILGIIFGIFGPIFNKWV,0
2htk,B,274,284,10,GMQDLLHRVH,0
2htk,B,285,290,5,GNITK,0
2htk,B,291,305,14,VLMGGAIGGLCGLL,0
2htk,B,317,324,7,NLIPIAT,0
2htk,B,337,351,14,VARVITTLLCFSSG,0
2htk,B,353,368,15,GGIFAPMLALGTVLG,0
2htk,B,392,415,23,GMGALLAASIRAPLTGIILVLEM,0
2htk,B,423,439,16,PMIITGLGATLLAQFT,0
2htk,B,440,458,18,GKPLASAILARTLAKQEA,0
2htk,B,459,473,14,QLARSKAASASENT,0
3gb7,F,1,21,20,APMLSGLLARLVKLLLGRHG,0
3gb7,F,26,50,24,RAAGAATVLLVIVLLAGSYLAVLA,0
3gb7,F,51,62,11,RGAPGAQLITY,0
3gb7,F,63,78,15,RALWWSVETATTVGY,0
3gb7,F,79,86,7,DLYPVTL,0
3gb7,F,87,111,24,GRCVAVVVMVAGITSFGLVTAALA,0
5d5a,A,32,56,24,VVGMGIVMSLIVLAIVFGNVLVIT,0
5d5a,A,57,70,13,IAKFERLQTVTNY,0
5d5a,A,71,95,24,ITSLACADLVMGLAVVPFGAAHIL,0
5d5a,A,105,129,24,CEFWTSIDVLCVTASIETLCVIAV,0
5d5a,A,130,151,21,RYFAITSPFKYQSLLTKNKAR,0
5d5a,A,152,175,23,IILMVWIVSGLTSFLPIQMHWYR,0
5d5a,A,179,186,7,EAINCYA,0
5d5a,A,196,220,24,QAYAIASSIVSFYVPLVIMVFVYS,0
5d5a,A,221,274,53,VFQEAKRQLNIFEMLRIDEGLRLKIYKDTEGYYTIGIGHLLTKSPSLNAAKSELDKAIGRNTNGVITKDEAEKLFNQDVDAAVRGILRNAKLKPVYDSLDAVRRAALINMVFQMGETGVAGFTNSLRMLQQKRWDEAAVNLAKSRWYNQTPNRAKRVITTFRTGTWDAYKFCLKEHKALKT,0
5d5a,A,275,299,24,GIIMGTFTLCWLPFFIVNIVHVIQ,0
5d5a,A,306,327,21,VYILLNWIGYVNSGFNPLIYC,0
5d5a,A,328,329,1,S,0
5d5a,A,330,339,9,DFRIAFQEL,0
5d5a,A,340,342,2,CL,0
3pbl,A,-8,31,39,YKDDDDGAPASLSQLSSHLNYTCGAENSTGASQARPHAY,0
3pbl,A,35,52,17,YCALILAIVFGNGLVCM,0
3pbl,A,53,67,14,VLKERALQTTTNYL,0
3pbl,A,68,84,16,VSLAVADLLVATLVMP,0
3pbl,A,109,123,14,DVMMCTASIWNLCA,0
3pbl,A,124,151,27,SIDRYTAVVMPVHYQHGTGQSSCRRVA,0
3pbl,A,152,166,14,MITAVWVLAFAVSC,0
3pbl,A,191,206,15,SSVVSFYLPFGVTVL,0
3pbl,A,207,333,126,YARIYVVLKQRRRKNIFEMLRIDEGLRLKIYKDTEGYYTIGIGHLLTKSPSLNAAKSELDKAIGRNTNGVITKDEAEKLFNQDVDAAVRGILRNAKLKPVYDSLDAVRRAALINMVFQMGETGVAGFTNSLRMLQQKRWDEAAVNLAKSRWYNQTPNRAKRVITTFRTGTWDAYGVPLREKKATQMVAI,0
3pbl,A,334,347,13,LGAFIVCWLPFFL,0
3pbl,A,368,382,14,TWLGYVNSALNPVI,0
3pbl,A,383,387,4,TTFN,0
3pbl,A,388,398,10,EFRKAFLKIL,0
3pbl,A,399,400,1,C,0
3pbl,A,401,409,8,RPLEVLFQ,0
3wfb,C,1,4,3,SET,0
3wfb,C,10,26,16,RNIYFGGSVFFILLFL,0
3wfb,C,27,146,119,LTYHTEKTLPERTNEAAMSAAVVRGKLVWEQNNCVGCHTLLGEGAYFAPELGNVVGRRGGEEGFNTFLQAWMKIQPLNVPGRRAMPQFHLSEGQVDDLAEFLKWSSKIDTNQWPPNKEG,0
3g5u,A,1,32,31,ELEEDLKGRADKNFSKMGKKSKKEKKEKKPA,0
3g5u,A,45,68,23,DRLYMLVGTLAAIIHGVALPLMM,0
3g5u,A,69,113,44,IFGDMTDSFASVGNVSKNSTNMSEADKRAMFAKLEEEMTTYAYY,0
3g5u,A,114,132,18,TGIGAGVLIVAYIQVSFW,0
3g5u,A,184,203,19,KIGMFFQAMATFFGGFIIG,0
3g5u,A,204,214,10,TRGWKLTLVI,0
3g5u,A,215,234,19,AISPVLGLSAGIWAKILSS,0
3g5u,A,291,310,19,NISMGAAFLLIYASYALAF,0
3g5u,A,311,331,20,YGTSLVISKEYSIGQVLTVF,0
3g5u,A,332,349,17,SVLIGAFSVGQASPNIE,0
3g5u,A,627,683,56,GNEIELGNEACKSKDEIDNLDMSSKDSGSSLIRRRSTRKSICGPHDQDRKLSTKEA,0
3g5u,A,695,702,7,ILKLNST,0
3g5u,A,708,728,20,VGIFCAIINGGLQPAFSVIF,0
3g5u,A,729,752,23,KVVGVFTNGGPPETQRQNSNLFS,0
3g5u,A,753,773,20,LFLILGIISFITFFLQGFTF,0
3g5u,A,829,847,18,AVIFQNIANLGTGIIISL,0
3g5u,A,848,851,3,YGW,0
3g5u,A,852,872,20,LTLLLLAIVPIIAIAGVVEM,0
3g5u,A,933,953,20,FGITFSFTQAMMYFSYAAAF,0
3g5u,A,954,972,18,FGAYLVTQQLMTFENVLL,0
3g5u,A,973,990,17,FSAIVFGAMAVGQVSSF,0
3g5u,A,1272,1284,12,AKRSYVHHHHHH,0
5c2t,D,28,55,27,SAAVTGAAPPQFDPIAAEKGFKPLHSH,0
5c2t,D,56,79,23,TLFKIERYFAAAMVPLIPAAYFI,0
5c2t,D,84,110,26,DLCLALALTLHVHWGVWGVVNDYGRP,0
5c2t,D,111,112,1,V,0
5c2t,D,113,137,24,GDTLAAAVRVGAYIFTACLLAGLL,0
5c2t,D,146,154,8,TRAFEMVW,0
5d57,C,34,48,14,GVAVLLCVVIAAWL,0
5d57,C,49,52,3,VDA,0
5d57,C,53,67,14,TRVLLISSVMLVMI,0
5d57,C,103,117,14,AIIDAVITWAILLW,0
5d57,C,118,121,3,HFG,0
4rym,A,9,27,18,VFFLTYGLFYVSSVLFPI,0
4rym,A,29,34,5,TWYDA,0
4rym,A,35,44,9,EKPSWTPPG,0
4rym,A,45,65,20,TIGMIWAVLFGLIALSVAII,0
4rym,A,75,96,21,FWFLFLLNYIFNQAFSYFQFS,0
4rym,A,97,101,4,KNLF,0
4rym,A,102,122,20,ATVDCLLVAITTLLLIMFSS,0
4rym,A,127,147,20,SAWLLIPYFLWSAFATYLSW,0
4rym,A,148,153,5,IYSIN,0
1qhj,C,1,4,3,AQI,0
1qhj,C,5,12,7,GRPEWIW,0
1qhj,C,13,30,17,ALGTALMGLGTLYFLVK,0
1qhj,C,45,60,15,TTLVPAIAFTMYLSM,0
1qhj,C,61,80,19,LGYGLTMVPFGGEQNPIYW,0
1qhj,C,81,96,15,RYADWLFTTPLLLLD,0
1qhj,C,110,125,15,LVGADGIMIGTGLVG,0
1qhj,C,126,135,9,LTKVYSYRF,0
1qhj,C,136,152,16,WWAISTAAMLYILYVL,0
1qhj,C,175,191,16,NVTVVLWSAYPVVWLI,0
1qhj,C,192,204,12,SEGAGIVPLNIE,0
1qhj,C,205,222,17,LLFMVLDVSAKVGFGLI,0
1qhj,C,233,248,15,EAPEPSAGDGAAATS,0
5vpn,H,0,12,12,INPNPKRSDEPV,0
5vpn,H,13,33,20,WGLFGAGGMWSAIIAPVMIL,0
5vpn,H,65,86,21,FLFLMIVLPLWCGLHRMHHAM,0
5vpn,H,87,93,6,DLKIHV,0
5vpn,H,94,116,22,AGKWVFYGLAAILTVVTLIGVV,0
5tin,E,8,224,216,SPSDFLDKLMGRTSGYDARIRPNFKGPPVQVTCNIFINSFGSIAETTMDYRVNIFLRQKWNDPRLAYSEYPDDSLDLDPSMLDSIWKPDLFFANEKGANFHEVTTDNKLLRIFKNGNVLYSIRLTLTLSCPMDLKNFPMDVQTCIMQLESFGYTMNDLIFEWQDEAPVQVAEGLTLPQFLLKEEKDLRYCTKHYNTGKFTCIEVRFHLERQMGYYL,0
5tin,E,225,244,19,QMYIPSLLIVILSWVSFWI,0
5tin,E,249,269,20,PARVALGITTVLTMTTQSSG,0
5tin,E,270,283,13,RASLPKVSYVKAI,0
5tin,E,284,305,21,IWMAVCLLFVFSALLEYAAVN,0
5tin,E,323,344,21,TISRACFPLAFLIFNIFYWVI,0
4wis,B,19,129,110,VDFVIHYKVPAAERDEAEAGFVQLIRALTTVGLATEVRHGENESLLVFVKVASPDLFAKQVYRARLGDWLHGVRVSAPHNDIAQALQDEPVVEAERLRLIYLMITKPHNE,0
4wis,B,141,195,54,KHVESIFPLHSHSFNKEWIKKWSSKYTLEQTDIDNIRDKFGESVAFYFAFLRSY,0
4wis,B,196,215,19,RFLVIPSAFGFGAWLLLGQ,0
4wis,B,217,233,16,YLYALLCGLWSVVFFE,0
4wis,B,234,286,52,WKKQEVDLAVQWGVRGVSSIQQSRPEFEWEHEAEDPITGEPVKVYPPMKRVK,0
4wis,B,287,318,31,QLLQIPFALACVVALGALIVTCNSLEVFINE,0
4wis,B,325,354,29,QYLGFLPTIFLVIGTPTISGVLMGAAEKL,0
4wis,B,355,370,15,AMENYATVDAHDAAL,0
4wis,B,371,397,26,QKQFVLNFMTSYMALFFTAFVYIPFG,0
4wis,B,398,415,17,ILHPFLNFWRATAQTLT,0
4wis,B,430,455,25,ARISNQMFYFTVTAQIVNFATEVVV,0
4wis,B,456,463,7,YIKQQAF,0
4wis,B,483,505,22,EFLQRVREECTLEEYDVSGDYR,0
4wis,B,506,521,15,MVMQFGYVAMFSVAW,0
4wis,B,523,535,12,AACCFLVNNWVE,0
4wis,B,536,561,25,RSDALKIAISSRRPIPWRTDSIGPW,0
4wis,B,562,585,23,TALSFLSWLGSITSSAIVYLCSN,0
4wis,B,597,621,24,KAWGLLLSILFAEHFYLVVQLAVR,0
4wis,B,622,656,34,VLSKLDSPGLQKERKERFQTKKRLLQENLGQDAA,0
4wis,B,660,684,24,APGIEHSEKITREALEEEARQASI,0
4wis,B,692,719,27,MFWQRQRGMQETIEIGRRMIEQQLAAG,0
2zd9,D,1,6,5,SVLPF,0
2zd9,D,16,28,12,LAAPGLLAVAAL,0
2zd9,D,29,40,11,IPDMSGRSRLA,0
2zd9,D,41,54,13,AALLAVIWGAYLL,0
2zd9,D,80,92,12,AVLVPLAAFLLD,0
2zd9,D,93,97,4,SPDW,0
2zd9,D,98,108,10,LYCAVWLLKP,0
2zd9,D,134,149,15,LFGVVLFAVALAAYV,0
2zd9,D,150,165,15,ERDIQPEKFGSIPQA,0
2zd9,D,166,178,12,WWAVVTLSTTGY,0
2zd9,D,179,187,8,DTIPQSFA,0
2zd9,D,188,203,15,RVLAGAVMMSGIGIF,0
2zd9,D,232,355,123,VPLFQKLGPAVLVEIVRALRARTVPAGAVICRIGEPGDRMFFVVEGSVSVATPNPVELGPGAFFGEMALISGEPRSATVSAATTVSLLSLHSADFQMLCSSSPEIAEIFRKTALERRGAAASA,0
2mgy,A,9,28,19,GLTLVPSLGGFMGAYFVRG,0
2mgy,A,29,40,11,GLRWYAGLQKP,0
2mgy,A,41,61,20,WHPPRWTLAPIWGTLYSAMG,0
2mgy,A,82,102,20,GLYTGQLALNWAWPPIFFGA,0
2mgy,A,103,106,3,QMG,0
2mgy,A,107,128,21,ALADLLLVSGVATATTLAWHR,0
2mgy,A,134,153,19,RLLYPYLAWLAFATVLNYY,0
2mgy,A,154,169,15,WRDNSGRRGGSRLAE,0
2b6u,A,1,11,10,NTTVMQGFNR,0
2b6u,A,12,25,13,ERCPRDTRIVQLV,0
2b6u,A,26,49,23,PALYTVVFLTGILLNTLALWVFV,0
2b6u,A,60,80,20,LKNTLVADLIMTLMLPFKIL,0
2b6u,A,81,94,13,DSHLAPWQLRAFV,0
2b6u,A,95,118,23,RFSSVIFYETMYVGIVLLGLIAF,0
2b6u,A,141,164,23,VSIFIWFFLFFISLPNMILSNKE,0
2b6u,A,165,183,18,TPSSVKKCASLKGPLGLK,0
2b6u,A,184,208,24,HQMVNNICQFIFWTVFILMLVFYV,0
2b6u,A,236,256,20,FVVVAVFFVCFAPFHFARVP,0
2b6u,A,257,278,21,THSQTNNKTDCRLQNQLFIAK,0
2b6u,A,279,299,20,TTLFLAATNICMDPLIYIFL,0
2b6u,A,305,333,28,KLPCMQGRKTTASSQENHSSQTDNITLG,0
2iqp,A,51,73,22,VTLGVISLLENILVIVAIAKNK,0
2iqp,A,74,78,4,LHSP,0
2iqp,A,79,98,19,YFFICSLAVADMLVSVSNG,0
2iqp,A,125,149,24,DSVICSSLLASICSLLSIAVDRYF,0
2iqp,A,150,163,13,IFYALQYHNIMTV,0
2iqp,A,164,187,23,RVGIIISCIWAACTVSGILFIIY,0
2iqp,A,193,217,24,IICLITMFFTMLALMASLYVHMFL,0
2iqp,A,218,240,22,ARLHIKRIAVLPGTGAIRQGAN,0
2iqp,A,241,263,22,KGAITLTILIGVFVVCWAPFFL,0
2iqp,A,288,310,22,ILIMCNSIIDPLIYALRSQELR,0
2iqp,A,311,317,6,TFKEII,0
2iqp,A,318,321,3,CYP,0
1p7b,D,1,35,34,NVDPFSPHSSDSFAQAASPARKPPRGGRRIWSGT,0
1p7b,D,47,57,10,WRDLYYWALK,0
1p7b,D,61,85,24,VFFASLAALFVVNNTLFALLYQLG,0
1p7b,D,86,97,11,APIANQSPPGF,0
1p7b,D,98,114,16,GAFFFSVETLATVGYG,0
1p7b,D,115,121,6,MHPQTV,0
1p7b,D,122,145,23,AHAIATLEIFVGMSGIALSTGLV,0
1p7b,D,196,205,9,REHSSEGYS,0
1p7b,D,290,295,5,DVDGM,0
1p7b,D,310,333,23,PPGAAPDAQAFAAKPGEGDARPV,0
5uar,A,1,10,9,QRSPVEDAN,0
5uar,A,11,16,5,LSRYF,0
5uar,A,17,84,67,WWTNPIMRKGFKEKLRPSDVYQAPSQDAADILAERLEKEWDREVASGKKKPSLLRAMARCYIKPFLL,0
5uar,A,85,103,18,GFLLYIGEATKTVQPQLL,0
5uar,A,126,142,16,GLGLLFTARFLLLQPA,0
5uar,A,143,200,57,FGLHHLGMQIRIALFSIIYKKTLKLSSRVLDKISTGQLVSLMSANLGKFDQSLGMAH,0
5uar,A,201,217,16,IWISPLQCILCTGLIW,0
5uar,A,223,238,15,SFCALAAISLLGVLQ,0
5uar,A,239,306,67,FLSHKMGPYKAQKVLLTNKRLALTSEIMENLHSVKAYGWEEIMETLIKNIRQDEVKLTRKIGSLRYF,0
5uar,A,307,323,16,SSAYFFSAIFVIVAAV,0
5uar,A,339,355,16,TLSYCMVLRMTVTRQL,0
5uar,A,356,402,46,GSIQMWYDTMRLIWKIEEFLSKEEYKLMEYDLSITELELQDVTASW,0
5uar,A,437,669,232,PVLKDISLKLKKGEMLAVTGSMGSGKSSLLMTILGELVPSSGKIRHSGRISYSSQTAWIMPGTIRDNILFGLTYDEYRYKSVVKACQLEEDLAALPEKDKTPMAEGGLNLSGGQKARVALARAVYRDADLYLLDAPFTHLDIATEKEIFDKCLCKLMASKTRILVTNKIEHLKRADKILLLHNGESFFYGTFPELQSERPDFSSLLLGLEAYDNISAERRCSILTETLHRVS,0
5uar,A,841,844,3,TKW,0
5uar,A,845,852,7,TYVRYVS,0
5uar,A,853,859,6,NKSLLY,0
5uar,A,860,876,16,LIFILFIAAIEIAGSV,0
5uar,A,927,943,16,VATSESLLAMGFFRGL,0
5uar,A,944,1001,57,FVHTTITISKKLHQKMLHAVLSAPMSVLNTMKTGRIMNRFTKDMATIDDMLPLLMFD,0
5uar,A,1002,1021,19,VQLTVVVVGCILVVSIVRP,0
5uar,A,1023,1037,14,FLAATPLAIIFIVM,0
5uar,A,1038,1108,70,KYFLRTGQQLKQLETEARSPIFSHLIMSLKGLWTIRAFERQAYFEALFHKTLNTHTATWFLYLSTLRWFL,0
5uar,A,1109,1125,16,RADILFVFFFTLAAWI,0
5uar,A,1140,1155,15,ICLAMLILGTFQWCV,0
5uar,A,1156,1180,24,TSIAVDGMMRSVDRVFKFIDLPSE,0
5uar,A,1203,1437,234,SWPHRGQIEVRNLTVKYTEAGHAVLKNLSFSAEGRQRVGILGRTGSGKSSLFNALLKLVYTDGEISIDGVNWNKMPLQKWRKAFGVVPQKVFIFTGPLRMNLDPYGCHSDEELWRVAEEVGLKTVIEQFPDKLDFQLEYGGYVLSNGHKQLICLARSILSGARILLLDEPSAHLDPVTIKVLKKTLRQSFSTCTILLSEHKVEPLLECQSFLMMDKGQVKTYDSIQKLLNETSH,0
3zuy,A,2,7,5,ILSKI,0
3zuy,A,8,26,18,SFIGKTFSLWAALFAAAA,0
3zuy,A,34,39,5,WAGPY,0
3zuy,A,40,55,15,PWLLGIIMFGMGLTL,0
3zuy,A,56,70,14,PSDFDILFKHPKVV,0
3zuy,A,71,88,17,IGVIAQFAIMPATAWLL,0
3zuy,A,103,118,15,LVGCCPGGTASNVMT,0
3zuy,A,119,128,9,LARGNVALS,0
3zuy,A,129,147,18,AVTSVSTLISPLLTPAIF,0
3zuy,A,163,181,18,MSIVKMVLLPIVLGLIVH,0
3zuy,A,182,191,9,VLGSKTEKL,0
3zuy,A,192,209,17,DALPLVSVAAIVLIIGA,0
3zuy,A,215,221,6,GKIMES,0
3zuy,A,227,247,20,VVVLHNGIGYLLGFFAAKWT,0
3zuy,A,248,254,6,LPYDAQ,0
3zuy,A,255,272,17,TLTIEVGMQNSGLAAAL,0
3zuy,A,287,304,17,ALFSVWHNISGSLLATY,0
3zuy,A,305,309,4,AAKA,0
3zuy,A,310,323,13,KHKKPGSENLYFQ,0
2lor,A,41,54,13,TGMAFGLQMFIQR,0
2lor,A,55,59,4,FPYP,0
2lor,A,60,78,18,QWSLLVAVVAGSVVSYGV,0
5khn,A,22,39,17,LSLLIAAFSGVYVARHF,0
5khn,A,40,226,186,INTDISKLVDAEPQWAALSQAVDRAFPQRNGTILAVVEAPAPEFATAAAHALTESLQKQAAAGRIGPVAEPGGGPFFEHNGLLFLSPQQVADTTSQLASARPLVNELAKNPSLTGLATTLSTTLGQPLLTGQVKLPSMAKLLSRSAATVDDVLAGKPAAFSWRALVDNDAARQPARAFVTVQPVVN,0
5khn,A,234,278,44,QTSDVIRETARALDLEKRYGAVVRLTGEQPLADDEFSSVEDGAA,0
5khn,A,279,295,16,NGVVTLLVVFVILWLA,0
5khn,A,303,325,22,SVLVTLFVGLVVTAALGLAMVG,0
5khn,A,326,331,5,LNMIS,0
5khn,A,332,347,15,AFMVLFVGLGVDFSI,0
5khn,A,382,395,13,TAVAASFFSFIPT,0
5khn,A,396,400,4,YRGV,0
5khn,A,401,418,17,ELGLIAGVGMFVALLTT,0
5khn,A,419,428,9,TLLPALLRL,0
5khn,A,444,453,9,PVDDYLDRH,0
5khn,A,458,473,15,IGTLAVVIGALPLLA,0
5khn,A,474,718,244,LHFDFNPLHLKDPHSESMSTLLALKDSPEAAVNDVTLLAPSLADADAAAKRLDALPEVGRTTTLSTFIPADQPEKRAAIATAASTLLPALTQPPAPPATDAQRVAALKRASDLLGYAAEDHPGPGAAAAQHLSQSLAKLAAADSATRDRAERAFADTLRIALNQLAALLQPQEITRDTLPPPLVRDWVAPDGKALVQISPKVPKGVDPNDDTMLRHFATAVKAAEPGAIGGPISILHSANTIIS,0
5khn,A,719,734,15,FLHAALWSIISITIL,0
5khn,A,750,766,16,PLLVSGIVTLEMCVVL,0
5khn,A,767,774,7,MSLNFAN,0
5khn,A,775,789,14,IALPLMLGVGVAFK,0
5khn,A,803,809,6,LHSSLT,0
5khn,A,813,828,15,FSAATTATAFGSLWL,0
5khn,A,829,837,8,HHPGTSSM,0
5khn,A,838,854,16,KLLALALTCTLIGAVV,0
5is0,E,440,453,13,YCLYMIIFTAAAY,0
5is0,E,454,473,19,RPVEGLPPYKLKNTVGDYF,0
5is0,E,474,490,16,VTGEILSVSGGVYFFF,0
5is0,E,516,531,15,FVQSLFMLVSVVLYF,0
5is0,E,532,536,4,QRKE,0
5is0,E,537,552,15,VASMVFSLAMGWTNM,0
5is0,E,560,576,16,QMGIYAVMIEKMILRD,0
5is0,E,582,598,16,VYLVFLFGFSTAVVTL,0
5is0,E,599,630,31,EDGKYNSL,0
5is0,E,631,647,16,STCLELFKFTIGMGDL,0
5is0,E,648,657,9,FTENYDFKA,0
5is0,E,658,676,18,FIILLLAYVILTYILLLN,0
5is0,E,677,711,34,LIALMGETVNKIAQESKNIWKLQRAITILDTEKS,0
4zw9,A,1,12,11,GTQKVTPALIF,0
4zw9,A,13,33,20,ITVATIGSFQFGYNTGVINA,0
4zw9,A,35,48,13,KIIKEFITKTLTD,0
4zw9,A,65,85,20,SVAIFSVGGMIGSFSVGLFV,0
4zw9,A,86,91,5,RFGRR,0
4zw9,A,92,110,18,SMLIVNLLAVTGGCFMGL,0
4zw9,A,119,140,21,LILGRLVIGLFCGLCTGFVPM,0
4zw9,A,141,153,12,IGEISPTALRGA,0
4zw9,A,154,174,20,GTLNQLGIVVGILVAQIFGL,0
4zw9,A,186,203,17,LLGFTILPAILQSAALP,0
4zw9,A,204,270,66,CPESPRFLLINRKEEENAKQILQRLWGTQDVSQDIQEMKDESARMSQEKQVTVLELFRVSSYRQPI,0
4zw9,A,271,292,21,ISIVLQLSQQLSGINAVFYYS,0
4zw9,A,307,326,19,TIGAGVVNTIFTVVSLFLV,0
4zw9,A,327,331,4,RAGR,0
4zw9,A,332,352,20,TLHMIGLGGMAFCSTLMTVS,0
4zw9,A,365,389,24,CIGAILVFVAFFEIGPGPIPWFIV,0
4zw9,A,390,400,10,ELFSQGPRPA,0
4zw9,A,401,424,23,MAVAGCSNWTSNFLVGLLFPSAA,0
4zw9,A,430,448,18,VFIIFTGFLITFLAFTFF,0
4zw9,A,449,470,21,VPETRGRTFEDITRAFEGQAH,0
4xnx,A,38,57,19,SVIGFAVDLANVWRFPYLC,0
4xnx,A,58,62,4,KNGG,0
4xnx,A,63,81,18,AFLVPYGIMLAVGGIPLF,0
4xnx,A,113,133,20,VLIAFYVDFYYNVIIAWSLR,0
4xnx,A,134,237,103,FFASFTNSLPWTSCNNIWNTPNCRPFEGHVEGFQSAASEYFNRYILELNRSEGIHDLGAIKW,0
4xnx,A,238,255,17,MALCLLIVYLICYFSLW,0
4xnx,A,261,280,19,GKVVWFTALFPYAVLLILL,0
4xnx,A,281,303,22,RGLTLPGSFLGIQYYLTPNFSA,0
4xnx,A,304,328,24,YKAEVWVDAATQVFFSLGPGFGVL,0
4xnx,A,346,362,16,LTSFINSATSFIAGFV,0
4xnx,A,363,384,21,FSVLGYMAHTLGVRIEDVATE,0
4xnx,A,385,390,5,PGLVF,0
4xnx,A,391,409,18,VYPAAIATMPASTFWALI,0
4xnx,A,410,429,19,FMMLATLGLDSSFGGSEAI,0
4xnx,A,449,464,15,GLFSLYFVVGLASCT,0
4xnx,A,465,467,2,GG,0
4xnx,A,468,488,20,YFFHLLDRYAAGYSILVAVF,0
4xnx,A,517,524,7,YWQVCWR,0
4xnx,A,527,545,18,PIFLLFITVYGLIGYEPL,0
4xnx,A,546,553,7,YADYVYP,0
4xnx,A,554,569,15,WANALGWCIAGSSVV,0
2l9u,A,645,667,22,LTVIAGLVVIFMMLGGTFLYWR,0
2l9u,A,668,676,8,RRHHHHHH,0
1rzz,H,1,10,9,VGVTAFGNF,0
1rzz,H,13,32,19,SLAIYSFWIFLAGLIYYLQ,0
1rzz,H,33,256,223,ENMREGYPLENEDGTPAANQGPFPLPKPKTFILPHGRGTLTVPGPESEDRPIALARTAVSEGFPHAPTGDPMKDGVGPASWVARRDLPELDGHGHNKIKPMKAAAGFHVSAGKNPIGLPVRGCDLEIAGKVVDIWVDIPEQMARFLEVELKDGSTRLLPMQMVKVQSNRVHVNALSSDLFAGIPTIKSPTEVTLLEEDKICGYVAGGLMYAAPKRKSVVAAML,0
1rzz,H,257,260,3,EYA,0
4qe7,D,24,41,17,LLVLAVIIYGTAGFHFI,0
4qe7,D,42,46,4,GESW,0
4qe7,D,47,63,16,VSLYWTFVTIATVGYG,0
4qe7,D,64,70,6,YSPHTP,0
4qe7,D,71,92,21,GMYFTCTLIVLGIGTFAVAVE,0
3vmr,A,7,40,33,GSSHHHHHHSSGLVPRGSHMQPVGKPPKKKKSK,0
3vmr,A,41,44,3,ILL,0
3vmr,A,45,59,14,ILLTILIIIALFIG,0
3vmr,A,112,125,13,KGTTRALFSTISD,0
3vmr,A,128,129,1,Q,0
4o6y,B,1,8,7,AVPVLGG,0
4o6y,B,14,35,21,VRVLGFIIAALVLTWTVHYRG,0
4o6y,B,36,44,8,LALSSDNK,0
4o6y,B,45,66,21,HIFNVHPVMMVIGLILFNGEA,0
4o6y,B,87,108,21,QLTAFILSLIGVWAALKFHID,0
4o6y,B,109,112,3,GIE,0
4o6y,B,113,134,21,FYSLHSWLGLACLFLFAFQWA,0
4o6y,B,161,184,23,ISIYALALVTATTGILEKVTFLQ,0
4o6y,B,185,189,4,NQVI,0
4o6y,B,190,214,24,RYSTEAMLVNTMGVLILILGGFVI,0
4o6y,B,220,230,10,VSGKDQVLTQ,0
3tt3,B,1,10,9,EVKREHWAT,0
3tt3,B,16,35,19,AMAGNAVGLGNFLRFPVQA,0
3tt3,B,36,43,7,ENGGGAF,0
3tt3,B,44,59,15,IPYIIAFLLVGIPLM,0
3tt3,B,96,124,28,GLWIPLVVAIYYVYIESWTLGFAIKFLV,0
3tt3,B,125,166,41,LVPEPPPNATDPDSILRPFKEFLYSYIGVPKGDEPILKPSL,0
3tt3,B,167,181,14,AYIVFLITMFINVS,0
3tt3,B,195,212,17,KIAMPTLFILAVFLVIR,0
3tt3,B,213,222,9,FLLETPNGT,0
3tt3,B,223,230,7,ADGLNFL,0
3tt3,B,231,241,10,TPDFEKLKDP,0
3tt3,B,242,259,17,VWIAAVGQIFFTLSLGF,0
3tt3,B,283,298,15,TLNEAAEVILGGSIS,0
3tt3,B,299,320,21,PAAVAFFGVANAVAIAKAGAF,0
3tt3,B,321,331,10,LGFITLPAIF,0
3tt3,B,332,336,4,QTAG,0
3tt3,B,337,360,23,TFLGFLWFFLLFFAGLVASIAIM,0
3tt3,B,382,396,14,AAIVFFSAHLVMFL,0
3tt3,B,397,399,2,KS,0
3tt3,B,400,418,18,DEMDFWAGTIGVVFFGLT,0
3tt3,B,447,453,6,YYYVMR,0
3tt3,B,455,472,17,TPAFLAVLLVVWAREYI,0
3tt3,B,473,483,10,KIMEETHWTV,0
3tt3,B,484,498,14,ITRFYIIGLFLFLT,0
3tt3,B,512,519,7,AGTLVPR,0
4o6n,B,-27,0,27,HHHHHHHHHHSSGVDLGTENLYFQSNA,0
4o6n,B,1,155,154,RLAYVKNHEIYGEKLLGLTLRERIEKTLQRAGFDVRFFDELSLEEAEDYLIILEPVLILERDLLLEGRKILVSDGFTVGYFFGGDFRTVFDGNLQSSIEKYLSLNNLESYEIWAIKLSNDNLKTAEKLLLSSLIKAKRTGLKPAYYDGWIAREI,0
4o6n,B,156,167,11,RKVSLRISRLL,0
4o6n,B,168,178,10,DTSVTPNQIT,0
4o6n,B,179,193,14,FSFFLSLVGSALFL,0
4o6n,B,199,214,15,TLLAGVIIQLHSIID,0
4o6n,B,215,237,22,CDGEIARLKFMESKYGAWLDGV,0
4o6n,B,238,252,14,DRYSDFIIVFSITY,0
4o6n,B,262,277,15,IIGFLAAFASLMIAY,0
4o6n,B,278,296,18,GDKFVAAYMRTYSPEGFA,0
4o6n,B,297,316,19,PITRDFRLLIIFACSVVNL,0
4o6n,B,318,334,16,LALVIIALLGNFEALR,0
4o6n,B,335,341,6,IVALRS,0
4o6n,B,342,344,2,TN,0
2eil,Z,13,35,22,EQAIGLSVTFLSFLLPAGWVLY,0
2eil,Z,36,43,7,LDNYKKS,0
2eil,Z,44,46,2,AA,0
3dqb,C,40,63,23,AAYMFLLIMLGFPINFLTLYVTV,0
3dqb,C,64,74,10,HKKLRTPLNY,0
3dqb,C,75,95,20,LLNLAVADLFMVFGGFTTTL,0
3dqb,C,113,133,20,GFFATLGGEIALWSLVVLAI,0
3dqb,C,134,154,20,RYVVVCKPMSNFRFGENHAI,0
3dqb,C,155,173,18,GVAFTWVMALACAAPPLV,0
3dqb,C,202,221,19,FVIYMFVVHFIIPLIVIFF,0
3dqb,C,222,254,32,YGQLVFTVKEAAAQQQESATTQKAEKEVTRMV,0
3dqb,C,255,277,22,IMVIAFLICWLPYAGVAFYIFT,0
3dqb,C,289,309,20,IPAFFAKTSAVYNPVIYIMM,0
3dqb,C,311,321,10,QFRNCMVTTL,0
3dqb,C,322,326,4,CGKN,0
3dqb,C,327,348,21,LGDDEASTTVSKTETSQVAPA,0
4a98,E,11,210,199,VDVSVSIFINKIYGVNTLEQTYKVDGYIVAQWTGKPRKTPGDKPLIVENTQIERWINNGLWVPALEFINVVGSPDTGNKRLMLFPDGRVIYNARFLGSFSNDMDFRLFPFDRQQFVLELEPFSYNNQQLRFSDIQVYTENIDNEEIDEWWIRGKASTHISDIRYDHLSSVQPNQNEFSRITVRIDAVRNPSYYLWSFIL,0
4a98,E,211,225,14,LGLIIAASWSVFWL,0
4a98,E,230,245,15,RLQTSFTLMLTVVAY,0
4a98,E,246,265,19,FYTSNILPRLPYTTVIDQM,0
4a98,E,266,282,16,IAGYGSIFAAILLIIF,0
4a98,E,298,315,17,RCRLAFPLGFLAIGCVL,0
4a98,E,316,317,1,I,0
2ih3,F,1,23,22,APMLSGLLARLVKLLLGRHGSA,0
2ih3,F,24,26,2,HW,0
2ih3,F,27,50,23,AAGAATVLLVIVLLAGSYLAVLA,0
2ih3,F,63,79,16,RALWWACETATTVAYG,0
2ih3,F,87,110,23,GRLVAVVVMVAGITSFGLVTAAL,0
2ih3,F,111,121,10,TWFVGREQER,0
5ksd,A,56,65,9,KLLKFLGFM,0
5ksd,A,67,83,16,PLSWVMEMAAIMAIAL,0
5ksd,A,84,92,8,NGDGRPPD,0
5ksd,A,93,114,21,QDFVGIICLLVINSTISFIEE,0
5ksd,A,241,263,22,AIGNFCICSIAIGMVIEIIVMY,0
5ksd,A,264,274,10,IQRRKYRDGI,0
5ksd,A,275,292,17,NLLVLLIGGIPIAMPTV,0
5ksd,A,645,666,21,TIYAVSITIRIVFGFMLIALI,0
5ksd,A,667,671,4,EFDF,0
5ksd,A,672,690,18,AFMVLIIAILNDGTIMTI,0
5ksd,A,710,730,20,ATGVVLGGYQAIMTVIFFWA,0
5ksd,A,731,754,23,HKTDFFSDTFGVRSIRDNNHELM,0
5ksd,A,755,774,19,AVYLQVSIISQALIFVTRS,0
5ksd,A,783,803,20,GALLMIAFLIAQLIATLIAV,0
5ksd,A,804,817,13,ANWEFAKIRGIGW,0
5ksd,A,818,841,23,WAGVIWLYSIVTYFPLDVFKFAI,0
3aym,A,1,8,7,GRDLRDN,0
3aym,A,9,35,26,TWWYNPSIVVHPHWREFDQVPDAVYY,0
3aym,A,36,57,21,LGIFIGICGIIGCGGNGIVIY,0
3aym,A,72,94,22,IINLAFSDFTFSLVNGFPLMTI,0
3aym,A,95,109,14,CFLKKWIFGFAACK,0
3aym,A,110,131,21,YGFIGGIFGFMSIMTMAMISI,0
3aym,A,153,172,19,IMIIFVWLWSVLWAIGPIF,0
3aym,A,173,199,26,WGAYTLEGVLCNCSFDYISRDSTTRS,0
3aym,A,200,221,21,ILCMFILGFFGPILIIFFCYF,0
3aym,A,263,282,19,IVIVSQFLLSWSPYAVVAL,0
3aym,A,283,297,14,AQFGPLEWVTPYAA,0
3aym,A,298,317,19,LPVMFAKASAIHNPMIYSV,0
3aym,A,320,329,9,KFREAISQT,0
3aym,A,359,448,89,SDAAPSADAAQMKEMMAMMQKMQQQQAAYPPQGYAPPPQGYPPQGYPPQGYPPQGYPPQGYPPPPQGAPPQGAPPAAPPQGVDNQAYQA,0
2nop,C,15,32,17,CTALVLFMTIPGIALFY,0
2nop,C,33,45,12,GLIRGKNVLSML,0
2nop,C,46,64,18,QVTVTFALVCILWVVYGY,0
2nop,C,103,118,15,QGSFACITVGLIVGA,0
2nop,C,119,126,7,AERIRFS,0
2nop,C,127,147,20,VLIFVVVWLTLSYIPIAHMV,0
2nop,C,161,178,17,AGGTVVHINAAIAGLVG,0
2nop,C,179,181,2,YL,0
2nop,C,182,194,12,GKRVGFGKEAFK,0
2nop,C,195,201,6,HNLPMV,0
2nop,C,202,219,17,TGTAILYIGWFGFNAGS,0
2nop,C,231,248,17,VNTVVATAAAILGWIFG,0
2nop,C,249,260,11,WALRGKPSLLG,0
2nop,C,261,276,15,CSGAIAGLVGVTPAC,0
2nop,C,282,299,17,GALIIGVVAGLAGLWGV,0
2nop,C,300,301,1,M,0
2nop,C,302,310,8,KRLLRVDD,0
2nop,C,311,313,2,CD,0
2nop,C,314,332,18,FGVHGVCGIVGCIMTGIF,0
2nop,C,353,377,24,VQLESIAITIVWSGVVAFIGYKLA,0
2nop,C,378,386,8,LTVGLRVP,0
2nop,C,387,424,37,EQEREGLDVNSHGENAYNADQAQQPAQADLEHHHHHH,0
4d1a,A,1,10,9,NSTPIEEAR,0
4d1a,A,31,45,14,LAAIWFAMAIQVAI,0
4d1a,A,46,62,16,IAAGQMTSSFQVWQVI,0
4d1a,A,63,77,14,AIAAGCTIAVILLF,0
4d1a,A,107,130,23,TLKALLSLFWFGFQTWLGALALD,0
4d1a,A,131,141,10,ITRLLTGFTN,0
4d1a,A,142,157,15,PLWIVIFGAIQVVTT,0
4d1a,A,164,180,16,RWMNVFASPVLLAMGV,0
4d1a,A,181,209,28,MVYLMLDGADVSLGEVMSMGGENPGMPF,0
4d1a,A,210,227,17,TAIMIFVGGWIAVVVSI,0
4d1a,A,254,268,14,AQWLGMVPASIIFG,0
4d1a,A,269,303,34,IGAASMVLVGEWNPVIAITEVVGGVSIPMAILFQ,0
4d1a,A,304,322,18,FVLLATWSTNPAANLLSP,0
4d1a,A,341,355,14,VSAVVGLLMMPWQF,0
4d1a,A,356,359,3,GVL,0
4d1a,A,360,375,15,TFLNLLASALGPLAG,0
4d1a,A,416,438,22,VALAVSFLTPDLMFVTGLIAAL,0
4d1a,A,467,495,28,PIGPVAPADESATANTKEQNGSENLYFQ,0
3zo6,M,1,5,4,AFLG,0
3zo6,M,6,18,12,AIAAGLAAVGGA,0
3zo6,M,55,66,11,VPIIAIVISLL,0
3zo6,M,67,69,2,LF,0
3zmh,A,94,109,15,PVTWVMMIACVVVFI,0
3zmh,A,110,115,5,MQILG,0
3zmh,A,116,123,7,QEVMLWL,0
3zmh,A,124,134,10,WPFDPTLKFE,0
3zmh,A,135,145,10,WRYFTHALMH,0
3zmh,A,146,148,2,SL,0
3zmh,A,149,166,17,HILFNLLWWWYLGGAVE,0
3zmh,A,172,188,16,KLIVITLISALLSGYV,0
3zmh,A,189,198,9,QKFSGPWFG,0
3zmh,A,199,213,14,LSGVVYALMGYVWL,0
3zmh,A,226,242,16,RGLIIFALIWIVAGWF,0
3zmh,A,243,251,8,LFGMSMAN,0
3zmh,A,252,267,15,AHIAGLAVGLAMAFV,0
5bzb,F,126,130,4,SHMG,0
5bzb,F,132,153,21,SVAALLTVVFYIAAVMATNLY,0
5bzb,F,154,163,9,ATFPEWFGD,0
5bzb,F,164,182,18,SKSLYTLFQVMTLESWSM,0
5bzb,F,183,193,10,IVRPVMNVHP,0
5bzb,F,194,218,24,AWVFFIPFIMLTTFTVLNLFIGII,0
5bzb,F,221,274,53,MAITKEQEEEAKTGHHQEPISQTLLHLGDRLDRIEKQLAQNNELLQRQQPQKK,0
3fps,A,55,74,19,QFEDLLVRILLLAACISFV,0
3fps,A,75,89,14,AWFEEGEETITAFV,0
3fps,A,90,109,19,PFVILLILIANAIVGVWQE,0
3fps,A,254,276,22,EFGEQLSKVISLICVAVWLINI,0
3fps,A,277,295,18,HFNDPVHGGSWIRGAIYY,0
3fps,A,296,318,22,KIAVALAVAAIPEGLPAVITTC,0
3fps,A,760,781,21,IRYLISSNVGEVVCIFLTAAL,0
3fps,A,782,785,3,LPE,0
3fps,A,786,809,23,LIPVQLLWVNLVTDGLPATALGF,0
3fps,A,833,852,19,FFRYMAIGGYVGAATVGAA,0
3fps,A,853,897,44,WWFMYAEDGPGVTYHQLTHFMQCTEDHPHFEGLDCEIFEAPEPM,0
3fps,A,898,917,19,MALSVLVTIEMCNALNSLS,0
3fps,A,926,948,22,PWVNIWLLGSICLSMSLHFLIL,0
3fps,A,949,950,1,V,0
3fps,A,951,956,5,PLPMI,0
3fps,A,957,966,9,KLKALDLTQ,0
3fps,A,967,987,20,LMVLKISLPVIGLDEILKFI,0
3zcc,B,329,351,22,ADDGTLLMAGVSHDLRTPLTRI,0
3zcc,B,352,371,19,LATEMMSEQDGYLAESINK,0
3zcc,B,372,387,15,IEECNAIIEQFIDYL,0
3vvo,A,1,3,2,SE,0
3vvo,A,4,6,2,TT,0
3vvo,A,7,12,5,GVQLL,0
3vvo,A,13,23,10,GDPKKAIVRL,0
3vvo,A,24,41,17,IPMMIGMSVQTLYNLAD,0
3vvo,A,60,79,19,PVFMGIIALAAGLGVGTSS,0
3vvo,A,80,97,17,IARRIGARDKEGADNVA,0
3vvo,A,98,118,20,HSLILSLILGVTITITMLPA,0
3vvo,A,119,126,7,DSLFRSM,0
3vvo,A,141,162,21,VLLAGAFIIVFNNVGNGILRG,0
3vvo,A,163,165,2,GD,0
3vvo,A,166,187,21,NRAMLAMVLGSGLNIVLDPIF,0
3vvo,A,199,219,20,YATLLSMVVTSLFIAYWLFV,0
3vvo,A,220,239,19,RDTYVDITLRDFSPSREIL,0
3vvo,A,240,264,24,DILRVGLPSSLSQLSMSIAMFFLN,0
3vvo,A,280,301,21,SAWRITMLGIVPILGMAAATT,0
3vvo,A,302,323,21,VTGAAYGERNVEKLETAYLYA,0
3vvo,A,324,346,22,KIAFMIELAVVAFIMLFAPQVA,0
3vvo,A,352,357,5,ESAQV,0
3vvo,A,363,387,24,SALRTLPVFLVLTPFGMMTSAMFQ,0
3vvo,A,388,390,2,IG,0
3vvo,A,391,414,23,GEKSLILTIFRTLVMQVGFAYIF,0
3vvo,A,424,444,20,VWIGIVIGNMVAAIVGFLWG,0
3vvo,A,445,457,12,MRISALKKTSAT,0
3vvo,A,458,461,3,GKR,0
3tlt,E,-3,4,7,SAAAQDM,0
3tlt,E,5,198,193,SPPPPIADEPLTVNTGIYLIECYSLDDKAETFKVNAFLSLSWKDRRLAFDPVRSGVRVKTYEPEAIWIPEIRFVNVENARDADVVDISVSPDGTVQYLERFSARVLSPLDFRRYPFDSQTLHIYLIVRSVDTRNIVLAVDLEKVGKNDDVFLTGWDIESFTAVVKPANFALEDRLESKLDYQLRISRQYFSYI,0
3tlt,E,199,218,19,NIILPMLFILFISWTAFWS,0
3tlt,E,222,242,20,ANVTLVVSTLIAFIAFNILV,0
3tlt,E,243,255,12,TNLPKTPYMTYT,0
3tlt,E,256,276,20,AIIFMIYLFYFVAVIEVTVQ,0
3tlt,E,292,313,21,RASRIAFPVVFLLANIILAFL,0
3tlt,E,314,315,1,F,0
3tlt,E,316,317,1,F,0
3m77,C,1,6,5,NITKP,0
3m77,C,7,11,4,PLPT,0
3m77,C,12,26,14,YFDIPLGLAALSLA,0
3m77,C,41,61,20,DVLGIVASAVWILFILMYAY,0
3m77,C,62,66,4,LRYY,0
3m77,C,67,75,8,EEVRAEYH,0
3m77,C,76,81,5,PVRFS,0
3m77,C,82,97,15,IALIPITTMLVGDIL,0
3m77,C,105,125,20,EVLIWIGTIGQLLFSTLRVS,0
3m77,C,126,140,14,LWQGGVFEQKSTHP,0
3m77,C,141,154,13,FYLPAVAANFTSA,0
3m77,C,167,182,15,LFFGAGMIAWIIFEP,0
3m77,C,183,200,17,LLQHLRISSLEPQFRAT,0
3m77,C,201,215,14,GIVLAPAFVCVSAY,0
3m77,C,227,245,18,KILWGYGFLQLFFLLRLF,0
3m77,C,246,255,9,WIVEKGLNI,0
3m77,C,256,271,15,LWAFSAGLASMANSA,0
3m77,C,284,307,23,IFAFVFSNVMIGLLVLMTIYKLT,0
3m77,C,308,313,5,GQFFL,0
2y5y,A,1,3,2,YY,0
2y5y,A,4,10,6,KNTNFW,0
2y5y,A,11,33,22,FGLFFFFYFFIMGAYFPFFPIW,0
2y5y,A,46,64,18,IIFAAISLFSLLFQPLFG,0
2y5y,A,65,75,10,LSDKLGLRKY,0
2y5y,A,76,96,20,LWIITGMLVMFAPFFIFIFG,0
2y5y,A,105,126,21,GSIVGGIYLGFSFNAGCPAVE,0
2y5y,A,127,143,16,FIEKVSRRSNFEFGRA,0
2y5y,A,144,162,18,MFGAVGWALVASIVGIMF,0
2y5y,A,167,186,19,FVFWLGSGMALILAVLLFF,0
2y5y,A,187,188,1,K,0
2y5y,A,189,202,13,DAPSSATVANAVG,0
2y5y,A,203,209,6,NHSAFS,0
2y5y,A,210,218,8,KLALELFR,0
2y5y,A,219,223,4,PKLW,0
2y5y,A,224,245,21,LSLYVIGVSSTYDVFDQQFAN,0
2y5y,A,259,279,20,VFGYVTTMGELLNASIMFFA,0
2y5y,A,280,286,6,LIINRI,0
2y5y,A,287,289,2,GK,0
2y5y,A,290,309,19,ALLLAGTIMSVRIIGSSFA,0
2y5y,A,314,333,19,VVILKTLHMFEVPFLLVGS,0
2y5y,A,334,350,16,KYITSQFEVRFSATIY,0
2y5y,A,351,372,21,VAFAFFKQLAMIFMSVLAGNM,0
2y5y,A,382,400,18,LVLGLVALGFTLISVFTL,0
2y5y,A,401,403,2,GP,0
2y5y,A,404,423,19,PLSLLRRQVNEVAHHHHHH,0
3m6e,C,-1,9,10,RAFGEQLLKN,0
3m6e,C,10,18,8,LIEFCDSV,0
3m6e,C,19,28,9,RGCGQVMFQ,0
3m6e,C,29,32,3,NTV,0
3m6e,C,33,46,13,GLLFFAGIFYNST,0
3m6e,C,48,62,14,GVCAVLGTAASTLT,0
3m6e,C,63,78,15,QLLGVDKPLVRAGLF,0
3m6e,C,79,91,12,ANGTLAGIALPF,0
3m6e,C,99,114,15,LGYVALNGAFTTIIM,0
3m6e,C,115,128,13,SLLNFLGKWGVPA,0
3m6e,C,129,143,14,TAPFVLATWLLMFG,0
3m6e,C,165,167,2,LA,0
3m6e,C,178,192,14,EGLFKGVGEVMFQD,0
3m6e,C,194,206,12,VTGVIFVVAILV,0
3m6e,C,207,209,2,SR,0
3m6e,C,210,226,16,SALFAVIGSLVGLCTA,0
3m6e,C,240,253,13,YGFNSVLCGIAMG,0
3m6e,C,254,264,10,IFFYLNIRTF,0
3m6e,C,265,282,17,YALGCMVLGAIATGAFS,0
3m6e,C,292,304,12,LTWPFIVVTWLF,0
3m6e,C,305,334,29,FAGSMFRNIAQVPTEKAGTPEDNLRSLAI,0
3m6e,C,335,337,2,SR,0
2uwv,M,1,54,53,EYQNIFSQVQVRGPADLGMTEDVNLANRSGVGPFSTLLGWFGNAQLGPIYLGS,0
2uwv,M,55,72,17,GVLSLFSGLMWFFTIGI,0
2uwv,M,82,87,5,AVFLR,0
2uwv,M,117,134,17,ASFFMFVAVWSWWGRTY,0
2uwv,M,135,146,11,RAQALGMGKHT,0
2uwv,M,147,164,17,WAFLSAIWLWMVLGFIR,0
2uwv,M,179,192,13,FSHLDWTNNFSLV,0
2uwv,M,200,221,21,FHGLSIAFLYGSALLFAMHGA,0
2uwv,M,222,268,46,ILAVSRFGGERELEQIADRGTAAERAALFWRWTMGFNATMEGIHRW,0
2uwv,M,269,286,17,IWMAVLVTLTGGIGILL,0
2uwv,M,294,300,6,YVWGQN,0
2uwv,M,303,307,4,APLN,0
2wli,E,1,11,10,TGGMKPPARK,0
2wli,E,12,28,16,RILNSDGSSNITRLGL,0
2wli,E,29,33,4,KRGW,0
2wli,E,34,47,13,DDHYHDLLTVSWP,0
2wli,E,48,71,23,FITLITGLYLVTNALFALAYLAC,0
2wli,E,84,99,15,DAFFFSVQTMATIGY,0
2wli,E,108,128,20,ANTLVTLEALCGMLGLAVAA,0
2wli,E,129,299,170,LIYARFTRPTAGVLFSSRMVISDFEGKPTLMMRLANLRIEQIIEADVHLVLVRSEISQEGMVFRRFHDLTRTRSRSPIFSLSWTVMHPIDHHSPIYGETDETLRNSHSEFLVLFTGHHEAFAQNVHARHAYSCDEIIWGGHFVDVFTTLPDGRRALDLGKFHEIAQHHHH,0
2wli,E,300,301,1,H,0
2uui,C,-5,4,9,HHHHHHKDE,0
2uui,C,5,28,23,ALLAAVTLLGVLLQAYFSLQVIS,0
2uui,C,52,74,22,QVNCSEYFPLFLATLWVAGIFF,0
2uui,C,76,97,21,GAAALCGLVYLFARLRYFQGY,0
2uui,C,104,131,27,LAPLYASARALWLLVALAALGLLAHFL,0
2uui,C,132,141,9,AALRAALLG,0
2uui,C,142,149,7,LRTLLPW,0
2uuh,C,9,22,13,AVTLLGVLLQAYF,0
2uuh,C,23,56,33,LQVISARRAFRVSPPLTTGPPEFERVYRAQVNC,0
2uuh,C,57,71,14,EYFPLFLATLWVAG,0
2uuh,C,79,92,13,ALCGLVYLFARLR,0
2uuh,C,93,107,14,FQGYARSAQLRLAP,0
2uuh,C,108,124,16,YASARALWLLVALAAL,0
2uuh,C,125,143,18,LLAHFLPAALRAALLGRL,0
2uuh,C,146,150,4,LPWA,0
3coc,C,1,4,3,AQI,0
3coc,C,5,8,3,GRP,0
3coc,C,9,34,25,WIWLALGTALMGLGTLYFLVKGMGV,0
3coc,C,39,62,23,KKFYAITTLVPAIAFTMYLSMLL,0
3coc,C,63,78,15,YGLTMVPFGGEQNPI,0
3coc,C,79,100,21,WARYADWLFTTPLLLLDLALL,0
3coc,C,103,127,24,DQGTILALVGAAGIMIGTGLVGAL,0
3coc,C,128,132,4,KVYS,0
3coc,C,133,157,24,RFVWWAISTAAMLYILYVLFFGFT,0
3coc,C,170,192,22,FKVLRNVTVVLWSAYPVVWLIG,0
3coc,C,193,201,8,EGAGIVPL,0
3coc,C,202,226,24,IETLLFMVLDVSAKVGFGLILLRS,0
3coc,C,232,249,17,AEAPEPSAGDGAAATSD,0
4j2t,A,49,54,5,WELVI,0
4j2t,A,55,73,18,QFEDLLVRILLLAACISF,0
4j2t,A,74,89,15,LAWFEEGEETITAFV,0
4j2t,A,90,110,20,PFVILLILIANAIVGVWQER,0
4j2t,A,254,276,22,EFGEQLSKVISLICVAVWLINI,0
4j2t,A,277,295,18,HFNDPVHGGSWIRGAIYY,0
4j2t,A,296,318,22,KIAVALAVAAIPEGLPAVITTC,0
4j2t,A,760,781,21,IRYLISSNVGEVVCIFLTAAL,0
4j2t,A,782,785,3,LPE,0
4j2t,A,786,808,22,LIPVQLLWVNLVTDGLPATALG,0
4j2t,A,833,852,19,FFRYMAIGGYVGAATVGAA,0
4j2t,A,853,897,44,WWFMYAEDGPGVTYHQLTHFMQCTEDHPHFEGLDCEIFEAPEPM,0
4j2t,A,898,916,18,MALSVLVTIEMCNALNSL,0
4j2t,A,927,950,23,WVNIWLLGSICLSMSLHFLILYV,0
4j2t,A,951,957,6,PLPMIF,0
4j2t,A,958,967,9,LKALDLTQW,0
4j2t,A,968,987,19,MVLKISLPVIGLDEILKFI,0
1bhb,A,10,31,21,IWLALGTALMGLGTLYFLVKG,0
1bhb,A,32,34,2,GV,0
1bhb,A,35,36,1,D,0
1bhb,A,37,39,2,DA,0
1bhb,A,40,63,23,KFYAITTLVPAIAFTMYLSMLLG,0
2wlh,D,1,11,10,TGGMKPPARK,0
2wlh,D,12,27,15,RILNSDGSSNITRLG,0
2wlh,D,28,32,4,EKRG,0
2wlh,D,33,36,3,LDD,0
2wlh,D,37,43,6,YHDLLT,0
2wlh,D,44,47,3,SWP,0
2wlh,D,48,71,23,FITLITGLYLVTNALFALAYLAC,0
2wlh,D,87,99,12,FFSVQTMATIGY,0
2wlh,D,108,128,20,ANTLVTLEALCGMLGLAVAA,0
2wlh,D,129,299,170,LIYARFTRPTAGVLFSSRMVISDFEGKPTLMMRLANLRIEQIIEADVHLVLVRSEISQEGMVFRRFHDLTLTRSRSPIFSLSWTVMHPIDHHSPIYGETDETLRNSHSEFLVLFTGHHEAFAQNVHARHAYSCDEIIWGGHFVDVFTTLPDGRRALDLGKFHEIAQHHHH,0
2wlh,D,300,301,1,H,0
2uww,M,1,54,53,EYQNIFSQVQVRGPADLGMTEDVNLANRSGVGPFSTLLGWFGNAQLGPIYLGS,0
2uww,M,55,72,17,GVLSLFSGLMWFFTIGI,0
2uww,M,82,87,5,AVFLR,0
2uww,M,117,133,16,ASFFMFVAVWSWWGRT,0
2uww,M,134,146,12,LRAQALGMGKHT,0
2uww,M,147,164,17,WAFLSAIWLWMVLGFIR,0
2uww,M,179,192,13,FSHLDWTNNFSLV,0
2uww,M,200,221,21,FHGLSIAFLYGSALLFAMHGA,0
2uww,M,222,268,46,ILAVSRFGGERELEQIADRGTAAERAALFWRWTMGFNATMEGIHRW,0
2uww,M,269,286,17,IWMAVLVTLTGGIGILL,0
2uww,M,294,300,6,YVWGQN,0
2uww,M,303,307,4,APLN,0
3tlu,E,-3,4,7,SAAAQDM,0
3tlu,E,5,202,197,SPPPPIADEPLTVNTGIYLIESYSLDDCAETFKVNAFLSLSWKDRRLAFDPVRSGVRVKTYEPEAIWIPEIRFVNVENARDADVVDISVSPDGTVQYLERFSARVLSPLDFRRYPFDSQTLHIYLIVRSVDTRNIVLAVDLEKVGKNDDVFLTGWDIESFTAVVKPANFALEDRLESKLDYQLRISRQYFSYIPNII,0
3tlu,E,203,218,15,PMLFILFISWTAFWS,0
3tlu,E,222,239,17,ANVTLVVSTLIAHIAFN,0
3tlu,E,240,258,18,LVETNLPCTPYMTYTGAI,0
3tlu,E,259,276,17,FMIYLFYFVAVIEVTVQ,0
3tlu,E,292,310,18,RASRIAFPVVFLLANIIL,0
3tlu,E,311,315,4,FLFF,0
3tlu,E,316,317,1,F,0
1l0v,P,13,38,25,WGLFGAGGMWSAIIAPVMILLVGIL,0
1l0v,P,39,61,22,PLGLFPGDALSYERVLAFAQSF,0
1l0v,P,62,86,24,GRVFLFLMIVLPLWCGLHRMHHAM,0
1l0v,P,94,116,22,AGKWVFYGLAAILTVVTLIGVV,0
1l0v,P,117,118,1,I,0
3m76,C,1,7,6,NITKPF,0
3m76,C,8,11,3,LPT,0
3m76,C,12,27,15,YFDIPLGLAALSLAW,0
3m76,C,41,61,20,DVLGIVASAVWILFILMYAY,0
3m76,C,62,66,4,LRYY,0
3m76,C,67,75,8,EEVRAEYH,0
3m76,C,76,81,5,PVRFS,0
3m76,C,82,97,15,IALIPITTMLVGDIL,0
3m76,C,105,125,20,EVLIWIGTIGQLLFSTLRVS,0
3m76,C,126,140,14,LWQGGVFEQKSTHP,0
3m76,C,141,154,13,FYLPAVAANFTSA,0
3m76,C,167,182,15,LFFGAGMIAWIIFEP,0
3m76,C,183,200,17,LLQHLRISSLEPQFRAT,0
3m76,C,201,217,16,GIVLAPAFVCVSAYLS,0
3m76,C,227,245,18,KILWGYGFLQLFFLLRLF,0
3m76,C,246,255,9,WIVEKGLNI,0
3m76,C,256,271,15,LWAFSFGLASMANSA,0
3m76,C,284,307,23,IFAFVFSNVMIGLLVLMTIYKLT,0
3m76,C,308,313,5,GQFFL,0
3vvn,A,1,3,2,SE,0
3vvn,A,7,12,5,GVQLL,0
3vvn,A,24,44,20,IPMMIGMSVQTLYNLADGIW,0
3vvn,A,45,56,11,SGLGPESLAAV,0
3vvn,A,57,79,22,LFFPVFMGIIALAAGLGVGTSS,0
3vvn,A,100,120,20,LILSLILGVTITITMLPAID,0
3vvn,A,121,128,7,LFRSMGA,0
3vvn,A,129,130,1,G,0
3vvn,A,131,137,6,AVELAI,0
3vvn,A,138,161,23,YARVLLAGAFIIVFNNVGNGILR,0
3vvn,A,167,188,21,RAMLAMVLGSGLNIVLDPIFI,0
3vvn,A,189,196,7,TLGFGVV,0
3vvn,A,197,218,21,AAYATLLSMVVTSLFIAYWLF,0
3vvn,A,243,264,21,RVGLPSSLSQLSMSIAMFFLN,0
3vvn,A,265,279,14,VAITAGGENGVAVF,0
3vvn,A,280,301,21,SAWRITMLGIVPILGMAAATT,0
3vvn,A,324,346,22,KIAFMIELAVVAFIMLFAPQVA,0
3vvn,A,347,350,3,LFT,0
3vvn,A,351,354,3,SES,0
3vvn,A,355,363,8,QVIKGDLI,0
3vvn,A,364,388,24,ALRTLPVFLVLTPFGMMTSAMFQG,0
3vvn,A,392,415,23,EKSLILTIFRTLVMQVGFAYIFV,0
3vvn,A,416,423,7,YTTLGLR,0
3vvn,A,424,444,20,VWIGIVIGNMVAAIVGFLWG,0
3vvn,A,455,461,6,ATGGKR,0
1kad,A,1,44,43,LSTSRSRFIRNTNESGEEVTTFFDYDYGAPCHKFDVKQIGAQL,0
1kad,A,45,69,24,PPLYSLVFIFGFVGNMLVVLILIN,0
1kad,A,77,100,23,DIYLLNLAISDLLFLITLPLWAH,0
1kad,A,101,111,10,AANEWVFGNA,0
1kad,A,112,136,24,CKLFTGLYHIGYFGGIFFIILLTI,0
1kad,A,158,179,21,VTSVITWLVAVFASVPGIIFT,0
1kad,A,180,199,19,CQKEDSVYVCGPYFPRGWN,0
1kad,A,200,223,23,FHTIMRNILGLVLPLLIMVICYS,0
1kad,A,245,269,24,FTIMIVYFLFWTPYNIVILLNTFQ,0
1kad,A,270,293,23,FFGLSNCESTSQLDQATQVTETL,0
1kad,A,294,317,23,MTHCCINPIIYAFVGEKFRRYLS,0
1kad,A,318,328,10,FFRKHITKRF,0
2lz3,B,8,29,21,IGLMVGGVVIATVIVITLVML,0
2lz3,B,30,32,2,KK,0
3zmi,A,92,93,1,A,0
3zmi,A,94,113,19,PVTWVMMIACVVVFIAMQI,0
3zmi,A,116,123,7,QEVMLWL,0
3zmi,A,137,143,6,YFTHAL,0
3zmi,A,144,166,22,HFSLMHILFNLLWWWYLGGAVE,0
3zmi,A,167,171,4,RLGS,0
3zmi,A,172,190,18,KLIVITLISALLSGYVQQ,0
3zmi,A,198,214,16,GLSGVVYALMGYVWLR,0
3zmi,A,215,225,10,ERDPQSGIYL,0
3zmi,A,226,244,18,RGLIIFALIWIVAGWFDL,0
3zmi,A,245,249,4,GMSM,0
3zmi,A,251,268,17,GAHIAGLAVGLAMAFVD,0
3zmi,A,269,270,1,L,0
1ufd,D,42,57,15,EAVGTYFLIFAGCAS,0
1ufd,D,58,71,13,VVNENYYNMITFP,0
1ufd,D,72,85,13,IAIVWGLVLTVLV,0
1ufd,D,95,104,9,FNPAVTIAF,0
1ufd,D,116,137,21,AYVVAQLLGSILASGTLRLLF,0
1ufd,D,138,155,17,GNHDQFSGTVPNGTNLQ,0
1ufd,D,156,172,16,FVFEFIMTFFLMFVIC,0
1ufd,D,186,200,14,IAIGSTLLLNVIIG,0
1ufd,D,201,203,2,PV,0
1ufd,D,204,218,14,GASMNPARSLGPAF,0
1ufd,D,219,225,6,HGEYEG,0
1ufd,D,226,244,18,WIYLLAPVVGAIAGAWVY,0
2yn9,B,1,31,30,AALQEKKSCSQRMEEFQRYCWNPDTGQMLG,0
2yn9,B,38,55,17,WISLYYVAFYVVMSGIF,0
2yn9,B,56,162,106,LCIYVLMRTIDPYTPDYQDQLKSPGVTLRPDVYGEKGLDISYNVSDSTTWAGLAHTLHRFLAGYSPAAQEGSINCTSEKYFFQESFLAPNHTKFSCKFTADMLQNC,0
2yn9,B,163,170,7,GRPDPTF,0
2yn9,B,171,203,32,FAEGKPCFIIKMNRIVKFLPGNSTAPRVDCAF,0
2yn9,B,204,208,4,DQPR,0
2yn9,B,209,290,81,GPPLQVEYFPANGTYSLHYFPYYGKKAQPHYSNPLVAAKLLNVPRNRDVVIVCKILAEHVSFDNPHDPYEGKVEFKLKIQK,0
5kpi,A,35,68,33,LTMFRYAGWLDRLYMLVGTLAAIIHGVALPLMM,0
5kpi,A,69,117,48,IFGDMTDSFASVGNVSKNSTNMSEADKRAMFAKLEEEMTTYAYYYTGI,0
5kpi,A,118,139,21,AGVLIVAYIQVSFWCLAAGRQ,0
5kpi,A,180,204,24,GIGDKIGMFFQAMATFFGGFIIGF,0
5kpi,A,205,210,5,RGWKL,0
5kpi,A,211,231,20,LVILAISPVLGLSAGIWAKI,0
5kpi,A,290,311,21,ANISMGAAFLLIYASYALAFW,0
5kpi,A,312,330,18,GTSLVISKEYSIGQVLTV,0
5kpi,A,331,352,21,FSVLIGAFSVGQASPNIEAFA,0
5kpi,A,693,699,6,WRILKL,0
5kpi,A,706,728,22,FVVGIFCAIINGGLQPAFSVIF,0
5kpi,A,729,751,22,KVVGVFTNGGPPETQRQNSNLF,0
5kpi,A,752,773,21,LLFLILGIISFITFFLQGFTF,0
5kpi,A,827,847,20,RLAVIFQNIANLGTGIIISL,0
5kpi,A,848,854,6,YGWQLT,0
5kpi,A,855,879,24,LLLAIVPIIAIAGVVEMKMLSGQA,0
5kpi,A,925,949,24,NAMKKAHVFGITFSFTQAMMYFSY,0
5kpi,A,950,972,22,ACFRFGAYLVTQQLMTFENVLL,0
5kpi,A,973,994,21,FSAIVFGAMAVGQVSSFAPDY,0
2nlj,F,1,21,20,APMLSGLLARLVKLLLGRHG,0
2nlj,F,22,25,3,ALH,0
2nlj,F,26,50,24,RAAGAATVLLVIVLLAGSYLAVLA,0
2nlj,F,63,79,16,RALWWSVETATTVGYG,0
2nlj,F,87,112,25,GRCVAVVVVVAGITSFGLVTAALAT,0
2nlj,F,113,124,11,FVGREQERRGH,0
1be3,K,1,14,13,LTRFLGPRYRQLA,0
1be3,K,18,36,18,PTAQLWGAVGAVGLVSAT,0
1be3,K,37,56,19,SRLILDWVPYINGKFKKDD,0
3aoa,C,1,10,9,PNFFIDRPI,0
3aoa,C,11,25,14,AWVIAIIIMLAGGL,0
3aoa,C,343,357,14,LVEAIILVFLVMYL,0
3aoa,C,358,365,7,LQNFRAT,0
3aoa,C,366,383,17,IPTIAVPVVLLGTFAVL,0
3aoa,C,397,410,13,MVLAIGLLVDDAI,0
3aoa,C,411,442,31,VVENVERVMAEEGLPPKEATRKSMGQIQGAL,0
3aoa,C,443,456,13,GIAMVLSAVFVPM,0
3aoa,C,471,489,18,ITIVSAMALSVLVALILT,0
3aoa,C,490,498,8,ALCATMLK,0
3aoa,C,499,512,13,IAKGDHGEGKKGF,0
3aoa,C,513,542,29,GWFNRMFEKSTHHYTDSVGGILRSTGRYL,0
3aoa,C,543,556,13,LYLIIVVGMAYLF,0
3aoa,C,875,890,15,LYAISLIVVFLCLAA,0
3aoa,C,891,898,7,YESWSIP,0
3aoa,C,899,916,17,SVMLVVPLGVIGALLAA,0
3aoa,C,928,943,15,VGLLTTIGLSAKNAI,0
3aoa,C,944,975,31,IVEFAKDLMDKEGKGLIEATLDAVRMRLRPI,0
3aoa,C,976,990,14,MTSLAFILGVMPLV,0
3aoa,C,1004,1019,15,TGVMGGMVTATVLAI,0
3aoa,C,1020,1021,1,F,0
3aoa,C,1022,1030,8,PVFFVVVR,0
3aoa,C,1031,1036,5,RFSRK,0
3aoa,C,1037,1053,16,EDIEHSHTVDHHHHHH,0
4qh1,E,5,198,193,SPPPPIADEPLTVNTGIYLIECYSLDDKAETFKVNAFLSLSWKDRRLAFDPVRSGVRVKTYEPEAIWIPEIRFVNVENARDADVVDISVSPDGTVQYLERFSARVLSPLDFRRYPFDSQTLHIYLIVRSVDTRNIVLAVDLEKVGKNDDVFLTGWDIESFTAVVKPANFALEDRLESKLDYQLRISRQYFSYI,0
4qh1,E,199,218,19,NIILPMLFILFISWTAFWS,0
4qh1,E,222,240,18,ANVTLVVSTLIAHIAFNI,0
4qh1,E,241,255,14,VETNLPKTPYMTYT,0
4qh1,E,256,275,19,AIIFMIYLFYFVAVIEVTV,0
4qh1,E,293,313,20,ASRIAFPVVFLLANIILAFL,0
4qh1,E,314,315,1,F,0
4x5n,B,2,5,3,TIL,0
4x5n,B,6,28,22,TGLFAAFFTTFAFAPQSIKTIR,0
4x5n,B,36,55,19,VVMYIMFLTGVISWIAYGI,0
4x5n,B,56,60,4,RSDF,0
4x5n,B,61,82,21,VLIANIVTLFLAAPVLVITLI,0
4h33,D,1,11,10,RYIVPIYSFF,0
4h33,D,12,14,2,SN,0
4h33,D,15,34,19,LNRFLMIFVLLVIIIPVPM,0
4h33,D,45,61,16,DALWWAIVTATTVGYG,0
4h33,D,69,93,24,GRILASIMMLFGIAFIGMITSTIT,0
4h33,D,94,102,8,FFRCKKPT,0
4h33,D,103,137,34,SSTQRANKITQLISETPDLTKEEIAVVEQFLTLR,0
2eim,Z,17,35,18,GLSVTFLSFLLPAGWVLY,0
2eim,Z,36,43,7,LDNYKKS,0
2eim,Z,44,46,2,AA,0
3hgc,C,2,45,43,DLKVDEEEVDSGQPVSIQAFASSSTLHGISHIFSYERLSLKRV,0
3hgc,C,51,75,24,MGSLALLALVCTNRIQYYFLYPHV,0
3hgc,C,76,422,346,KLDEVAATRLTFPAVTFCNLNEFRFSRVTKNDLYHAGELLALLNNRYEIPDTQTADEKQLEILQDKANFRNFKPKPFNMLEFYDRAGHDIREMLLSCFFRGEQCSPEDFKVVFTRYGKCYTFNAGQDGKPRLITMKGGTGNGLEIMLDIQQDEYLPVWGETDETSFEAGIKVQIHSQDEPPLIDQLGFGVAPGFQTFVSCQEQRLIYLPPPWGDCKATTGDSEFYDTYSITACRIDCETRYLVENCNCRMVHMPGDAPYCTPEQYKECADPALDFLVEKDNEYCVCEMPCNVTRYGKELSMVKIPSKASAKYLAKKYNKSEQYIGENILVLDIFFEALNYETIEQK,0
3hgc,C,423,448,25,AYEVAGLLGDIGGQMGLFIGASILT,0
3hgc,C,452,466,14,FDYAYEVIKHRLCR,0
4myh,B,114,132,18,LGLLISAKILNVQVPFFF,0
4myh,B,133,158,25,QTIDSMNIAWDDPTVALPAAIGLTI,0
4myh,B,159,175,16,CYGVARFGSVLFGELR,0
4myh,B,238,252,14,ISFEISVVCGILTY,0
4myh,B,253,256,3,FGA,0
4myh,B,257,272,15,FAAITFSTMLLYSIF,0
4myh,B,344,358,14,GQNLIFTTALTAMM,0
4myh,B,359,376,17,MGCTGVIGGNLTVGDLV,0
4myh,B,377,390,13,INQLVFQLSVPLN,0
3fi1,B,15,28,13,IILIIAAILAMIM,0
3fi1,B,29,34,5,NSGAT,0
3fi1,B,35,42,7,GWYHDFL,0
3fi1,B,43,62,19,TPVQLRVGSLEINKNMLLW,0
3fi1,B,63,80,17,NDALMAVFFLLVGLEVK,0
3fi1,B,98,115,17,IAAIGGMIVPALLYLAF,0
3fi1,B,116,125,9,YADPITREG,0
3fi1,B,126,140,14,AIPAATDIAFALGV,0
3fi1,B,157,174,17,ALAIIDDLGAIIIIALF,0
3fi1,B,175,184,9,TNDLSMASL,0
3fi1,B,185,200,15,VAAVAIAVLAVLNLC,0
3fi1,B,205,220,15,GVYILVGVVLWTAVL,0
3fi1,B,221,223,2,SG,0
3fi1,B,224,237,13,HATLAGVIVGFFI,0
3fi1,B,247,255,8,AKRLEHVL,0
3fi1,B,256,274,18,PWVAYLILPLFAFANAGV,0
3fi1,B,275,293,18,LQGVTLDGLTSILPLGII,0
3fi1,B,294,311,17,GLLIGKPLGISLFCWLA,0
3fi1,B,330,348,18,VGILCGIGFTMSIFIASL,0
3fi1,B,349,361,12,FGSVDPELINWA,0
3fi1,B,362,378,16,LGILVGSISSAVIGYS,0
4zyr,A,6,9,3,TNF,0
4zyr,A,10,30,20,MFGLFFFFYFFIMGAYFPFF,0
4zyr,A,49,67,18,AAISLFSLLFQPLFGLLS,0
4zyr,A,68,74,6,KLGLRK,0
4zyr,A,75,91,16,LLWIITGMLVMFAPFF,0
4zyr,A,109,130,21,GGIYLGFCFNAGAPAVEAFIE,0
4zyr,A,131,140,9,VSRRSNFEF,0
4zyr,A,141,158,17,RARMFGCVGWALCASIV,0
4zyr,A,170,187,17,WLGSGCALILAVLLFFA,0
4zyr,A,188,190,2,TD,0
4zyr,A,207,209,2,FS,0
4zyr,A,210,217,7,KLALELF,0
4zyr,A,218,223,5,QPKLW,0
4zyr,A,224,243,19,LSLYVIGVSCTYDVFDQQF,0
4zyr,A,263,280,17,VTTMGELLNASIMFFAP,0
4zyr,A,281,290,9,IINRIGGKN,0
4zyr,A,291,309,18,LLLAGTIMSVRIIGSSFA,0
4zyr,A,314,334,20,VVILKTLHMFEVPFLLVGCF,0
4zyr,A,335,347,12,YITSQFEVRFSA,0
4zyr,A,348,369,21,IYLVCFCFFKQLAMIFMSVLA,0
4zyr,A,380,397,17,AYLVLGLVALGFTLISV,0
4zyr,A,398,408,10,TLSGPGPLSL,0
3qjq,C,5,27,22,KGALAVILVLTLTILVFWLGVY,0
3qjq,C,28,34,6,VFFARG,0
5eh6,A,71,73,2,EI,0
5eh6,A,74,96,22,LIIFGVIAGVIGTILLISYGIR,0
3vms,A,7,42,35,GSSHHHHHHSSGLVPRGSHMQPVGKPPKKKKSKRI,0
3vms,A,43,47,4,LKIL,0
3vms,A,48,61,13,TILIIIALFIGIM,0
3vms,A,112,118,6,KGTTRA,0
3vms,A,123,129,6,SDRDVQ,0
3spj,D,36,42,6,ARRKCR,0
3spj,D,61,69,8,KPQRYIAD,0
3spj,D,78,104,26,WRYMLLLFSLAFLVSWLLFGLIFWLI,0
3spj,D,105,130,25,LIHGDLENPGGDDTFKPCVLQVNGF,0
3spj,D,131,147,16,AAFLFSIETQTTIGYG,0
3spj,D,148,155,7,RCVTEEC,0
3spj,D,156,181,25,LAVFMVVVQSIVGCIIDSFMIGAIM,0
3spj,D,373,378,5,EVLFQ,0
1p49,A,23,74,51,ASRPNIILVMADDLGIGDPGCYGNKTIRTPNIDRLASGGVKLTQHLAASPL,0
1p49,A,76,180,104,PSRAAFMTGRYPVRSGMASWSRTGVFLFTASSGGLPTDEITFAKLLKDQGYSTALIGKWHLGMSCHSKTDFCHHPLHHGFNYFYGISLTNLRDCKPGEGSVFTT,0
1p49,A,181,205,24,FKRLVFLPLQIVGVTLLTLAALNC,0
1p49,A,212,233,21,LGVFFSLLFLAALILTLFLGF,0
1p49,A,234,476,242,HYFRPLNCFMMRNYEIIQQPMSYDNLTQRLTVEAAQFIQRNTETPFLLVLSYLHVHTALFSSKDFAGKSQHGVYGDAVEEMDWSVGQILNLLDELRLANDTLIYFTSDQGAHVEEVSSKGEIHGGSNGIYKGGKANNWEGGIRVPGILRWPRVIQAGQKIDEPTSNMDIFPTVAKLAGAPLPEDRIIDGRDLMPLLEGKSQRSDHEFLFHYCNAYLNAVRWHPQNSTSIWKAFFFTPNFNPV,0
1p49,A,477,480,3,SNG,0
1p49,A,481,575,94,FATHVCFCFGSYVTHHDPPLLFDISKDPRERNPLTPASEPRFYEILKVMQEAADRHTQTLPEVPDQFSWNNFLWKPWLQLCCPSTGLSCQCDRE,0
1p49,A,576,583,7,QDKRLSR,0
2los,A,-8,0,8,TSLYKKVG,0
2los,A,1,5,4,QDTS,0
2los,A,6,29,23,VVPLHWFGFGYAALVASGGIIGY,0
2los,A,37,54,17,LAAGLLFGSLAGLGAYQ,0
2los,A,55,58,3,SQD,0
2los,A,59,74,15,RNVWVFLATSGTLAG,0
2los,A,75,86,11,MGMRFYHSGKF,0
2los,A,87,102,15,PAGLIAGASLLMVAK,0
3f3c,B,1,4,3,EVK,0
3f3c,B,13,32,19,LILAMAGNAVGLGNFLRFP,0
3f3c,B,33,43,10,QAAENGGGAF,0
3f3c,B,44,63,19,IPYIIAFLLVGIPLMWIEW,0
3f3c,B,90,124,34,KILGVFGLWIPLVVAIYYVYIESWTLGFAIKFLV,0
3f3c,B,125,132,7,LVPEPPP,0
3f3c,B,133,134,1,A,0
3f3c,B,135,166,31,DPDSILRPFKEFLYSYIGVPKGDEPILKPSL,0
3f3c,B,167,185,18,AYIVFLITMFINVSILIR,0
3f3c,B,191,212,21,ERFAKIAMPTLFILAVFLVIR,0
3f3c,B,213,222,9,FLLETPNGT,0
3f3c,B,223,231,8,ADGLNFLW,0
3f3c,B,232,243,11,PDFEKLKDPGV,0
3f3c,B,244,265,21,IAAVGQIFFTLSLGFGAIITY,0
3f3c,B,278,297,19,GLTAATLNEKAEVILGGSI,0
3f3c,B,298,307,9,IPAAVAFFG,0
3f3c,B,308,317,9,ANAVAIAKA,0
3f3c,B,318,325,7,AFNLGFI,0
3f3c,B,326,331,5,LPAIF,0
3f3c,B,332,339,7,QTAGGTF,0
3f3c,B,340,367,27,GFLWFFLLFFAGLTSSIAIMQPMIAFL,0
3f3c,B,378,396,18,VLWTAAIVFFSAHLVMFL,0
3f3c,B,397,399,2,KS,0
3f3c,B,400,426,26,DEMDFWAGTIGVVFFGLTELIIFFWI,0
3f3c,B,429,437,8,DKAWEEIN,0
3f3c,B,445,469,24,RIYYYVMRYITPAFLAVLLVVWAR,0
3f3c,B,470,483,13,YIPKIMEETHWTV,0
3f3c,B,484,502,18,ITRFYIIGLFLFLTFLVF,0
3f3c,B,516,519,3,VPR,0
2nww,C,1,9,8,GLYRKYIE,0
2nww,C,13,31,18,QKILIGLILGAIVGLILG,0
2nww,C,32,38,6,YGYAHA,0
2nww,C,39,63,24,HTYVKPFGDLFVRLLKMLVMPIVF,0
2nww,C,82,107,25,VKIVVYYLLTSAFAVTLGIIMARLF,0
2nww,C,108,127,19,PGAGIHLAVGGQQFQPHQA,0
2nww,C,128,140,12,PLVHILLDIVPT,0
2nww,C,141,150,9,PFGALANGQ,0
2nww,C,151,160,9,LPTIFFAII,0
2nww,C,176,200,24,RKSAETLLDAINGLAEAMYKIVNG,0
2nww,C,201,221,20,MQYAPIGVFALIAYVMAEQG,0
2nww,C,222,229,7,HVVGELA,0
2nww,C,230,251,21,VTAAVYVGLTLQILLVYFVLL,0
2nww,C,258,265,7,ISFIKHA,0
2nww,C,266,286,20,DAMLTAFVTRSSSGTLPVTM,0
2nww,C,301,321,20,TLPLGATINMDGTALYQGVC,0
2nww,C,322,338,16,FFIANALGSHLTVGQQ,0
2nww,C,339,363,24,TIVLTAVLASIGTAGVPGAGAIML,0
2nww,C,364,370,6,MVLHSV,0
2nww,C,371,389,18,LPLTDPNVAAAYAMILGI,0
2nww,C,390,409,19,AILDMGRTMVNVTGDLTGT,0
2nww,C,417,422,5,TLVPR,0
3zux,A,-4,1,5,VAASM,0
3zux,A,2,7,5,ILSKI,0
3zux,A,8,27,19,SFIGKTFSLWAALFAAAAF,0
3zux,A,36,55,19,GPYIPWLLGIIMFGMGLTL,0
3zux,A,56,67,11,PSDFDILFKHP,0
3zux,A,68,88,20,VVIIGVIAQFAIMPATAWCL,0
3zux,A,103,118,15,LVGCCPGGTASNVMT,0
3zux,A,119,127,8,LARGNVAL,0
3zux,A,128,147,19,VAVTSVSTLTSPLLTPAIF,0
3zux,A,163,181,18,MSIVKMVLLPIVLGLIVH,0
3zux,A,182,191,9,VLGSKTEKL,0
3zux,A,192,211,19,DALPLVSVAAIVLIIGAVV,0
3zux,A,215,221,6,GKIMES,0
3zux,A,226,248,22,AVVVLHNGIGYLLGFFAAKWTG,0
3zux,A,249,254,5,PYDAQ,0
3zux,A,255,272,17,ALTIEVGMQNSGLAAAL,0
3zux,A,285,304,19,PGALFSVWHNISGSLLATY,0
3zux,A,305,309,4,AAKA,0
3zux,A,310,327,17,KHKKPLDRAGSENLYFQ,0
1ezv,S,17,33,16,VGTIFAGAFVFQTVFD,0
1ezv,S,34,58,24,AITSWYENHNKGKLWKDVKARIAA,0
1ds8,H,1,10,9,VGVTAFQNF,0
1ds8,H,16,32,16,IYSFWIFLAGLIYYLQ,0
1ds8,H,33,256,223,ENMREGYPLENEDGTPAANQGPFPLPKPKTFILPHGRGTLTVPGPESEDRPIALARTAVSEGFPHAPTGDPMKDGVGPASWVARRDLPELDGHGHNKIKPMKAAAGFHVSAGKNPIGLPVRGCDLEIAGKVVDIWVDIPEQMARFLEVELKDGSTRLLPMQMVKVQSNRVHVNALSSDLFAGIPTIKSPTEVTLLEEDKICGYVAGGLMYAAPKRKSVVAAML,0
1ds8,H,257,260,3,EYA,0
5tio,E,1,7,6,RSRSAP,0
5tio,E,225,246,21,QMYIPSLLIVILSWVSFWINM,0
5tio,E,247,248,1,A,0
5tio,E,249,269,20,PARVALGITTVLTMTTQSSG,0
5tio,E,284,306,22,IWMAVCLLFVFSALLEYAAVNF,0
5tio,E,307,322,15,SRAGTKVFIDRAKKI,0
5tio,E,323,344,21,TISRACFPLAFLIFNIFYWVI,0
5tio,E,346,362,16,ILRHEDIHWSHPQFEK,0
1sr1,A,1,3,2,DA,0
1sr1,A,4,8,4,ATAY,0
1sr1,A,9,26,17,GGAVALIVGVAFVWLLY,0
1sr1,A,29,32,3,DGS,0
1sr1,A,40,56,16,LAIIPVFAGLSYVGMA,0
1sr1,A,58,64,6,IGTVIV,0
1sr1,A,65,70,5,GNQIV,0
1sr1,A,71,87,16,LRYIDWLVTTPILVGY,0
1sr1,A,92,96,4,GASR,0
1sr1,A,98,114,16,IIGVMVADALMIAVGA,0
1sr1,A,115,118,3,AVV,0
1sr1,A,119,126,7,DGTLKWA,0
1sr1,A,128,142,14,GVSSIFHLSLFAYL,0
1sr1,A,148,154,6,VVPDVP,0
1sr1,A,163,179,16,KNHIGLLWLAYPLVWL,0
1sr1,A,181,190,9,PAGIGEATA,0
1sr1,A,191,193,2,GV,0
1sr1,A,194,211,17,LTYVFLDVLAKVPYVYF,0
1sr1,A,215,239,24,RRVFMHSESPPAPEQATVEATAAD,0
1qkp,A,1,4,3,AQI,0
1qkp,A,5,9,4,GRPE,0
1qkp,A,10,31,21,IWLALGTALMGLGTLYFLVKG,0
1qkp,A,42,66,24,YAITTLVPAIAFTMYLSMLLGYGL,0
1qkp,A,67,78,11,MVPFGGEQNPI,0
1qkp,A,79,100,21,WARYADWLFTTPLLLLDLALL,0
1qkp,A,104,127,23,QGTILALVGADGIMIGTGLVGAL,0
1qkp,A,128,134,6,KVYSYR,0
1qkp,A,135,158,23,VWWAISTAAMLYILYVLFFGFTS,0
1qkp,A,171,192,21,KVLRNVTVVLWSAYPVVWLIG,0
1qkp,A,193,201,8,EGAGIVPL,0
1qkp,A,202,225,23,IETLLFMVLDVSAKVGFGLILLR,0
1qkp,A,233,248,15,EAPEPSAGDGAAATS,0
2asg,E,102,104,2,KM,0
2asg,E,105,121,16,LCISVLLALTFFLLLI,0
4i7z,P,5,23,18,VFYIVFIALFFGIAVGII,0
4i7z,P,24,29,5,AIKSI,0
4i7z,P,30,32,2,LI,0
5d6l,A,32,59,27,VVGMGIVMSLIVLAIVFGNVLVITAIA,0
5d6l,A,60,69,9,FERLQTVTN,0
5d6l,A,70,95,25,FITSLACADLVMGLAVVPFGAAHIL,0
5d6l,A,105,129,24,CEFWTSIDVLCVTASIETLCVIAV,0
5d6l,A,130,150,20,RYFAITSPFKYQSLLTKNKA,0
5d6l,A,151,175,24,VIILMVWIVSGLTSFLPIQMHWYR,0
5d6l,A,179,186,7,EAINCYA,0
5d6l,A,196,220,24,QAYAIASSIVSFYVPLVIMVFVYS,0
5d6l,A,221,274,53,VFQEAKRQLNIFEMLRIDEGLRLKIYKDTEGYYTIGIGHLLTKSPSLNAAKSELDKAIGRNTNGVITKDEAEKLFNQDVDAAVRGILRNAKLKPVYDSLDAVRRAALINMVFQMGETGVAGFTNSLRMLQQKRWDEAAVNLAKSRWYNQTPNRAKRVITTFRTGTWDAYKFCLKEHKALKT,0
5d6l,A,275,299,24,GIIMGTFTLCWLPFFIVNIVHVIQ,0
5d6l,A,303,327,24,RKEVYILLNWIGYVNSGFNPLIYC,0
5d6l,A,328,329,1,S,0
5d6l,A,330,339,9,DFRIAFQEL,0
5d6l,A,340,342,2,CL,0
5d56,C,34,48,14,GVAVLLCVVIAAWL,0
5d56,C,49,52,3,VDA,0
5d56,C,53,67,14,TRVLLISSVMLVMI,0
5d56,C,102,117,15,IAIIDAVITWAILLW,0
5d56,C,118,121,3,HFG,0
1xnu,E,3,13,10,KVQYLTRSAI,0
1xnu,E,25,50,25,RQNLQNLFINFCLILICLLLICIIV,0
1xnu,E,51,53,2,LL,0
1zv0,B,34,55,21,YSIIFVVGIFGNSLVVIVIYF,0
1zv0,B,56,63,7,MKLKTVA,0
1zv0,B,64,83,19,VFLLNLALADLCFLLTLPL,0
1zv0,B,104,124,20,SASVSFNLYASVFLLTCLSI,0
1zv0,B,125,145,20,RYLAIVHPMKSRLRRTMLVA,0
1zv0,B,146,163,17,VTCIIIWLLAGLASLPA,0
1zv0,B,194,216,22,LGLTKNILGFLFPFLIILTSYT,0
1zv0,B,217,241,24,IWKALKKAYEIQKNKPRNDDIFKI,0
1zv0,B,242,265,23,MAIVLFFFFSWIPHQIFTFLDVL,0
1zv0,B,284,304,20,PITICIAYFNNCLNPLFYGF,0
1zv0,B,305,306,1,G,0
1zv0,B,307,315,8,KFKRYFLQ,0
1zv0,B,316,359,43,LKYIPPKAKSHSNLSTKMSTLSYRPSDNVSSSTKKPAPCFEVE,0
4p79,A,5,29,24,ETFGFFMSALGLLMLGLTLSNSYW,0
4p79,A,30,33,3,VST,0
4p79,A,34,41,7,HGNVITT,0
4p79,A,42,66,24,TIFENLWYSCATDSLGVSNCWDFP,0
4p79,A,67,72,5,MLALS,0
4p79,A,73,77,4,YVQG,0
4p79,A,78,100,22,RALMITAILLGFLGLFLGMVGL,0
4p79,A,113,139,26,AKLLAIAGTLHILAGACGMVAISWYA,0
4p79,A,140,159,19,NITTDFFNPLYAGTKYELG,0
4p79,A,160,184,24,ALYLGWSASLLSILGGICVFSTAA,0
4p79,A,187,194,7,KEEPATR,0
4pb2,C,-5,1,6,PAVPRM,0
4pb2,C,5,21,16,SCCGMAVLLGIAVLLS,0
4pb2,C,22,29,7,NRKAINL,0
4pb2,C,30,46,16,TVGGAFAIQFSLGAFI,0
4pb2,C,50,78,28,WGQELLRGFSDAVSNVINYGNDGTSFLF,0
4pb2,C,103,118,15,TLIFFSALISVLYYL,0
4pb2,C,120,136,16,MQWVIRILGGGLQKAL,0
4pb2,C,137,175,38,TSRAESMSAAANIFVGQTEAPLVVRPFVPKMTQSELFA,0
4pb2,C,176,192,16,MCGGLASIAGGVLAGY,0
4pb2,C,202,220,18,VAASFMAAPGGLLFAKLM,0
4pb2,C,221,229,8,PETEKPQD,0
4pb2,C,230,240,10,EDITLDGGDD,0
4pb2,C,242,274,32,ANVIDAAAGGASAGLQLALNVGAMLIAFIGLI,0
4pb2,C,275,286,11,LINGMLGGIGG,0
4pb2,C,361,379,18,ALCGFANLSSIAILLGGL,0
4pb2,C,380,394,14,SLAPKRRGDIARMG,0
4pb2,C,395,412,17,KAVIAGTLSNLMAATIA,0
4pb2,C,417,418,1,F,0
3p5n,A,1,9,8,NGRRKLNM,0
3p5n,A,18,33,15,SMLSAIAFVLTFIKF,0
3p5n,A,34,42,8,IPFLPPYL,0
3p5n,A,43,56,13,LDFSDVPSLLATF,0
3p5n,A,61,79,18,AGIIVALVKNLLNYLFSM,0
3p5n,A,80,82,2,DP,0
3p5n,A,83,103,20,GPFANFLAGASFLLTAYAIY,0
3p5n,A,111,131,20,LITGLIIATIVMTIVLSILN,0
3p5n,A,132,141,9,FVLLPLYGM,0
3p5n,A,142,152,10,FNLADIANNL,0
3p5n,A,153,161,8,VIIVSGII,0
3p5n,A,162,181,19,FNIIKGIVISIVFILLYRR,0
3wfc,C,1,4,3,SET,0
3wfc,C,6,26,20,KGMARNIYFGGSVFFILLFL,0
3wfc,C,27,146,119,LTYHTEKTLPERTNEAAMSAAVVRGKLVWEQNNCVGCHTLLGEGAYFAPELGNVVGRRGGEEGFNTFLQAWMKIQPLNVPGRRAMPQFHLSEGQVDDLAEFLKWSSKIDTNQWPPNKEG,0
2fyu,K,1,22,21,LTRFLGPRYRQLARNWVPTAS,0
2fyu,K,23,38,15,WGAVGAVGLVWATDW,0
2fyu,K,54,56,2,DD,0
5mke,D,215,218,3,YLK,0
5mke,D,219,242,23,VLRELVTYLLFLIVLCILTYGMM,0
5mke,D,472,496,24,LAACEIIFCFFIFYYVVEEILEIR,0
5mke,D,497,506,9,HKLHYFRSF,0
5mke,D,507,527,20,NCLDVVIVVLSVVAIGINIY,0
5mke,D,557,579,22,FNNIAAVTVFFVWIKLFKFINF,0
5mke,D,580,581,1,R,0
5mke,D,582,592,10,MSQLSTTMSR,0
5mke,D,593,594,1,A,0
5mke,D,595,620,25,DLFGFAIMFFIIFLAYAQLAYLVFG,0
5mke,D,626,644,18,STFQECIFTQFRIILGDI,0
5mke,D,646,652,6,AEIEEA,0
5mke,D,655,681,26,LGPIYFTTFVFFMFFILLNMFLAIIN,0
5mke,D,682,695,13,TYSEVKSDLAQQK,0
5hwx,A,1,7,6,VILGVG,0
5hwx,A,8,28,20,FLLGLILLYYGSDWFVLGSE,0
5hwx,A,40,56,16,IGATVMAIGTSLPEIL,0
5hwx,A,57,73,16,SAYASYMHAPGISIGN,0
5hwx,A,74,92,18,IGSCICNIGLVLGLSAII,0
5hwx,A,104,120,16,ILVYLLFVIFAAVIGI,0
5hwx,A,121,126,5,GFSWI,0
5hwx,A,127,144,17,GVVLLILFIIYLRWTVK,0
5hwx,A,163,183,20,SLVLLIIGLIGVLVGAELFV,0
5hwx,A,184,206,22,GAKKIALALDISDKVIGFTLVA,0
5hwx,A,207,222,15,GTSLPELMVSLAAAK,0
5hwx,A,227,247,20,MVLGNVIGSNIADIGGALAV,0
5hwx,A,248,258,10,SLFMHLPAEN,0
5hwx,A,259,275,16,QMAVLVIMSLLLYLFA,0
5hwx,A,281,299,18,RWQGILFLALYIIAIASL,0
5hwx,A,300,301,1,M,0
2jln,A,1,7,6,NSTPIE,0
2jln,A,31,52,21,LAAIWFAMAIQVAIFIAAGQM,0
2jln,A,53,59,6,SSFQVW,0
2jln,A,60,76,16,VIVAIAAGCTIAVILL,0
2jln,A,110,134,24,ALLSLFWFGFQTWLGALALDEITR,0
2jln,A,135,139,4,LTGF,0
2jln,A,140,157,17,NLPLWIVIFGAIQVVTT,0
2jln,A,164,181,17,RWMNVFASPVLLAMGVY,0
2jln,A,182,207,25,VYLMLDGADVSLGEVMSMGGENPGM,0
2jln,A,208,225,17,FSTAIMIFVGGWIAVVV,0
2jln,A,226,231,5,IHDIV,0
2jln,A,254,271,17,AQWLGMVPASIIFGFIG,0
2jln,A,272,300,28,ASMVLVGEWNPVIAITEVVGGVSIPMAI,0
2jln,A,301,320,19,FQVFVLLATWSTNPAANLL,0
2jln,A,342,357,15,SAVVGLLMMPWQFAG,0
2jln,A,359,372,13,NTFLNLLASALGP,0
2jln,A,419,436,17,AVSFLTPDLMFVTGLIA,0
2jln,A,471,501,30,VAPADESATANTKEQNQPAGGRGSHHHHHH,0
4p6k,B,4,23,19,IAHALFSALFALSELYIAV,0
3leo,C,-4,7,11,HHHHHKDEVAL,0
3leo,C,8,25,17,AAVTLLGVLLQAYFSLQ,0
3leo,C,53,71,18,VNCSEYFPLFLATLWVAG,0
3leo,C,72,78,6,FFHEGA,0
3leo,C,79,95,16,ALCGLVYLFARLRYFQ,0
3leo,C,106,124,18,PLYASARALWLLVALAAL,0
3leo,C,125,142,17,LLAHFLPAALRAALLGR,0
3leo,C,143,145,2,RT,0
3leo,C,146,150,4,LPWA,0
1aty,A,1,8,7,ENLNMDL,0
1aty,A,10,26,16,MAAAVMMGLAAIGAAI,0
1aty,A,27,51,24,IGILGGKFLEGAARQPDLIPLLRT,0
1aty,A,58,77,19,LVDAIPMICVGLGLYVMFA,0
1aty,A,78,79,1,A,0
5hcj,E,5,198,193,SPPPPIADEPLTVNTGIYLIESYSLDDCAETFKVNAFLSLSWKDRRLAFDPVRSGVRVKTYEPEAIWIPEIRFVNVENARDADVVDISVSPDGTVQYLERFSARVLSPLDFRRYPFDSQTLHIYLIVRSVDTRNIVLAVDLEKVGKNDDVFLTGWDIESFTAVVKPANFALEDRLESKLDYQLRISRQYFSYI,0
5hcj,E,199,218,19,NIILPMLFILFISWTAFWS,0
5hcj,E,222,242,20,ANVTLVVSTLIAHIAFNILV,0
5hcj,E,243,255,12,TNCPKTPYMTYT,0
5hcj,E,256,276,20,AIIFMIYLFYFVAVIEVTVQ,0
5hcj,E,292,313,21,RASRIAFPVVFLLANIILAFL,0
5hcj,E,314,315,1,F,0
1c8r,C,1,4,3,AQI,0
1c8r,C,5,9,4,GRPE,0
1c8r,C,10,28,18,IWLALGTALMGLGTLYFL,0
1c8r,C,47,62,15,LVPAIAFTMYLSMLL,0
1c8r,C,63,79,16,YGLTMVPFGGEQNPIY,0
1c8r,C,80,94,14,ARYADWLFTTPLLL,0
1c8r,C,111,127,16,VGADGIMIGTGLVGAL,0
1c8r,C,128,133,5,KVYSY,0
1c8r,C,134,150,16,FVWWAISTAAMLYILY,0
1c8r,C,157,161,4,SKAE,0
1c8r,C,178,192,14,VVLWSAYPVVWLIG,0
1c8r,C,193,202,9,EGAGIVPLN,0
1c8r,C,203,220,17,ETLLFMVLDVSAKVGFG,0
1c8r,C,232,249,17,AEAPEPSAGDGAAATSD,0
3e8f,E,19,22,3,KDK,0
3e8f,E,23,25,2,FQ,0
3e8f,E,26,45,19,LFVLTILTLISGTIFYSTV,0
3e8f,E,51,67,16,DALYFSVVTLTTVGDG,0
3e8f,E,75,96,21,GKIFTILYIFIGIGLVFGFIH,0
3e8f,E,97,103,6,LAVNVQ,0
3e8f,E,104,110,6,PSILSN,0
3e8f,E,111,113,2,VP,0
1vvk,X,2,31,29,KLIPILEKIPEVELPVKEITFKEKLKWTG,0
1vvk,X,32,45,13,VLVLYFIMGCIDV,0
1vvk,X,59,84,25,QTITASRIGTLITLGIGPIVTAGII,0
1vvk,X,85,114,29,QLLVGSGIIQMDLSIPENRALFQGCQKLL,0
1vvk,X,115,127,12,IIMCFVEAVLFV,0
1vvk,X,142,158,16,VIIQIAFGSIILIYLD,0
1vvk,X,159,170,11,IVSKYGIGSGI,0
1vvk,X,171,188,17,LFIAAGVSQTIFVGALG,0
1vvk,X,212,224,12,IIGTIIVFLMVV,0
1vvk,X,225,258,33,AECMRVEIPLAHGRIKGAVGKYPIKFVYVSNIP,0
1vvk,X,259,273,14,ILAAALFANIQLWG,0
1vvk,X,314,328,14,HAIVYMIAMIITCV,0
1vvk,X,329,382,53,FGIFWVETTGLDPKSMAKRIGSLGMAIKGFRKSEKAIEHRLKRYIPPLTVMSS,0
1vvk,X,383,396,13,FVGFLATIANFIG,0
1vvk,X,398,411,13,GGGTGVLLTVSIV,0
1vvk,X,412,433,21,RMYEQLLREKVSELHPAIAKL,0
1vvk,X,434,436,2,NK,0
3gwv,B,1,4,3,EVK,0
3gwv,B,13,31,18,LILAMAGNAVGLGNFLRF,0
3gwv,B,32,44,12,VQAAENGGGAFM,0
3gwv,B,45,63,18,PYIIAFLLVGIPLMWIEW,0
3gwv,B,90,120,30,KILGVFGLWIPLVVAIYYVYIESWTLGFAI,0
3gwv,B,121,132,11,FLVGLVPEPPP,0
3gwv,B,133,134,1,A,0
3gwv,B,135,167,32,DPDSILRPFKEFLYSYIGVPKGDEPILKPSLF,0
3gwv,B,168,184,16,YIVFLITMFINVSILI,0
3gwv,B,191,211,20,ERFAKIAMPTLFILAVFLVI,0
3gwv,B,212,222,10,VFLLETPNGT,0
3gwv,B,223,230,7,ADGLNFL,0
3gwv,B,231,244,13,TPDFEKLKDPGVW,0
3gwv,B,245,265,20,AAVGQIFFTLSLGFGAIITY,0
3gwv,B,278,296,18,GLTAATLNEKAEVILGGS,0
3gwv,B,297,325,28,SIPAAVAFFGVANAVAIAKAGAFNLGFI,0
3gwv,B,326,331,5,LPAIF,0
3gwv,B,332,342,10,QTAGGTFLGF,0
3gwv,B,343,366,23,WFFLLFFAGLTSSIAIMQPMIAF,0
3gwv,B,378,394,16,VLWTAAIVFFSAHLVM,0
3gwv,B,395,399,4,LNKS,0
3gwv,B,400,425,25,DEMDFWAGTIGVVFFGLTELIIFFW,0
3gwv,B,429,437,8,DKAWEEIN,0
3gwv,B,445,468,23,RIYYYVMRYITPAFLAVLLVVWA,0
3gwv,B,469,472,3,EYI,0
3gwv,B,473,478,5,KIMEE,0
3gwv,B,479,484,5,HWTVW,0
3gwv,B,485,502,17,TRFYIIGLFLFLTFLVF,0
3gwv,B,602,605,3,AGT,0
5svk,D,26,47,21,NRVVQLLIISYFVGWVFLHEK,0
5svk,D,48,315,267,YQVRDTAIESSVVTKVKGSGLYANRVMDVSDYVTPPQGTSVFVIITKMIVTENQMQGFCPESEEKYRCVSDSQCGPERLPGGGILTGRCVNYSSVLRTCEIQGWCPTEVDTVETPIMMEAENFTIFIKNSIRFPLFNFEKGNLLPNLTARDMKTCRFHPDKDPFCPILRVGDVVKFAGQDFAKLARTGGVLGIKIGWVCDLDKAWDQCIPKYSFTRLDSVSEKSSVSPGYNFRFAKYYKMENGSEYRTLLKAFGIRFDVLVYGNAGK,0
5svk,D,316,339,23,NIIPTIISSVAAFTSVGVGTVLC,0
3wqj,C,15,32,17,WLGIGTLLMLIGTFYFI,0
3wqj,C,33,50,17,RGWGVTDKEAREYYAIT,0
3wqj,C,51,66,15,LVPGIASAAYLAMFF,0
3wqj,C,84,99,15,YARYADWLFTTPLLL,0
3wqj,C,100,116,16,DLALLAKVDRVTIGTL,0
3wqj,C,117,133,16,GVDALMIVTGLIGALS,0
3wqj,C,138,155,17,RYTWWLFSTIAFLFVLY,0
3wqj,C,156,181,25,LLTSLRSAAAKRSEEVRSTFNTLTA,0
3wqj,C,182,197,15,VAVLWTAYPILWIVG,0
3wqj,C,209,226,17,TLAFMVLDVTAKVGFGF,0
3wqj,C,227,234,7,LLRSRAI,0
2ahz,D,2,18,16,SFLLTLKRMLRACLRA,0
2ahz,D,19,25,6,KDKEFQ,0
2ahz,D,26,45,19,LFVLTILTLISGTIFYSTV,0
2ahz,D,51,67,16,DALYFSVVTLTTVGDG,0
2ahz,D,75,94,19,GKIFTILYIFIGIGLVFGF,0
2ahz,D,95,103,8,HKLAVNVQ,0
2ahz,D,104,110,6,PSILSN,0
5a3s,A,50,76,26,ELVIEQFEDLLVRILLLAACISFVLA,0
5a3s,A,77,87,10,FEEGEETITA,0
5a3s,A,88,106,18,VEPFVILLILIANAIVGV,0
5a3s,A,254,274,20,EFGEQLSKVISLICVAVWLI,0
5a3s,A,275,295,20,IGHFNDPVHGGSWIRGAIYY,0
5a3s,A,296,317,21,KIAVALAVAAIPEGLPAVITT,0
5a3s,A,760,780,20,IRYLISSNVGEVVCIFLTAA,0
5a3s,A,781,786,5,GLPEA,0
5a3s,A,787,807,20,IPVQLLWVNLVTDGLPATAL,0
5a3s,A,832,851,19,LFFRYMAIGGYVGAATVGA,0
5a3s,A,852,897,45,AWWFMYAEDGPGVTYHQLTHFMQCTEDHPHFEGLDCEIFEAPEPM,0
5a3s,A,898,916,18,MALSVLVTIEMCNALNSL,0
5a3s,A,931,950,19,WLLGSICLSMSLHFLILYV,0
5a3s,A,951,967,16,PLPMIFKLKALDLTQW,0
5a3s,A,968,987,19,MVLKISLPVIGLDEILKFI,0
4gx1,F,4,17,13,QRGSAYFLRGRAR,0
4gx1,F,18,20,2,NL,0
4gx1,F,21,41,20,VLLLYCAFLLVMLLAYASIF,0
4gx1,F,59,71,12,YWTITVMTTLGF,0
4gx1,F,83,105,22,FASIVTVSGVIFLDIILPFGFV,0
4gx1,F,106,564,458,MFLAPWIERRLRYHPTIELPDDTRGHILIFGIDPITRTLIRKLESRNHLFVVVTDNYDQALHLEEQEGFKVVYGSPTDAHVLAGLRVAAARSIIANLSDPDNANLCLTVRSLCQTPIIAVVKEPVHGELLRLAGANQVVPLTRILGRYLGIRATTCGALAHILDSFGNLQIAELPVHGTPFAGKTIGESGIRQRTGLSIIGVWERGSLTTPQRETVLTEQSLLVLAGTKSQLAALEYLIGEAPEDELIFIIGHGRIGCAAAAFLDRKPVPFILIDRQESPVCNDHVVVYGDATVGQTLRQAGIDRASGIIVTTNDDSTNIFLTLACRHLHSHIRIVARANGEENVDQLYAAGADFVVSNASVGANILGNLLEHKESAFLSEGMAVFRRPLPPAMAGKTIAETRLRPLTGCSIVAIEAPDRADILISPPPETILAEGARLILIGTSEQEKTFDQTIAAR,0
4gx1,F,565,568,3,VPR,0
4iu9,B,1,11,10,ALQNEKNSRY,0
4iu9,B,41,60,19,CLLLAFCVWMLFSAVTVNL,0
4iu9,B,61,69,8,KIGFNFTT,0
4iu9,B,70,87,17,QLFLLTALPSVSGALLR,0
4iu9,B,106,123,17,TAILIIPCVWLGIAVQN,0
4iu9,B,124,126,2,NT,0
4iu9,B,127,145,18,FGIFIVIALLCGFAGANF,0
4iu9,B,170,189,19,LGNLGVSVMQLVAPLVIFV,0
4iu9,B,190,209,19,VFAFLGVNGVPQADGSVMS,0
4iu9,B,210,227,17,ANAAWIWVPLLAIATIA,0
4iu9,B,236,241,5,SSRAS,0
4iu9,B,257,279,22,SLLYLATFGSFIGFSAGFAMLA,0
4iu9,B,280,288,8,TQFPDVNI,0
4iu9,B,289,307,18,RLAFFGPFIGAIARSVGG,0
4iu9,B,318,336,18,TLINFIFMAIFSALLFLT,0
4iu9,B,337,346,9,PGTGSGNFI,0
4iu9,B,347,366,19,FYAVFMGLFLTAGLGSGST,0
4iu9,B,382,391,9,KMKGGSDEQ,0
4iu9,B,408,428,20,AIGAVGGFFIPQAFGMSLNM,0
4iu9,B,429,432,3,GSP,0
4iu9,B,433,452,19,GAMKVFLIFYIVCVLLTWL,0
4iu9,B,455,468,13,RRKFSQKLEVLFQ,0
4u2p,C,528,540,12,IVFAYIGVSVVL,0
4u2p,C,541,543,2,LV,0
4u2p,C,594,597,3,SLS,0
4u2p,C,598,613,15,RIVAGVWWFFTLIII,0
4u2p,C,797,809,12,ILVGGLGLAMLV,0
4u2p,C,810,816,6,LIEFAY,0
4gyc,D,1,22,21,SLNVSRLLLPSRVRHSYTGKM,0
4gyc,D,24,39,15,VFIFVGALTVLFGAI,0
4gyc,D,65,83,18,GLIILLGINLGLVAATLG,0
4gyc,D,84,135,51,DTAASLSTLAAKASRMGDGDLDVELETRREDEIGDLYAAFDEMRQSVRTSL,0
2hn2,E,4998,5008,10,SHMEEKRLSA,0
2hn2,E,5009,5293,284,KGLPPGTLVYTGKYREDFEIEVMNYSIEEFREFKTTDVESVLPFRDSSTPTWINITGIHRTDVVQRVGEFFGIHPLVLEDILNVHQRPKVEFFENYVFIVLKMFTYDKNLHELESEQVSLILTKNCVLMFQEKIGDVFDPVRERIRYNRGIIRKKRADYLLYSLIDALVDDYFVLLEKIDDEIDVLEEEVLERPEKETVQRTHQLKRNLVELRKTIWPLREVLSSLYRDVPPLIEKETVPYFRDVYDHTIQIADTVETFRDIVSGLLDVYLSSVSNKTNEVMKV,0
2hn2,E,5294,5313,19,TIIATIFMPLTFIAGIYGM,0
2hn2,E,5316,5325,9,YMPELRWKW,0
2hn2,E,5327,5346,19,PVVLAVMGVIAVIMVVYFK,0
2hn2,E,5347,5349,2,KK,0
2hn2,E,5350,5351,1,L,0
5f5b,A,91,93,2,RA,0
5f5b,A,94,109,15,PVTWVMMIACVVVFI,0
5f5b,A,116,123,7,QEVMLWL,0
5f5b,A,136,145,9,RYFTHALMH,0
5f5b,A,148,163,15,MHILFNLLWWWYLGG,0
5f5b,A,164,171,7,VEKRLGS,0
5f5b,A,172,189,17,KLIVITLISALLSGYVQ,0
5f5b,A,199,213,14,LSGVVYALMGYVWL,0
5f5b,A,214,228,14,GERDPQSGIYLQRG,0
5f5b,A,229,245,16,IIFALIWIVAGWFDLF,0
5f5b,A,250,267,17,NGAHIAGLAVGLAMAFV,0
5f5b,A,268,272,4,SLNA,0
3u2y,E,13,31,18,ISTIGLLGAGIGIAIVFA,0
3u2y,E,32,49,17,LINGVSRNPSIKDTVFP,0
3u2y,E,50,70,20,AILGFALSEATGLFCLMVSF,0
3u2y,E,75,76,1,V,0
5xjy,A,4,19,15,PQLRLLLWKNLTFRR,0
5xjy,A,23,40,17,QLLLEVAWPLFIFLILI,0
5xjy,A,41,174,133,VRLSYPPYEQHECHFPNKAMPSAGTLPWVQGIICNANNPCFRYPTPGEAPGVVGNFNKSIVARLFSDARRLLLYSQKDTSMKDMRKVLRTLQQIKKSSSNLKLQDFLVDNETFSGFLYHNLSLPKSTVDKMLR,0
5xjy,A,198,312,114,KSEEMIQLGDQEVSELCGLPREKLAAAERVLRSNMDILKPILRTLNSTSPFPSKELAEATKTLLHSLGTLAQELFSMRSWSDMRQEVMFLTNVNSSSSSTQIYQAVSRIVCGHP,0
5xjy,A,352,640,288,PYCNDLMKNLESSPLSRIIWKALKPLLVGKILYTPDTPATRQVMAEVNKTFQELAVFHDLEGMWEELSPKIWTFMENSQEMDLVRMLLDSRDNDHFWEQQLDGLDWTAQDIVAFLAKHPEDVQSSNGSVYTWREAFNETNQAIRTISRFMECVNLNKLEPIATEVWLINKSMELLDERKFWAGIVFTGITPGSIELPHHVKYKIRMDIDNVERTNKIKDGYWDPGPRADPFEDMRYVWGGFAYLQDVVEQAIIRVLTGTEKKTGVYMQQMPYPCYVDDIFLRVMSRSM,0
5xjy,A,641,659,18,LFMTLAWIYSVAVIIKGI,0
5xjy,A,683,704,21,SWFISSLIPLLVSAGLLVVIL,0
5xjy,A,705,715,10,LGNLLPYSDP,0
5xjy,A,716,740,24,VVFVFLSVFAVVTILQCFLISTLF,0
5xjy,A,745,763,18,AAACGGIIYFTLYLPYVL,0
5xjy,A,764,776,12,VAWQDYVGFTLK,0
5xjy,A,777,788,11,FASLLSPVAFG,0
5xjy,A,789,801,12,GCEYFALFEEQG,0
5xjy,A,819,822,3,NLT,0
5xjy,A,823,843,20,SVSMMLFDTFLYGVMTWYIE,0
5xjy,A,1345,1363,18,GFFAQIVLPAVFVCIALV,0
5xjy,A,1364,1655,291,SLIVPPFGKYPSLELQPWMYNEQYTFVSNDAPEDTGTLELLNALTKDPGFGTRCMEGNPIPDTPCQAGEEEWTTAPVPQTIMDLFQNGNWTMQNPSPACQCSSDKIKKMLPVCPPGAGGLPPPQRKQNTADILQDLTGRNISDYLVKTYVQIIAKSLKNKIWVNEFRYGGFSLGVSNTQALPPSQEVNDAIKQMKKHLKLAKDSSADRFLNSLGRFMTGLDTKNNVKVWFNNKGWHAISSFLNVINNAILRANLQKGENPSHYGITAFNHPLNLTKQQLSEVALMTTSVDV,0
5xjy,A,1656,1673,17,VSICVIFAMSFVPASFV,0
5xjy,A,1704,1724,20,WDMCNYVVPATLVIIIFICF,0
5xjy,A,1725,1732,7,QKSYVSS,0
5xjy,A,1733,1754,21,NLPVLALLLLLYGWSITPLMY,0
5xjy,A,1766,1785,19,YVVLTSVNLFIGINGSVAT,0
5xjy,A,1786,1789,3,VLE,0
5xjy,A,1796,1800,4,NNIN,0
5xjy,A,1801,1824,23,ILKSVFLIFPHFCLGRGLIDMVK,0
5xjy,A,1825,1845,20,QAMADALERFGENRFVSPLS,0
5xjy,A,1846,1865,19,DLVGRNLFAMAVEGVVFFL,0
2f75,A,1,35,34,VLLSENASEGSNCTHPPAPVNISKAILLGVILGG,0
2f75,A,37,49,12,IFGVLGNILVIL,0
2f75,A,50,64,14,VACHRHLHSVTHYY,0
2f75,A,65,87,22,VNLAVADLLLTSTVLPFSAIFE,0
2f75,A,98,120,22,CNIWAAVDVLCCTASIMGLCII,0
2f75,A,121,144,23,IDRYIGVSYPLRYPTIVTQRRGV,0
2f75,A,145,169,24,ALLCVWVLSLVISIGPLFGWRQPA,0
2f75,A,183,202,19,YVLFSALGSFYVPLAIILV,0
2f75,A,203,273,70,YCRVYVVAKRESRGLKSGLKTDKSDSEQVTLRIHRKNVPAEGGGVSSAKNKTHFSVRLLKFSREKKAAKT,0
2f75,A,274,293,19,GIVVGCFVLCWLPFFLVMP,0
2f75,A,306,326,20,VFKIVFWLGYLNSCINPIIY,0
2f75,A,327,330,3,CSS,0
2f75,A,331,340,9,EFKKAFQNV,0
2f75,A,342,466,124,IQCLRRRQSSKHALGYTLHPPSQALEGQHRDMVRIPVGSGETFYKISKTDGVCEWKFFSSMPQGSARITVPKDQSACTTARVRSKSFLQVCCCVGSSAPRPEENHQVPTIKIHTISLGENGEEV,0
4gx5,F,4,16,12,QRGSAYFLRGRA,0
4gx5,F,21,41,20,VLLLYCAFLLVMLLAYASIF,0
4gx5,F,42,55,13,YLMWHLEGRAYSF,0
4gx5,F,56,71,15,AGIYWTITVMTTLGF,0
4gx5,F,72,80,8,DITFESDA,0
4gx5,F,81,108,27,YLFASIVTVSGVIFLLIILPFGFVSMF,0
4gx5,F,565,568,3,VPR,0
4r6z,E,29,45,16,LTILTLISGTIFYSTV,0
4r6z,E,46,50,4,GLRP,0
4r6z,E,51,67,16,DALYFSVVTLTTVGET,0
4r6z,E,68,73,5,PPQTD,0
4r6z,E,74,91,17,GKIFTILYIFIGIGLVF,0
4r6z,E,92,99,7,FIHKLAV,0
4r6z,E,102,109,7,LPSILSN,0
2dys,Z,17,36,19,GLSVTFLSFLLPAGWVLYH,0
2dys,Z,37,43,6,DNYKKS,0
2dys,Z,44,46,2,AA,0
1zll,E,1,24,23,EKVQYLTRSAIRRASTIEMPQQA,0
1zll,E,25,49,24,QKLQNLFINFCLILICLLLICIIV,0
4bem,J,1,28,27,IGDMNIVDFVIQFLSQFDPVDVIKGFS,0
4bem,J,29,40,11,LGIGLAMVAGV,0
4bem,J,82,97,15,IFSLVIALILLFANP,0
4bem,J,98,111,13,ISSTASVWILSAS,0
4bem,J,112,123,11,MASGIAMIAGI,0
4bem,J,165,180,15,IYALIVALILMYANP,0
4bem,J,181,182,1,L,0
4u1x,D,519,542,23,PLAYEIWMAIVFAYILVSVVLFL,0
4u1x,D,543,544,1,S,0
4u1x,D,593,596,3,RSL,0
4u1x,D,597,621,24,ARIVAGVWWFFTLIIISSYTANLA,0
4u1x,D,788,810,22,LSNVAGVFYILVGGLGLAMLVA,0
4u1x,D,811,815,4,IEFA,0
2q68,D,2,18,16,SFLLTLKRMLRACLRA,0
2q68,D,27,45,18,FVLTILTLISGTIFYSTV,0
2q68,D,46,50,4,GLRP,0
2q68,D,51,67,16,DALYFSVVTLTTVGAG,0
2q68,D,68,74,6,FEPQTD,0
2q68,D,75,92,17,GKIFTILYIFIGIGLVF,0
2q68,D,104,114,10,PSILSNLVPR,0
2h8p,J,87,114,27,GRLVAVVVMVAGITSFGLVTAALATWF,0
2h8p,J,115,122,7,GREQERR,0
5hla,A,70,84,14,KLAIVFAVLIAIYG,0
5hla,A,85,239,154,YLDQKIRSRIDGKVWQLPAAVYGRMVNLEPDMTISKNEMVKLLEATQYRQVSKMTRPGEFTVQANSIEMIRRPFDFPDSKEGQVRARLTFDGDHLATIVNMENNRQFGFFRLDPRLITMISSPNGEQRLFVPRSGFPDLLVDTLLATEDRHFYE,0
5hla,A,267,279,12,LTQQLVKNLFLS,0
5hla,A,288,300,12,NEAYMALIMDAR,0
5hla,A,301,399,98,SKDRILELYMNEVYLGQSGDNEIRGFPLASLYYFGRPVEELSLDQQALLVGMVKGASIYNPWRNPKLALERRNLVLRLLQQQQIIDQELYDMLSARPL,0
5hla,A,402,799,397,PRGGVISPQPAFMQLVRQELQAKLGDKVKDLSGVKIFTTFDSVAQDAAEKAAVEGIPALKKQRKLSDLETAIVVVDRFSGEVRAMVGGSEPQFAGYNRAMQARRSIGSLAKPATYLTALSQPKIYRLNTWIADAPIALRQPNGQVWSPQNDDRRYSESGRVMLVDALTRSMNVPTVNLGMALGLPAVTETWIKLGVPKDQLHPVPAMLLGALNLTPIEVAQAFQTIASGGNRAPLSALRSVIAEDGKVLYQSFPQAERAVPAQAAYLTLWTMQQVVQRGTGRQLGAKYPNLHLAGKTGTTNNNVDTWFAGIDGSTVTITWVGRDNNQPTKLYGASGAMSIYQRYLANQTPTPLNLVPPEDIADMGVDYDGNFVCSGGMRILPVWTSDPQSLCQQSEM,0
4bez,B,1,39,38,CGTEGPNFYVPFSNKTGVVRSPFEAPQYYLAEPWQFSM,0
4bez,B,40,63,23,AAYMFLLIMLGFPINFLTLYVTV,0
4bez,B,75,95,20,LLNLAVADLFMVFGDFTTTL,0
4bez,B,96,112,16,TSLHGYFVFGPTGCNL,0
4bez,B,113,133,20,GFFATLGGEIALWSLVVLAI,0
4bez,B,154,172,18,MGVAFTWVMALACAAPPL,0
4bez,B,173,201,28,GWSRYIPEGMQCSCGIDYYTPHEETNNE,0
4bez,B,202,222,20,FVIYMFVVHFIIPLIVIFFC,0
4bez,B,255,277,22,IMVIAFLICWLPYAGVAFYIFT,0
4bez,B,278,289,11,QGSCFGPIFMT,0
4bez,B,290,309,19,PAFFAKTSAVYNPVIYIMM,0
4bez,B,311,321,10,QFRNCMVTTL,0
4bez,B,327,348,21,LGDDEASTTVSKTETSQVAPA,0
5sv9,B,24,25,1,W,0
5sv9,B,26,37,11,DLKDRIPYYKS,0
5sv9,B,38,42,4,WVDA,0
5sv9,B,43,65,22,NYRVIPSTVDTYFNNLLPAIAF,0
5sv9,B,83,100,17,LSSAMAGIVFGVLAGQP,0
5sv9,B,102,113,11,IVGVTGPISIF,0
5sv9,B,136,152,16,LWSMIFHLLLAFTNVV,0
5sv9,B,153,162,9,LLQYVTTFP,0
5sv9,B,163,179,16,DIFGLFINVVYIQKGI,0
5sv9,B,204,219,15,ALVMTAFGLFFKSFH,0
5sv9,B,220,228,8,YPLFTHKI,0
5sv9,B,229,246,17,TFISDYSTALSVLFWSS,0
5sv9,B,297,317,20,FGIILTILFYFDHNVSSLMA,0
5sv9,B,318,331,13,RHQYKLRKPSSFH,0
5sv9,B,332,346,14,DFALLGLTTCISGV,0
5sv9,B,351,366,15,PNGLIPQAPLHTETL,0
5sv9,B,367,381,14,VRDSNQNVVRCVEQ,0
5sv9,B,382,396,14,LTNTFQGLMILGTM,0
5sv9,B,401,406,5,VCLGE,0
5sv9,B,412,427,15,SGLFFIMGINGLMTN,0
5sv9,B,428,437,9,IIHRIVFLF,0
5sv9,B,438,461,23,DPKRRDNNSPLAKISKRSMVIFL,0
5sv9,B,462,478,16,FSLAGFTGEFAITNTI,0
5sv9,B,480,492,12,IGFPLVLLLSVI,0
5sv9,B,493,499,6,SFSFTY,0
5vhz,F,-819,0,819,SIQIGGLFPRGADQEYSAFRVGMVQFSTSEFRLTPHIDNLEVANSFAVTNAFCSQFSRGVYAIFGFYDKKSVNTITSFCGTLHVSFITPSFPTDGTHPFVIQMRPDLKGALLSLIEYYQWDKFAYLYDSDRGLSTLQAVLDSAAEKKWQVTAINVGNINNDKKDETYRSLFQDLELKKERRVILDCERDKVNDIVDQVITIGKHVKGYHYIIANLGFTDGDLLKIQFGGAEVSGFQIVDYDDSLVSKFIERWSTLEEKEYPGAHTATIKYTSALTYDAVQVMTEAFRNLRKQRIEISRRGNAGDCLANPAVPWGQGVEIERALKQVQVEGLSGNIKFDQNGKRINYTINIMELKTNGPRKIGYWSEVDKMVLTEDDTSGLEQKTVVVTTILESPYVMMKKNHEMLEGNERYEGYCVDLAAEIAKHCGFKYKLTIVGDGKYGARDADTKIWNGMVGELVYGKADIAIAPLTITLVREEVIDFSKPFMSLGISIMIKKPQKSKPGVFSFLDPLAYEIWMCIVFAYIGVSVVLFLVSRFSPYEWHTEEFEDGRETQSSESTNEFGIFNSLWFSLGAFMQQGCDISPRSLSGRIVGGVWWFFTLIIISSYTANLAAFLTVERMVSPIESAEDLSKQTEIAYGTLDSGSTKEFFRRSKIAVFDKMWTYMRSAEPSVFVRTTAEGVARVRKSKGKYAYLLESTMNEYIEQRKPCDTMKVGGNLDSKGYGIATPKGSSLGTPVNLAVLKLSEQGVLDKLKNKWWYDKGECGAKDSGSKEKTSALSLSNVAGVFYILVGGLGLAMLVALIEFCYKSRAEAKRMKGTG,0
5vhz,F,1,10,9,TSRRGRALL,0
5vhz,F,11,29,18,VALNLLALLFATTAFLTT,0
5vhz,F,40,84,44,PGCGQGGGANCPNSGANATANSTAAPVAASPAGAPYSWEAGDER,0
5vhz,F,101,105,4,LGGP,0
5vhz,F,123,144,21,LWLSVVSEVLYILLLVVGFSL,0
5vhz,F,145,153,8,CLELLHSS,0
5vhz,F,154,156,2,VI,0
5vhz,F,157,164,7,GLKLNAF,0
5vhz,F,165,184,19,AVFTVLSGLLGMVAHMMYT,0
5vhz,F,206,224,18,WSFCLAWGSFTCCMAASV,0
5vhz,F,225,232,7,TLNSYTK,0
5vhz,F,233,237,4,VIEF,0
5aid,C,34,50,16,SVLVWIMIPGVGLLYS,0
5aid,C,51,55,4,ISRK,0
5aid,C,57,61,4,ALSL,0
5aid,C,62,84,22,WAALMAACVAAFQWFWWGYSLV,0
5aid,C,121,139,18,YQGMFAAVTAILMAGAGC,0
5aid,C,140,144,4,RARL,0
5aid,C,145,166,21,PMMVFLFIWLTVVYCPIAYWT,0
5aid,C,181,201,20,AGGGPVHENSGFAALAYSLW,0
5aid,C,202,203,1,G,0
5aid,C,218,223,5,PHSVS,0
5aid,C,224,242,18,IVMGTIFLWFGWYGFNGG,0
5aid,C,255,275,20,VNTNLAAATGGLTWMLVDWF,0
5aid,C,276,283,7,TGGKWST,0
5aid,C,284,301,17,GLCMGAIAGLVGITPAA,0
5aid,C,307,326,19,TSVIFGIVPAIICNFAVDL,0
5aid,C,327,335,8,DLLQIDDG,0
5aid,C,336,356,20,DVWALHGVGGFVGNFMTGLF,0
5aid,C,382,409,27,YQLAGSCAVAAWSFTVTSIILLAMDRI,0
5aid,C,410,416,6,FLRIRL,0
1jgw,H,1,10,9,VGVTAFGNF,0
1jgw,H,12,29,17,ASLAIYSFWIFLAGLIY,0
1jgw,H,30,246,216,LQTENMREGYPLENEDGTPAANQGPFPLPKPKTFILPHGRGTLTVPGPESEDRPIALARTAVSEGFPHAPTGDPMKDGVGPASWVARRDLPELDGHGHNKIKPMKAAAGFHVSAGKNPIGLPVRGCDLEIAGKVVDIWVDIPEQMARFLEVELKDGSTRLLPMQMVKVQSNRVHVNALSSDLFAGIPTIKSPTEVTLLEEDKICGYVAGGLMYAAP,0
1jgw,H,247,260,13,RKSVVAAMLAEYA,0
3pwh,A,1,6,5,PIMGS,0
3pwh,A,12,29,17,ELAIAVLAILGNVLVCW,0
3pwh,A,30,43,13,VWLNSNLQNVTNY,0
3pwh,A,44,63,19,VVSLAAADILVGVLAIPFA,0
3pwh,A,83,99,16,VLVLAQSSIFSLLAIA,0
3pwh,A,100,121,21,DRYIAIAIPLRYNGLVTGTRA,0
3pwh,A,122,138,16,GIIAICWVLSFAIGLT,0
3pwh,A,150,157,7,EGKNHSQ,0
3pwh,A,178,197,19,YFNFFACVLVPLLLMLGVY,0
3pwh,A,198,235,37,RIFAAARRQLKQMESQPLPGERARSTLQKEVHAAKSA,0
3pwh,A,236,252,16,IIAGLFALCWLPLHII,0
3pwh,A,273,287,14,IVLAHTNSVVNPFI,0
3pwh,A,288,292,4,AYRI,0
3pwh,A,293,304,11,EFRQTFRKIIR,0
3pwh,A,306,329,23,VLRQQEPFKAAAAHHHHHHHHHH,0
3e8b,E,19,22,3,KDK,0
3e8b,E,23,25,2,FQ,0
3e8b,E,26,45,19,LFVLTILTLISGTIFYSTV,0
3e8b,E,51,67,16,DALYFSVVTLTTVGDG,0
3e8b,E,75,96,21,GKIFTILYIFIGIGLVFGFIH,0
3e8b,E,97,103,6,LAVNVQ,0
3e8b,E,104,110,6,PSILSN,0
3e8b,E,111,113,2,VP,0
4in7,M,1,54,53,EYQNIFSQVQVRGPADLGMTEDVNLANRSGVGPFSTLLGWFGNAQLGPIYLGS,0
4in7,M,55,72,17,GVLSLFSGLMWFFTIGI,0
4in7,M,82,87,5,AVFLR,0
4in7,M,117,133,16,ASFFMFVAVWSWWGRT,0
4in7,M,134,146,12,LRAQALGMGKHT,0
4in7,M,147,164,17,WAFLSAIWLWMVLGFIR,0
4in7,M,179,192,13,FSHLDWTNNFSLV,0
4in7,M,201,221,20,HGLSIAFLYGSANLFAMHGA,0
4in7,M,222,268,46,ILAVSRFGGERELEQIADRGTAAERAALFWRWTMGFNATMEGIHRW,0
4in7,M,269,286,17,IWMAVLVTLTGGIGILL,0
4in7,M,294,299,5,YVWGQ,0
4in7,M,303,306,3,APL,0
5jlc,A,20,24,4,SYFQ,0
5jlc,A,25,29,4,LPLA,0
5jlc,A,30,45,15,RVSIMVALPFVYTIT,0
3wdo,A,12,33,21,ATWGLGTVFSLRMLGMFMVLP,0
3wdo,A,34,52,18,LTTYGMALQGASEALIGI,0
3wdo,A,53,72,19,IGIYGLTQAVFQIPFGLLS,0
3wdo,A,79,98,19,LIVGGLAVFAAGSVIAALS,0
3wdo,A,99,102,3,SIW,0
3wdo,A,103,122,19,IILGRALQGSGAIAAAVMA,0
3wdo,A,134,155,21,KAMAFIGVSFGITFAIAMVLG,0
3wdo,A,156,162,6,IITHKL,0
3wdo,A,163,185,22,LHALFWMIAILATTGIALTIWV,0
3wdo,A,203,209,6,SFSKVL,0
3wdo,A,210,232,22,EPRLLKLNFGIMCLHMLLMSTF,0
3wdo,A,233,250,17,ALPGQLADAGFPAAEHW,0
3wdo,A,251,272,21,VYLATMLIAFGSVVPFIIYAE,0
3wdo,A,277,296,19,KQVFVFCVGLIVVAEIVLW,0
3wdo,A,297,306,9,AQTQFWQLV,0
3wdo,A,307,328,21,GVQLFFVAFNLMEALLPSLIS,0
3wdo,A,338,358,20,AMGVYSTSQFLGVAIGGSLG,0
3wdo,A,359,370,11,WIDGMFDGQGV,0
3wdo,A,371,388,17,LAGAMLAAVWLAVASTM,0
5hv9,C,5,7,2,AL,0
5hv9,C,8,28,20,AAVTLLGVLLQAYFSLQVIS,0
5hv9,C,50,71,21,RAQVNCSEYFPLFLATLWVAG,0
5hv9,C,72,78,6,FFHEGA,0
5hv9,C,79,98,19,ALCGLVYLFARLRYFQGYA,0
5hv9,C,104,124,20,LAPLYASARALWLLVALAAL,0
5hv9,C,125,141,16,LLAHFLPAALRAALLG,0
5hv9,C,142,147,5,LRTLL,0
4gbz,A,1,4,3,NTQ,0
4gbz,A,5,14,9,NSSYIFSIT,0
4gbz,A,15,35,20,VATLGGLLFGYDTAVISGTV,0
4gbz,A,36,41,5,SLNTV,0
4gbz,A,56,75,19,LGFCVASALIGCIIGGALG,0
4gbz,A,76,87,11,YCSNRFGRRDS,0
4gbz,A,88,105,17,KIAAVLFFISGVGSAWP,0
4gbz,A,125,148,23,VPEFVIYRIIGGIGVGLASMLSP,0
4gbz,A,149,161,12,YIAELAPAHIRG,0
4gbz,A,162,185,23,LVSFNQFAIIFGQLLVYCVNYFI,0
4gbz,A,199,218,19,RYMFASECIPALLFLMLLY,0
4gbz,A,219,279,60,VPESPRWLMSRGKQEQAEGILRKIMGNTLATQAVQEIKHSLDHGRKTGGRLLMFGVGVIV,0
4gbz,A,280,302,22,GVMLSIFQQFVGINVVLYYAPE,0
4gbz,A,316,336,20,QTIIVGVINLTFTVLAIMTV,0
4gbz,A,337,341,4,KFGR,0
4gbz,A,342,364,22,PLQIIGALGMAIGMFSLGTAFY,0
4gbz,A,372,395,23,LLSMLFYVAAFAMSWGPVCWVLL,0
4gbz,A,396,409,13,EIFPNAIRGKALA,0
4gbz,A,410,431,21,AVAAQWLANYFVSWTFPMMDK,0
4gbz,A,432,439,7,SWLVAHF,0
4gbz,A,442,460,18,FSYWIYGCMGVLAALFMW,0
4gbz,A,461,479,18,FVPETKGKTLEELEALWE,0
4gbz,A,480,491,11,ETKKTQQTATL,0
3lrb,B,1,5,4,SSDA,0
3lrb,B,6,14,8,AHKVGLIP,0
3lrb,B,15,31,16,TLMVSGNIMGSGVFLL,0
3lrb,B,44,58,14,GWLVTIIGALGLSM,0
3lrb,B,59,88,29,YAKMSFLDPSPGGSYAYARRCFGPFLGYQ,0
3lrb,B,89,112,23,NVLYWLACWIGNIAMVVIGVGYL,0
3lrb,B,125,140,15,TITCVVVLWIFVLLN,0
3lrb,B,141,146,5,VGPKM,0
3lrb,B,147,171,24,TRVQAVATVLALIPIVGIAVFGWF,0
3lrb,B,194,209,15,STLNVTLWSFIGVES,0
3lrb,B,210,228,18,SVAAGVVKNPKRNVPIAT,0
3lrb,B,229,244,15,GGVLIAAVCYVLSTT,0
3lrb,B,253,272,19,ALRVSASPFGDAARMALGD,0
3lrb,B,278,298,20,SFCAAAGCLGSLGGWTLLAG,0
3lrb,B,299,327,28,TAKAAADDGLFPPIFARVNKAGTPVAGL,0
3lrb,B,328,342,14,IVGILMTIFQLSSI,0
3lrb,B,349,367,18,FGLVSSVSVIFTLVPYLY,0
3lrb,B,368,389,21,CAALLLLGHGHFGKARPAYLA,0
3lrb,B,390,407,17,TTIAFLYCIWAVVGSGA,0
3lrb,B,409,423,14,VMWSFVTLMVITAM,0
3lrb,B,424,435,11,ALNYNRLHKNP,0
3lrb,B,436,445,9,PLDAPISKD,0
5fxk,D,26,31,5,RSQKS,0
5fxk,D,32,206,174,PSIGIAVILVGTSDEVAIKDAHEKDDFHHLSVVPRVELVAMNETDPKSIITRICDLMSDRKIQGVVFADDTDQEAIAQILDFISAQTLTPILGIHGGSSMIMADKDESSMFFQFGPSIEQQASVMLNIMEEYDWYIFSIVTTYFPGYQDFVNKIRSTIENSFVGWELEEVLLLD,0
5fxk,D,207,213,6,SLDDGD,0
5fxk,D,214,393,179,KIQNQLKKLQSPIILLYCTKEEATYIFEVANSVGLTGYGYTWIVPSLVAGDTDTVPSEFPTGLISVSYDEWDYGLPARVRDGIAIITTAASDMLSEHSFIPEPKSSCYNTHEKRIYQSNMLNRYLINVTFEGRDLSFSEDGYQMHPKLVIILLNKERKWERVGKWKDKSLQMKYYVWPR,0
5fxk,D,394,401,7,CPETEEQ,0
5fxk,D,402,439,37,DDHLSIVTLEEAPFVIVESVDPLSGTCMRNTVPCQKR,0
5fxk,D,440,451,11,ISENKTDEEPG,0
5fxk,D,452,557,105,IKKCCKGFCIDILKKISKSVKFTYDLYLVTNGKHGKKINGTWNGMIGEVVMKRAYMAVGSLTINEERSEVVDFSVPFIETGISVMVSRSNGTVSPSAFLEPFSAC,0
5fxk,D,558,575,17,WVMMFVMLLIVSAVAVF,0
5fxk,D,579,599,20,FSPVGYNRSLADGREPGGPS,0
5fxk,D,602,620,18,GKAIWLLWGLVFNNSVPV,0
5fxk,D,625,643,18,TTSKIMVSVWAFFAVIFL,0
5fxk,D,644,821,177,SYTANLAAFMIQEEYVDQVSGLSDKKFQRPNDFSPPFRFGTVPNGSTERNIRNNYAEMHAYMGKFNQRGVDDALLSLKTGKLDAFIYDAAVLNYMAGRDEGCKLVTIGSGKVFASTGYGIAIQKDSGWKRQVDLAILQLFGDGEMEELEALWLTGICHNEKNEVMSSQLDIDNMAGV,0
5fxk,D,822,839,17,YMLGAAMALSLITFISE,0
5fxk,D,846,852,6,RHSFMG,0
5hvx,D,13,32,19,FQNVITAIIVLNGAVLGLL,0
5hvx,D,33,44,11,DTTLSASSQNL,0
5hvx,D,45,65,20,ERVDQLCLTIFIVEISLKIY,0
5hvx,D,73,91,18,RSGWNLFDFVIVAIALMP,0
5hvx,D,92,99,7,QGSLSVL,0
5hvx,D,101,118,17,FRIFRVMRLVSVIPTMR,0
5hvx,D,120,149,29,VQGMLLALPGVGSVAALLTVVFYIAAVMA,0
5hvx,D,150,167,17,NLYGATFPEWFGDLSKS,0
5hvx,D,168,178,10,YTLFQVMTLE,0
5hvx,D,179,196,17,WSMGIVRPVMNVHPNAW,0
5hvx,D,197,222,25,FFIPFIMLTTFTVLNLFIGIIVDAM,0
5hvx,D,263,274,11,ELLQRQQPQKK,0
4g70,C,1,3,2,EE,0
4g70,C,4,6,2,PK,0
4g70,C,7,24,17,ALAVILVLTLTILVFWL,0
4g7q,C,1,2,1,E,0
4g7q,C,3,6,3,KPK,0
4g7q,C,7,24,17,ALAVILVLTLTILVFWL,0
5hxs,A,5,24,19,VGYFLLGLILLYYGSDWFV,0
5hxs,A,25,39,14,GSERIARHFNVSNF,0
5hxs,A,40,58,18,IGATVMAIGTSLPEILTS,0
5hxs,A,72,92,20,NAIGSCICNIGLVLGLSAII,0
5hxs,A,93,103,10,PIIVDKNLQK,0
5hxs,A,104,120,16,ILVYLLFVIFAAVIGI,0
5hxs,A,127,143,16,GVVLLILFIIYLRWTV,0
5hxs,A,144,153,9,NGSAEIEEN,0
5hxs,A,158,165,7,PSVVFSL,0
5hxs,A,166,186,20,LLIIGLIGVLVGAELFVDGA,0
5hxs,A,205,222,17,AFGTSLPELMVSLAAAK,0
5hxs,A,223,228,5,NLGGM,0
5hxs,A,229,247,18,LGNVIGSNIADIGGALAV,0
5hxs,A,259,275,16,QMAVLVIMSLLLYLFA,0
5hxs,A,276,280,4,YSKI,0
5hxs,A,281,298,17,RWQGILFLALYIIAIAS,0
4pop,A,6,11,5,NVRLL,0
4pop,A,12,31,19,EIAFMAALAFIISLIPNTV,0
4pop,A,36,49,13,VEIACIPILLLSL,0
4pop,A,50,53,3,RGL,0
4pop,A,54,73,19,AGLVGGLIWGILSMITGHA,0
4pop,A,80,97,17,AFLEYLVAPVSLGIAGL,0
4pop,A,98,110,12,RQKTAPLKLAPV,0
4pop,A,111,128,17,LGTFVAVLLKYFFHFIA,0
4pop,A,149,169,20,VNGISGILTAIAAFVILIIF,0
4pop,A,170,182,12,KKFPKLFIHSNY,0
1a91,A,1,13,12,ENLNMDLLYMAA,0
1a91,A,14,38,24,VMMGLAAIGAAIGIGILGGKFLEG,0
1a91,A,49,71,22,RTQFFIVMGLVDAIPMIAVGLG,0
1a91,A,72,79,7,YVMFAVA,0
1sqx,J,2,4,2,PT,0
1sqx,J,5,12,7,TARLYSL,0
1sqx,J,13,17,4,FRRT,0
1sqx,J,18,43,25,TFALTIVVGALFFERAFDQGADAIY,0
5d91,A,-130,14,144,RLAYVKNHEIYGEKLLGLTLRERIEKTLQRAGFDVRFFDELSLEEAEDYLIILEPVLILERDLLLEGRKILVSDGFTVGYFFGGDFRTVFDGNLQSSIEKYLSLNNLESYEIWAIKLSNDNLKTAEKLLLSSLIGSRGLFAAIF,0
5d91,A,15,23,8,PIARLLAD,0
5d91,A,24,33,9,GVSPDAVTV,0
5d91,A,34,51,17,GTLGVMAGALIFYPMGQ,0
5d91,A,53,66,13,WGTVVITVFVFSD,0
5d91,A,67,90,23,IDGLMARLLFREGPWGAFLDSYL,0
5d91,A,91,108,17,RVGDSSVFTGIVIWFFL,0
5d91,A,114,129,15,IAILALICLVLSSLV,0
5d91,A,130,147,17,YSKARAEGLGLTANVGI,0
5d91,A,148,166,18,ERSERLVVVLVATGLVGL,0
5d91,A,171,187,16,VLLVVLIVLAIASVVT,0
5d91,A,188,204,16,FQRVLTVREQAKAWTA,0
3rvy,D,1983,2000,17,DYKDDDDKGSLVPRGSH,0
3rvy,D,2002,2009,7,LRITNIV,0
3rvy,D,2015,2033,18,KFIIYLIVLNGITMGLET,0
3rvy,D,2034,2044,10,KTFMQSFGVY,0
3rvy,D,2045,2064,19,TLFNQIVITIFTIEIILRI,0
3rvy,D,2076,2091,15,SLFDFFVVAISLVPT,0
3rvy,D,2092,2097,5,SGFEI,0
3rvy,D,2098,2113,15,RVLRVLRLFRLVTAV,0
3rvy,D,2114,2130,16,QMRKIVSALISVIPGM,0
3rvy,D,2131,2148,17,SVIALMTLFFYIFAIMA,0
3rvy,D,2149,2166,17,QLFGERFPEWFGTLGES,0
3rvy,D,2167,2180,13,YTLFQVMTLESWS,0
3rvy,D,2181,2190,9,GIVRPLMEV,0
3rvy,D,2191,2194,3,PYA,0
3rvy,D,2195,2214,19,VFFIPFIFVVTFVMINLVV,0
3rvy,D,2222,2267,45,ILNQKEEQHIIDEVQSHEDNINNEIIKLREEIVELKELIKTSLKN,0
5ch4,G,11,25,14,YLGVAGLLVYLVLV,0
5ch4,G,26,52,26,EPKQGAGDLMGGSADLFSARGVTGGL,0
5ch4,G,53,67,14,RLTVILGVVFAALA,0
4y28,3,106,122,16,RFAMLGAVGAIAPEYL,0
4y28,3,123,154,31,KVGLIPQETALAWFQTGVIPPAGTYNYWADN,0
4y28,3,155,167,12,TLFVLEMALMGF,0
4y28,3,234,246,12,MLAILGYFIQGL,0
4y28,3,247,251,4,TGVG,0
4y28,3,252,261,9,YQNLLDHVA,0
4y28,3,262,272,10,PVNNNVLTSL,0
2met,C,205,232,27,EIIILEGTAVIAMFFWLLLVIILRTVK,0
2met,C,233,237,4,ANGG,0
4ib4,A,26,47,21,YKDDDDGAPTESIPEEMKQIV,0
4ib4,A,54,76,22,HWAALLILMVIIPTIGGNTLVI,0
4ib4,A,77,93,16,AVSLEKKLQYATNYFL,0
4ib4,A,94,116,22,SLAVADLLVGLFVMPIALLTIM,0
4ib4,A,122,148,26,LPLVLCPAWLFLDVLFSTASIWHLCA,0
4ib4,A,149,176,27,SVDRYIAIKKPIQANQYNSRATAFIKI,0
4ib4,A,177,195,18,VVWLISIGIAIPVPIKGI,0
4ib4,A,198,200,2,VD,0
4ib4,A,208,235,27,LTKERFGDFMLFGSLAAFFTPLAIMIV,0
4ib4,A,236,1042,806,YFLTIHALQKKAADLEDNWETLNDNLKVIEKADNAAQVKDALTKMRAAALDAQK,0
4ib4,A,1043,1058,15,TPPKLEDKSPDSPEM,0
4ib4,A,1059,327,-732,DFRHGFDILVGQIDDALKLANEGKVKEAQAAAEQLKTTRNAYIQKYLQTISNEQRASKVLG,0
4ib4,A,328,350,22,VFFLFLLMWCPFFITNITLVLC,0
4ib4,A,359,380,21,MLLEIFVWIGYVSSGVNPLVY,0
4ib4,A,381,384,3,LFN,0
4ib4,A,385,394,9,TFRDAFGRY,0
4ib4,A,395,400,5,TCNYR,0
4ib4,A,401,414,13,TKSVGRPLEVLFQ,0
1zza,A,1,5,4,SMSI,0
1zza,A,6,25,19,DHSPTTGVVTVIVILIAIA,0
1zza,A,62,81,19,LLVQYSAKGPCVERKAKLM,0
4q2g,B,1,21,20,GSSHHHHHHSSGLVPRGSHM,0
4q2g,B,24,45,21,KTRVITASVVAPFVVLCFVSY,0
4q2g,B,47,64,17,LIGLVSAILILAGYELI,0
4q2g,B,75,92,17,FYVILLALYPVLYGLVF,0
4q2g,B,94,112,18,PTQPLSILFITGVVFSLI,0
4q2g,B,125,145,20,AFSIALIYVTFFLSFFLPIY,0
4q2g,B,146,152,6,DFGAAN,0
4q2g,B,153,175,22,LLVLTSTWVFDSFAYFTGLKFG,0
4q2g,B,188,206,18,LEGVIGGFLGVVIYTFLY,0
4q2g,B,207,223,16,LVVNDLLSVNVICFRT,0
4q2g,B,224,242,18,LPFAATVAIMDTFGDIFE,0
4q2g,B,258,284,26,PGHGGMLDRIDGLLFVAPVCYIVFKI,0
4q2g,B,285,290,5,EGVVR,0
4jrz,C,-5,7,12,HHHHHHKDEVAL,0
4jrz,C,8,22,14,AAVTLLGVLLQAYF,0
4jrz,C,57,71,14,EYFPLFLATLWVAG,0
4jrz,C,72,78,6,FFHEGA,0
4jrz,C,79,92,13,ALCGLVYLFARLR,0
4jrz,C,108,124,16,YASARALFLLVALAAL,0
4jrz,C,125,139,14,LLAHFLPAALRAAL,0
4jrz,C,140,149,9,GRLRTLLPW,0
2l91,A,689,711,22,GPDILVVLLSVMGAILLIGLAP,0
2l91,A,712,727,15,LIWALLITIHDRKEF,0
4zwj,A,1002,1038,36,IFEMLRIDEGLRLKIYKDTEGYYTIGIGHLLTKSPS,0
4zwj,A,1039,1050,11,NAAKSELDKAI,0
4zwj,A,1051,39,-1012,RNTNGVITKDEAEKLFNQDVDAAVRGILRNAKLKPVYDSLDAVRRAALINMVFQMGETGVAGFTNSLRMLQQKRWDEAAVNLAKSRWYNQTPNRAKRVITTFRTGTWDAYMCGTEGPNFYVPFSNATGVVRSPFEYPQYYLAEPWQFSM,0
4zwj,A,40,65,25,AAYMFLLIVLGFPINFLTLYVTVQH,0
4zwj,A,69,95,26,TPLNYILLNLAVADLFMVLGGFTSTL,0
4zwj,A,96,112,16,TSLHGYFVFGPTGCNL,0
4zwj,A,113,137,24,GFFATLGGEIALWSLVVLAIERYV,0
4zwj,A,151,173,22,HAIMGVAFTWVMALACAAPPLA,0
4zwj,A,174,202,28,WSRYIPEGLQCSCGIDYYTLKPEVNNES,0
4zwj,A,203,228,25,VIYMFVVHFTIPMIIIFFCYGQLVF,0
4zwj,A,251,274,23,RMVIIYVIAFLICWVPYASVAFY,0
4zwj,A,275,289,14,FTHQGSCFGPIFMT,0
4zwj,A,290,314,24,PAFFAKSAAIYNPVIYIMMNKQFR,0
4zwj,A,315,321,6,CMLTTI,0
4cz9,B,1,3,2,IE,0
4cz9,B,4,24,20,SLAEALFLILFTGVISMLIS,0
4cz9,B,30,46,16,YVPIFILTGLVIGPLL,0
4cz9,B,47,53,6,LIPRDL,0
4cz9,B,54,75,21,HEIFDFVRVFGLVIILFTEGH,0
4cz9,B,79,84,5,RLLKK,0
4cz9,B,88,108,20,IVTLDTIGLILTALIAGFIF,0
4cz9,B,109,119,10,VVFNSSFLLG,0
4cz9,B,120,134,14,LFGAIIGATDPATL,0
4cz9,B,152,169,17,TESIFNDPLGIVLTLIA,0
4cz9,B,170,179,9,SMLVPGYGG,0
4cz9,B,180,189,9,IFSTLSEKL,0
4cz9,B,190,192,2,IY,0
4cz9,B,193,217,24,GGVIYFLYNVSVSISLGIFLGILG,0
4cz9,B,218,224,6,KFIKRT,0
4cz9,B,231,250,19,IEAFSLSLAFLGFFIGERL,0
4cz9,B,252,264,12,SGYLVATVTGIV,0
4cz9,B,294,313,19,DTLAALATIFIFVLLGAEM,0
4cz9,B,315,320,5,EVIWS,0
4cz9,B,321,322,1,L,0
4cz9,B,323,346,23,KGLLVALGVMILARPLATLPLLK,0
4cz9,B,354,372,18,FIALEGPRGVVPSALASL,0
4cz9,B,373,393,20,LSLALKYKSPLLTVHWGEII,0
4cz9,B,394,411,17,ATVVITVLTSVIVETLW,0
4cz9,B,412,419,7,PILKDKL,0
2b6p,D,2,10,8,ELRSASFW,0
2b6p,D,11,31,20,AICAEFFASLFYVFFGLGAS,0
2b6p,D,43,60,17,VALAFGLALATLVQAVG,0
2b6p,D,61,62,1,I,0
2b6p,D,63,78,15,GAHVNPAVTFAFLVG,0
2b6p,D,79,83,4,QMSL,0
2b6p,D,84,107,23,RAICYMVAQLLGAVAGAAVLYSV,0
2b6p,D,129,149,20,ATIVEIFLTLQFVLCIFATY,0
2b6p,D,150,157,7,ERRNGRL,0
2b6p,D,158,176,18,SVALAVGFSLTLGHLFGM,0
2b6p,D,180,194,14,AGMNPARSFAPAIL,0
2b6p,D,202,223,21,VYWVGPVIGAGLGSLLYDFLL,0
2b6p,D,224,229,5,PRLKS,0
2b6p,D,230,236,6,SERLSI,0
2b6p,D,237,263,26,KGSRPSESNGQPEVTGEPVELKTQAL,0
5b6y,C,4,11,7,TGRPEWI,0
5b6y,C,12,28,16,LALGTALMGLGTLYFL,0
5b6y,C,47,61,14,LVPAIAFTMYLSML,0
5b6y,C,62,79,17,GYGLTMVPFGGEQNPIY,0
5b6y,C,80,94,14,ARYADWLFTTPLLL,0
5b6y,C,111,126,15,VGADGIMIGTGLVGA,0
5b6y,C,127,134,7,TKVYSYR,0
5b6y,C,135,150,15,VWWAISTAAMLYILY,0
5b6y,C,178,192,14,VVLWSAYPVVWLIG,0
5b6y,C,193,203,10,EGAGIVPLNI,0
5b6y,C,204,220,16,TLLFMVLDVSAKVGFG,0
3txt,C,96,110,14,TWVMMIACVVVFIA,0
3txt,C,111,133,22,QILGDQEVMLWLAWPFDPTLKF,0
3txt,C,134,145,11,FWRYFTHALMH,0
3txt,C,146,147,1,S,0
3txt,C,148,165,17,MHILFNLLWWWYLGGAV,0
3txt,C,173,189,16,LIVITLISALLSGYVQ,0
3txt,C,190,198,8,KFSGPWFG,0
3txt,C,199,214,15,LSGVVYALMGYVWLR,0
3txt,C,226,241,15,RGLIIFALIWIVAGW,0
3txt,C,242,244,2,DL,0
3txt,C,245,248,3,GMS,0
3txt,C,249,251,2,AN,0
3txt,C,252,267,15,AHIAGLAVGLAMAFV,0
2low,A,1,10,9,EEGGDFDNY,0
2low,A,24,48,24,KSSGALIPAIYMLVFLLGTTGNGL,0
2low,A,49,64,15,LWTVFRKKGHHHHHH,0
1rzh,H,1,10,9,VGVTAFGNF,0
1rzh,H,13,29,16,SLAIYSFWIFLAGLIY,0
1rzh,H,30,248,218,LQTENMREGYPLENEDGTPAANQGPFPLPKPKTFILPHGRGTLTVPGPESEDRPIALARTAVSEGFPHAPTGDPMKDGVGPASWVARRDLPELDGHGHNKIKPMKAAAGFHVSAGKNPIGLPVRGCDLEIAGKVVDIWVDIPEQMARFLEVELKDGSTRLLPMQMVKVQSNRVHVNALSSDLFAGIPTIKSPTEVTLLEEDKICGYVAGGLMYAAPKR,0
1rzh,H,249,260,11,SVVAAMLAEYA,0
2iq4,_,13,28,15,VVATSLLKSTEGFTR,0
2iq4,_,29,32,3,WPT,0
2iq4,_,33,49,16,GCLVGYGIAFALLALS,0
2iq4,_,67,82,15,TAAIVLVAVLFLGSP,0
2iq4,_,83,86,3,SVM,0
2iq4,_,87,104,17,VVGVGLIVVGVVTLNLA,0
2iqu,A,48,68,20,EVFVTLGVISLLENILVIVA,0
2iqu,A,69,82,13,AKNKNLHSPMYFF,0
2iqu,A,83,101,18,CSLAVADMLVSVSNGSET,0
2iqu,A,122,142,20,NVIDSVICSSLLASICSLLS,0
2iqu,A,143,170,27,AVDRYFTIFYALQYHNIMTVKRVGIII,0
2iqu,A,171,190,19,CIWAACTVSGILFIIYSDS,0
2iqu,A,192,209,17,VIICLITMFFTMLALMA,0
2iqu,A,210,245,35,LYVHMFLMARLHIKRIAVLPGTGAIRQGANMKGAI,0
2iqu,A,246,274,28,LTILIGVFVVCWAPFFLHLIFYISCPQN,0
2iqu,A,285,305,20,LYLILIMCNSIIDPLIYALR,0
2iqu,A,307,317,10,ELRKTFKEII,0
2iqu,A,318,321,3,CYP,0
4xnj,A,5,16,11,KTFFGQPLGLS,0
4xnj,A,17,37,20,LFMTEMWERFSYYGMRAILL,0
4xnj,A,58,78,20,IMAIYASMVYLSGTIGGFVA,0
4xnj,A,79,84,5,RIIGA,0
4xnj,A,85,104,19,PAVFWGGVLIMLGHIVLAL,0
4xnj,A,111,130,19,FGSIILIIIGTGFLKPNVS,0
4xnj,A,131,148,17,LVGTLYDEHDRRRDAGF,0
4xnj,A,149,169,20,IFVFGINLGAFIAPLIVGAA,0
4xnj,A,178,197,19,FSLAAIGMFIGLLVYYFGG,0
4xnj,A,198,219,21,KTLDPHYLRPTDPLAPEEVKP,0
4xnj,A,220,240,20,LVKVSLAVAGFIAIIVVMNL,0
4xnj,A,248,270,22,YINLLTIVAIAIPVFYFAWMIS,0
4xnj,A,275,283,8,STEHLRVV,0
4xnj,A,284,307,23,YIPLFIAAVLFWAIEEQGSVVLA,0
4xnj,A,323,342,19,FQSLNPLFIMLYTPFFAWL,0
4xnj,A,343,353,10,TAWKKNQPSS,0
4xnj,A,354,372,18,TKFAVGLMFAGLSFLLMA,0
4xnj,A,387,408,21,WLVGSWALVILGEMLISPVGL,0
4xnj,A,409,414,5,VTTKL,0
4xnj,A,420,422,2,SQ,0
4xnj,A,423,442,19,MSMWFLSSSVGSALNAQLV,0
4xnj,A,454,472,18,SYFGLGSVVLGIVLVFLS,0
4xnj,A,473,478,5,RIQGL,0
4h37,D,1,13,12,RYIVPIYSFFRS,0
4h37,D,14,17,3,GLN,0
4h37,D,18,34,16,FLMIFVLLVIIIPVPM,0
4h37,D,48,61,13,WWAIVTATTVGYG,0
4h37,D,69,89,20,GRILASIMMLFGIAFIGMIT,0
4h37,D,90,99,9,TITNFFRCK,0
4h37,D,100,137,37,PTNSSTQRANKITQLISETPDLTKEEIAVVEQFLTLR,0
2lbg,A,7,24,17,AAGAVVGGLGGYMLGSA,0
2lbg,A,25,27,2,SR,0
4qh5,E,5,194,189,SPPPPIADEPLTVNTGIYLIECYSLDDKAETFKVNAFLSLSWKDRRLAFDPVRSGVRVKTYEPEAIWIPEIRFVNVENARDADVVDISVSPDGTVQYLERFSARVLSPLDFRRYPFDSQTLHIYLIVRSVDTRNIVLAVDLEKVGKNDDVFLTGWDIESFTAVVKPANFALEDRLESKLDYQLRISRQY,0
4qh5,E,195,217,22,SYIPNIILPMLFILFISWTAFW,0
4qh5,E,222,244,22,ANVTLVVSTLIAHIAFNILVET,0
4qh5,E,245,251,6,LPKTPY,0
4qh5,E,252,275,23,TYTGAIIFMIYLFYFVAVIEVTV,0
4qh5,E,295,315,20,RIAFPVVFLLANIILAFLFF,0
4qi1,C,18,37,19,WLALGTIGMLLGMLYFIAD,0
4qi1,C,38,50,12,LDVQDPRQKEFY,0
4qi1,C,51,69,18,ITILIPAIAAASYLSMFF,0
4qi1,C,88,104,16,ARYADWLFTTPLLLLD,0
4qi1,C,105,117,12,GLLAGASQRDIG,0
4qi1,C,118,136,18,LVGIDAFMIVTGLVATLT,0
4qi1,C,141,160,19,RYAFWTISTISMVFLLYYL,0
4qi1,C,161,182,21,AVFGEAVSDADEDTRSTFNAL,0
4qi1,C,183,200,17,NIILVTWAIYPVAWLVG,0
4qi1,C,212,230,18,TLLFMVLDLVAKVGFGFI,0
4qi1,C,231,238,7,LRSRAIM,0
1p8h,C,1,4,3,AQI,0
1p8h,C,5,9,4,GRPE,0
1p8h,C,10,32,22,IWLALGTALMGLGTLYFLVKGM,0
1p8h,C,43,62,19,AITTLVPAIAFTMYLSMLL,0
1p8h,C,63,78,15,YGLTMVPFGGEQNPI,0
1p8h,C,79,98,19,WARYADWLFTTPLLLLDLA,0
1p8h,C,107,128,21,ILALVGADGIMIGTGLVGALT,0
1p8h,C,129,133,4,VYSY,0
1p8h,C,134,155,21,FVWWAISTAAMLYILYVLFFG,0
1p8h,C,157,161,4,SKAE,0
1p8h,C,174,192,18,RNVTVVLWSAYPVVWLIG,0
1p8h,C,193,202,9,EGAGIVPLN,0
1p8h,C,203,224,21,ETLLFMVLDVSAKVGFGLILL,0
1p8h,C,232,249,17,AEAPEPSAGDGAAATSD,0
4o79,B,1,8,7,AVPVLGG,0
4o79,B,14,35,21,VRVLGFIIAALVLTWTVHYRG,0
4o79,B,36,44,8,LALSSDNK,0
4o79,B,45,66,21,HIFNVHPVMMVIGLILFNGEA,0
4o79,B,87,107,20,QLTAFILSLIGVWAALKFHI,0
4o79,B,108,112,4,KGIE,0
4o79,B,113,134,21,FYSLHSWLGLACLFLFAFQWA,0
4o79,B,161,184,23,ISIYALALVTATTGILEKVTFLQ,0
4o79,B,185,191,6,NQVITR,0
4o79,B,192,214,22,STEAMLVNTMGVLILILGGFVI,0
4o79,B,220,230,10,VSGKDQVLTQ,0
2yxq,C,1,20,19,SKREETGLATSAGLIRYMD,0
2yxq,C,33,48,15,IGVTVAFVIIEAILT,0
2yxq,C,49,52,3,GRF,0
3qju,C,2,5,3,EKP,0
3qju,C,6,27,21,GALAVILVLTLTILVFWLGVY,0
3o7q,A,1,21,20,GNTSIQTQSYRAVDKDAGQS,0
3o7q,A,30,49,19,LCSLFFLWAVANNLNDILL,0
3o7q,A,50,65,15,QFQQAFTLTNFQAGL,0
3o7q,A,66,85,19,QSAFYFGYFIIPIPAGILM,0
3o7q,A,91,110,19,AGIITGLFLYALGAALFWP,0
3o7q,A,111,119,8,AEIMNYTL,0
3o7q,A,120,142,22,LVGLFIIAAGLGCLETAANPFV,0
3o7q,A,154,174,20,LNLAQTFNSFGAIIAVVFGQ,0
3o7q,A,175,209,34,LILSNVPHQSQDVLDKMSPEQLSAYKHSLVLSVQ,0
3o7q,A,210,228,18,PYMIIVAIVLLVALLIML,0
3o7q,A,247,254,7,SASLSRL,0
3o7q,A,261,281,20,WAVLAQFCYVGAQTACWSYL,0
3o7q,A,282,300,18,RYAVEEIPGMTAGFAANY,0
3o7q,A,301,319,18,TGTMVCFFIGRFTGTWLI,0
3o7q,A,325,345,20,KVLAAYALIAMALCLISAFA,0
3o7q,A,346,349,3,GHV,0
3o7q,A,350,372,22,LIALTLCSAFMSIQYPTIFSLG,0
3o7q,A,382,401,19,GSSFIVMTIIGGGIVTPVM,0
3o7q,A,402,412,10,FVSDAAGNIP,0
3o7q,A,413,431,18,AELIPALCFAVIFIFARF,0
3o7q,A,436,438,2,TN,0
4c48,I,2,26,24,ELLKSLVFAVIMVPVVMAIILGLI,0
4c48,I,27,35,8,GLGEVFNI,0
4c48,I,47,49,2,NH,0
2uxk,M,1,50,49,EYQNIFSQVQVRGPADLGMTEDVNLANRSGVGPFSTLLGWFGNAQLGPI,0
2uxk,M,51,72,21,LGSLGVLSLFSGLMWFFTIGI,0
2uxk,M,82,87,5,AVFLR,0
2uxk,M,118,137,19,SFFMFVAVWSWWGRTYLRA,0
2uxk,M,138,143,5,ALGMG,0
2uxk,M,144,163,19,HTAWAFLSAIWLWMVLGFI,0
2uxk,M,179,192,13,FSHLDWTNNFSLV,0
2uxk,M,201,222,21,HGLSIAFLYGSALLFAMHGAT,0
2uxk,M,223,233,10,LAVSRFGGER,0
2uxk,M,234,239,5,LEQIA,0
2uxk,M,240,264,24,RGTAAERAALFWRWTMGFNATMEG,0
2uxk,M,265,285,20,HRWAIWMAVLVTLTGGIGIL,0
2uxk,M,294,300,6,YVWGQN,0
2uxk,M,303,307,4,APLN,0
4d1d,A,1,10,9,NSTPIEEAR,0
4d1d,A,31,52,21,LAAIWFAMAIQVAIFIAAGQM,0
4d1d,A,53,58,5,SSFQV,0
4d1d,A,59,76,17,QVIVAIAAGCTIAVILL,0
4d1d,A,110,134,24,ALLSLFWFGFQTWLGALALDEITR,0
4d1d,A,135,139,4,LTGF,0
4d1d,A,140,157,17,NLPLWIVIFGAIQVVTT,0
4d1d,A,164,183,19,RWMNVFASPVLLAMGVYMV,0
4d1d,A,184,206,22,LMLDGADVSLGEVMSMGGENPG,0
4d1d,A,207,225,18,PFSTAIMIFVGGWIAVVV,0
4d1d,A,254,272,18,AQWLGMVPASIIFGFIGA,0
4d1d,A,273,300,27,SMVLVGEWNPVIAITEVVGGVSIPMAI,0
4d1d,A,301,320,19,FQVFVLLATWSTNPAANLL,0
4d1d,A,342,357,15,SAVVGLLMMPWQFAG,0
4d1d,A,359,372,13,NTFLNLLASALGP,0
4d1d,A,417,436,19,ALAVSFLTPDLMFVTGLIA,0
4d1d,A,467,495,28,PIGPVAPADESATANTKEQNGSENLYFQ,0
1iwo,A,49,55,6,WELVIE,0
1iwo,A,60,76,16,LVRILLLAACISFVLA,0
1iwo,A,77,88,11,FEEGEETITAF,0
1iwo,A,89,103,14,EPFVILLILIANAI,0
1iwo,A,260,276,16,SKVISLICVAVWLINI,0
1iwo,A,277,295,18,HFNDPVHGGSWIRGAIYY,0
1iwo,A,296,314,18,KIAVALAVAAIPEGLPAV,0
1iwo,A,761,780,19,RYLISSNVGEVVCIFLTAA,0
1iwo,A,781,785,4,GLPE,0
1iwo,A,786,807,21,LIPVQLLWVNLVTDGLPATAL,0
1iwo,A,834,851,17,FRYMAIGGYVGAATVGA,0
1iwo,A,852,900,48,AWWFMYAEDGPGVTYHQLTHFMQCTEDHPHFEGLDCEIFEAPEPMTMA,0
1iwo,A,901,916,15,SVLVTIEMCNALNSL,0
1iwo,A,931,948,17,WLLGSICLSMSLHFLIL,0
1iwo,A,949,970,21,VDPLPMIFKLKALDLTQWLMV,0
1iwo,A,971,987,16,KISLPVIGLDEILKFI,0
3ous,D,24,41,17,LLVLAVIIYGTAGFHFI,0
3ous,D,42,46,4,GESW,0
3ous,D,47,63,16,VSLYWTFVTIAAVGYG,0
3ous,D,64,70,6,YSPHTP,0
3ous,D,71,92,21,GMYFTCTLIVLGIGTFAVAVE,0
3ous,D,93,98,5,LLEFL,0
2by4,A,54,73,19,EQFEDLLVRILLLAACISF,0
2by4,A,74,89,15,LAWFEEGEETITAFV,0
2by4,A,90,110,20,PFVILLILIANAIVGVWQER,0
2by4,A,254,274,20,EFGEQLSKVISLICVAVWLI,0
2by4,A,275,295,20,IGHFNDPVHGGSWIRGAIYY,0
2by4,A,296,318,22,KIAVALAVAAIPEGLPAVITTC,0
2by4,A,760,781,21,IRYLISSNVGEVVCIFLTAAL,0
2by4,A,782,785,3,LPE,0
2by4,A,786,808,22,LIPVQLLWVNLVTDGLPATALG,0
2by4,A,833,852,19,FFRYMAIGGYVGAATVGAA,0
2by4,A,853,897,44,WWFMYAEDGPGVTYHQLTHFMQCTEDHPHFEGLDCEIFEAPEPM,0
2by4,A,898,916,18,MALSVLVTIEMCNALNSL,0
2by4,A,931,950,19,WLLGSICLSMSLHFLILYV,0
2by4,A,951,966,15,PLPMIFKLKALDLTQ,0
2by4,A,967,987,20,LMVLKISLPVIGLDEILKFI,0
4xu6,C,9,26,17,VLFLLGAVAALIGDHSH,0
4xu6,C,27,40,13,VTGTTVYHTDAVP,0
4xu6,C,41,61,20,VWSSPFWFPILVGAATASLA,0
4xu6,C,80,97,17,GGVAAVVGTYVTTALVH,0
4xu6,C,98,101,3,FPV,0
4xu6,C,102,118,16,PVTALVAAAAAITWCV,0
4xu6,C,125,143,18,AAGVVIAVIGPAVEIALV,0
4xu6,C,144,160,16,LGVFAYHPDSDGLFGV,0
4xu6,C,161,176,15,PFLAPLYFAFGVVAA,0
1iw9,C,1,4,3,AQI,0
1iw9,C,5,9,4,GRPE,0
1iw9,C,10,29,19,IWLALGTALMGLGTLYFLV,0
1iw9,C,45,62,17,TTLVPAIAFTMYLSMLL,0
1iw9,C,63,78,15,YGLTMVPFGGEQNPI,0
1iw9,C,79,95,16,WARYADWLFTTPLLLL,0
1iw9,C,110,128,18,LVGADGIMIGTGLVGALT,0
1iw9,C,129,133,4,VYSY,0
1iw9,C,134,153,19,FVWWAISTAAMLYILYVLF,0
1iw9,C,175,192,17,NVTVVLWSAYPVVWLIG,0
1iw9,C,193,202,9,EGAGIVPLN,0
1iw9,C,203,222,19,ETLLFMVLDVSAKVGFGLI,0
1iw9,C,232,248,16,AEAPEPSAGDGAAATS,0
2wll,D,-33,0,33,NVDPFSPHSSDSFAQAASPARKPPRGGRRIWSG,0
2wll,D,47,57,10,WRDLYYWALK,0
2wll,D,59,85,26,WPVFFASLAALFVVNNTLFALLYQLG,0
2wll,D,86,97,11,APIANQSPPGF,0
2wll,D,98,114,16,GAFFFSVETLATVGYG,0
2wll,D,115,121,6,MHPQTV,0
2wll,D,122,146,24,AHAIATLEIFVGMSGIALSTGLVF,0
2wll,D,198,206,8,HSSEGYSL,0
2wll,D,310,333,23,PPGAAPDAQAFAAKPGEGDARPV,0
2uws,M,1,54,53,EYQNIFSQVQVRGPADLGMTEDVNLANRSGVGPFSTLLGWFGNAQLGPIYLGS,0
2uws,M,55,72,17,GVLSLFSGLMWFFTIGI,0
2uws,M,82,87,5,AVFLR,0
2uws,M,117,133,16,ASFFMFVAVWSWWGRT,0
2uws,M,134,146,12,LRAQALGMGKHT,0
2uws,M,147,164,17,WAFLSAIWLWMVLGFIR,0
2uws,M,179,191,12,FSHLDWTNNFSL,0
2uws,M,200,221,21,FHGLSIAFLYGSALLFAMHGA,0
2uws,M,222,268,46,ILAVSRFGGERELEQIADRGTAAERAALFWRWTMGFNATMEGIHRW,0
2uws,M,269,286,17,IWMAVLVTLTGGIGILL,0
2uws,M,294,300,6,YVWGQN,0
2uws,M,303,307,4,APLN,0
1wrg,A,1,15,14,EVKQESLSGITEGE,0
1wrg,A,16,38,22,KEFHKIFTSSILVFFGVAAFAH,0
4cl4,B,1,20,19,SLPETKSDDILLDAWDFQG,0
4cl4,B,32,56,24,SAAMILCIEAVERLTTLGIGVNLV,0
4cl4,B,57,69,12,YLTGTMHLGNAT,0
4cl4,B,70,89,19,ANTVTNFLGTSFMLCLLGG,0
4cl4,B,101,119,18,IAIFAAIQATGVSILTLS,0
4cl4,B,120,123,3,IIP,0
4cl4,B,124,141,17,LRPPRCNPTTSSHCEQA,0
4cl4,B,142,146,4,GIQL,0
4cl4,B,147,171,24,VLYLALYLTALGTGGVKASVSGFG,0
4cl4,B,188,208,20,FFNRFFFCINVGSLLAVTVL,0
4cl4,B,209,220,11,YVQDDVGRKWG,0
4cl4,B,221,239,18,GICAFAIVLALSVFLAGT,0
4cl4,B,270,325,55,PADPSYLYDVDDIIAAEGSMKGKQKLPHTEQFRSLDKAAIRDQEAGVTSNVFNKW,0
4cl4,B,344,361,17,IWATCILFWTVHAQLTT,0
4cl4,B,362,385,23,SVAQSETLDRSIGSFEIPPASMA,0
4cl4,B,386,410,24,FYVGGLLLTTAVYDRVAIRLCKKL,0
4cl4,B,416,436,20,LRPLQRIGLGLFFGSMAMAV,0
4cl4,B,437,451,14,ALVELKRLRTAHAH,0
4cl4,B,452,460,8,PTVKTLPL,0
4cl4,B,461,467,6,FYLLIP,0
4cl4,B,468,486,18,YLIVGIGEALIYTGQLDF,0
4cl4,B,501,524,23,LLLSTLALGFFFSSVLVTIVEKF,0
4cl4,B,525,542,17,GKAHPWIADDLNKGRLY,0
4cl4,B,543,562,19,FYWLVAVLVALNFLIFLVF,0
4cl4,B,574,590,16,EVGIELDDEPSIPMGH,0
2i36,B,1,35,34,GTEGPNFYVPFSNKTGVVRSPFEAPQYYLAEPWQ,0
2i36,B,36,64,28,SMLAAYMFLLIMLGFPINFLTLYVTVQH,0
2i36,B,72,95,23,YILLNLAVADLFMVFGGFTTTLY,0
2i36,B,96,112,16,SLHGYFVFGPTGCNLE,0
2i36,B,113,134,21,FFATLGGEIALWSLVVLAIER,0
2i36,B,137,146,9,VCKPMSNFR,0
2i36,B,151,170,19,AIMGVAFTWVMALACAAPP,0
2i36,B,171,203,32,VGWSRYIPEGMQCSCGIDYYTPHEETNNESFV,0
2i36,B,204,225,21,YMFVVHFIIPLIVIFFCYGQL,0
2i36,B,254,277,23,IMVIAFLICWLPYAGVAFYIFTH,0
2i36,B,278,286,8,GSDFGPIF,0
2i36,B,287,308,21,TIPAFFAKTSAVYNPVIYIMM,0
2i36,B,314,321,7,CMVTTLC,0
2i36,B,325,348,23,PLGDDEASTTVSKTETSQVAPA,0
1kch,E,35,38,3,ALI,0
1kch,E,39,49,10,IALLLIAIIV,0
3cn5,D,-22,31,53,SHHHHHHSSGLVPRGSHMLEDLMSKEVSEEAQAHQHGKDYVDPPPAPFFDLGE,0
3cn5,D,41,58,17,IAEFIATLLFLYITVAT,0
3cn5,D,59,75,16,IGHSKETVVCGSVGLL,0
3cn5,D,76,93,17,IAWAFGGMIFVLVYCTA,0
3cn5,D,97,110,13,GHINPAVTFGLFL,0
3cn5,D,119,137,18,LVYMIAQCLGAICGVGLV,0
3cn5,D,138,141,3,AFM,0
3cn5,D,142,147,5,GPYNQ,0
3cn5,D,148,162,14,GGGANSVALGYNKG,0
3cn5,D,163,182,19,ALGAEIIGTFVLVYTVFSA,0
3cn5,D,198,214,16,PLPIGFAVFMVHLATI,0
3cn5,D,215,217,2,IT,0
3cn5,D,218,232,14,TGINPARSFGAAVI,0
3cn5,D,233,242,9,NSNKVWDDQ,0
3cn5,D,243,260,17,IFWVGPFIGAAVAAAYH,0
3cn5,D,269,281,12,KALGEFRSNPTN,0
3qs6,B,1,4,3,EVK,0
3qs6,B,14,32,18,ILAMAGNAVGLGNFLRFP,0
3qs6,B,33,43,10,QAAENGGGAF,0
3qs6,B,44,63,19,IPYIIAFLLVGIPLMWIEW,0
3qs6,B,90,124,34,KILGVFGLWIPLVVAIYYVYIESWTLGFAIKFLV,0
3qs6,B,125,132,7,LVPEPPP,0
3qs6,B,133,134,1,A,0
3qs6,B,135,166,31,DPDSILRPFKEFLYSYIGVPKGDEPILKPSL,0
3qs6,B,167,184,17,AYIVFLITMFINVSILI,0
3qs6,B,191,212,21,ERFAKIAMPTLFILAVFLVIR,0
3qs6,B,213,222,9,FLLETPNGT,0
3qs6,B,223,230,7,ADGLNFL,0
3qs6,B,231,243,12,TPDFEKLKDPGV,0
3qs6,B,244,265,21,IAAVGQIFFTLSLGVGAIITY,0
3qs6,B,278,297,19,GLTAATLNEKAEVILGGSI,0
3qs6,B,298,318,20,IPAAVAFFGVANAVAIAKAG,0
3qs6,B,319,324,5,FNLGF,0
3qs6,B,326,331,5,LPAIF,0
3qs6,B,332,339,7,QTAGGTF,0
3qs6,B,340,366,26,GFLWFFLLFFAGLTSSIAQMQPMIAF,0
3qs6,B,378,396,18,VLWTAAIVFFSAHLVMFL,0
3qs6,B,397,399,2,KS,0
3qs6,B,400,425,25,DEMDFWAGTIGVVFFGLTELIIFFW,0
3qs6,B,429,437,8,DKAWEEIN,0
3qs6,B,445,469,24,RIYYYVMRYITPAFLAVLLVVWAR,0
3qs6,B,470,483,13,YIPKIMEETHWTV,0
3qs6,B,484,502,18,ITRFYIIGLFLFLTFLVF,0
3qs6,B,602,604,2,PR,0
3m72,C,1,5,4,NITK,0
3m72,C,6,11,5,FPLPT,0
3m72,C,12,27,15,YFGIPLGLAALSLAW,0
3m72,C,41,60,19,DVLGIVASAVWILFILMYA,0
3m72,C,61,66,5,KLRYY,0
3m72,C,67,75,8,EEVRAEYH,0
3m72,C,76,81,5,PVRFS,0
3m72,C,82,97,15,IALIPITTMLVGDIL,0
3m72,C,105,125,20,EVLIWIGTIGQLLFSTLRVS,0
3m72,C,126,140,14,LWQGGVFEQKSTHP,0
3m72,C,141,154,13,FYLPAVAANFTSA,0
3m72,C,166,182,16,YLFFGAGMIAWIIFEP,0
3m72,C,183,200,17,LLQHLRISSLEPQFRAT,0
3m72,C,201,217,16,GIVLAPPFVCVSAYLS,0
3m72,C,227,245,18,KILWGYGFLQLFFLLRLF,0
3m72,C,246,257,11,WIVEKGLNIGL,0
3m72,C,258,271,13,AFSFPLASMANSA,0
3m72,C,284,307,23,IFAFVFSNVMIGLLVLMTIYKLT,0
3m72,C,308,311,3,GQF,0
3m72,C,312,314,2,LK,0
5uvi,A,6,28,22,SVYITVELAIAVLAILGNVLVC,0
5uvi,A,29,44,15,AVWLNSNLQNVTNYF,0
5uvi,A,45,67,22,VSLAAADIAVGVLAIPFAITIS,0
5uvi,A,76,97,21,CLFIACFVLVLTQSSIFSLLA,0
5uvi,A,98,123,25,AIDRYIAIRIPLRYNGLVTGTRAKG,0
5uvi,A,124,144,20,IAICWVLSFAIGLTPMLGWN,0
5uvi,A,172,195,23,PMNYMVYFNFFACVLVPLLLMLG,0
5uvi,A,196,1043,847,YLRIFLAARRQLADLEDNWETLNDNLKVIEKADNAAQVKDALTKMRAAALDAQKA,0
5uvi,A,1060,236,-824,FRHGFDILVGQIDDALKLANEGKVKEAQAAAEQLKTTRNAYIQKYLERARSTLQKEVHAAKSLA,0
5uvi,A,237,259,22,IVGLFALCWLPLHIINCFTFFC,0
5uvi,A,266,287,21,LWLMYLAIVLSHTNSVVNPFI,0
5uvi,A,288,292,4,AYRI,0
5uvi,A,293,305,12,EFRQTFRKIIRS,0
5uvi,A,306,308,2,VL,0
3m73,C,1,11,10,NITKPFPLPT,0
3m73,C,12,27,15,YFGIPLGLAALSLAW,0
3m73,C,41,61,20,DVLGIVASAVWILFILMYAY,0
3m73,C,62,66,4,LRYY,0
3m73,C,67,75,8,EEVRAEYH,0
3m73,C,76,81,5,PVRFS,0
3m73,C,82,97,15,IALIPITTMLVGDIL,0
3m73,C,105,125,20,EVLIWIGTIGQLLFSTLRVS,0
3m73,C,126,140,14,LWQGGVFEQKSTHP,0
3m73,C,141,154,13,FYLPAVAANFTSA,0
3m73,C,167,182,15,LFFGAGMIAWIIFEP,0
3m73,C,183,200,17,LLQHLRISSLEPQFRAT,0
3m73,C,201,215,14,GIVLAPAFVCVSAY,0
3m73,C,227,245,18,KILWGYGFLQLFFLLRLF,0
3m73,C,246,255,9,WIVEKGLNI,0
3m73,C,256,271,15,LWAFSAGLASMANSA,0
3m73,C,284,307,23,IFAFVFSNVMIGLLVLMTIYKLT,0
3m73,C,308,313,5,GQFFL,0
5lxa,A,132,140,8,RACFKSIF,0
5lxa,A,146,169,23,GNIWTHLLGCVFFLCLGIFYMFR,0
5lxa,A,170,178,8,NISFVAPL,0
5lxa,A,179,203,24,EKVVFGLFFLGAILCLSFSWLFHT,0
5lxa,A,216,238,22,KLDYSGIALLIMGSFVPWLYYS,0
5lxa,A,239,244,5,YCNPQ,0
5lxa,A,245,266,21,CFIYLIVICVLGIAAIIVSQW,0
5lxa,A,275,296,21,GVRAGVFLGLGLSGIIPTLHY,0
5lxa,A,297,309,12,ISEGFLKAATIG,0
5lxa,A,310,334,24,IGWLMLMASLYITGAALYAARIPE,0
5lxa,A,345,369,24,HSHQLFHIFVVAGAFVHFHGVSNL,0
5lxa,A,370,381,11,EFRFMIGGGCS,0
4c9h,A,1,20,19,SSNAQVKTPLPPAPAPKKE,0
4c9h,A,21,27,6,NFLIDF,0
4c9h,A,28,49,21,MGGVSAAVAKTAASPIERVKL,0
4c9h,A,87,108,21,RGNTANVIRYFPTQALNFAFK,0
4c9h,A,109,115,6,KIKAMF,0
4c9h,A,116,131,15,FKKEEGYAKWFAGNL,0
4c9h,A,132,153,21,SGGAAGALSLLFVYSLDYART,0
4c9h,A,160,166,6,SSKKGG,0
4c9h,A,173,184,11,IDVYKKTLKSD,0
4c9h,A,190,207,17,RGFLPSVVGIVVYRGLY,0
4c9h,A,208,215,7,GMYDSLK,0
4c9h,A,216,227,11,LLLTGSLEGSF,0
4c9h,A,228,234,6,ASFLLG,0
4c9h,A,235,253,18,VVTTGASTCSYPLDTVRR,0
4c9h,A,285,306,21,KGCGANILRGVAGAGVISMYD,0
4c9h,A,307,317,10,LQMILFGKKF,0
3vvk,C,1,17,16,TETLPPVTESAVALQA,0
3vvk,C,18,20,2,VT,0
3vvk,C,21,28,7,RELFEFV,0
3vvk,C,29,36,7,NDPLLAS,0
3vvk,C,37,57,20,LYINIALAGLSILLFVFMTR,0
3vvk,C,66,87,21,IAVSTILVPVVSIASYTGLAS,0
3vvk,C,88,120,32,LTISVLEMPAGHFAEGSSVMLGGEEVDGVVTM,0
3vvk,C,121,142,21,GRYLTWALSTPMILLALGLLA,0
3vvk,C,147,168,21,KLFTAITFDIAMCVTGLAAAL,0
3vvk,C,169,174,5,TSSHL,0
3vvk,C,175,199,24,RWFWYAISCACFIVVLYILLVEWA,0
3vvk,C,211,232,21,STLKLLTVVMWLGYPIVWALG,0
3vvk,C,233,243,10,EGVAVLPVGY,0
3vvk,C,244,268,24,SWAYSALDIVAKYIFAFLLLNYLT,0
3vvk,C,277,291,14,ILDVPSASGAPADD,0
4cl5,B,1,20,19,SLPETKSDDILLDAWDFQG,0
4cl5,B,32,55,23,SAAMILCIEAVERLTTLGIGVNL,0
4cl5,B,56,71,15,TYLTGTMHLGNATAA,0
4cl5,B,72,89,17,TVTNFLGTSFMLCLLGG,0
4cl5,B,100,119,19,TIAIFAAIQATGVSILTLS,0
4cl5,B,120,123,3,IIP,0
4cl5,B,124,141,17,LRPPRCNPTTSSHCEQA,0
4cl5,B,142,146,4,GIQL,0
4cl5,B,147,171,24,VLYLALYLTALGTGGVKASVSGFG,0
4cl5,B,188,208,20,FFNRFFFCINVGSLLAVTVL,0
4cl5,B,209,220,11,YVQDDVGRKWG,0
4cl5,B,221,239,18,GICAFAIVLALSVFLAGT,0
4cl5,B,252,260,8,TQVAAVIV,0
4cl5,B,270,325,55,PADPSYLYDVDDIIAAEGSMKGKQKLPHTEQFRSLDKAAIRDQEAGVTSNVFNKW,0
4cl5,B,344,361,17,IWATCILFWTVHAQLTT,0
4cl5,B,362,385,23,SVAQSETLDRSIGSFEIPPASMA,0
4cl5,B,386,410,24,FYVGGLLLTTAVYDRVAIRLCKKL,0
4cl5,B,416,436,20,LRPLQRIGLGLFFGSMAMAV,0
4cl5,B,437,445,8,ALVELKRL,0
4cl5,B,446,460,14,TAHAHGPTVKTLPL,0
4cl5,B,461,467,6,FYLLIP,0
4cl5,B,468,486,18,YLIVGIGEALIYTGQLDF,0
4cl5,B,501,524,23,LLLSTLALGFFFSSVLVTIVEKF,0
4cl5,B,525,542,17,GKAHPWIADDLNKGRLY,0
4cl5,B,543,562,19,FYWLVAVLVALNFLIFLVF,0
4cl5,B,574,590,16,EVGIELDDEPSIPMGH,0
3m7e,C,1,4,3,NIT,0
3m7e,C,5,11,6,PFPLPT,0
3m7e,C,12,27,15,YFGIPLGLAALSLAW,0
3m7e,C,41,61,20,DVLGIVASAVWILFILMYAY,0
3m7e,C,62,66,4,LRYY,0
3m7e,C,67,75,8,EEVRAEYH,0
3m7e,C,76,81,5,PVRFS,0
3m7e,C,82,97,15,IALIPITTMLVGDIL,0
3m7e,C,105,125,20,EVLIWIGTIGQLLFSTLRVS,0
3m7e,C,126,140,14,LWQGGVFEQKSTHP,0
3m7e,C,141,154,13,FYLPAVAANFTSA,0
3m7e,C,167,182,15,LFFGAGMIAWIIFEP,0
3m7e,C,183,200,17,LLQHLRISSLEPQFRAT,0
3m7e,C,201,216,15,GIVLAPAFVCVSAYL,0
3m7e,C,227,245,18,KILWGYGFLQLFFLLRLF,0
3m7e,C,246,255,9,WIVEKGLNI,0
3m7e,C,256,271,15,LWAFSFGLASMANSA,0
3m7e,C,284,307,23,IFAFVFSNVMIGLLVLMTIYKLT,0
3m7e,C,308,313,5,GQFFL,0
2ycz,A,31,38,7,GAELLSQ,0
2ycz,A,39,42,3,WEA,0
2ycz,A,43,64,21,MSLLMALVVLLIVAGNVLVIA,0
2ycz,A,80,103,23,TSLACADLVVGLLVVPFGATLVV,0
2ycz,A,104,112,8,GTWLWGSF,0
2ycz,A,113,134,21,CELWTSLDVLCVTASIETLCV,0
2ycz,A,163,183,20,TVWAISALVSFLPIMMHWWR,0
2ycz,A,184,186,2,ED,0
2ycz,A,187,193,6,QALKCY,0
2ycz,A,194,200,6,DPGCCD,0
2ycz,A,201,225,24,VTNRAYAIASSIISFYIPLLIMIF,0
2ycz,A,294,316,22,IMGVFTLCWLPFFLVNIVNVFN,0
2ycz,A,317,323,6,DLVPDW,0
2ycz,A,324,343,19,FVAFNWLGYANSAMNPIIY,0
2ycz,A,347,356,9,DFRKAFKRL,0
2ycz,A,360,373,13,RKADRRLHHHHHH,0
2i37,B,1,35,34,GTEGPNFYVPFSNKTGVVRSPFEAPQYYLAEPWQ,0
2i37,B,36,64,28,SMLAAYMFLLIMLGFPINFLTLYVTVQH,0
2i37,B,72,96,24,YILLNLAVADLFMVFGGFTTTLYT,0
2i37,B,97,112,15,LHGYFVFGPTGCNLE,0
2i37,B,113,134,21,FFATLGGEIALWSLVVLAIER,0
2i37,B,145,149,4,RFGE,0
2i37,B,151,170,19,AIMGVAFTWVMALACAAPP,0
2i37,B,171,203,32,VGWSRYIPEGMQCSCGIDYYTPHEETNNESFV,0
2i37,B,204,224,20,YMFVVHFIIPLIVIFFCYGQ,0
2i37,B,235,237,2,QQ,0
2i37,B,254,277,23,IMVIAFLICWLPYAGVAFYIFTH,0
2i37,B,278,286,8,GSDFGPIF,0
2i37,B,287,308,21,TIPAFFAKTSAVYNPVIYIMM,0
2i37,B,311,322,11,FRNCMVTTLCC,0
2i37,B,328,348,20,DDEASTTVSKTETSQVAPA,0
5eqg,A,14,35,21,AVGGAVLGSLQFGYNTGVINA,0
5eqg,A,37,52,15,KVIEEFYNQTWVHRY,0
5eqg,A,53,63,10,ESILPTTLTT,0
5eqg,A,64,83,19,WSLSVAIFSVGGMIGSFSV,0
5eqg,A,95,113,18,MLMMNLLAFVSAVLMGFS,0
5eqg,A,114,119,5,LGKSF,0
5eqg,A,120,141,21,MLILGRFIIGVYCGLTTGFVP,0
5eqg,A,159,175,16,HQLGIVVGILIAQVFG,0
5eqg,A,176,187,11,DSIMGNKDLWP,0
5eqg,A,188,206,18,LLSIIFIPALLQCIVLPF,0
5eqg,A,259,264,5,LELFR,0
5eqg,A,274,295,21,AVVLQLSQQLSGINAVFYYST,0
5eqg,A,296,308,12,IFEKAGVQQPVY,0
5eqg,A,309,328,19,TIGSGIVNTAFTVVSLFVV,0
5eqg,A,335,353,18,LHLIGLAGMAGCAILMTI,0
5eqg,A,354,367,13,LALLEQLPWMSYL,0
5eqg,A,368,388,20,IVAIFGFVAFFEVGPGPIPW,0
5eqg,A,406,426,20,AGFSNWTSNFIVGMCFQYVE,0
5eqg,A,427,432,5,LCGPY,0
5eqg,A,433,450,17,FIIFTVLLVLFFIFTYF,0
2wlm,D,1,11,10,TGGMKPPARK,0
2wlm,D,28,32,4,EKRG,0
2wlm,D,37,43,6,YHDLLT,0
2wlm,D,46,71,25,PVFITLITGLYLVTNALFALAYLAC,0
2wlm,D,72,83,11,DVIENARPGSF,0
2wlm,D,84,99,15,DAFFFSVQTMATIGY,0
2wlm,D,100,107,7,KLIPIGP,0
2wlm,D,108,132,24,ANTLVTLEALCGMLGLAVAASLIY,0
2wlm,D,296,301,5,HHHHH,0
4au5,B,1,9,8,KHLHRFFS,0
4au5,B,14,31,17,GIILIIAAILAMIMANS,0
4au5,B,32,42,10,ATSGWYHDFL,0
4au5,B,43,59,16,TPVQLRVGSLEINKNM,0
4au5,B,60,79,19,LWINDALMAVFFLLVGLEV,0
4au5,B,99,116,17,AAIGGMIVPALLYLAFN,0
4au5,B,117,123,6,ADPITR,0
4au5,B,124,140,16,GWAIPAATDIAFALGV,0
4au5,B,158,176,18,LAIIDDLGAIIIIALFYT,0
4au5,B,177,181,4,DLSM,0
4au5,B,182,199,17,SLGVAAVAIAVLAVLNL,0
4au5,B,206,222,16,VYILVGVVLWTAVLKS,0
4au5,B,224,237,13,HATLAGVIVGFFI,0
4au5,B,247,255,8,AKRLEHVL,0
4au5,B,256,276,20,PWVAYLILPLFAFANAGVSL,0
4au5,B,277,287,10,GVTLDGLTSI,0
4au5,B,288,307,19,PLGIIAGLLIGKPLGISLF,0
4au5,B,330,349,19,VGILCGIGFTMSIFIASLA,0
4au5,B,350,358,8,GSVDPELI,0
4au5,B,359,378,19,WAKLGILVGSISSAVIGYS,0
4au5,B,384,401,17,RPSVEFRVPGSENLYFQ,0
3det,B,1,17,16,KTDTPSLETPQAARLR,0
3det,B,37,61,24,MAAVVGTLVGLAAVAFDKGVAWLQ,0
3det,B,62,83,21,QRMGALVHTADNYPLLLTVAF,0
3det,B,84,97,13,CSAVLAMFGYFLV,0
3det,B,129,142,13,VKFFGGLGTLGGG,0
3det,B,144,156,12,LGRAGPTVQIGG,0
3det,B,181,203,22,AAAGLAAAFNAPLAGILFIIEE,0
3det,B,216,232,16,AVFIGVIMSTIMYRIF,0
3det,B,233,252,19,HEVALIDVGKLSDAPLNTL,0
3det,B,253,273,20,LYLILGIIFGIFGPIFNKWV,0
3det,B,290,305,15,WVLMGGAIGGLCGLL,0
3det,B,306,337,31,FVAPATSGGGFNLIPIATAGNFSMGMLVFIF,0
3det,B,338,351,13,ARVITTLLCFSSG,0
3det,B,353,368,15,GGIFAPMLALGTVLG,0
3det,B,369,391,22,AFGMVAVELFPQYHLEAGTFAI,0
3det,B,392,415,23,GMGALLAASIRAPLTGIILVLEM,0
3det,B,416,422,6,DNYQLI,0
3det,B,423,439,16,PMIITGLGATLLAQFT,0
3det,B,459,473,14,QLARSKAASASENT,0
5g2c,A,-2,16,18,NSMKNIESLFDYSAGQFE,0
5g2c,A,17,40,23,IDHLLTMGVGVHFAALIFFLVVS,0
5g2c,A,50,73,23,TALSCIVMVSAGLILNSQAVMWT,0
5g2c,A,74,90,16,AYAYVDGSYQLQDLTF,0
5g2c,A,91,114,23,NGYRYVNWMADIPCLLLQLLIVL,0
5g2c,A,121,143,22,FSTATWLILAAWGMIITGYVGQ,0
5g2c,A,144,154,10,YEVDDIAQLM,0
5g2c,A,155,178,23,WGAVSTAFFVVMNWIVGTKIFKN,0
5g2c,A,189,210,21,ITKVFWLMMFAWTLYPIAYLV,0
5g2c,A,211,221,10,AFMNNADGVV,0
5g2c,A,222,245,23,RQLLFTIADISSKVIYGLMITYI,0
5g2c,A,256,263,7,PAQQALG,0
5lwy,A,132,140,8,RACFKSIF,0
5lwy,A,146,169,23,GNIWTHLLGCVFFLCLGIFYMFR,0
5lwy,A,170,178,8,NISFVAPL,0
5lwy,A,179,203,24,EKVVFGLFFLGAILCLSFSWLFHT,0
5lwy,A,216,239,23,KLDYSGIALLIMGSFVPWLYYSF,0
5lwy,A,240,244,4,CNPQ,0
5lwy,A,245,266,21,CFIYLIVICVLGIAAIIVSQW,0
5lwy,A,275,297,22,GVRAGVFLGLGLSGIIPTLHYV,0
5lwy,A,298,301,3,SEG,0
5lwy,A,302,307,5,LKAAT,0
5lwy,A,308,309,1,G,0
5lwy,A,310,334,24,IGWLMLMASLYITGAALYAARIPE,0
5lwy,A,345,368,23,HSHQLFHIFVVAGAFVHFHGVSN,0
5lwy,A,369,382,13,QEFRFMIGGGCSE,0
2yl4,B,151,152,1,A,0
2yl4,B,154,167,13,PEARKLLGLAYPE,0
2yl4,B,168,189,21,RRLAAAVGFLTMSSVISMSAP,0
2yl4,B,219,239,20,AVFLCGAAANAIRVYLMQTS,0
2yl4,B,240,284,44,QRIVNRLRTSLFSSILRQEVAFFDKTRTGELINRLSSDTALLGR,0
2yl4,B,285,308,23,VTENLSDGLRAGAQASVGISMMF,0
2yl4,B,316,337,21,FVLSVVPPVSIIAVIYGRYLR,0
2yl4,B,338,390,52,LTKVTQDSLAQATQLAEERIGNVRTVRAFGKEMTEIEKYASKVDHVMQLARK,0
2yl4,B,391,413,22,AFARAGFFGATGLSGNLIVLSV,0
2yl4,B,435,455,20,MYAFWVGISIGGLSSFYSEL,0
2yl4,B,456,1717,1261,KGLGAGGRLWELLEREPKLPFNEGVILNEKSFQGALEFKNVHFAYPARPEVPIFQDFSLSIPSGSVTALVGPSGSGKSTVLSLLLRLYDPASGTISLDGHDIRQLNPVWLRSKIGTVSQEPILFSCSIAENIAYGADDPSSVTAEEIQRVAEVANAVAFIRNFPQGFNTVVGEKGVLLSGGQKQRIAIARALLKNPKILLLDEATSALDAENEYLVQEALDRLMDGRTVLVIAHRLSTIKNANMVAVLDQGKITEYGKHEEG,0
2yl4,B,1718,1744,26,SKPNGIYRKLMNKQSFISAAENLYFQ,0
2ped,A,1,39,38,GTEGPNFYVPFSNKTGVVRSPFEAPQYYLAEPWQFSML,0
2ped,A,40,65,25,AYMFLLIMLGFPINFLTLYVTVQHK,0
2ped,A,69,95,26,PLNYILLNLAVADLFMVFGGFTTTLY,0
2ped,A,96,111,15,SLHGYFVFGPTGCNL,0
2ped,A,112,137,25,GFFATLGGEIALWSLVVLAIERYVV,0
2ped,A,151,173,22,AIMGVAFTWVMALACAAPPLVG,0
2ped,A,174,202,28,SRYIPEGMQCSCGIDYYTPHEETNNESF,0
2ped,A,203,227,24,IYMFVVHFIIPLIVIFFCYGQLVF,0
2ped,A,251,274,23,MVIIMVIAFLICWLPYAGVAFYI,0
2ped,A,275,288,13,THQGSDFGPIFMT,0
2ped,A,289,310,21,PAFFAKTSAVYNPVIYIMMNK,0
2ped,A,311,321,10,FRNCMVTTLC,0
4mnd,B,33,71,38,ASWSHPQFEKGALEVLFQGPGMINVDGEYLKIFAGRIK,0
4mnd,B,72,83,11,MKAVILAAGLG,0
4mnd,B,84,86,2,RL,0
4mnd,B,87,291,204,GVPKPLVRVGGCEIILRTMKLLSPHVSEFIIVASRYADDIDAFLKDKGFNYKIVRHDRPEKGNGYSLLVAKNHVEDRFILTMGDHVYSQQFIEKAVRGEGVIADREPRFVDIGEATKIRVEDGRVAKIGKDLREFDCVDTGFFVLDDSIFEHAEKLRDREEIPLSEIVKLARLPVTYVDGELWMDVDTKEDVRRANRALVSAAV,0
4mnd,B,292,294,2,GS,0
4mnd,B,295,303,8,DGFISRKI,0
4mnd,B,304,315,11,RKISTRISAAI,0
4mnd,B,316,325,9,NKVNPNQMT,0
4mnd,B,326,340,14,ISFLVGAFSALASF,0
4mnd,B,344,357,13,LAGLLYQFSSILD,0
4mnd,B,358,378,20,CDGEIARASLKMSKKGGYVD,0
4mnd,B,379,395,16,ILDRFVDFLFLAIIAL,0
4mnd,B,402,417,15,VAMFAIFGSVMVSYT,0
4mnd,B,418,429,11,EKYKAEFGESI,0
4mnd,B,430,433,3,GKF,0
4mnd,B,434,438,4,VLNY,0
4mnd,B,439,456,17,PGKRDERIFLIMIFCLL,0
4mnd,B,465,484,19,WMFLFVAAISLTRVVVTLL,0
4mnd,B,485,489,4,VLVS,0
4mnd,B,490,511,21,ELALVPRGSSAHHHHHHHHHH,0
1yq3,D,9,29,20,WTSERAVSALLLGLLPAAYL,0
1yq3,D,30,34,4,PGPA,0
1yq3,D,35,55,20,DYSLAAALTLHGHWGLGQVI,0
1yq3,D,67,87,20,ANTGLYVLSAITFTGLCYFN,0
1yq3,D,88,92,4,YDVG,0
1yq3,D,93,100,7,CKAVAML,0
1yq3,D,101,103,2,SI,0
4d0a,A,1,3,2,EL,0
4d0a,A,4,24,20,MAIGYLGLALVLGSLVAKIA,0
4d0a,A,30,46,16,DIPLLLLLGLIIGPFL,0
4d0a,A,47,50,3,IIP,0
4d0a,A,51,57,6,DSAMEI,0
4d0a,A,58,76,18,EYAGPIGLIFILLGGAFT,0
4d0a,A,89,108,19,VRLDTITFLITLLISGFIF,0
4d0a,A,109,122,13,MVLNLPYTSPVGY,0
4d0a,A,123,140,17,FGAITAATDPATLIPVF,0
4d0a,A,153,171,18,EAESIFNDPLGIVSTSVI,0
4d0a,A,172,184,12,GLFGLFSSSNPL,0
4d0a,A,185,206,21,DLITLAGGAIVVGLLLAKIYE,0
4d0a,A,218,237,19,APLVLGGAMLLLYVGDDLL,0
4d0a,A,238,243,5,SICGY,0
4d0a,A,244,259,15,FSGYMAVAIMGLYLG,0
4d0a,A,277,296,19,DDLSLLARVFIFVFLGACI,0
4d0a,A,297,305,8,LSMLENYF,0
4d0a,A,306,329,23,PGLLVALGSIFLARPLGVFLGLI,0
4d0a,A,339,356,17,YFALEGPRGVVPAALAV,0
4d0a,A,357,386,29,VGIEILKNADKIPASITKYITPTDIAGTI,0
4d0a,A,387,404,17,IGTFMTILLSVILEASW,0
2uxj,M,1,55,54,EYQNIFSQVQVRGPADLGMTEDVNLANRSGVGPFSTLLGWFGNAQLGPIYLGSL,0
2uxj,M,56,72,16,VLSLFSGLMWFFTIGI,0
2uxj,M,82,87,5,AVFLR,0
2uxj,M,115,132,17,LIASFFMFVAVWSWWGR,0
2uxj,M,133,146,13,YLRAQALGMGKHT,0
2uxj,M,147,167,20,WAFLSAIWLWMVLGFIRPIL,0
2uxj,M,179,192,13,FSHLDWTNNFSLV,0
2uxj,M,200,221,21,FHGLSIAFLYGSALLFAMHGA,0
2uxj,M,222,268,46,ILAVSRFGGERELEQIADRGTAAERAALFWRWTMGFNATMEGIHRW,0
2uxj,M,269,286,17,IWMAVLVTLTGGIGILL,0
2uxj,M,294,300,6,YVWGQN,0
2uxj,M,303,307,4,APLN,0
2kpe,B,74,96,22,LIIFGVMAGVIGTILLISYGIR,0
2kpe,B,97,98,1,L,0
4cas,D,1,15,14,YHGALAQHLDIAQL,0
4cas,D,16,32,16,WYAQWLVIWTVVLLYL,0
4ayw,B,120,153,33,MRGPPAWAGDEAWRRGPAAPPGDKGRLRPAAAG,0
4ayw,B,155,168,13,EARKLLGLAYPER,0
4ayw,B,169,195,26,RLAAAVGFLTMSSVISMSAPFFLGKI,0
4ayw,B,196,214,18,DVIYTNPTVDYSDNLTRL,0
4ayw,B,215,237,22,LGLSAVFLCGAAANAIRVYLMQ,0
4ayw,B,288,312,24,NLSDGLRAGAQASVGISMMFFVSP,0
4ayw,B,314,336,22,ATFVLSVVPPVSIIAVIYGRYL,0
4ayw,B,393,417,24,ARAGFFGATGLSGNLIVLSVLYKG,0
4ayw,B,418,429,11,LLMGSAHMTVG,0
4ayw,B,430,453,23,LSSFLMYAFWVGISIGGLSSFYS,0
4ayw,B,660,663,3,TSA,0
4ayw,B,718,738,20,LSKPNGIYRKLMNKQSFISA,0
3hqk,B,1,9,8,SSDADAHK,0
3hqk,B,10,13,3,GLI,0
3hqk,B,14,27,13,VTLMVSGNIMGSG,0
3hqk,B,47,60,13,VTIIGALALSMVY,0
3hqk,B,61,88,27,KMSSLDPSPGGSYAYARRCFGPFLGYQ,0
3hqk,B,89,105,16,NVLYWLACWIGNIAMV,0
3hqk,B,129,141,12,VAVLWIFVLLNI,0
3hqk,B,142,146,4,GPKM,0
3hqk,B,147,162,15,TRVQAVATVLALVPI,0
3hqk,B,175,181,6,ETYMAA,0
3hqk,B,201,211,10,WSFIGVESAS,0
3hqk,B,212,227,15,AAGVVKNPKRNVPIA,0
3hqk,B,228,241,13,IGGVLIAAVCYVL,0
3hqk,B,285,298,13,CLGSLGGWTLLAG,0
3hqk,B,299,321,22,TAKAAADDGLFPPIFARVNKAG,0
3hqk,B,322,325,3,PVA,0
3hqk,B,327,339,12,LIVGVLMTIFQF,0
3hqk,B,354,369,15,SVSVIFTLVPYLYTC,0
3hqk,B,370,389,19,ALLLLGHGHFGKARPLYLL,0
3hqk,B,390,405,15,TFVAFVYCIWAVIGS,0
3hqk,B,410,423,13,MWSFVTLMVITAL,0
3hqk,B,424,440,16,ALNYNRIHKNPYPLDA,0
3hqk,B,441,445,4,VKQD,0
1rvj,H,1,10,9,VGVTAFQNF,0
1rvj,H,16,32,16,IYSFWIFLAGLIYYLQ,0
1rvj,H,33,248,215,ENMREGYPLENEDGTPAANQGPFPLPKPKTFILPHGRGTLTVPGPESEDRPIALARTAVSEGFPHAPTGDPMKDGVGPASWVARRDLPELDGHGHNKIKPMKAAAGFHVSAGKNPIGLPVRGCDLEIAGKVVDIWVDIPEQMAHFLEVELKDGSTRLLPMQMVKVQSNRVHVNALSSDLFAGIPTIKSPTEVTLLEEDKICGYVAGGLMYAAPKR,0
1rvj,H,249,260,11,SVVAAMLAEYA,0
3o7p,A,1,21,20,GNTSIQTQSYRAVDKDAGQS,0
3o7p,A,30,49,19,LCSLFFLWAVANNLNDILL,0
3o7p,A,50,56,6,QFQQAF,0
3o7p,A,57,60,3,LTN,0
3o7p,A,61,66,5,QAGLI,0
3o7p,A,67,85,18,SAFYFGYFIIPIPAGILM,0
3o7p,A,91,109,18,AGIITGLFLYALGAALFW,0
3o7p,A,110,119,9,AAEIMNYTL,0
3o7p,A,120,142,22,LVGLFIIAAGLGCLETAANPFV,0
3o7p,A,156,174,18,LAQTFASFGAIIAVVFGQ,0
3o7p,A,175,209,34,LILSNVPHQSQDVLDKMSPEQLSAYKHSLVLSVQ,0
3o7p,A,210,228,18,PYMIIVAIVLLVALLIML,0
3o7p,A,247,256,9,SASLSRLAR,0
3o7p,A,261,281,20,WAVLAQFCYVGAQTACWSYL,0
3o7p,A,282,300,18,RYAVEEIPGMTAGFAANY,0
3o7p,A,301,319,18,TGTMVCFFIGRFTGTWLI,0
3o7p,A,326,345,19,VLAAYALIAMALCLISAFA,0
3o7p,A,346,349,3,GHV,0
3o7p,A,350,372,22,LIALTLCSAFMSIQYPTIFSLG,0
3o7p,A,382,401,19,GSSFIVMTIIGGGIVTPVM,0
3o7p,A,402,412,10,FVSDAAGNIP,0
3o7p,A,413,431,18,AELIPALCFAVIFIFARF,0
3o7p,A,436,438,2,TN,0
4twd,E,11,210,199,VDVSVSIFINKIYGVNTLEQTYKVDGYIVAQWTGKPRKTPGDKPLIVENTQIERWINNGLWVPALEFINVVGSPDTGNKRLMLFPDGRVIYNARFLGSFSNDMDFRLFPFDRQQFVLELEPFSYNNQQLRFSDIQVYTENADNEEIDEWWIRGKASTHISDIRYDHLSSVQPNQNEFSRITVRIDAVRNPSYYLWSFIL,0
4twd,E,211,225,14,LGLIIAASWSVFWL,0
4twd,E,230,245,15,RLQTSFTLMLTVVAY,0
4twd,E,246,265,19,SYTSNILPRLPYTTVIDQM,0
4twd,E,266,282,16,IAGYGSIFAAILLIIF,0
4twd,E,300,315,15,RLAFPLGFLAIGCVL,0
4twd,E,316,317,1,I,0
3qjt,C,2,6,4,EKPK,0
3qjt,C,7,23,16,ALAVILVLTLTILVFW,0
5ul0,A,9,22,13,EALEYVNIGLSHF,0
5ul0,A,23,29,6,ALPLAQ,0
5ul0,A,30,48,18,ISLIIIIPFIYNIVWQLL,0
5ul0,A,76,87,11,YEFFEECQKKY,0
5l4h,E,5,202,197,SPPPPIADEPLTVNTGIYLIESYSLDDCAETFKVNAFLSLSWKDRRLAFDPVRSGVRVKTYEPEAIWIPEIRFVNVENARDADVVDISVSPDGTVQYLERFSARVLSPLDFRRYPFDSQTLHIYLIVRSVDTRNIVLAVDLEKVGKNDDVFLTGWDIESFTAVVKPANFALEDRLESKLDYQLRISRQYFSYIPNII,0
5l4h,E,203,218,15,PMLFILFISWTAFWS,0
5l4h,E,222,239,17,ANVTLVVSTLIAHIAFN,0
5l4h,E,240,258,18,LVETNCPKTPYMTYTGAI,0
5l4h,E,259,276,17,FMIYLFYFVAVIEVTVQ,0
5l4h,E,292,310,18,RASRIAFPVVFLLANIIL,0
5l4h,E,311,315,4,FLFF,0
3aod,C,11,27,16,AWVIAIIIMLAGGLAI,0
3aod,C,28,340,312,KLPVAQYPTIAPPAVTISASYPGADAKTVQDTVTQVIEQNMNGIDNLMYMSSNSDSTGTVQITLTFESGTDADIAQVQVQNKLQLAMPLLPQEVQQQGVSVEKSSSSFLMVVGVINTDGTMTQEDISDYVAANMKDAISRTSGVGDVQLFGSQYAMRIWMNPNELNKFQLTPVDVITAIKAQNAQVAAGQLGGTPPVKGQQLNASIIAQTRLTSTEEFGKILLKVNQDGSRVLLRDVAKIELGGENYDIIAEFNGQPASGLGIKLATGANALDTAAAIRAELAKMEPFFPSGLKIVYPYDTTPFVKISIHEV,0
3aod,C,341,357,16,KTLVEAIILVFLVMYL,0
3aod,C,366,386,20,IPTIAVPVVLLGTFAVLAAF,0
3aod,C,387,394,7,FSINTLT,0
3aod,C,395,410,15,FGMVLAIGLLVDDAI,0
3aod,C,443,458,15,GIAMVLSAVFVPMAF,0
3aod,C,459,470,11,GGSTGAIYRQF,0
3aod,C,471,489,18,ITIVSAMALSVLVALILT,0
3aod,C,499,512,13,IAKGDHGEGKKGF,0
3aod,C,523,530,7,THHYTDS,0
3aod,C,543,558,15,LYLIIVVGMAYLFVR,0
3aod,C,559,873,314,PSSFLPDEDQGVFMTMVQLPAGATQERTQKVLNEVTHYYLTKEKNNVESVFAVNGFGFAGRGQNTGIAFVSLKDWADRPGEENKVEAITMRATRAFSQIKDAMVFAFNLPAIVELGTATGFDFELIDQAGLGHEKLTQARNQLLAEAAKHPDMLTSVRPNGLEDTPQFKIDIDQEKAQALGVSINDINTTLGAAWGGSYVNDFIDRGRVKKVYVMSEAKYRMLPDDIGDWYVRAADGQMVPFSAFSSSRWEYGSPRLERYNGLPSMEILGQAAPGKSTGEAMELMEQLASKLPTGVGYDWTGMSYQERLSGNQA,0
3aod,C,874,890,16,SLYAISLIVVFLCLAA,0
3aod,C,899,919,20,SVMLVVPLGVIGALLAATFR,0
3aod,C,920,926,6,LTNDVY,0
3aod,C,927,943,16,QVGLLTTIGLSAKNAI,0
3aod,C,976,991,15,MTSLAFILGVMPLVI,0
3aod,C,992,1003,11,TGAGSGAQNAV,0
3aod,C,1004,1019,15,TGVMGGMVTATVLAI,0
3aod,C,1020,1030,10,FVPVFFVVVR,0
3aod,C,1037,1053,16,EDIEHSHTVDHHHHHH,0
4qiq,A,2,7,5,SHMNS,0
4qiq,A,16,39,23,ATLGGLLFGYDTAVISGTVESLN,0
4qiq,A,40,51,11,VFVAPQNLSES,0
4qiq,A,52,75,23,ANSLLGFCVASALIGCIIGGALG,0
4qiq,A,87,106,19,LKIAAVLFFISGVGSAWPE,0
4qiq,A,107,122,15,GFTSINPDNTVPVYL,0
4qiq,A,123,145,22,GYVPEFVIYRIIGGIGVGLASM,0
4qiq,A,166,187,21,NQFAIIFGQLLVYCVNYFIAR,0
4qiq,A,188,197,9,GDASWLNTD,0
4qiq,A,198,218,20,WRYMFASECIPALLFLMLLY,0
4qiq,A,229,246,17,RGKQEQAEGILRKIMGN,0
4qiq,A,262,268,6,GRKTGG,0
4qiq,A,280,305,25,GVMLSIFQQFVGINVVLYYAPEVFK,0
4qiq,A,306,311,5,LGAST,0
4qiq,A,312,336,24,IALLQTIIVGVINLTFTVLAIMTV,0
4qiq,A,343,364,21,LQIIGALGMAIGMFSLGTAFY,0
4qiq,A,365,369,4,QAPG,0
4qiq,A,370,392,22,VALLSMLFYVAAFAMSWGPVCW,0
4qiq,A,411,432,21,VAAQWLANYFVSWTFPMMDKN,0
4qiq,A,433,439,6,WLVAHF,0
4qiq,A,440,441,1,N,0
4qiq,A,442,462,20,FSYWIYGCMGVLAALFMWKF,0
4qiq,A,472,480,8,ELEALWEP,0
1yew,K,1,44,43,HETKQGGEKRFTGAICRCSHRYNSMEVKMAATTIGGAAAAEAP,0
1yew,K,45,52,7,LDKKWLT,0
1yew,K,53,67,14,ALAIYTVFYLWVRW,0
1yew,K,93,108,15,YTEIVLEIVTASILW,0
1yew,K,109,138,29,YLWKTRDRNLAALTPREELRRNFTHLVWL,0
1yew,K,139,155,16,AYAWAIYWGASYFTEQ,0
1yew,K,175,190,15,EFYLSYPIYIITGFA,0
1yew,K,191,203,12,FIYAKTRLPFFA,0
1yew,K,204,230,26,GISLPYLVLVVGPFMILPNVGLNEWG,0
1yew,K,231,259,28,TFWFMEELFVAPLHYGFVIFGWLALAVM,0
1yew,K,260,289,29,TLTQTFYSFAQGGLGQSLCEAVDEGLIAK,0
1p8i,C,1,4,3,AQI,0
1p8i,C,5,11,6,GRPEWI,0
1p8i,C,12,30,18,LALGTALMGLGTLYFLVK,0
1p8i,C,44,61,17,ITTLVPAIAFTMYLSML,0
1p8i,C,62,79,17,GYGLTMVPFGGEQNPIY,0
1p8i,C,80,97,17,ARYADWLFTTPLLLLDL,0
1p8i,C,109,126,17,ALVGADGIMIGTGLVGA,0
1p8i,C,127,134,7,TKVYSYR,0
1p8i,C,135,153,18,VWWAISTAAMLYILYVLF,0
1p8i,C,157,161,4,SKAE,0
1p8i,C,175,192,17,NVTVVLWSAYPVVWLIG,0
1p8i,C,193,203,10,EGAGIVPLNI,0
1p8i,C,204,222,18,TLLFMVLDVSAKVGLGLI,0
1p8i,C,232,249,17,AEAPEPSAGDGAAATSD,0
4h0l,P,9,23,14,LLSFGLIFVGWGLG,0
4h0l,P,24,32,8,LLLKIQGA,0
4h0l,P,33,35,2,KE,0
3dsy,H,1,10,9,VGVTAFGNF,0
3dsy,H,12,32,20,ASLAIYSFWIFLAGLIYYLQ,0
3dsy,H,33,250,217,ENMREGYPLENEDGTPAANQGPFPLPKPKTFILPHGRGTLTVPGPESEDRPIALARTAVSEGFPHAPTGDPMKDGVGPASWVARRDLPELDGHGHNKIKPMKAAAGFHVSAGKNPIGLPVRGCDLEIAGKVVDIWVDIPEQMARFLEVELKDGSTRLLPMQMVKVQSNRVHVNALSSDLFAGIPTIKSPTEVTLLEEDKICGYVAGGLMYAAPKRKS,0
3dsy,H,251,260,9,VAAMLAEYA,0
4qh4,E,5,198,193,SPPPPIADEPLTVNTGIYLIECYSLDDKAETFKVNAFLSLSWKDRRLAFDPVRSGVRVKTYEPEAIWIPEIRFVNVENARDADVVDISVSPDGTVQYLERFSARVLSPLDFRRYPFDSQTLHIYLIVRSVDTRNIVLAVDLEKVGKNDDVFLTGWDIESFTAVVKPANFALEDRLESKLDYQLRISRQYFSYI,0
4qh4,E,199,218,19,NIILPMLFILFISWTAFWS,0
4qh4,E,222,240,18,ANVTLVVSTLIAHIAFNI,0
4qh4,E,241,255,14,VETNLPKTPYMTYT,0
4qh4,E,256,275,19,AIIFMIYLFYFVAVIEVTV,0
4qh4,E,295,313,18,RIAFPVVFLLANIILAFL,0
4qh4,E,314,315,1,F,0
3vma,A,73,86,13,IVFAVLIAIYGVY,0
3vma,A,87,240,153,DQKIRSRIDGKVWQLPAAVYGRMVNLEPDMTISKNEMVKLLEATQYRQVSKMTRPGEFTVQANSIEMIRRPFDFPDSKEGQVRARLTFDGDHLATIVNMENNRQFGFFRLDPRLITMISSPNGEQRLFVPRSGFPDLLVDTLLATEDRHFYEH,0
3vma,A,246,251,5,SIGRA,0
3vma,A,267,283,16,LTQQLVKNLFLSSERS,0
3vma,A,284,300,16,WRKANEAYMALIMDAR,0
3vma,A,301,399,98,SKDRILELYMNEVYLGQSGDNEIRGFPLASLYYFGRPVEELSLDQQALLVGMVKGASIYNPWRNPKLALERRNLVLRLLQQQQIIDQELYDMLSARPL,0
3vma,A,401,800,399,QPRGGVISPQPAFMQLVRQELQAKLGDKVKDLSGVKIFTTFDSVAQDAAEKAAVEGIPALKKQRKLSDLETAIVVVDRFSGEVRAMVGGSEPQFAGYNRAMQARRSIGSLAKPATYLTALSQPKIYRLNTWIADAPIALRQPNGQVWSPQNDDRRYSESGRVMLVDALTRSMNVPTVNLGMALGLPAVTETWIKLGVPKDQLHPVPAMLLGALNLTPIEVAQAFQTIASGGNRAPLSALRSVIAEDGKVLYQSFPQAERAVPAQAAYLTLWTMQQVVQRGTGRQLGAKYPNLHLAGKTGTTNNNVDTWFAGIDGSTVTITWVGRDNNQPTKLYGASGAMSIYQRYLANQTPTPLNLVPPEDIADMGVDYDGNFVCSGGMRILPVWTSDPQSLCQQSEMQ,0
2k21,A,-8,0,8,GHHHHHHG,0
2k21,A,1,49,48,ILSNTTAVTPFLTKLWQETVQQGGNMSGLARRSPRSGDGKLEALYVLM,0
2k21,A,50,72,22,LGFFGFFTLGIMLSYIRSKKLE,0
2k1k,B,536,547,11,PPVSRGLTGGE,0
2k1k,B,548,569,21,VAVIFGLLLGAALLLGILVFR,0
5l7d,A,234,251,17,AAFGAVTGLCTLFTLAT,0
5l7d,A,252,266,14,VADWRNSNRYPAVI,0
5l7d,A,267,283,16,FYVNACFFVGSIGWLA,0
5l7d,A,289,294,5,RREIV,0
5l7d,A,316,336,20,IFVIVYYALMAGFVWFVVLT,0
5l7d,A,337,346,9,AWHTSFKAL,0
5l7d,A,351,361,10,PLSGKTSYFH,0
5l7d,A,362,378,16,LTWSLPFVLTVAILAV,0
5l7d,A,400,420,20,AGFVLAPIGLVLIVGGYFLI,0
5l7d,A,421,1061,640,GVMTLFSARRQLADLEDNWETLNDNLKVIEKADNAAQVKDALTKMRAAALDAQKATPP,0
5l7d,A,1070,454,-616,PEMKDFRHGFDILVGQIDDALKLANEGKVKEAQAAAEQLKTTRNAYIQKYLERARSTLSKINETMLRLGI,0
5l7d,A,455,472,17,GFLAFGFVLITFSCHFY,0
5l7d,A,518,537,19,KINLFAMFGTGIAMSTWVW,0
5l7d,A,539,552,13,ATLLIWRRTWCRL,0
2llm,A,1,17,16,SQKLVFFAEDVGSNKG,0
2llm,A,18,40,22,IIGLMVGGVVIATVIVITLVML,0
4f05,C,1,3,2,EE,0
4f05,C,4,6,2,PK,0
4f05,C,7,24,17,ALAVILVLTLTILVFWL,0
2b6q,A,1,23,22,ASTESSLLRSLGLSPGPGSSEV,0
2b6q,A,24,34,10,LDCWFDEDFK,0
2b6q,A,35,62,27,ILLPVSYAVVFVLGLGLNAPTLWLFIF,0
2b6q,A,70,97,27,ATYMFHLALSDTLYVLSLPTLIYYYAA,0
2b6q,A,98,106,8,NHWPFGTE,0
2b6q,A,107,133,26,CKFVRFLFYWNLYCSVLFLTCISVHR,0
2b6q,A,151,175,24,AGLLCLAVWLVVAGCLVPNLFFVT,0
2b6q,A,176,198,22,SNKGTTVLCHDTTRPEEFDHYV,0
2b6q,A,199,222,23,FSSAVMGLLFGVPCLVTLVCYGL,0
2b6q,A,246,270,24,IAVVLTVFAVCFVPFHITRTIYYL,0
2b6q,A,271,286,15,RLLEADCRVLNIVNV,0
2b6q,A,287,309,22,YKVTRPLASANSCLDPVLYLLT,0
2b6q,A,311,317,6,KYRRQL,0
2b6q,A,322,365,43,GGKPQPRTAASSLALVSLPEDSSCRWAATPQDSSCSTPRADRL,0
4cz8,B,2,6,4,ELSL,0
4cz8,B,7,24,17,EALFLILFTGVISMLIS,0
4cz8,B,30,43,13,YVPIFILTGLVIG,0
4cz8,B,44,57,13,LLKLIPRDLAHEI,0
4cz8,B,58,74,16,DFVRVFGLVIILFTEG,0
4cz8,B,79,84,5,RLLKK,0
4cz8,B,90,108,18,TLDTIGLILTALIAGFIF,0
4cz8,B,109,120,11,VVFNSSFLLGF,0
4cz8,B,121,133,12,FGAIIGATDPAT,0
4cz8,B,155,168,13,IFNDPLGIVLTLI,0
4cz8,B,169,180,11,ISMLVPGYGGG,0
4cz8,B,181,189,8,FSTLSEKL,0
4cz8,B,190,195,5,IYAGG,0
4cz8,B,196,214,18,IYFLYNVSVSISLGIFLG,0
4cz8,B,234,250,16,FSLSLAFLGFFIGERL,0
4cz8,B,252,262,10,SGYLVATVTG,0
4cz8,B,294,313,19,DTLAALATIFIFVLLGAEM,0
4cz8,B,315,320,5,EVIWS,0
4cz8,B,321,322,1,L,0
4cz8,B,323,344,21,KGLLVALGVMILARPLATLPL,0
4cz8,B,358,371,13,EGPRGVVPSALAS,0
4cz8,B,372,394,22,PLSLALKYKSPLLTVHWGEIIM,0
4cz8,B,395,411,16,TVVITVLTSVIVETLW,0
4jq6,F,1,8,7,GEILAVD,0
4jq6,F,9,13,4,YVGI,0
4jq6,F,14,31,17,FWLAAAIMLASTVFFFV,0
4jq6,F,45,62,17,VAGLVTGVAFWHYLYMR,0
4jq6,F,63,74,11,VWIYAGETPTV,0
4jq6,F,75,91,16,RYIDWLITVPLQIIEF,0
4jq6,F,97,104,7,VTAISSA,0
4jq6,F,106,122,16,WKLLIASLVMLIGGFI,0
4jq6,F,123,131,8,EAGLGDVV,0
4jq6,F,132,148,16,WWIVGMIAWLYIIYEI,0
4jq6,F,150,164,14,GETAKANAGSGNAA,0
4jq6,F,173,189,16,WIVTVGWAIYPIGYAW,0
4jq6,F,190,200,10,YFGDGLNEDA,0
4jq6,F,201,219,18,NIVYNLADLINKAAFGLA,0
4jq6,F,231,235,4,TSHA,0
4a4m,C,43,63,20,MFLLIMLGFPINFLTLYVTV,0
4a4m,C,64,74,10,HKKLRTPLNY,0
4a4m,C,75,92,17,LLNLAVADLFMVFGGFT,0
4a4m,C,114,133,19,FFATLGGEIALWSLVVLAI,0
4a4m,C,134,153,19,RYVVVCKPMSNFRFGENHA,0
4a4m,C,154,170,16,MGVAFTWVMALACAAP,0
4a4m,C,203,221,18,VIYMFVVHFIIPLIVIFF,0
4a4m,C,222,254,32,YGQLVFTVKEAAAQQQESATTQKAEKEVTRMV,0
4a4m,C,255,274,19,IYVIAFLICWLPYAGVAFY,0
4a4m,C,291,309,18,AFFAKTSAVYNPVIYIMM,0
4a4m,C,310,326,16,KQFRNCMVTTLCCGKN,0
4a4m,C,327,348,21,LGDDEASTTVSKTETSQVAPA,0
5b6x,C,4,11,7,TGRPEWI,0
5b6x,C,12,28,16,LALGTALMGLGTLYFL,0
5b6x,C,47,61,14,LVPAIAFTMYLSML,0
5b6x,C,62,79,17,GYGLTMVPFGGEQNPIY,0
5b6x,C,80,94,14,ARYADWLFTTPLLL,0
5b6x,C,111,126,15,VGADGIMIGTGLVGA,0
5b6x,C,127,134,7,TKVYSYR,0
5b6x,C,135,150,15,VWWAISTAAMLYILY,0
5b6x,C,178,192,14,VVLWSAYPVVWLIG,0
5b6x,C,193,203,10,EGAGIVPLNI,0
5b6x,C,204,220,16,TLLFMVLDVSAKVGFG,0
5u70,D,76,84,8,KERLKLFF,0
5u70,D,91,113,22,LRIRLFNFSLKLLTCLLYIVRV,0
5u70,D,114,118,4,LDNP,0
5u70,D,139,154,15,KINWSHIFWVDRKLP,0
5u70,D,155,178,23,WAVQVSIALISFLETMLLIYLSY,0
5u70,D,182,207,25,WEQIFRISFILEMINTVPFIITIFW,0
5u70,D,208,213,5,PLRNL,0
5u70,D,214,232,18,IPVFLNCWLAKYALENMI,0
5u70,D,248,271,23,QVLILICTLLCLVFTGTCGIQHL,0
5u70,D,272,280,8,RAGEKLSL,0
5u70,D,281,297,16,KSFYFCIVTFSTVGYG,0
5u70,D,298,305,7,VTPKIWP,0
5u70,D,306,333,27,QLLVVIMICVALVVLPLQFEELVYLWM,0
5u70,D,402,407,5,LWSQR,0
4cy4,E,266,279,13,FAVPMWITGIYGM,0
4cy4,E,280,292,12,FSYLPLANNPQG,0
4cy4,E,293,306,13,WLVMALMVVIIMI,0
4o93,D,4,19,15,QAAYFVVAILFIVGL,0
4o93,D,20,33,13,RMAHPTTAKSGIV,0
4o93,D,34,48,14,AGWGMVLAVLATFF,0
4o93,D,57,72,15,ILLALLLGSVVAWWA,0
4o93,D,73,86,13,VRVAMTDMPQMVA,0
4o93,D,87,101,14,YNGMGGGAAATIAA,0
4o93,D,117,134,17,AILGGLIGSVAFTGSLI,0
4o93,D,135,152,17,FAKLQGIMKSRPILFPG,0
4o93,D,153,169,16,KAVNALVLALTVVIGL,0
4o93,D,181,195,14,LFFLLALLFGVLMT,0
4o93,D,196,209,13,PIGGGDMPVAISF,0
4o93,D,210,226,16,NAFTGMAVGFEGFAVG,0
4o93,D,228,242,14,ALMVAGTLVGAAGT,0
4o93,D,243,260,17,LTVLMARAMNRSVWISV,0
4o9r,A,187,191,4,GTSG,0
4o9r,A,192,233,41,CEVPLVRTDNPKSWYEDVEGCGIQCQNPLFTEAEHQDMHSY,0
4o9r,A,234,253,19,AAFGAVTGLCTLFTLATFV,0
4o9r,A,267,283,16,FYVNACFFVGSIGWLA,0
4o9r,A,284,288,4,FMDG,0
4o9r,A,289,294,5,RREIV,0
4o9r,A,295,315,20,RADGTMRLGEPTSNETLSCV,0
4o9r,A,316,337,21,IFVIVYYALMAGVVWFVVLTY,0
4o9r,A,345,354,9,LGTTYQPLS,0
4o9r,A,361,377,16,LLTWSLPFVLTVAILA,0
4o9r,A,378,399,21,AQVDGDSVSGICFVGYKNYRY,0
4o9r,A,400,420,20,AGFVLAPIGLVLIVGGYFLI,0
4o9r,A,454,472,18,FGFLAFGFVLITFSCHFY,0
4o9r,A,473,496,23,FFNQAEWERSFRDYVLCQANVTI,0
4o9r,A,497,504,7,LPTKQPI,0
4o9r,A,505,517,12,DCEIKNRPSLLV,0
4o9r,A,518,537,19,KINLFAMFGTGIAMSTWVW,0
4o9r,A,541,548,7,LLIWRRT,0
4o9r,A,552,555,3,TGQ,0
4a7a,A,1,2,1,S,0
4a7a,A,3,108,105,KCDVVVVGGGISGMAAAKLLHDSGLNVVVLEARDRVGGRTYTLRNQKVKYVDLGGSYVGPTQNRILRLAKELGLETYKVNEVERLIHHVKGKSYPFRGPFPPVWN,0
4a7a,A,109,126,17,ITYLDHNNFWRTMDDMG,0
4a7a,A,127,487,360,EIPSDAPWKAPLAEEWDNMTMKELLDKLCWTESAKQLATLFVNLCVTAETHEVSALWFLWYVKQCGGTTRIISTTNGGQERKFVGGSGQVSERIMDLLGDRVKLERPVIYIDQTRENVLVETLNHEMYEAKYVISAIPPTLGMKIHFNPPLPMMRNQMITRVPLGSVIKCIVYYKEPFWRKKDYCGTMIIDGEEAPVAYTLDDTKPEGNYAAIMGFILAHKARKLARLTKEERLKKLCELYAKVLGSLEALEPVHYEEKNWCEEQYSGGCYTTYFPPGILTQYGRVLRQPVDRIYFAGTETATHWSGYMEGAVEAGERAAREILHAMGKIPEDEIWQSEPESVDVPAQPITTTFLERHLP,0
4a7a,A,488,501,13,VPGLLRLIGLTTI,0
4a7a,A,502,520,18,SATALGFLAHKRGLLVRV,0
4fg6,B,1,17,16,KTDTPSLETPQAARLR,0
4fg6,B,37,60,23,MAAVVGTLVGLAAVAFDKGVAWL,0
4fg6,B,61,83,22,NQRMGALVHTADNYPLLLTVAF,0
4fg6,B,84,97,13,CSAVLAMFGYFLV,0
4fg6,B,128,142,14,PVKFFGGLGTLGGG,0
4fg6,B,144,156,12,LGRAGPTVQIGG,0
4fg6,B,180,203,23,GAAAGLAAAFNAPLAGILFIIEE,0
4fg6,B,216,232,16,AVFIGVIMSTIMYRIF,0
4fg6,B,233,252,19,HEVALIDVGKLSDAPLNTL,0
4fg6,B,253,277,24,LYLILGIIFGIFGPIFNKWVLGMQ,0
4fg6,B,290,305,15,WVLMGGAIGGLCGLL,0
4fg6,B,306,337,31,FVAPATSGGGFNLIPIATAGNFSMGMLVFIF,0
4fg6,B,338,351,13,ARVITTLLCFSSG,0
4fg6,B,353,365,12,GGIFAPMLALGT,0
4fg6,B,366,392,26,LGTAFGMVAVELFPQYHLEAGTFAIA,0
4fg6,B,393,415,22,MGALLAASIRAPLTGIILVLEM,0
4fg6,B,416,422,6,DNYQLI,0
4fg6,B,423,439,16,PMIITGLGATLLAQFT,0
4fg6,B,459,465,6,QLARSK,0
1fjk,A,31,49,18,FINFCLILIFLLLICIIV,0
1fjk,A,50,52,2,LL,0
5hya,A,7,24,17,YFLLGLILLYYGSDWFV,0
5hya,A,25,39,14,GSERIARHFNVSNF,0
5hya,A,40,59,19,IGATVMAIGTSLPEILTSA,0
5hya,A,72,92,20,NAIGSCICNIGLVLGLSAII,0
5hya,A,93,103,10,PIIVDKNLQK,0
5hya,A,104,120,16,ILVYLLFVIFAAVIGI,0
5hya,A,127,143,16,GVVLLILFIIYLRWTV,0
5hya,A,144,148,4,NGSA,0
5hya,A,156,165,9,NNPSVVFSL,0
5hya,A,166,186,20,LLIIGLIGVLVGAELFVDGA,0
5hya,A,205,222,17,AFGTSLPELMVSLAAAK,0
5hya,A,223,228,5,NLGGM,0
5hya,A,229,248,19,LGNVIGSNIADIGGALAVG,0
5hya,A,259,275,16,QMAVLVIMSLLLYLFA,0
5hya,A,276,280,4,YSKI,0
5hya,A,281,299,18,RWQGILFLALYIIAIASL,0
5do7,B,-1,22,23,GSAGKAAEERGLPKGATPQDTSG,0
5do7,B,23,44,21,QDRLFSSESDNSLYFTYSGQP,0
5do7,B,45,86,41,TLEVRDLNYQVDLASQVPWFEQLAQFKMPWTSPSCQNSCEL,0
5do7,B,87,321,234,IQNLSFKVRSGQMLAIIGSSGCGRASLLDVITGRGHGGKIKSGQIWINGQPSSPQLVRKCVAHVRQHNQLLPNLTVRETLAFIAQMRLPRTFSQAQRDKRVEDVIAELRLRQCADTRVGNMYVRGLSGGERRRVSIGVQLLWNPGILILDEPTSGLDSFTAHNLVKTLSRLAKGNRLVLISLHQPRSDIFRLFDLVLLMTSGTPIYLGAAQHMVQYFTAIGYPCPRYSNPADFY,0
5do7,B,322,341,19,DLTSIDRRSREQELATREK,0
5do7,B,342,366,24,QSLAALFLEKVRDLDDFLWKAETK,0
5do7,B,367,393,26,LDEDTCVESSVTPLDTNCLPSPTKMP,0
5do7,B,394,413,19,AVQQFTTLIRRQISNDFRD,0
5do7,B,414,431,17,PTLLIHGAEACLMSMTI,0
5do7,B,455,469,14,GALIPFNVILDVIS,0
5do7,B,470,496,26,CYSERAMLYYELEDGLYTTGPYFFAK,0
5do7,B,497,513,16,LGELPEHCAYIIIYGM,0
5do7,B,533,550,17,LVWLVVFCCRIMALAAA,0
5do7,B,551,558,7,LLPTFHM,0
5do7,B,559,574,15,SFFSNALYNSFYLAG,0
5do7,B,644,659,15,LIVIGLSGGFMVLYY,0
5do7,B,660,673,13,SLRFIKQKPSQDW,0
5do7,B,674,683,9,SNSLEVLFQ,0
5jae,B,14,32,18,ILAMAGNAVGLGNFLRFP,0
5jae,B,33,41,8,QAAENGGG,0
5jae,B,42,63,21,FMIPYIIAFLLVGIPLMWIEW,0
5jae,B,90,120,30,KILGVFGLWIPLVVAIYYVYIESWTLGFAI,0
5jae,B,121,166,45,FLVGLVPEPPPNATDPDSILRPFKEFLYSYIGVPKGDEPILKPSL,0
5jae,B,167,184,17,AYIVFLITMFINVSILI,0
5jae,B,191,212,21,ERFAKIAMPTLFILAVFLVIR,0
5jae,B,213,222,9,FLLETPNGT,0
5jae,B,223,231,8,ADGLNFLW,0
5jae,B,232,243,11,PDFEKLKDPGV,0
5jae,B,244,265,21,IAAVGQIFFTLSLGFGAIITY,0
5jae,B,279,297,18,LTAATLNEKAEVILGGSI,0
5jae,B,298,325,27,IPAAVAFFGVANAVAIAKAGAFNLGFI,0
5jae,B,326,332,6,LPAIFS,0
5jae,B,333,342,9,TAGGTFLGF,0
5jae,B,343,366,23,WFFLLFFAGLTSSIAIMQPMIAF,0
5jae,B,378,394,16,VLWTAAIVFFSAHLVM,0
5jae,B,395,399,4,LNKS,0
5jae,B,400,425,25,DEMDFWAGTIGVVFFGLTELIIFFW,0
5jae,B,429,437,8,DKAWEEIN,0
5jae,B,448,469,21,YYVMRYITPAFLAVLLVVWAR,0
5jae,B,470,475,5,YIPKI,0
5jae,B,480,484,4,WTVW,0
5jae,B,485,501,16,TRFYIIGLFLFLTFLV,0
5j4n,B,6,16,10,AHKVGLIPVT,0
5j4n,B,17,32,15,MVSGNIMGSGVFLLP,0
5j4n,B,41,57,16,AIYGWLVTIIGALGLS,0
5j4n,B,58,91,33,VYAKMSFLDPSPGGSYAYARRCFGPFLGYQTNV,0
5j4n,B,92,113,21,YWLACWIGNIAMVVIGVGYLS,0
5j4n,B,123,140,17,VLTITCVVVLWIFVLLN,0
5j4n,B,141,147,6,VGPKMI,0
5j4n,B,148,171,23,RVQAVATVLALIPIVGIAVFGWF,0
5j4n,B,175,181,6,ETYMAA,0
5j4n,B,190,209,19,GAIQSTLNVTLWSFIGVES,0
5j4n,B,210,228,18,SVAAGVVKNPKRNVPIAT,0
5j4n,B,229,246,17,GGVLIAAVCYVLSTTAI,0
5j4n,B,252,257,5,AALRV,0
5j4n,B,261,270,9,FGDAARMAL,0
5j4n,B,277,297,20,VSFCAAAGCLGSLGGWTLLA,0
5j4n,B,298,327,29,QTAKAAADDGLFPPIFARVNKAGTPVAGL,0
5j4n,B,328,342,14,IVGILMTIFQLSSI,0
5j4n,B,347,366,19,KEFGLVSSVSVIFTLVPYL,0
5j4n,B,367,389,22,TCAALLLLGHGHFGKARPAYLA,0
5j4n,B,390,407,17,TTIAFLYCIWAVVGSGA,0
5j4n,B,409,423,14,VMWSFVTLMVITAM,0
5j4n,B,424,441,17,ALNYNRLHKNPYPLDAP,0
5mdx,8,54,58,4,KSWI,0
5mdx,8,59,64,5,AVKGG,0
5mdx,8,65,101,36,NFLDPEWLDGSLPGDFGFDPLGLGKDPAFLKWYREA,0
5mdx,8,102,119,17,LIHGRWAMAAVLGIFVG,0
5mdx,8,145,158,13,LGTQLLLMGWVES,0
5mdx,8,159,227,68,RWVDFFNPDSQSVEWATPWSKTAENFANYTGDQGYPGGRFFDPLGLAGKNRDGVYEPDFEKLERLKLA,0
5mdx,8,228,243,15,IKHSRLAMVAMLIFY,0
1ocz,Z,16,35,19,IGLSVTFLSFLLPAGWVLY,0
1ocz,Z,36,43,7,LDNYKKS,0
1ocz,Z,44,46,2,AA,0
2m3e,A,1063,1083,20,MLYLYVLSGIGGLLLLLLIF,0
2m3e,A,1084,1099,15,VLYKVGFFKRNLKEK,0
2m3e,A,1100,1103,3,EAG,0
5hxe,A,5,27,22,VGYFLLGLILLYYGSDWFVLGS,0
5hxe,A,28,39,11,RIARHFNVSNF,0
5hxe,A,40,59,19,IGATVMAIGTSLPEILTSA,0
5hxe,A,72,92,20,NAIGSCICNIGLVLGLSAII,0
5hxe,A,93,102,9,PIIVDKNLQ,0
5hxe,A,103,120,17,NILVYLLFVIFAAVIGI,0
5hxe,A,127,143,16,GVVLLILFIIYLRWTV,0
5hxe,A,144,148,4,NGSA,0
5hxe,A,156,165,9,NNPSVVFSL,0
5hxe,A,166,186,20,LLIIGLIGVLVGAELFVDGA,0
5hxe,A,205,222,17,AFGTSLPELMVSLAAAK,0
5hxe,A,223,228,5,NLGGM,0
5hxe,A,229,248,19,LGNVIGSNIADIGGALAVG,0
5hxe,A,259,275,16,QMAVLVIMSLLLYLFA,0
5hxe,A,276,280,4,YSKI,0
5hxe,A,281,299,18,RWQGILFLALYIIAIASL,0
2meu,B,101,111,10,KTNLEIIILV,0
2meu,B,112,136,24,TAVIAMEFWLLLVIILRTVKRANG,0
4up6,C,28,32,4,AAFR,0
4up6,C,33,47,14,EGVAVLLAVVIACW,0
4up6,C,54,68,14,RVLLISSVMLVMIV,0
4up6,C,69,101,32,ILNSAIEAVVDRIGSEYHELSGRAKDMGSAAV,0
4up6,C,102,116,14,IAIIVAVITWCILL,0
4bpm,C,3,9,6,HHHHHH,0
4bpm,C,10,13,3,PAL,0
4bpm,C,14,32,18,AFLLCSTLLVIKMYVVAI,0
4bpm,C,73,90,17,NDMETIYPFLFLGFVYS,0
4bpm,C,91,97,6,LGPNPF,0
4bpm,C,98,115,17,AWMHFLVFLVGRVAHTV,0
4bpm,C,129,149,20,YTLAQLPCASMALQILWEAA,0
4bpm,C,150,154,4,HFLP,0
4bpm,C,155,160,5,ALRAA,0
4bpm,C,161,171,10,LGRLRTLRPW,0
4bpm,C,172,180,8,DYKDDDDK,0
4brr,C,-8,31,39,HHHHHHELANNTTGFTRIIKAAGYSWKGLRAAWINEAAF,0
4brr,C,34,48,14,GVAVLLCVVIAAWL,0
4brr,C,49,52,3,VDA,0
4brr,C,53,68,15,TRVLLISSVMLVMIV,0
4brr,C,102,117,15,IAIIDAVITWAILLW,0
4brr,C,118,121,3,HFG,0
5hxr,A,8,27,19,FLLGLILLYYGSDWFVLGS,0
5hxr,A,28,39,11,RIARHFNVSNF,0
5hxr,A,40,56,16,IGATVMAIGTSLPEIL,0
5hxr,A,74,92,18,IGSCICNIGLVLGLSAII,0
5hxr,A,93,104,11,PIIVDKNLQKN,0
5hxr,A,105,120,15,LVYLLFVIFAAVIGI,0
5hxr,A,127,143,16,GVVLLILFIIYLRWTV,0
5hxr,A,144,148,4,NGSA,0
5hxr,A,156,162,6,NNPSVV,0
5hxr,A,163,182,19,SLVLLIIGLIGVLVGAELF,0
5hxr,A,207,222,15,GTSLPELMVSLAAAK,0
5hxr,A,223,228,5,NLGGM,0
5hxr,A,229,247,18,LGNVIGSNIADIGGALAV,0
5hxr,A,259,275,16,QMAVLVIMSLLLYLFA,0
5hxr,A,276,280,4,YSKI,0
5hxr,A,281,297,16,RWQGILFLALYIIAIA,0
5fxj,D,26,31,5,RSQKS,0
5fxj,D,32,192,160,PSIGIAVILVGTSDEVAIKDAHEKDDFHHLSVVPRVELVAMNETDPKSIITRICDLMSDRKIQGVVFADDTDQEAIAQILDFISAQTLTPILGIHGGSSMIMADKDESSMFFQFGPSIEQQASVMLNIMEEYDWYIFSIVTTYFPGYQDFVNKIRSTIEN,0
5fxj,D,193,197,4,FVGW,0
5fxj,D,198,394,196,LEEVLLLDMSLDDGDSKIQNQLKKLQSPIILLYCTKEEATYIFEVANSVGLTGYGYTWIVPSLVAGDTDTVPSEFPTGLISVSYDEWDYGLPARVRDGIAIITTAASDMLSEHSFIPEPKSSCYNTHEKRIYQSNMLNRYLINVTFEGRDLSFSEDGYQMHPKLVIILLNKERKWERVGKWKDKSLQMKYYVWPRM,0
5fxj,D,395,400,5,PETEE,0
5fxj,D,401,439,38,EDDHLSIVTLEEAPFVIVESVDPLSGTCMRNTVPCQKR,0
5fxj,D,440,451,11,ISENKTDEEPG,0
5fxj,D,452,555,103,IKKCCKGFCIDILKKISKSVKFTYDLYLVTNGKHGKKINGTWNGMIGEVVMKRAYMAVGSLTINEERSEVVDFSVPFIETGISVMVSRSNGTVSPSAFLEPFS,0
5fxj,D,556,573,17,CVWVMMFVMLLIVSAVA,0
5fxj,D,579,599,20,FSPVGYNRSLADGREPGGPS,0
5fxj,D,606,619,13,WLLWGLVFNNSVP,0
5fxj,D,627,647,20,SKIMVSVWAFFAVIFLASYT,0
5fxj,D,648,817,169,NLAAFMIQEEYVDQVSGLSDKKFQRPNDFSPPFRFGTVPNGSTERNIRNNYAEMHAYMGKFNQRGVDDALLSLKTGKLDAFIYDAAVLNYMAGRDEGCKLVTIGSGKVFASTGYGIAIQKDSGWKRQVDLAILQLFGDGEMEELEALWLTGICHNEKNEVMSSQLDIDN,0
5fxj,D,818,837,19,AGVFYMLGAAMALSLITFI,0
5fxj,D,838,852,14,EHLFYWQFRHSFMG,0
3lrc,B,1,5,4,SSDA,0
3lrc,B,6,12,6,AHKVGL,0
3lrc,B,13,31,18,PVTLMVSGNIMGSGVFLL,0
3lrc,B,44,61,17,GWLVTIIGALGLSMVYA,0
3lrc,B,62,84,22,MSFLDPSPGGSYAYARRCFGPF,0
3lrc,B,85,112,27,GYQTNVLYWLACWIGNIAMVVIGVGYL,0
3lrc,B,126,144,18,ITCVVVLWIFVLLNIVGP,0
3lrc,B,146,171,25,ITRVQAVATVLALIPIVGIAVFGWF,0
3lrc,B,197,213,16,NVTLWSFIGVESASVA,0
3lrc,B,214,224,10,GVVKNPKRNV,0
3lrc,B,225,244,19,IATIGGVLIAAVCYVLSTT,0
3lrc,B,253,272,19,ALRVSASPFGDAARMALGD,0
3lrc,B,278,301,23,SFCAAAGCLGSLGGWTLLAGQTA,0
3lrc,B,302,323,21,AAADDGLFPPIFARVNKAGTP,0
3lrc,B,324,342,18,AGLIIVGILMTIFQLSSI,0
3lrc,B,350,370,20,GLVSSVSVIFTLVPYLYTCA,0
3lrc,B,371,385,14,LLLLGHGHFGKARP,0
3lrc,B,386,407,21,YLAVTTIAFLYCIWAVVGSGA,0
3lrc,B,409,426,17,VMWSFVTLMVITAMYAL,0
3lrc,B,427,435,8,YNRLHKNP,0
3lrc,B,436,445,9,PLDAPISKD,0
2j8d,M,1,52,51,EYQNIFSQVQVRGPADLGMTEDVNLANRSGVGPFSTLLGWFGNAQLGPIYL,0
2j8d,M,53,72,19,SLGVLSLFSGLMWFFTIGI,0
2j8d,M,82,87,5,AVFLR,0
2j8d,M,118,134,16,SFFMFVAVWSWWGRTY,0
2j8d,M,135,144,9,RAQALGMGK,0
2j8d,M,145,163,18,TAWAFLSAIWLWMVLGFI,0
2j8d,M,179,192,13,FSHLDWTNNFSLV,0
2j8d,M,201,221,20,HGLSIAFLYGSALLFAMHGA,0
2j8d,M,222,267,45,ILAVSRFGGERELEQIADRGTAAERAALFWRWTMGFNATMEGIHR,0
2j8d,M,268,285,17,AIWMAVLVTLTGGIGIL,0
2j8d,M,294,300,6,YVWGQN,0
3wgu,E,1,14,13,AGLSTDDGGSPKG,0
3wgu,E,29,46,17,GLIFAALAFIVGLIIIL,0
3wgu,E,47,49,2,KR,0
3wgu,E,50,65,15,RCGGKKHRPINEDEL,0
4njn,A,66,90,24,GSSHHHHHHSSGLVPRGSHMAALR,0
4njn,A,91,92,1,R,0
4njn,A,93,110,17,GPVTWVMMIACVVVFIA,0
4njn,A,133,145,12,EFWRYFTHALMH,0
4njn,A,148,166,18,MHILFNLLWWWYLGGAVE,0
4njn,A,167,171,4,RLGS,0
4njn,A,172,189,17,KLIVITLISALLSGYVQ,0
4njn,A,199,216,17,LSGVVYALMGYVWLRGE,0
4njn,A,217,224,7,DPQSGIY,0
4njn,A,225,241,16,QRGLIIFALIWIVAGW,0
4njn,A,252,268,16,AHIAGLAVGLAMAFVD,0
4njn,A,269,272,3,LNA,0
4njn,A,273,276,3,KRK,0
4g71,C,1,3,2,EE,0
4g71,C,4,6,2,PK,0
4g71,C,7,24,17,ALAVILVLTLTILVFWL,0
2jo1,A,14,37,23,SLQIGGLVIAGILFILGILIVLS,0
2jo1,A,38,59,21,RCRCKFNQQQRTGEPDEEEGT,0
2jo1,A,60,69,9,RSSIRRLST,0
2jo1,A,70,72,2,RR,0
4in6,H,-5,10,15,HHHHHMVGVTAFGNF,0
4in6,H,12,31,19,ASLAIYSFWIFLAGLIYYL,0
4in6,H,32,250,218,TENMREGYPLENEDGTPAANQGPFPLPKPKTFILPHGRGTLTVPGPESEDRPIALARTAVSEGFPHAPTGDPMKDGVGPASWVARRDLPELDGHGHNKIKPMKAAAGFHVSAGKNPIGLPVRGCDLEIAGKVVDIWVDIPEQMARFLEVELKDGSTRLLPMQMVKVQSNRVHVNALSSDLFAGIPTIKSPTEVTLLEEDKICGYVAGGLMYAAPKRKS,0
4in6,H,251,260,9,VAAMLAEYA,0
3nkc,E,-1,4,5,HMFRK,0
3nkc,E,5,22,17,AAECFGTFWLVFGGCGS,0
3nkc,E,38,55,17,VALAWGLTVLTMAFAVG,0
3nkc,E,56,58,2,IS,0
3nkc,E,59,73,14,GHFNPAVTIGLWAG,0
3nkc,E,74,81,7,RFPAKEV,0
3nkc,E,82,99,17,GYVIAQVVGGIVAAALL,0
3nkc,E,135,152,17,VVELVLSAGFLLVIHGA,0
3nkc,E,153,161,8,DKFAPAGF,0
3nkc,E,162,178,16,PIAIGLALTLIGLISI,0
3nkc,E,184,195,11,VNPARSTAVAI,0
3nkc,E,206,223,17,FFWVVPIVGGIIGGLIY,0
3nkc,E,224,229,5,TLLEK,0
3nkc,E,230,231,1,D,0
4ryi,B,3,9,6,KKSSII,0
4ryi,B,10,27,17,FFLTYGLFYVSSVLFPI,0
4ryi,B,29,34,5,TWYDA,0
4ryi,B,43,63,20,GMTIGMIWAVLFGLIALSVA,0
4ryi,B,64,74,10,IYNNYGFKPK,0
4ryi,B,75,96,21,FWFLFLLNYIFNQAFSYFQFS,0
4ryi,B,103,122,19,TVDCLLVAITTLLLIMFSS,0
4ryi,B,123,126,3,LSK,0
4ryi,B,127,146,19,SAWLLIPYFLWSAFATYLS,0
5t04,A,43,62,19,SESDTAGPNSDLDVNTDIY,0
5t04,A,63,90,27,KVLVTAIYLALFVVGTVGNSVTLFTLA,0
5t04,A,105,130,25,LGSLALSDLLILLLAMPVELYNFIW,0
5t04,A,131,139,8,HHPWAFGD,0
5t04,A,140,164,24,GCRGYYFLRDACTYATALNVASLS,0
5t04,A,189,209,20,ISAIWLASALLAIPMLFTMG,0
5t04,A,210,231,21,QNRSADGTHPGGLVCTPIVDT,0
5t04,A,232,256,24,TVKVVIQVNTFMSFLFPMLVISIL,0
5t04,A,309,334,25,LRAVVIAFVVCWLPYHVRRLMFCYI,0
5t04,A,335,346,11,DEQWTTFLFDF,0
5t04,A,347,370,23,HYFYMLTNALAYASSAINPILYN,0
5d6i,C,17,27,10,WKGLRAAWIN,0
5d6i,C,28,33,5,AAFRQ,0
5d6i,C,34,47,13,GVAVLLAVVIACW,0
5d6i,C,53,67,14,TRVLLISSVMLVMI,0
5d6i,C,68,102,34,ELLNSAIEAVVDRIGSEYHELSGRAKDLGSAAVL,0
5d6i,C,103,116,13,AIIDAVITWCILL,0
3nk5,A,-2,-1,1,S,0
3nk5,A,0,4,4,MFRK,0
3nk5,A,5,22,17,AAECFGTFWLVFGGCGS,0
3nk5,A,38,55,17,VALAWGLTVLTMAFAVG,0
3nk5,A,56,58,2,IS,0
3nk5,A,59,73,14,GHFNPAVTIGLWAG,0
3nk5,A,74,80,6,RFPAKE,0
3nk5,A,81,99,18,VGYVIAQVVGGIVAAALL,0
3nk5,A,135,152,17,VVELVLSAGFLLVIHGA,0
3nk5,A,153,161,8,DKFAPAGF,0
3nk5,A,162,178,16,PIAIGLALTLIHLISI,0
3nk5,A,183,195,12,SVNPARSTAVAI,0
3nk5,A,206,223,17,FFWVVPIVGGIIGGLIY,0
3nk5,A,224,228,4,TLLE,0
3nk5,A,229,231,2,RD,0
5aji,G,25,34,9,SYAVNIVAA,0
5aji,G,35,59,24,AIIIVGLIIARMISNAVNRLMISR,0
5aji,G,67,87,20,FLSALVRYGIIAFTLIAALG,0
5aji,G,88,91,3,VGV,0
5aji,G,92,108,16,TASVIAVLGAAGLAVG,0
5duo,B,4,26,22,WALFLTFLAACGAPATTGALLK,0
5duo,B,27,37,10,DEWYDNLNKP,0
5duo,B,38,65,27,WNPPRWVFPLAWTSLYFLMSLAAMRVA,0
5duo,B,72,92,20,ALAFYAAQLAFNTLWTPVFF,0
5duo,B,93,97,4,MKRM,0
5duo,B,98,119,21,TALAVVMVMWLFVAATMWAFF,0
5duo,B,125,145,20,GVLFVPYLIWATATTGLNFE,0
5duo,B,146,157,11,MRLNWNRPEAR,0
1jdm,A,1,4,3,GIN,0
1jdm,A,5,26,21,RELFLNFTIVLITVILMWLLV,0
4ro2,F,22,24,2,EF,0
4ro2,F,25,45,20,VLFVLTILTLISGTIFYSTV,0
4ro2,F,51,67,16,DALYFSVVTLTTVGET,0
4ro2,F,74,99,25,GKIFTILYIFIGIGLVFGFIHKLAV,0
4ro2,F,100,101,1,V,0
4ro2,F,102,108,6,LPSILS,0
4ro2,F,109,112,3,LVP,0
5f5g,A,93,109,16,GPVTWVMMIACVVVFI,0
5f5g,A,110,115,5,MQILG,0
5f5g,A,116,123,7,QEVMLWL,0
5f5g,A,124,136,12,WPFDPTLKFEFW,0
5f5g,A,137,143,6,YFTHAL,0
5f5g,A,144,147,3,HFS,0
5f5g,A,148,166,18,MHILFNLLWWWYLGGAVE,0
5f5g,A,171,189,18,GKLIVITLISALLSGYVQ,0
5f5g,A,190,198,8,KFSGPWFG,0
5f5g,A,199,214,15,LSGVVFALMGYVWLR,0
5f5g,A,226,245,19,RGLIIFALIWIVAGWFDLF,0
5f5g,A,246,249,3,MSM,0
5f5g,A,250,268,18,NGAHIAGLAVGLAMAFVD,0
2a0d,A,1,59,58,ESPIQIFRGEPGPTCAPSACLPPNSSAWFPGWAEPDSNGSAGSEDAQLEPAHISPAIP,0
2a0d,A,60,87,27,IITAVYSVVFVVGLVGNSLVMFVIIRY,0
2a0d,A,91,118,27,TATNIYIFNLALADALVTTTMPFQSTV,0
2a0d,A,119,132,13,LMNSWPFGDVLCK,0
2a0d,A,133,158,25,VISIDYYNMFTSIFTLTMMSVDRYI,0
2a0d,A,173,195,22,KAKIINICIWLLSSSVGISAIV,0
2a0d,A,196,225,29,GGTKVREDVDVIECSLQFPDDDYSWWDLF,0
2a0d,A,226,250,24,KICVFIFAFVIPVLIIIVCYTLMI,0
2a0d,A,273,294,21,RLVLVVVAVFVVCWTPIHIFI,0
2a0d,A,295,307,12,VEALGSTSHSTA,0
2a0d,A,308,334,26,LSSYYFCIALGYTNSSLNPILYAFLD,0
2q69,D,2,18,16,SFLLTLKRMLRACLRA,0
2q69,D,19,24,5,KDKEF,0
2q69,D,25,45,20,VLFVLTILTLISGTIFYSTV,0
2q69,D,51,67,16,DALYFSVVTLTTVGNG,0
2q69,D,75,95,20,GKIFTILYIFIGIGLVFGFI,0
2q69,D,96,103,7,KLAVNVQ,0
2q69,D,104,114,10,PSILSNLVPR,0
4u1y,D,11,34,23,IGGLFPRGADQEYSAFRVGMVQF,0
4u1y,D,42,381,339,PHIDNLEVANSFAVTNAFCSQFSRGVYAIFGFYDKKSVNTITSFCGTLHVSFITPSFPTDGTHPFVIQMRPDLKGALLSLIEYYQWDKFAYLYDSDRGLSTLQAVLDSAAEKKWQVTAINVGNINNDKKDETYRSLFQDLELKKERRVILDCERDKVNDIVDQVITIGKHVKGYHYIIANLGFTDGDLLKIQFGGAEVSGFQIVDYDDSLVSKFIERWSTLEEKEYPGAHTATIKYTSALTYDAVQVMTEAFRNLRKQRIEISRRGNAGDCLANPAVPWGQGVEIERALKQVQVEGLSGNIKFDQNGKRINYTINIMELKTNGPRKIGYWSEVDKMVVT,0
4u1y,D,392,510,118,KTVVVTTILESPYVMMKKNHEMLEGNERYEGYCVDLAAEIAKHCGFKYKLTIVGDGKYGARDADTKIWNGMVGELVYGKADIAIAPLTITLVREEVIDFSKPFMSLGISIMIKKPQKS,0
4u1y,D,513,523,10,VFSFLDPLAY,0
4u1y,D,524,542,18,IWMAIVFAYILVSVVLFL,0
4u1y,D,597,617,20,ARIVAGVWWFFTLIIISSYT,0
4u1y,D,618,775,157,NLAAFLTVERMVSPIESAEDLSKQTEIAYGTLDSGSTKEFFRRSKIAVFDKMWTYMRSAEPSVFVRTTAEGVARVRKSKGKYAYLLESTMNEYIEQRKPCDTMKVGGNLDSKGYGIATPKGSSLGTPVNLAVLKLSEQGVLDKLKNKWWYDKGECGA,0
4u1y,D,785,792,7,ALSLSNV,0
4u1y,D,793,812,19,GVFYILVGGLGLAMLVALI,0
4u3f,W,5,12,7,LRQAYSA,0
4u3f,W,20,36,16,ALTVVLGAVLFERAFD,0
4u3f,W,37,62,25,GADAIFEHLNEGKLWKHIKHKYEAS,0
4u3f,W,63,64,1,E,0
2dyr,Z,13,34,21,EQAIGLSVTFLSFLLPAGWVL,0
2dyr,Z,35,43,8,HLDNYKKS,0
2dyr,Z,44,46,2,AA,0
2jwa,B,141,154,13,CPAEQRASPLTSI,0
2jwa,B,155,179,24,SAVVGILLVVVLGVVFGILIKRRQ,0
1ots,B,1,17,16,KTDTPSLETPQAARLR,0
1ots,B,37,60,23,MAAVVGTLVGLAAVAFDKGVAWL,0
1ots,B,61,83,22,NQRMGALVHTADNYPLLLTVAF,0
1ots,B,84,97,13,CSAVLAMFGYFLV,0
1ots,B,129,142,13,VKFFGGLGTLGGG,0
1ots,B,144,156,12,LGREGPTVQIGG,0
1ots,B,181,203,22,AAAGLAAAFNAPLAGILFIIEE,0
1ots,B,216,231,15,AVFIGVIMSTIMYRI,0
1ots,B,232,252,20,NHEVALIDVGKLSDAPLNTL,0
1ots,B,253,273,20,LYLILGIIFGIFGPIFNKWV,0
1ots,B,274,284,10,GMQDLLHRVH,0
1ots,B,290,304,14,WVLMGGAIGGLCGL,0
1ots,B,305,316,11,GFVAPATSGGG,0
1ots,B,317,324,7,NLIPIAT,0
1ots,B,325,337,12,GNFSMGMLVFIF,0
1ots,B,338,351,13,ARVITTLLCFSSG,0
1ots,B,353,365,12,GGIFAPMLALGT,0
1ots,B,366,392,26,LGTAFGMVAVELFPQYHLEAGTFAIA,0
1ots,B,393,415,22,MGALLAASIRAPLTGIILVLEM,0
1ots,B,416,422,6,DNYQLI,0
1ots,B,423,439,16,PMIITGLGATLLAQFT,0
1ots,B,459,465,6,QLARSK,0
2qb4,B,1,4,3,EVK,0
2qb4,B,13,32,19,LILAMAGNAVGLGNFLRFP,0
2qb4,B,33,43,10,QAAENGGGAF,0
2qb4,B,44,63,19,IPYIIAFLLVGIPLMWIEW,0
2qb4,B,90,124,34,KILGVFGLWIPLVVAIYYVYIESWTLGFAIKFLV,0
2qb4,B,125,132,7,LVPEPPP,0
2qb4,B,133,134,1,A,0
2qb4,B,135,166,31,DPDSILRPFKEFLYSYIGVPKGDEPILKPSL,0
2qb4,B,167,185,18,AYIVFLITMFINVSILIR,0
2qb4,B,191,212,21,ERFAKIAMPTLFILAVFLVIR,0
2qb4,B,213,222,9,FLLETPNGT,0
2qb4,B,223,231,8,ADGLNFLW,0
2qb4,B,232,241,9,PDFEKLKDP,0
2qb4,B,242,265,23,VWIAAVGQIFFTLSLGFGAIITY,0
2qb4,B,277,297,20,SGLTAATLNEKAEVILGGSI,0
2qb4,B,298,318,20,IPAAVAFFGVANAVAIAKAG,0
2qb4,B,319,324,5,FNLGF,0
2qb4,B,326,331,5,LPAIF,0
2qb4,B,332,339,7,QTAGGTF,0
2qb4,B,340,367,27,GFLWFFLLFFAGLTSSIAIMQPMIAFL,0
2qb4,B,378,396,18,VLWTAAIVFFSAHLVMFL,0
2qb4,B,397,399,2,KS,0
2qb4,B,400,426,26,DEMDFWAGTIGVVFFGLTELIIFFWI,0
2qb4,B,429,437,8,DKAWEEIN,0
2qb4,B,445,469,24,RIYYYVMRYITPAFLAVLLVVWAR,0
2qb4,B,470,471,1,Y,0
2qb4,B,472,477,5,PKIME,0
2qb4,B,478,483,5,THWTV,0
2qb4,B,484,502,18,ITRFYIIGLFLFLTFLVF,0
2qb4,B,602,603,1,R,0
5mrw,D,6,21,15,TGVLLVFLLLGYLVY,0
5mrw,D,22,27,5,LINAE,0
4rcr,H,1,11,10,VGVTAFGNFD,0
4rcr,H,13,30,17,SLAIYSFWIFLAGLIYY,0
4rcr,H,249,260,11,SVVAAMLAEYA,0
4bey,A,1,39,38,GTEGPNFYVPFSNKTGVVRSPFEAPQYYLAEPWQFSML,0
4bey,A,40,65,25,AYMFLLIMLGFPINFLTLYVTVQHK,0
4bey,A,69,96,27,PLNYILLNLAVADLFMVFGDFTTTLYT,0
4bey,A,97,112,15,LHGYFVFGPTGCNLE,0
4bey,A,113,137,24,FFATLGGEIALWSLVVLAIERYVV,0
4bey,A,151,173,22,AIMGVAFTWVMALACAAPPLVG,0
4bey,A,174,202,28,SRYIPEGMQCSCGIDYYTPHEETNNESF,0
4bey,A,203,227,24,IYMFVVHFIIPLIVIFFCYGQLVF,0
4bey,A,250,274,24,RMVIIMVIAFLICWLPYAGVAFYI,0
4bey,A,275,289,14,THQGSCFGPIFMTI,0
4bey,A,290,311,21,AFFAKTSAVYNPVIYIMMNKQ,0
4bey,A,314,324,10,CMVTTLCCGK,0
4bey,A,327,348,21,GDDEASTTVSKTETSQVAPA,0
4pxz,A,-8,14,22,YKDDDDGAPQAVDNLTSAPGNT,0
4pxz,A,24,48,24,QVLFPLLYTVLFFVGLITNGLAMR,0
4pxz,A,49,62,13,FFQIRSKSNFIIF,0
4pxz,A,63,85,22,KNTVISDLLMILTFPFKILSDA,0
4pxz,A,93,119,26,TFVCQVTSVIFYFTMYISISFLGLIT,0
4pxz,A,120,129,9,DRYQKTTRP,0
4pxz,A,130,134,4,KTSN,0
4pxz,A,135,142,7,KNLLGAK,0
4pxz,A,143,164,21,LSVVIWAFMFLLSLPNMILTN,0
4pxz,A,183,210,27,LVWHEIVNYICQVIFWINFLIVIVCYT,0
4pxz,A,211,237,26,ITKELYRSYVRTADLEDNWETLNDNLKVIEKADNAAQVKDALTKMRAAALDAQKATPPKLEDKSPDSPEMKDFRHGFDILVGQIDDALKLANEGKVKEAQAAAEQLKTTRNAYIQKYLRGVGKVPRKKVNVK,0
4pxz,A,238,264,26,FIIIAVFFICFVPFHFARIPYTLSQT,0
4pxz,A,276,299,23,FYVKESTLWLTSLNACLNPFIYF,0
4pxz,A,300,305,5,LCKSF,0
4pxz,A,306,351,45,NSLISMLKCPNSATSLSQDNRKKEQDGGDPNEETPMGRPLEVLFQ,0
5syt,A,21,39,18,AVLLFSWTVYLWETFLAQ,0
5syt,A,40,77,37,QRRIYKTTTHVPPELGQIMDSETFEKSRLYQLDKSTF,0
5syt,A,78,96,18,FWSGLYSETEGTLILLFG,0
5syt,A,97,111,14,IPYLWRLSGRFCGY,0
5syt,A,121,143,22,QSLVFLLLATLFSALTGLPWSL,0
5syt,A,144,167,23,NTFVIEEKHGFNQQTLGFFMKDA,0
5syt,A,168,189,21,KKFVVTQCILLPVSSLLLYII,0
5syt,A,196,215,19,FIYAWLFTLVVSLVLVTIY,0
5syt,A,216,265,49,DYIAPLFDKFTPLPEGKLKEEIEVMAKSIDFPLTKVYVVEGSKRSSHSN,0
5syt,A,275,292,17,RIVLFDTLLEEYSVLNK,0
5syt,A,311,346,35,EIKAKVKNKKQGCKNEEVLAVLGHELGHWKLGHTV,0
5syt,A,347,364,17,NIIISQMNSFLCFFLFA,0
5syt,A,385,410,25,IGLLIIFQFIFSPYNEVLSFCLTVL,0
5syt,A,411,449,38,RRFEFQADAFAKKLGKAKDLYSALIKLNKDNLGFPVSD,0
5syt,A,450,456,6,LFSMWH,0
5syt,A,457,480,23,SHPPLLERLQALKTMKQSGLEVL,0
5hlb,A,58,66,8,PRGKRGWL,0
5hlb,A,67,69,2,LL,0
5hlb,A,70,86,16,KLAIVFAVLIAIYGVY,0
5hlb,A,800,804,4,QQPS,0
5f8u,A,43,67,24,MSLLMALVVLLIVAGNVLVIAAIG,0
5f8u,A,68,76,8,TQRLQTLT,0
5f8u,A,77,100,23,LFITSLACADLVVGLLVVPFGAT,0
5f8u,A,117,140,23,TSLDVLCVTASIETLCVIAIDRY,0
5f8u,A,141,145,4,AITS,0
5f8u,A,146,152,6,FRYQSL,0
5f8u,A,153,156,3,TRA,0
5f8u,A,157,178,21,AKVIICTVWAISALVSFLPIM,0
5f8u,A,208,232,24,IASSIISFYIPLLIMIFVALRVYR,0
5f8u,A,233,238,5,AKEQI,0
5f8u,A,284,289,5,EHKAL,0
5f8u,A,290,312,22,TLGIIMGVFTLCWLPFFLVNIV,0
5f8u,A,325,345,20,VAFNWLGYANSAMNPIIYCR,0
5f8u,A,347,356,9,DFRKAFKRL,0
5f8u,A,357,359,2,AF,0
5vhy,F,-819,0,819,SIQIGGLFPRGADQEYSAFRVGMVQFSTSEFRLTPHIDNLEVANSFAVTNAFCSQFSRGVYAIFGFYDKKSVNTITSFCGTLHVSFITPSFPTDGTHPFVIQMRPDLKGALLSLIEYYQWDKFAYLYDSDRGLSTLQAVLDSAAEKKWQVTAINVGNINNDKKDETYRSLFQDLELKKERRVILDCERDKVNDIVDQVITIGKHVKGYHYIIANLGFTDGDLLKIQFGGAEVSGFQIVDYDDSLVSKFIERWSTLEEKEYPGAHTATIKYTSALTYDAVQVMTEAFRNLRKQRIEISRRGNAGDCLANPAVPWGQGVEIERALKQVQVEGLSGNIKFDQNGKRINYTINIMELKTNGPRKIGYWSEVDKMVLTEDDTSGLEQKTVVVTTILESPYVMMKKNHEMLEGNERYEGYCVDLAAEIAKHCGFKYKLTIVGDGKYGARDADTKIWNGMVGELVYGKADIAIAPLTITLVREEVIDFSKPFMSLGISIMIKKPQKSKPGVFSFLDPLAYEIWMCIVFAYIGVSVVLFLVSRFSPYEWHTEEFEDGRETQSSESTNEFGIFNSLWFSLGAFMQQGCDISPRSLSGRIVGGVWWFFTLIIISSYTANLAAFLTVERMVSPIESAEDLSKQTEIAYGTLDSGSTKEFFRRSKIAVFDKMWTYMRSAEPSVFVRTTAEGVARVRKSKGKYAYLLESTMNEYIEQRKPCDTMKVGGNLDSKGYGIATPKGSSLGTPVNLAVLKLSEQGVLDKLKNKWWYDKGECGAKDSGSKEKTSALSLSNVAGVFYILVGGLGLAMLVALIEFCYKSRAEAKRMKGTG,0
5vhy,F,1,10,9,TSRRGRALL,0
5vhy,F,11,31,20,VALNLLALLFATTAFLTTYW,0
5vhy,F,40,84,44,PGCGQGGGANCPNSGANATANSTAAPVAASPAGAPYSWEAGDER,0
5vhy,F,101,105,4,LGGP,0
5vhy,F,123,143,20,LWLSVVSEVLYILLLVVGFS,0
5vhy,F,144,153,9,MCLELLHSS,0
5vhy,F,154,156,2,VI,0
5vhy,F,157,165,8,GLKLNAFA,0
5vhy,F,166,185,19,VFTVLSGLLGMVAHMMYTQ,0
5vhy,F,206,224,18,WSFCLAWGSFTCCMAASV,0
5vhy,F,225,232,7,TLNSYTK,0
5vhy,F,233,237,4,VIEF,0
1jfp,A,1,39,38,NGTEGPNFYVPFSNKTGVVRSPFEAPQYYLAEPWQFSM,0
1jfp,A,40,43,3,AAY,0
1jfp,A,44,67,23,FLLIMLGFPINFLTLYVTVQHKK,0
1jfp,A,70,96,26,PLNYILLNLAVADLFMVFGGFTTTLY,0
1jfp,A,97,111,14,SLHGYFVFGPTGCN,0
1jfp,A,112,136,24,EGFFATLGGEIALWSLVVLAIERY,0
1jfp,A,153,174,21,IMGVAFTWVMALACAAPPLVG,0
1jfp,A,175,202,27,SRYIPEGMQCSCGIDYYTPHEETNNES,0
1jfp,A,203,224,21,VIYMFVVHFIIPLIVIFFCYG,0
1jfp,A,250,273,23,TRMVIIMVIAFLICWLPYAGVAF,0
1jfp,A,274,290,16,IFTHQGSDFGPIFMTI,0
1jfp,A,291,309,18,AFFAKTSAVYNPVIYIMM,0
5hcm,E,5,198,193,SPPPPIADEPLTVNTGIYLIESYSLDDCAETFKVNAFLSLSWKDRRLAFDPVRSGVRVKTYEPEAIWIPEIRFVNVENARDADVVDISVSPDGTVQYLERFSARVLSPLDFRRYPFDSQTLHIYLIVRSVDTRNIVLAVDLEKVGKNDDVFLTGWDIESFTAVVKPANFALEDRLESKLDYQLRISRQYFSYI,0
5hcm,E,199,218,19,NIILPMLFILFISWTAFWS,0
5hcm,E,222,242,20,ANVTLVVSTLIAHIAFNILV,0
5hcm,E,243,254,11,TCLPKTPYMTY,0
5hcm,E,255,276,21,GAIIFMIYLFYFVAVIEVTVQ,0
5hcm,E,292,313,21,RASRIAFPVVFLLANIILAFL,0
5hcm,E,314,315,1,F,0
5x0m,A,-42,46,88,ASWSHPQFEKGGGARGGSGGGSWSHPQFEKGFDYKDDDDKGTMADNSPLIREERQRLFRPYTRAMLTAPSAQPAKENGKTEENKDNSR,0
5x0m,A,47,141,94,KGRGANKDRDGSAHPDQALEQGSRLPARMRNIFPAELASTPLEDFDPFYKNKKTFVVVTKAGDIFRFSGEKSLWMLDPFTPIRRVAISTMVQPI,0
5x0m,A,142,159,17,SYFIMITILIHCIFMIM,0
5x0m,A,168,185,17,ELVFLSIYTIEVVVKVL,0
5x0m,A,186,196,10,RGFILHPFAY,0
5x0m,A,197,217,20,RDPWNWLDFLVTLIGYITLV,0
5x0m,A,226,242,16,RAFRVLRSWRTVTIVP,0
5x0m,A,243,254,11,WRTIVDALSLS,0
5x0m,A,255,279,24,TSLKDLVLLLLFSLFVFAVLGLQI,0
5x0m,A,362,378,16,WAFLSVFRLVTLDYWE,0
5x0m,A,391,415,24,HILFFIIVVFYGTFCFLNFILAVV,0
5x0m,A,416,435,19,MSYTHMVKRADEEKAAERE,0
5x0m,A,436,501,65,KKEKKAASVANNTANGQEQTTIEMNGDEAVVIDNNDQAARQQSDPETPAPSVTQRLTDFLCVWDC,0
5x0m,A,502,521,19,VPWQKLQGAIGAVVLSPFF,0
5x0m,A,522,539,17,LFIAVIIVLNITFMALD,0
5x0m,A,551,570,19,RTGNYIFTSIYIVEAVLKI,0
5x0m,A,571,583,12,ALSPKFYFKDSW,0
5x0m,A,584,602,18,VFDFIIVVFAILELGLEG,0
5x0m,A,608,624,16,FRSFRLLRVFRLAKFW,0
5x0m,A,625,638,13,TLNNFMSVMTKSY,0
5x0m,A,639,660,21,AFVNVMYVMFLLLFIFAIIGM,0
5x0m,A,691,703,12,MIVFRALCGEWI,0
5x0m,A,717,740,23,IPFFVAVFFVGNLVILNLLIALL,0
5x0m,A,741,746,5,NNYGS,0
5x0m,A,747,832,85,CTSPTSDEEDSKDEDALAQIVRIFKRFKPNLNAVKLSPMKPDSEDIVESQEIQGNNIADAEDVLAGEFPPDCCCNAFYKCFPSRP,0
5x0m,A,833,860,27,RDSSVQRMWSNIRRVCFLLAKNKYFQK,0
5x0m,A,861,876,15,VTAVLVITSVLLALE,0
5x0m,A,889,906,17,TLYVDYVLTAFFVIEMI,0
5x0m,A,907,921,14,MLFAVGFKKYFTSK,0
5x0m,A,922,945,23,YWLDFIVVVAYLLNFVLMCAGIE,0
5x0m,A,947,963,16,QTLRLLRVFRLFRPLS,0
5x0m,A,964,978,14,VNGMQVVTSTLVEA,0
5x0m,A,979,1002,23,PHIFNVILVGIFFWLVFAIMGVQ,0
5x0m,A,1047,1063,16,GNAYLSLLQVATFKGW,0
5x0m,A,1088,1111,23,YLYFIFFIVFGSFFILKLFVCIL,0
5x0m,A,1112,1172,60,DIFRQQRRKAEGLSATDSRTQLIYRRAVMRTMSAKPVKRIPKPTCHPQSLMYDISVNRKF,0
5x0m,A,1173,1190,17,YTMMILIILNVAVMAID,0
5x0m,A,1202,1222,20,DYLNLIFIIIFFVECVIKVS,0
5x0m,A,1223,1232,9,LRHHYFKDP,0
5x0m,A,1233,1251,18,NIIDFLYVVLAIAGLMLS,0
5x0m,A,1258,1276,18,ISPTLLRILRILRVGRLL,0
5x0m,A,1277,1296,19,YFQSARGMRLLLLALRKAL,0
5x0m,A,1297,1320,23,TLFNVSFLLFVIMFVYAVFGMEF,0
5x0m,A,1340,1356,16,QSIILLFQLATSAGWD,0
5x0m,A,1386,1410,24,GIAYLVSYLIITCLVVINMYAAVI,0
5x0m,A,1411,1521,110,DYVLEVYEDSKEGLTDDDYDMFFEVWQQFDPEATQYIRYDQLSELLEALQPPLQVQKPNKYKILSMNIPICKDDHIFYKDVLEALVKDVFSRRGSPVEAGDVQAPNVDEA,0
5x0m,A,1522,1553,31,YKPVSSTLQRQREEYCVRLIQNAWRKHKQQN,0
5svl,D,24,47,23,IINRVVQLLIISYFVGWVFLHEK,0
5svl,D,48,315,267,YQVRDTAIESSVVTKVKGSGLYANRVMDVSDYVTPPQGTSVFVIITKMIVTENQMQGFCPESEEKYRCVSDSQCGPERLPGGGILTGRCVNYSSVLRTCEIQGWCPTEVDTVETPIMMEAENFTIFIKNSIRFPLFNFEKGNLLPNLTARDMKTCRFHPDKDPFCPILRVGDVVKFAGQDFAKLARTGGVLGIKIGWVCDLDKAWDQCIPKYSFTRLDSVSEKSSVSPGYNFRFAKYYKMENGSEYRTLLKAFGIRFDVLVYGNAGK,0
5svl,D,316,343,27,NIIPTIISSVAAFTSVGVGTVLCDIIL,0
5d6k,A,6,16,10,TFFGQPLGLS,0
5d6k,A,17,37,20,LFMTEMWERFSYYGMRAILL,0
5d6k,A,56,74,18,ASIMAIYASMVYLSGTIG,0
5d6k,A,75,86,11,FVADRIIGARP,0
5d6k,A,87,104,17,VFWGGVLIMLGHIVLAL,0
5d6k,A,110,130,20,LFGSIILIIIGTGFLKPNVS,0
5d6k,A,131,149,18,LVGTLYDEHDRRRDAGFS,0
5d6k,A,150,169,19,FVFGINLGAFIAPLIVGAA,0
5d6k,A,178,196,18,FSLAAIGMFIGLLVYYFG,0
5d6k,A,197,224,27,KKTLDPHYLRPTDPLAPEEVKPLLVKV,0
5d6k,A,225,244,19,LAVAGFIAIIVVMNLVGWN,0
5d6k,A,246,266,20,PAYINLLTIVAIAIPVFYFA,0
5d6k,A,267,270,3,MIS,0
5d6k,A,279,286,7,LRVVSYI,0
5d6k,A,287,307,20,LFIAAVLFWAIEEQGSVVLA,0
5d6k,A,323,342,19,FQSLNPLFIMLYTPFFAWL,0
5d6k,A,343,345,2,TA,0
5d6k,A,349,354,5,QPSSP,0
5d6k,A,355,371,16,KFAVGLMFAGLSFLLM,0
5d6k,A,388,405,17,LVGSWALVILGEMLISP,0
5d6k,A,420,424,4,SQMM,0
5d6k,A,425,444,19,MWFLSSSVGSALNAQLVTL,0
5d6k,A,454,472,18,SYFGLGSVVLGIVLVFLS,0
5d6k,A,473,478,5,RIQGL,0
1jsq,B,1,9,8,HNDKDLST,0
1jsq,B,10,24,14,QTFRRLWPTIAPFK,0
1jsq,B,25,46,21,GLIVAGVALILNAASDTFMLS,0
1jsq,B,66,80,14,MPLVVIGLMILRGI,0
1jsq,B,81,150,69,SYVSSYCISWVSGKVVMTMRRRLFGHMMGMPVSFFDKQSTGTLLSRITYDSEQVASSSSGALITVVREG,0
1jsq,B,151,162,11,SIIGLFIMMFY,0
1jsq,B,173,186,13,LAPIVSIAIRVVS,0
1jsq,B,187,207,20,RFRNISKNMQNTMGQVTTSA,0
1jsq,B,208,237,29,QMLKGHKEVLIFGGQEVETKRFDKVSNRM,0
1jsq,B,238,259,21,LQGMKMVSASSISDPIIQLIA,0
1jsq,B,260,273,13,LALAFVLYAASFP,0
1jsq,B,281,295,14,GTITVVFSSMIALM,0
1jsq,B,296,343,47,PLKSLTNVNAQFQRGMAACQTLFTILDSEQEKDEGKRVIERATGDVE,0
1jsq,B,344,418,74,RNVTFTYPGRDVPALRNINLKIPAGKTVALVGRSGSGKSTIASLITRFYDIDEGEILMDGHDLREYTLASLRNQ,0
1jsq,B,419,564,145,ALVSQNVHLFNDTVANNIAYARTEQYSREQIEEAARMAYAMDFINKMDNGLDTVIGENGVLLSGGQRQRIAIARALLRDSPILILDEATSALDTESERAIQAALDELQKNRTSLVIAHRLSTIEKADEIVVVEDGVIVERGTHND,0
1jsq,B,565,582,17,LEHRGVYAQLHKMQFGQ,0
2ziy,A,2,3,1,R,0
2ziy,A,36,57,21,LGIFIGICGIIGCGGNGIVIY,0
2ziy,A,58,71,13,FTKTKSLQTPANM,0
2ziy,A,72,94,22,IINLAFSDFTFSLVNGFPLMTI,0
2ziy,A,110,131,21,YGFIGGIFGFMSIMTMAMISI,0
2ziy,A,132,152,20,RYNVIGRPMAASKKMSHRRA,0
2ziy,A,153,171,18,IMIIFVWLWSVLWAIGPI,0
2ziy,A,200,221,21,ILCMFILGFFGPILIIFFCYF,0
2ziy,A,222,263,41,IVMSVSNHEKEMAAMAKRLNAKELRKAQAGANAEMRLAKIS,0
2ziy,A,264,283,19,VIVSQFLLSWSPYAVVALL,0
2ziy,A,298,316,18,LPVMFAKASAIHNPMIYS,0
2ziy,A,317,319,2,SH,0
2ziy,A,320,329,9,KFREAISQT,0
2ziy,A,330,373,43,PWVLTCCQFDDKETEDDKDAETEIPAGESSDAAPSADAAQMKE,0
3wfd,C,1,4,3,SET,0
3wfd,C,11,27,16,NIYFGGSVFFILLFLA,0
3wfd,C,28,146,118,TYHTEKTLPERTNEAAMSAAVVRGKLVWEQNNCVGCHTLLGEGAYFAPELGNVVGRRGGEEGFNTFLQAWMKIQPLNVPGRRAMPQFHLSEGQVDDLAEFLKWSSKIDTNQWPPNKEG,0
2mic,B,113,133,20,CSILAAVVVGLVAYIAFKRW,0
2mic,B,134,137,3,SSK,0
2mic,B,138,141,3,NKQ,0
1zti,A,36,60,24,SAFIVILCCAIVVENLLVLIAVAR,0
1zti,A,61,67,6,SKFHSA,0
1zti,A,68,91,23,YLFLGNLAASDLLAGVAFVANTL,0
1zti,A,107,131,24,REGSAFITLSASVFSLLAIAIERH,0
1zti,A,132,146,14,AIAKVKLYGSDKSC,0
1zti,A,147,168,21,MLLLIGASWLISLVLGGLPIL,0
1zti,A,189,213,24,YVLCVVTIFSIILLAIVALYVRIY,0
1zti,A,214,231,17,VVRSSHADMAAPQTLAL,0
1zti,A,232,255,23,KTVTIVLGVFIVCWLPAFSILLL,0
1zti,A,270,292,22,HYFFAVSTLNSLLNPVIYTWRS,0
1zti,A,293,304,11,DLRREVLRPLQ,0
1zti,A,305,327,22,WRPGVGVQGRRRGGTPGHHLLP,0
1zti,A,328,340,12,RSSSSLERGMHM,0
1zti,A,341,353,12,TSPTFLEGNTVV,0
4g7r,C,1,3,2,EE,0
4g7r,C,4,6,2,PK,0
4g7r,C,7,24,17,ALAVILVLTLTILVFWL,0
4pa9,F,126,130,4,SHMG,0
4pa9,F,135,152,17,ALLTVVFYIAAVMATNL,0
4pa9,F,153,163,10,GATFPEWFGD,0
4pa9,F,164,181,17,SKSLYTLFQVMTLESWS,0
4pa9,F,182,191,9,GIVRPVMNV,0
4pa9,F,192,194,2,PN,0
4pa9,F,195,214,19,WVFFIPFIMLTTFTVLNLF,0
4pa9,F,221,274,53,MAITKEQEEEAKTGHHQEPISQTLLHLGDRLDRIEKQLAQNNELLQRQQPQKK,0
4gby,A,1,4,3,NTQ,0
4gby,A,12,32,20,ITLVATLGGLLFGYDTAVIS,0
4gby,A,33,34,1,T,0
4gby,A,35,41,6,ESLNTV,0
4gby,A,42,58,16,VAPQNLSESAANSLLG,0
4gby,A,59,79,20,CVASALIGCIIGGALGGYCS,0
4gby,A,85,106,21,DSLKIAAVLFFISGVGSAWPE,0
4gby,A,107,127,20,GFTSINPDNTVPVYLAGYVP,0
4gby,A,128,151,23,FVIYRIIGGIGVGLASMLSPMYI,0
4gby,A,162,182,20,LVSFNQFAIIFGQLLVYCVN,0
4gby,A,183,201,18,FIARSGDASWLNTDGWRY,0
4gby,A,202,220,18,FASECIPALLFLMLLYTV,0
4gby,A,280,301,21,GVMLSIFQQFVGINVVLYYAP,0
4gby,A,302,317,15,VFKTLGASTDIALLQ,0
4gby,A,318,336,18,IIVGVINLTFTVLAIMTV,0
4gby,A,342,362,20,PLQIIGALGMAIGMFSLGTA,0
4gby,A,363,371,8,YTQAPGIV,0
4gby,A,372,396,24,LLSMLFYVAAFAMSWGPVCWVLLS,0
4gby,A,409,430,21,IAVAAQWLANYFVSWTFPMMD,0
4gby,A,431,439,8,NSWLVAHF,0
4gby,A,440,442,2,NG,0
4gby,A,443,460,17,SYWIYGCMGVLAALFMW,0
4gby,A,480,491,11,ETKKTQQTATL,0
5fxh,D,26,31,5,RSQKS,0
5fxh,D,32,326,294,PSIGIAVILVGTSDEVAIKDAHEKDDFHHLSVVPRVELVAMNETDPKSIITRICDLMSDRKIQGVVFADDTDQEAIAQILDFISAQTLTPILGIHGGSSMIMADKDESSMFFQFGPSIEQQASVMLNIMEEYDWYIFSIVTTYFPGYQDFVNKIRSTIENSFVGWELEEVLLLDMSLDDGDSKIQNQLKKLQSPIILLYCTKEEATYIFEVANSVGLTGYGYTWIVPSLVAGDTDTVPSEFPTGLISVSYDEWDYGLPARVRDGIAIITTAASDMLSEHSFIPEPKSSCYNTHE,0
5fxh,D,327,331,4,RIYQ,0
5fxh,D,332,394,62,NMLNRYLINVTFEGRDLSFSEDGYQMHPKLVIILLNKERKWERVGKWKDKSLQMKYYVWPRM,0
5fxh,D,395,401,6,PETEEQ,0
5fxh,D,402,439,37,DDHLSIVTLEEAPFVIVESVDPLSGTCMRNTVPCQKR,0
5fxh,D,440,451,11,ISENKTDEEPG,0
5fxh,D,452,541,89,IKKCCKGFCIDILKKISKSVKFTYDLYLVTNGKHGKKINGTWNGMIGEVVMKRAYMAVGSLTINEERSEVVDFSVPFIETGISVMVSRS,0
5fxh,D,542,545,3,GTV,0
5fxh,D,546,551,5,PSAFL,0
5fxh,D,552,555,3,PFS,0
5fxh,D,557,572,15,VWVMMFVMLLIVSAV,0
5fxh,D,579,599,20,FSPVGYNRSLADGREPGGPS,0
5fxh,D,605,618,13,IWLLWGLVFNNSV,0
5fxh,D,619,621,2,VQ,0
5fxh,D,629,646,17,IMVSVWAFFAVIFLASY,0
5fxh,D,647,820,173,ANLAAFMIQEEYVDQVSGLSDKKFQRPNDFSPPFRFGTVPNGSTERNIRNNYAEMHAYMGKFNQRGVDDALLSLKTGKLDAFIYDAAVLNYMAGRDEGCKLVTIGSGKVFASTGYGIAIQKDSGWKRQVDLAILQLFGDGEMEELEALWLTGICHNEKNEVMSSQLDIDNMAG,0
5fxh,D,821,838,17,FYMLGAAMALSLITFIS,0
5fxh,D,842,852,10,YWQFRHSFMG,0
3nka,E,5,22,17,AAECFGTFWLVFGGCGS,0
3nka,E,23,37,14,VLAAGFPELGIGFA,0
3nka,E,38,55,17,VALAFGLTVLTMAFAVG,0
3nka,E,59,73,14,GHFNPAVTIGLWAG,0
3nka,E,81,99,18,VGYVIAQVVGGIVAAALL,0
3nka,E,100,134,34,LIASGKTGFDAAASGFASNGYGEHSPGGYSMLSA,0
3nka,E,135,152,17,VVELVLSAGFLLVIHGA,0
3nka,E,162,177,15,PIAIGLALTLIGLIS,0
3nka,E,178,183,5,PVTNF,0
3nka,E,184,195,11,VNPARSTAVAI,0
3nka,E,196,205,9,QGGWALEQL,0
3nka,E,206,223,17,FFWVVPIVGGIIGGLIY,0
3nka,E,229,231,2,RD,0
2mjo,A,10,31,21,PVYASILAAVVVGLVAYIAFK,0
2mjo,A,32,41,9,WNSSKQNKQ,0
4p6l,B,1,3,2,YK,0
4p6l,B,4,24,20,IAHALFSALFALSELYIAVR,0
4nh2,F,16,32,16,TALVLFMTIPGIALFY,0
4nh2,F,33,45,12,GLIRGKNVLSML,0
4nh2,F,46,64,18,QVTVTFALVCILWVVYGY,0
4nh2,F,103,118,15,QGSFACITVGLIVGA,0
4nh2,F,119,126,7,AERIRFS,0
4nh2,F,127,144,17,VLIFVVVWLTLSYIPIA,0
4nh2,F,161,178,17,AGGTVVHINAAIAGLVG,0
4nh2,F,179,182,3,YLI,0
4nh2,F,183,194,11,KRVGFGKEAFK,0
4nh2,F,195,201,6,HNLPMV,0
4nh2,F,202,217,15,TGTAILYIGWFGFNA,0
4nh2,F,231,248,17,VNTVVATAAAILGWIFG,0
4nh2,F,249,260,11,WALRGKPSLLG,0
4nh2,F,261,276,15,CSGAIAGLVGVTPAC,0
4nh2,F,282,299,17,GALIIGVVAGLAGLWGV,0
4nh2,F,300,302,2,ML,0
4nh2,F,303,311,8,RLLRVDDP,0
4nh2,F,312,313,1,D,0
4nh2,F,314,331,17,FGVHGVCGIVGCIMTGI,0
4nh2,F,356,377,21,ESIAITIVWSGVVAFIGYKLA,0
4nh2,F,378,385,7,LTVGLRV,0
4nh2,F,386,406,20,EEQEREGLDVNSHGENAYNA,0
5d92,A,-137,1,138,RLAYVKNHEIYGEKLLGLTLRERIEKTLQRAGFDVRFFDELSLEEAEDYLIILEPVLILERDLLLEGRKILVSDGFTVGYFFGGDFRTVFDGNLQSSIEKYLSLNNLESYEIWAIKLSNDNLKTAEKLLLSSLIGSGS,0
5d92,A,5,24,19,ARGLFAAIFLPIARLLADW,0
5d92,A,25,30,5,VSPDA,0
5d92,A,31,48,17,TVVGTLGVMAGALIFYP,0
5d92,A,53,66,13,WGTVVITVFVFSD,0
5d92,A,67,89,22,IDGLMARLLFREGPWGAFLDSY,0
5d92,A,90,105,15,DRVGDSSVFTGIVIW,0
5d92,A,116,131,15,ILALICLVLSSLVSY,0
5d92,A,132,147,15,KARAEGLGLTANVGI,0
5d92,A,148,164,16,ERSERLVVVLVATGLV,0
5d92,A,173,189,16,LVVLIVLAIASVVTIF,0
5d92,A,190,204,14,RVLTVREQAKAWTA,0
2qto,D,26,48,22,RAAGAATVLLVIVLLAGSYLAV,0
2qto,D,49,65,16,AERGAPGAQLITYPRA,0
2qto,D,66,78,12,WWSVETATTVGY,0
2qto,D,79,86,7,DLYPVTL,0
2qto,D,87,111,24,GRCVAVVVMVAGITSFGLVTAALA,0
3rvz,D,1983,2000,17,DYKDDDDKGSLVPRGSH,0
3rvz,D,2002,2009,7,LRITNIV,0
3rvz,D,2015,2033,18,KFIIYLIVLNGITMGLET,0
3rvz,D,2034,2043,9,KTFMQSFGV,0
3rvz,D,2044,2064,20,TTLFNQIVITIFTIEIILRI,0
3rvz,D,2076,2094,18,SLFDFFVVAISLVPTSSG,0
3rvz,D,2096,2113,17,ILRVLRVLRLFRLVTAV,0
3rvz,D,2114,2127,13,QMRKIVSALISVI,0
3rvz,D,2131,2151,20,SVIALMTLFFYIFAIMATQL,0
3rvz,D,2152,2163,11,GERFPEWFGTL,0
3rvz,D,2164,2190,26,ESFYTLFQVMTLESWSMGIVRPLMEV,0
3rvz,D,2191,2193,2,PY,0
3rvz,D,2194,2214,20,WVFFIPFIFVVTFVMINLVV,0
3rvz,D,2220,2267,47,MAILNQKEEQHIIDEVQSHEDNINNEIIKLREEIVELKELIKTSLKN,0
3usg,B,1,4,3,EVK,0
3usg,B,14,35,21,ILAMAGNAVGLGNFLRFPVQA,0
3usg,B,36,41,5,ENGGG,0
3usg,B,42,63,21,FMIPYIIAFLLVGIPLMWIEW,0
3usg,B,89,124,35,AKILGVFGLWIPLVVAIYYVYIESWTLGFAIKFLV,0
3usg,B,125,131,6,LVPEPP,0
3usg,B,132,134,2,,0
3usg,B,135,166,31,DPDSILRPFKEFLYSYIGVPKGDEPILKPSL,0
3usg,B,167,185,18,AYIVFLITMFINVSILIR,0
3usg,B,191,214,23,ERFAKIAMPTLFILAVFLVIRVF,0
3usg,B,215,222,7,LETPNGT,0
3usg,B,223,231,8,ADGLNFLW,0
3usg,B,232,241,9,PDFEKLKDP,0
3usg,B,242,265,23,VWIAAVGQIFFTLSLGFGAIITY,0
3usg,B,278,298,20,GLTAATLNEKAEVILGGSIS,0
3usg,B,299,307,8,PAAVAFFG,0
3usg,B,308,317,9,ANAVAIAKA,0
3usg,B,319,324,5,FNLGF,0
3usg,B,326,331,5,LPAIF,0
3usg,B,332,339,7,QTAGGTF,0
3usg,B,340,367,27,GFLWFFLLFFAGLTSSIAIMQPMIAFL,0
3usg,B,377,396,19,AVLWTAAIVFFSAHLVMFL,0
3usg,B,397,399,2,KS,0
3usg,B,400,425,25,DEMDFWAGTIGVVFFGLTELIIFFW,0
3usg,B,429,437,8,DKAWEEIN,0
3usg,B,445,472,27,RIYYYVMRYITPAFLAVLLVVWAREYI,0
3usg,B,473,483,10,KIMEETHWTV,0
3usg,B,484,502,18,ITRFYIIGLFLFLTFLVF,0
3usg,B,602,610,8,SAGTLVPR,0
1oco,Z,16,36,20,IGLSVTFLSFLLPAGWVLYH,0
1oco,Z,37,43,6,DNYKKS,0
1oco,Z,44,46,2,AA,0
4uqq,D,521,535,14,FSFLNPLSPDIWMY,0
4uqq,D,536,611,75,LWWF,0
4uqq,D,612,629,17,TLIIISSYTANLAAFLT,0
4uqq,D,787,794,7,NIGGIFI,0
4uqq,D,795,882,87,LAAGLVLSVFVAVGEFLYKSKKNAQLEKRSFCSAMVEELRMSLKCQRRLKHKPQAPVIVKTEEVINMHTFNDRRLPGKETMAGLVPR,0
7prc,H,13,30,17,QLVWYAQWLVIWTVVLL,0
7prc,H,31,258,227,LRREDRREGYPLVEPLGLVKLAPEDGQVYELPYPKTFVLPHGGTVTVPRRRPETRELKLAQTDGFEGAPLQPTGNPLVDAVGPASYAERAEVVDATVDGKAKIVPLRVATDFSIAEGDVDPRGLPVVAADGVEAGTVTDLWVDRSEHYFRYLELSVAGSARTALIPLGFCDVKKDKIVVTSILSEQFANVPRLQSRDQITLREEDKVSAYYAGGLLYATPERAESLL,0
5jag,A,14,35,21,ILAMAGNAVGLGNFLRFPVQA,0
5jag,A,36,38,2,EN,0
5jag,A,39,63,24,GGAFMIPYIIAFLLVGIPLMWIEW,0
5jag,A,89,120,31,AKILGVFGLWIPLVVAIYYVYIESWTLGFAI,0
5jag,A,121,131,10,FLVGLVPEPP,0
5jag,A,135,167,32,DPDSILRPFKEFLYSYIGVPKGDEPILKPSLF,0
5jag,A,168,185,17,YIVFLITMFINVSILIR,0
5jag,A,191,214,23,ERFAKIAMPTLFILAVFLVIRVF,0
5jag,A,215,222,7,LETPNGT,0
5jag,A,223,230,7,ADGLNFL,0
5jag,A,231,238,7,TPDFEKL,0
5jag,A,239,257,18,DPGVWIAAVGQIFFTLSL,0
5jag,A,280,298,18,TAATLNEKAEVILGGSIS,0
5jag,A,299,310,11,PAAVAFFGVAN,0
5jag,A,311,317,6,VAIAKA,0
5jag,A,319,324,5,FNLGF,0
5jag,A,326,332,6,LPAIFS,0
5jag,A,333,339,6,TAGGTF,0
5jag,A,340,367,27,GFLWFFLLFFAGLHSSIAIMQPMIAFL,0
5jag,A,377,394,17,AVLWTAAIVFFSAHLVM,0
5jag,A,395,399,4,LNKS,0
5jag,A,400,425,25,DEMDFWAGTIGVVFFGLTELIIFFW,0
5jag,A,429,437,8,DKAWEEIN,0
5jag,A,448,469,21,YYVMRYITPAFLAVLLVVWAR,0
5jag,A,470,473,3,YIP,0
5jag,A,479,484,5,HWTVW,0
5jag,A,485,503,18,TRFYIIGLFLFLTFLVFL,0
3usp,B,1,4,3,EVK,0
3usp,B,13,31,18,LILAMAGNAVGLGNFLRF,0
3usp,B,32,44,12,VQAAENGGGAFM,0
3usp,B,45,63,18,PYIIAFLLVGIPLMWIEW,0
3usp,B,89,120,31,AKILGVFGLWIPLVVAIYYVYIESWTLGFAI,0
3usp,B,121,132,11,FLVGLVPEPPP,0
3usp,B,133,134,1,A,0
3usp,B,135,167,32,DPDSILRPFKEFLYSYIGVPKGDEPILKPSLF,0
3usp,B,168,185,17,YIVFLITMFINVSILIR,0
3usp,B,191,211,20,ERFAKIAMPTLFILAVFLVI,0
3usp,B,212,222,10,VFLLETPNGT,0
3usp,B,223,230,7,ADGLNFL,0
3usp,B,231,244,13,TPDFEKLKDPGVW,0
3usp,B,245,266,21,AAVGQIFFTLSLGFGAIITYA,0
3usp,B,277,296,19,SGLTAATLNEKAEVILGGS,0
3usp,B,297,325,28,SIPAAVAFFGVANAVAIAKAGAFNLGFI,0
3usp,B,326,331,5,LPAIF,0
3usp,B,332,342,10,QTAGGTFLGF,0
3usp,B,343,367,24,WFFLLFFAGLTSSIAIMQPMIAFL,0
3usp,B,378,394,16,VLWTAAIVFFSAHLVM,0
3usp,B,395,402,7,LNKSLDE,0
3usp,B,403,426,23,DFWAGTIGVVFFGLTELIIFFWI,0
3usp,B,429,437,8,DKAWEEIN,0
3usp,B,445,468,23,RIYYYVMRYITPAFLAVLLVVWA,0
3usp,B,469,471,2,EY,0
3usp,B,472,477,5,PKIME,0
3usp,B,478,484,6,THWTVW,0
3usp,B,485,502,17,TRFYIIGLFLFLTFLVF,0
3usp,B,602,604,2,PR,0
2m3g,C,1,6,5,NLESL,0
2m3g,C,7,26,19,HWIYVAGMTIGALHFWSLS,0
2m3g,C,38,55,17,VAMFIPIWSGLAYMAMA,0
2m3g,C,56,69,13,DQGKVEAAGQIAH,0
2m3g,C,70,87,17,ARYIDWMVTTPLLLLSL,0
2m3g,C,104,122,18,LMSTQIVVITSGLIADLS,0
2m3g,C,123,127,4,RDWV,0
2m3g,C,128,147,19,YLWYICGVCAFLIILWGIW,0
2m3g,C,169,189,20,TYFTVLWIGYPIVWIIGPSG,0
2m3g,C,190,197,7,GWINQTI,0
2m3g,C,198,217,19,TFLFCLLPFFSKVGFSFLD,0
4wib,B,271,277,6,VYSEAG,0
4wib,B,278,303,25,VALWLARVRWLVILILTGMVTSSIL,0
4wib,B,307,312,5,SVLEA,0
4wib,B,318,338,20,YVPVLLGTGGNTGNQSATLI,0
4wib,B,339,352,13,RALATRDLDLRDW,0
4wib,B,353,381,28,RVFLKEMGVGLLLGLTLSFLLVGKVYWD,0
4wib,B,388,412,24,VVGVSLVLIVFFANLVGAMLPFLL,0
4wib,B,413,419,6,RLGVDP,0
4wib,B,420,442,22,LVSNPLVATLSDVTGLLIYLSV,0
3q17,B,1,25,24,AADFETSNRRWLDKLPRNLTDSAR,0
3q17,B,26,32,6,LHPRTL,0
3q17,B,33,54,21,AAIVVGLITGVLGAGFKSAVN,0
3q17,B,77,92,15,TALISGGMVALSFWL,0
3q17,B,93,124,31,KRFAPDTSGSGIPQIEGHLEGKLPLVWQRVL,0
3q17,B,125,138,13,IKLVGGFLSLGAG,0
3q17,B,140,152,12,AGFEGPTIQMGG,0
3q17,B,153,175,22,IGQMTGGWFKATQENQRILIAV,0
3q17,B,176,198,22,AGAGLATAFNAPLAGVALIGEE,0
3q17,B,199,210,11,HPRFRSQTLAY,0
3q17,B,211,227,16,SLLFGCVMATIILRMI,0
3q17,B,248,268,20,MFIILGILFGVMGYTFNRGL,0
3q17,B,269,284,15,KVLDWFDRLPPLATK,0
3q17,B,285,297,12,KGFLLGSIIGIL,0
3q17,B,330,343,13,GRFLLTLICYGSG,0
3q17,B,345,357,12,GGIFAPMLGIAS,0
3q17,B,385,407,22,MGALVAATVRAPLTAILLTIEM,0
3q17,B,415,431,16,PLLVTCLVASVVAEAL,0
3q17,B,432,450,18,GKPIYTVLLERTLAKQNR,0
3q17,B,451,466,15,SLVPRGSGGHHHHHH,0
4o9p,B,4,20,16,QAAYFVVAILFIVGLK,0
4o9p,B,21,32,11,MAHPTTAKSGI,0
4o9p,B,33,47,14,WAGWGMVLAVLATF,0
4o9p,B,58,73,15,LLALLLGSVVAWWAA,0
4o9p,B,74,85,11,RVAMTDMPQMV,0
4o9p,B,86,101,15,IYNGMGGGAAATIAA,0
4o9p,B,117,137,20,AILGGLIGSVAFTGSLIAFA,0
4o9p,B,138,150,12,LQGIMKSRPILF,0
4o9p,B,151,169,18,GQKAVNALVLALTVVIGL,0
4o9p,B,182,196,14,FFLLALLFGVLMTL,0
4o9p,B,197,209,12,IGGGDMPVAISF,0
4o9p,B,210,224,14,NAFTGMAVGFEGFA,0
4o9p,B,228,242,14,ALMVAGTLVGAAGT,0
4o9p,B,243,264,21,LTVLMARAMNRSVWSVLVGGF,0
4o9p,B,265,283,18,VEQEAGEVKGHHHHHHHH,0
5kk2,H,1,5,4,GLFD,0
5kk2,H,6,10,4,GVQM,0
5kk2,H,11,29,18,LTTVGAFAAFSLMTIAVG,0
5kk2,H,39,55,16,CKTKSVSENETSKKNE,0
5kk2,H,69,71,2,EG,0
5kk2,H,83,90,7,PEDADYE,0
5kk2,H,101,121,20,RASSIFPILSVILLFMGGLC,0
5kk2,H,122,126,4,AASE,0
5kk2,H,127,130,3,YKT,0
5kk2,H,131,136,5,HNIIL,0
5kk2,H,137,155,18,AGIFFVSAGLSNIIGIIV,0
5kk2,H,163,172,9,PSKSDSKKN,0
5kk2,H,178,196,18,SFYFGALSFIIAEMVGVL,0
5kk2,H,197,215,18,VHMFIDRHKQLRATARAT,0
5kk2,H,216,323,107,YLQASAITRIPSYRYRYQRRSRSSSRSTEPSHSRDASPVGVKGFNTLPSTEISMYTLSRDPLKAATTPTATYNSDRDNSFLQVHNCIQKDSKDSLHANTANRRTTPV,0
4jr8,C,1,3,2,PA,0
4jr8,C,4,8,4,EGEA,0
4jr8,C,9,31,22,WLWLGTAGMFLGMLYFIARGWG,0
4jr8,C,39,60,21,FYIATILITAIAFVNYLAMAL,0
4jr8,C,61,77,16,FGLTIVEIAGEQRPIY,0
4jr8,C,78,98,20,ARYSDWLFTTPLLLYDLGLL,0
4jr8,C,104,126,22,TISSLVSLDVLMIGTGLVATLS,0
4jr8,C,127,137,10,GSGVLSAGAE,0
4jr8,C,138,160,22,LVWWGISTAFLLVLLYFLFSSL,0
4jr8,C,175,196,21,KTLRNLVTVVWLVYPVWWLVG,0
4jr8,C,197,207,10,EGIGLVGIGI,0
4jr8,C,208,229,21,TAGFMVIDLVAKVGFGIILLR,0
4jr8,C,238,250,12,ETTGAGATATAD,0
2b76,P,13,38,25,WGLFGAGGMWSAIIAPVMILLVGIL,0
2b76,P,39,61,22,PLGLFPGDALSYERVLAFAQSF,0
2b76,P,62,86,24,GRVFLFLMIVLPLWCGLHRMHHAM,0
2b76,P,94,116,22,AGKWVFYGLAAILTVVTLIGVV,0
2b76,P,117,118,1,I,0
4xni,A,5,15,10,KTFFGQPLGL,0
4xni,A,16,37,21,TLFMTEMWERFSYYGMRAILL,0
4xni,A,56,75,19,ASIMAIYASMVYLSGTIGG,0
4xni,A,76,85,9,VADRIIGAR,0
4xni,A,86,104,18,AVFWGGVLIMLGHIVLAL,0
4xni,A,110,130,20,LFGSIILIIIGTGFLKPNVS,0
4xni,A,131,148,17,LVGTLYDEHDRRRDAGF,0
4xni,A,149,167,18,IFVFGINLGAFIAPLIVG,0
4xni,A,178,198,20,FSLAAIGMFIGLLVYYFGGK,0
4xni,A,199,223,24,TLDPHYLRPTDPLAPEEVKPLLVK,0
4xni,A,224,244,20,SLAVAGFIAIIVVMNLVGWN,0
4xni,A,246,265,19,PAYINLLTIVAIAIPVFYF,0
4xni,A,280,285,5,RVVSY,0
4xni,A,286,307,21,PLFIAAVLFWAIEEQGSVVLA,0
4xni,A,323,343,20,FQSLNPLFIMLYTPFFAWLW,0
4xni,A,344,353,9,AWKKNQPSS,0
4xni,A,354,372,18,TKFAVGLMFAGLSFLLMA,0
4xni,A,388,408,20,LVGSWALVILGEMLISPVGL,0
4xni,A,409,410,1,V,0
4xni,A,425,445,20,MWFLSSSVGSALNAQLVTLY,0
4xni,A,453,472,19,FSYFGLGSVVLGIVLVFLS,0
4xni,A,473,477,4,RIQG,0
3qf4,B,1,9,8,PEIRRRPH,0
3qf4,B,21,31,10,TATLRRLLGY,0
3qf4,B,33,57,24,PHTFTLIMVFVFVTVSSILGVLSP,0
3qf4,B,58,84,26,LIGKTIDVVFVPRRFDLLPRYMLILG,0
3qf4,B,85,107,22,IYALTSLLFWLQGKIMLTLSQD,0
3qf4,B,150,173,23,LGNSIIQFFSGIVTLAGAVIMMF,0
3qf4,B,174,177,3,VNV,0
3qf4,B,178,201,23,LSLVTLSIVPLTVLITQIVSSQT,0
3qf4,B,258,278,20,FSGVLPPLMNMVNNLGFALI,0
3qf4,B,279,298,19,GFGGWLALKDIITVGTIAT,0
3qf4,B,299,320,21,IGYSRQFTRPLNELSNQFNMI,0
4x88,F,126,130,4,SHMG,0
4x88,F,132,153,21,SVAALLTVVFYIAAVMATNLY,0
4x88,F,154,163,9,ATFPEWFGD,0
4x88,F,164,186,22,SKSLYTLFQVMTLDSWSMGIVR,0
4x88,F,187,193,6,VMNVHP,0
4x88,F,194,218,24,AWVFFIPFIMLTTFTVLNLFIGII,0
4x88,F,221,274,53,MAITKEQEEEAKTGHHQEPISQTLLHLGDRLDRIEKQLAQNNELLQRQQPQKK,0
3f3d,B,1,4,3,EVK,0
3f3d,B,13,32,19,LILAMAGNAVGLGNFLRFP,0
3f3d,B,33,43,10,QAAENGGGAF,0
3f3d,B,44,63,19,IPYIIAFLLVGIPLMWIEW,0
3f3d,B,89,124,35,AKILGVFGLWIPLVVAIYYVYIESWTLGFAIKFLV,0
3f3d,B,125,132,7,LVPEPPP,0
3f3d,B,133,134,1,A,0
3f3d,B,135,166,31,DPDSILRPFKEFLYSYIGVPKGDEPILKPSL,0
3f3d,B,167,185,18,AYIVFLITMFINVSILIR,0
3f3d,B,191,212,21,ERFAKIAMPTLFILAVFLVIR,0
3f3d,B,213,222,9,FLLETPNGT,0
3f3d,B,223,230,7,ADGLNFL,0
3f3d,B,231,243,12,TPDFEKLKDPGV,0
3f3d,B,244,266,22,IAAVGQIFFTLSLGFGAIITYA,0
3f3d,B,277,297,20,SGLTAATLNEKAEVILGGSI,0
3f3d,B,298,318,20,IPAAVAFFGVANAVAIAKAG,0
3f3d,B,319,324,5,FNLGF,0
3f3d,B,326,331,5,LPAIF,0
3f3d,B,332,339,7,QTAGGTF,0
3f3d,B,340,367,27,GFLWFFLLFFAGLTSSIAIMQPMIAFL,0
3f3d,B,378,396,18,VLWTAAIVFFSAHLVMFL,0
3f3d,B,397,399,2,KS,0
3f3d,B,400,426,26,DEMDFWAGTIGVVFFGLTELIIFFWI,0
3f3d,B,429,437,8,DKAWEEIN,0
3f3d,B,445,469,24,RIYYYVMRYITPAFLAVLLVVWAR,0
3f3d,B,470,471,1,Y,0
3f3d,B,472,477,5,PKIME,0
3f3d,B,478,483,5,THWTV,0
3f3d,B,484,502,18,ITRFYIIGLFLFLTFLVF,0
3f3d,B,602,604,2,PR,0
2lot,A,1,32,31,EEGGDFDNYYGADNQSECEYTDWKSSGALIP,0
2lot,A,33,56,23,IYMLVFLLGTTGNGLVLWTVFRK,0
3oma,B,30,60,30,EIIGRPQPGGTGFQPSASPVATQIHWLDGF,0
3oma,B,61,81,20,LVIIAAITIFVTLLILYAVW,0
3oma,B,99,117,18,LEIAWTIVPIVILVAIGA,0
3oma,B,118,285,167,SLPVLFNQQEIPEADVTVKVTGYQWYWGYEYPDEEISFESYMIGSPATGGDNRMSPEVEQQLIEAGYSRDEFLLATDTAMVVPVNKTVVVQVTGADVIHSWTVPAFGVKQDAVPGRLAQLWFRAEREGIFFGQCSELCGISHAYMPITVKVVSEEAYAAWLEQHHHH,0
5b6z,C,4,11,7,TGRPEWI,0
5b6z,C,12,28,16,LALGTALMGLGTLYFL,0
5b6z,C,47,61,14,LVPAIAFTMYLSML,0
5b6z,C,62,79,17,GYGLTMVPFGGEQNPIY,0
5b6z,C,80,94,14,ARYADWLFTTPLLL,0
5b6z,C,111,126,15,VGADGIMIGTGLVGA,0
5b6z,C,127,134,7,TKVYSYR,0
5b6z,C,135,150,15,VWWAISTAAMLYILY,0
5b6z,C,178,192,14,VVLWSAYPVVWLIG,0
5b6z,C,193,203,10,EGAGIVPLNI,0
5b6z,C,204,220,16,TLLFMVLDVSAKVGFG,0
3abv,D,35,40,5,SKAAS,0
3abv,D,41,61,20,HWTGERVVSVLLLGLLPAAY,0
3abv,D,69,92,23,YSLAAALTLHGHWGIGQVVTDYV,0
3abv,D,93,96,3,GDA,0
3abv,D,97,118,21,QKAAKAGLLALSAFTFAGLCY,0
3abv,D,125,134,9,ICKAVAMLW,0
2b6s,A,9,15,6,AANVSG,0
2b6s,A,16,35,19,KSCPANFLAAADDKLSGFQ,0
2b6s,A,36,63,27,DFLWPILVVEFLVAVASNGLALYRFSI,0
2b6s,A,75,99,24,SVQLAVSDLLCALTLPPLAAYLYP,0
2b6s,A,100,107,7,KHWRYGE,0
2b6s,A,108,132,24,ACRLERFLFTCNLLGSVIFITCIS,0
2b6s,A,156,177,21,VSAAGWVLAALLAMPTLSFSH,0
2b6s,A,178,207,29,KRPQQGAGNCSVARPEACIKCLGTADHGL,0
2b6s,A,208,234,26,AYRAYSLVLAGLGCGLPLLLTLAAYG,0
2b6s,A,258,282,24,ASGVALYASSYVPYHIMRVLNVDA,0
2b6s,A,283,307,24,RRWSTRCPSFADIAQATAALELGP,0
2b6s,A,308,331,23,VGYQVMRGLMPLAFCVHPLLYMA,0
2b6s,A,334,382,48,SLGCCCRHCPGYRDSWNPEDAKSTGQALPLNATAAPKPSEPQSRELSQ,0
5wud,C,9,25,16,DIFNYIGIVAFAISGA,0
5wud,C,26,35,9,KAVKKGMDL,0
5wud,C,36,57,21,GVLVLGFSTALGGGIISNLLL,0
5wud,C,63,83,20,NLIYYPYPITAFLASLATFV,0
5wud,C,84,96,12,YRIFTNVGKPLL,0
5wud,C,97,114,17,ADAIGLGAFASSGASLA,0
5wud,C,122,142,20,LVVIVGAITAVGGGVIRDIL,0
5wud,C,143,153,10,NEVPLILTRE,0
5wud,C,154,169,15,YATTAVIGSFVYFIA,0
5wud,C,178,193,15,ALIVSFLITLILRIL,0
5wud,C,194,201,7,MELKWEL,0
3cwb,W,5,12,7,LRQAYSA,0
3cwb,W,19,40,21,FALTVVLGAVLFERAFDQGAD,0
3cwb,W,41,62,21,IFEHLNEGKLWKHIKHKYEAS,0
3cwb,W,63,64,1,E,0
5uld,B,19,35,16,RNSLIVLADVALFLAL,0
5uld,B,51,64,13,LAFIAVLWLTEAL,0
5uld,B,66,76,10,TVTAILVPVM,0
5uld,B,90,110,20,NFANSIIFLFLGGFALAAAM,0
5uld,B,111,140,29,HQGLDKVIADKVLAMAQGKMSVAVFMLFG,0
5uld,B,141,154,13,TALLSMWISNTAT,0
5uld,B,155,187,32,AMMLPLVLGVLSKVDADKQRSTYVFVLLGVAY,0
5uld,B,188,209,21,ASIGGIATLVGTGPNAIAAAE,0
5uld,B,213,235,22,FTDWMKFGLPTAMMMLPMAIAI,0
5uld,B,236,260,24,YFLLKPTLNGMFELDRAPVNWDKG,0
5uld,B,261,278,17,VVTLGIFGLTVFLWIFS,0
5uld,B,291,309,18,DTLVALGAILMLSFARVV,0
5uld,B,311,332,21,KEIQKTADWGILLLFGGGLCL,0
5uld,B,360,376,16,VILVVATFVVFLTEFT,0
5uld,B,378,389,11,VATTTLLIPVF,0
5uld,B,403,417,14,SVLIAVAASCAFML,0
5uld,B,418,439,21,VATPPNAIVFASGHIKQSEMM,0
5uld,B,440,460,20,VGLYLNIACIGLLTAIAMLF,0
2eij,Z,13,34,21,EQAIGLSVTFLSFLLPAGWVL,0
2eij,Z,35,43,8,HLDNYKKS,0
2eij,Z,44,46,2,AA,0
4twf,E,11,210,199,VDVSVSIFINKIYGVNTLEQTYKVDGYIVAQWTGKPRKTPGDKPLIVENTQIERWINNGLWVPALEFINVVGSPDTGNKRLMLFPDGRVIYNARFLGSFSNDMDFRLFPFDRQQFVLELEPFSYNNQQLRFSDIQVYTENADNEEIDEWWIRGKASTHISDIRYDHLSSVQPNQNEFSRITVRIDAVRNPSYYLWSFIL,0
4twf,E,211,225,14,LGLIIAASWSVFWL,0
4twf,E,230,245,15,RLQTSFTLMLTVVAY,0
4twf,E,246,265,19,SYTSNILPRLPYTTVIDQM,0
4twf,E,266,282,16,IAGYGSIFAAILLIIF,0
4twf,E,298,315,17,RCRLAFPLGFLAIGCVL,0
4twf,E,316,317,1,I,0
3qjv,C,7,27,20,ALAVILVLTLTILVFWLGVY,0
3qjv,C,28,34,6,VFFARG,0
2yxr,C,1,20,19,SKREETGLATSAGLIRYMD,0
2yxr,C,33,50,17,IGVTVAFVIIEAILTYG,0
2yxr,C,51,52,1,F,0
4qid,A,17,39,22,IWLALGTIGMLLGMLYFIADGL,0
4qid,A,40,48,8,VQDPRQKE,0
4qid,A,49,73,24,YVITILIPAIAAASYLSMFFGFGL,0
4qid,A,87,109,22,WARYADWLFTTPLLLLDIGLLA,0
4qid,A,110,113,3,ASQ,0
4qid,A,114,136,22,DIGALVGIDAFMIVTGLVATLT,0
4qid,A,142,165,23,YAFWTISTISMVFLLYYLVAVFG,0
4qid,A,166,177,11,AVSDADEDTRS,0
4qid,A,178,200,22,FNALRNIILVTWAIYPVAWLVG,0
4qid,A,211,233,22,ETLLFMVLDLVAKVGFGFILLR,0
4qid,A,234,239,5,RAIMG,0
3vmt,A,7,40,33,GSSHHHHHHSSGLVPRGSHMQPVGKPPKKKKSK,0
3vmt,A,41,44,3,ILL,0
3vmt,A,45,59,14,ILLTILIIIALFIG,0
3vmt,A,112,118,6,KGTTRA,0
3vmt,A,123,129,6,SDRDVQ,0
4hfi,E,1,4,3,QDM,0
4hfi,E,5,198,193,SPPPPIADEPLTVNTGIYLIECYSLDDKAETFKVNAFLSLSWKDRRLAFDPVRSGVRVKTYEPEAIWIPEIRFVNVENARDADVVDISVSPDGTVQYLERFSARVLSPLDFRRYPFDSQTLHIYLIVRSVDTRNIVLAVDLEKVGKNDDVFLTGWDIESFTAVVKPANFALEDRLESKLDYQLRISRQYFSYI,0
4hfi,E,199,218,19,NIILPMLFILFISWTAFWS,0
4hfi,E,222,240,18,ANVTLVVSTLIAHIAFNI,0
4hfi,E,241,255,14,VETNLPKTPYMTYT,0
4hfi,E,256,275,19,AIIFMIYLFYFVAVIEVTV,0
4hfi,E,293,313,20,ASRIAFPVVFLLANIILAFL,0
4hfi,E,314,315,1,F,0
4hfi,E,316,317,1,F,0
2n90,B,112,134,22,AVGLAVFACLFLSTLLLVLNKA,0
2n90,B,135,139,4,RRNK,0
5nl2,B,-38,122,160,RVPEKYSTLPAEDRSVHIVNICAIEDLGYLPSEGTLLNSLSVDPDAECKYGLYFRDGKRKVDYILVYHHKRASGSRTLARRGLQNDMVLGTRSVRQDQPLPGKGSPVDAGSPEVPMDYHEDDKRFRREEYEGNLLEAGLELENDEDTKIHGVGFVKIHAP,0
5nl2,B,123,201,78,KRFRREAEFLKLKMPTKKVYHISETRGLLKTINSVLQKI,0
5nl2,B,202,203,1,D,0
5nl2,B,204,214,10,IQPKVAEHRP,0
5nl2,B,215,241,26,TTKRLSYPFSREKQHLFDLTDRDSFF,0
5nl2,B,242,254,12,SKTRSTIVYEIL,0
5nl2,B,255,277,22,RTTCTKAKYSMGITSLLANGVY,0
5nl2,B,278,282,4,AAYP,0
5nl2,B,283,294,11,HDGDYEGDNVE,0
5nl2,B,295,305,10,NDRKLLYEEW,0
5nl2,B,306,314,8,SYGVFYKY,0
5nl2,B,315,334,19,PIDLVRKYFGEKVGLYFAW,0
5nl2,B,335,350,15,GAYTQMLIPASIVGV,0
5nl2,B,356,408,52,CATVDENIPSMEMCDQRYNITMCPLCDKTCSYWKMSSACATARASHLFDNPA,0
5nl2,B,413,427,14,VFMALWAATFMEHW,0
5nl2,B,428,438,10,RKQMRLNYRW,0
5nl2,B,439,485,46,LTGFEEEEEAVKDHPRAEYEARVLEKSLRKESRNKETDKVKLTWRD,0
5nl2,B,487,504,17,PAYFTNLVSIIFMIAVT,0
5nl2,B,521,534,13,LAMNSSPSVRSNI,0
5nl2,B,547,564,17,VVIILLDEVYGCIARWL,0
5nl2,B,565,578,13,KIEVPKTEKSFEE,0
5nl2,B,579,594,15,LTFKAFLLKFVNSYT,0
5nl2,B,603,632,29,GRFVGRPGDYVYIFRSFRMEECAPGGCLM,0
5nl2,B,639,657,18,IIMLGKQLIQNNLFEIGI,0
5nl2,B,658,666,8,KMKKFIRY,0
5nl2,B,667,680,13,KLRRQSPSDREEY,0
5nl2,B,681,692,11,KRKQRYEVDFN,0
5nl2,B,693,696,3,EPF,0
5nl2,B,697,700,3,GLT,0
5nl2,B,701,717,16,EYMEMIIQFGFVTLFV,0
5nl2,B,721,735,14,LAPLFALLNNIIEI,0
5nl2,B,736,758,22,LDAKKFVTELRRPVAIRAKDIG,0
5nl2,B,759,773,14,WYNILRGVGKLAVI,0
5nl2,B,782,854,72,SDFIPRLVYLYMYSQNGTMHGFVNHTLSSFNVSDFQNGTAPNDPLDLGYEVQICRYKDYREPPWSEHKYDIS,0
5nl2,B,875,885,10,MFMSDFVDWV,0
5nl2,B,886,891,5,PDIPK,0
5nl2,B,892,909,17,ISQQIHKEKVLMVELFM,0
5nl2,B,910,960,50,EEQGKQQLLDTWMEKEKPRDVPCNNHSPTTHPEAGDGSPVPSYEYHGDAL,0
4cbj,M,1,4,3,AFL,0
4cbj,M,5,18,13,AAIAAGLAAVAGA,0
4cbj,M,55,68,13,VPIIAIVISLLIL,0
2gfp,A,12,32,20,LVLLVAVGQMAQTIYIPAIA,0
2gfp,A,33,42,9,MARDLNVRE,0
2gfp,A,43,59,16,AVQSVMGAYLLTYGVS,0
2gfp,A,62,67,5,YGPIS,0
2gfp,A,72,88,16,RPVILVGMSIFMLATL,0
2gfp,A,89,98,9,AVTTSSLTV,0
2gfp,A,99,115,16,IAASAMQGMGTGVGGV,0
2gfp,A,137,153,16,NMGILVSPLLAPLIGG,0
2gfp,A,154,157,3,LDT,0
2gfp,A,158,177,19,WNWRACYLFLLVLCAGVTF,0
2gfp,A,215,231,16,LIGGLAGIAAFEACSG,0
2gfp,A,232,237,5,LMGAV,0
2gfp,A,238,255,17,GLSSMTVSILFILPIPA,0
2gfp,A,256,264,8,FFGAWFAG,0
2gfp,A,272,288,16,LMWQSVICCLLAGLLM,0
2gfp,A,290,304,14,PDWFGVMNVWTLLV,0
2gfp,A,332,349,17,GTAGALVGGLQNIGSGV,0
2gfp,A,350,354,4,ASLS,0
2gfp,A,355,370,15,MLPQTGQGSLGLLMT,0
4xu5,C,9,26,17,VLFLLGAVAALIGDHSH,0
4xu5,C,27,40,13,VTGTTVYHTDAVP,0
4xu5,C,41,61,20,VWSSPFWFPILVGAATASLA,0
4xu5,C,80,97,17,GGVAAVVGTYVTTALVH,0
4xu5,C,98,101,3,FPV,0
4xu5,C,102,118,16,PVTALVCAAAAITWCV,0
4xu5,C,125,142,17,ACGVVIAVIGPAVEIAL,0
4xu5,C,143,160,17,QLGVFAYHPDSDGLFGV,0
4xu5,C,161,176,15,PFLAPLYFAFGVVAA,0
5bz2,B,7,27,20,LEIFYLLLAAQVMAFIFKRL,0
5bz2,B,29,42,13,PCVIGEVLAGVLV,0
5bz2,B,59,75,16,AELGAVFLLFMVGLET,0
5bz2,B,76,84,8,LKDILAVG,0
5bz2,B,85,102,17,EAFLVAVLGVALPFLGG,0
5bz2,B,121,134,13,ALVATSVGCTARV,0
5bz2,B,135,148,13,QELGVLSRPYSRI,0
5bz2,B,149,165,16,LGAAVIDDVLGLIVLA,0
5bz2,B,185,202,17,VLSVVFVGLAVFLSTLI,0
5bz2,B,203,209,6,RLPLER,0
5bz2,B,210,233,23,PVGSPLGFALALGVGMAALAASI,0
5bz2,B,236,249,13,PIVGAFLGGMLLS,0
5bz2,B,250,257,7,VREKYRL,0
5bz2,B,258,277,19,EPIFAIESFLAPIFFAMVG,0
5bz2,B,295,314,19,VVTVIAILGKVLGGFLGAL,0
5bz2,B,315,321,6,QGVRSA,0
5bz2,B,322,340,18,TVGVGMAPRGEVGLIVAA,0
5bz2,B,357,372,15,FMVVFTTLFAPFALK,0
5bz2,B,373,386,13,LIAWTERERAAKE,0
5g2a,A,16,38,22,FIDHLLTMGVGVHFAALIFFLV,0
5g2a,A,39,50,11,SQFVAPKYRIA,0
5g2a,A,51,74,23,ALSCIVMVSAGLILNSQAVMWTD,0
5g2a,A,91,111,20,NGYRYVNWMATIPCLLLQLL,0
5g2a,A,112,122,10,VLNLKGKELF,0
5g2a,A,123,146,23,TATWLILAAWGMIITGYVGQLYE,0
5g2a,A,153,176,23,MIWGAVSTAFFVVMNWIVGTKIF,0
5g2a,A,177,189,12,NRATMLGGTDST,0
5g2a,A,190,213,23,TKVFWLMMFAWTLYPIAYLVPAF,0
5g2a,A,220,243,23,VLRQLLFTIADISSKVIYGLMIT,0
5g2a,A,244,265,21,IAIQQSAAAGYVPAQQALGRI,0
4xwk,A,35,68,33,LTMFRYAGWLDRLYMLVGTLAAIIHGVALPLMM,0
4xwk,A,69,117,48,IFGDMTDSFASVGQVSKQSTQMSEADKRAMFAKLEEEMTTYAYYYTGI,0
4xwk,A,118,140,22,AGVLIVAYIQVSFWCLAAGRQI,0
4xwk,A,180,204,24,GIGDKIGMFFQAMATFFGGFIIGF,0
4xwk,A,205,208,3,RGW,0
4xwk,A,209,229,20,LTLVILAISPVLGLSAGIWA,0
4xwk,A,290,313,23,ANISMGAAFLLIYASYALAFWYG,0
4xwk,A,314,328,14,SLVISKEYSIGQVL,0
4xwk,A,329,352,23,VFFSVLIGAFSVGQASPNIEAFA,0
4xwk,A,695,700,5,ILKLN,0
4xwk,A,706,729,23,FVVGIFCAIINGGLQPAFSVIFS,0
4xwk,A,730,750,20,VVGVFTNGGPPETQRQNSNL,0
4xwk,A,751,773,22,SLLFLILGIISFITFFLQGFTF,0
4xwk,A,828,848,20,LAVIFQNIANLGTGIIISLI,0
4xwk,A,849,853,4,GWQL,0
4xwk,A,854,879,25,LLLLAIVPIIAIAGVVEMKMLSGQA,0
4xwk,A,925,952,27,NAMKKAHVFGITFSFTQAMMYFSYAAC,0
4xwk,A,953,971,18,RFGAYLVTQQLMTFENVL,0
4xwk,A,972,991,19,VFSAIVFGAMAVGQVSSFA,0
2i35,A,40,64,24,AYMFLLIMLGFPINFLTLYVTVQH,0
2i35,A,65,71,6,KLRTPL,0
2i35,A,72,96,24,YILLNLAVADLFMVFGGFTTTLYT,0
2i35,A,112,136,24,GFFATLGGEIALWSLVVLAIERYV,0
2i35,A,137,151,14,VCKPMSNFRFGENH,0
2i35,A,152,176,24,IMGVAFTWVMALACAAPPLVGWSR,0
2i35,A,203,228,25,IYMFVVHFIIPLIVIFFCYGQLVFT,0
2i35,A,229,250,21,KEAAAQQQESATTQKAEKEVT,0
2i35,A,251,274,23,MVIIMVIAFLICWLPYAGVAFYI,0
2i35,A,289,310,21,PAFFAKTSAVYNPVIYIMMNK,0
2i35,A,311,322,11,FRNCMVTTLCC,0
2i35,A,323,326,3,KNP,0
2i35,A,327,329,2,GD,0
2i35,A,330,331,1,E,0
2i35,A,332,348,16,STTVSKTETSQVAPA,0
3cod,C,1,4,3,AQI,0
3cod,C,5,8,3,GRP,0
3cod,C,9,34,25,WIWLALGTALMGLGTLYFLVKGMGV,0
3cod,C,39,62,23,KKFYAITTLVPAIAFTMYLSMLL,0
3cod,C,63,78,15,YGLTMVPFGGEQNPI,0
3cod,C,79,100,21,WARYADWLFTAPLLLLDLALL,0
3cod,C,103,127,24,DQGTILALVGAAGIMIGTGLVGAL,0
3cod,C,128,132,4,KVYS,0
3cod,C,133,157,24,RFVWWAISTAAMLYILYVLFFGFT,0
3cod,C,170,192,22,FKVLRNVTVVLWSAYPVVWLIG,0
3cod,C,193,202,9,EGAGIVPLN,0
3cod,C,203,226,23,ETLLFMVLDVSAKVGFGLILLRS,0
3cod,C,232,249,17,AEAPEPSAGDGAAATSD,0
2ycx,A,31,38,7,GAELLSQ,0
2ycx,A,42,63,21,GMSLLMALVVLLIVAGNVLVI,0
2ycx,A,64,80,16,AIGSTQRLQTLTNLFI,0
2ycx,A,81,103,22,SLACADLVVGLLVVPFGATLVV,0
2ycx,A,108,136,28,WGSFLCELWTSLDVLCVTASIETLCVIA,0
2ycx,A,137,162,25,DRYLAITSPFRYQSLMTRARAKVII,0
2ycx,A,163,183,20,TVWAISALVSFLPIMMHWWR,0
2ycx,A,187,194,7,QALKCYQ,0
2ycx,A,200,228,28,FVTNRAYAIASSIISFYIPLLIMIFVAL,0
2ycx,A,229,291,62,VYREAKEQIRKIDRASKRKRVMLMREHKALKT,0
2ycx,A,292,315,23,GIIMGVFTLCWLPFFLVNIVNVF,0
2ycx,A,324,345,21,FVAFNWLGYANSAMNPIIYCR,0
2ycx,A,346,354,8,PDFRKAFK,0
2ycx,A,355,373,18,LLAFPRKADRRLHHHHHH,0
3t9n,G,1,12,11,WADIYHKLVEI,0
3t9n,G,17,47,30,VKFLLDVLKILIIAFIGIKFADFLIYRFYK,0
3t9n,G,48,68,20,YSKSKIQLPQRKIDTLTSLT,0
3t9n,G,69,88,19,NAVRYIIYFLAGASILKLF,0
3t9n,G,90,101,11,DMTSLLAVAGI,0
3t9n,G,102,212,110,SLAIGFGAQNLVKDMISGFFIIFEDQFSVGDYVTINGISGTVEEIGLRVTKIRGFSDGLHIIPNGEIKMVTNLTKDSMMAVVNIAFPIDEDVDKIIEGLQEICEEVKKSR,0
3t9n,G,213,217,4,DLIE,0
3t9n,G,218,281,63,PTVLGITDMQDSKLVIMVYAKTQPMQKWAVERDIRYRVKKMFDQKNISFPYPRTTVILSEKKT,0
4tll,D,27,47,20,PNMDIAVILVGTTEEVAIKD,0
4tll,D,48,54,6,HEKDDF,0
4tll,D,55,308,253,HLPVTPRVELVTMQESDPKSIITRICDLMSDKKVQGVVFGDDTDQEAIAQILDFISVQTLTPILGIHGGSSMIMADKEEASMFFQFGPSIEQQASVMLNIMEEYDWYIFSIVTTYFPGYQDFENKVRSTIENSFVGWELEEVIHLDMSLDDIDSKIQNQLCKLQSPVILLYCTKEEATYIFEVAHSVGLTGYGFTWIVPSLVAGDTDTVPDEFPTGLISVSYDEWDYDLPARVRDGIAIITTAASTMLSEHNS,0
4tll,D,309,311,2,PQ,0
4tll,D,312,390,78,KSSCNNIQESRVYEAHMLKRYLINVTFEGRDLSFSEDGYQMHPKLVIILLNQERKWERVGKYKDRSLKMWPVFDLYPN,0
4tll,D,391,396,5,EEHKD,0
4tll,D,397,535,138,HLSIVTLEEAPFVIVEDVDPLSGTCMRNTVPCRKQIRPENRTEEGGNYIKRCCKGFCIDILKKIAKTVKFTYDLYLVTNGKHGKKINGVWNGMIGEVVTKRAYMAVGSLTINEERSEVVDFSVPFIETGISVMVSRSN,0
4tll,D,536,540,4,TVSP,0
4tll,D,542,547,5,FLEPF,0
4tll,D,548,551,3,ADV,0
4tll,D,552,568,16,VMMFVMLLIVSAVAVF,0
4tll,D,570,581,11,EYFSPVGYNGP,0
4tll,D,586,599,13,KAIWLLWGLVFNN,0
4tll,D,601,610,9,PVQNPKGTT,0
4tll,D,612,630,18,IMVSVWAFFAVIFLASYT,0
4tll,D,631,805,174,NLAAFMIQRRYVDQVSGLSDKKFQRPNDFSPAFRFGTVPNGSTERNIRNNYLEMHSYMVKFNQRSVQDALLSLKSGKLDAFIYDAAVLNYMAGRDEGCKLVTIGSGKVFATTGYGIAIQKDSGWKRQVDLAILQLFGDGEMEELEALWLTGICHNEKNEVMSSQLDIDNMAGVF,0
4tll,D,806,825,19,MLAAAMALSLITFIMEHLF,0
4tll,D,828,843,15,RAEAKRMKGLEVLFQ,0
3fpb,A,49,56,7,WELVIEQ,0
3fpb,A,58,73,15,DLLVRILLLAACISF,0
3fpb,A,74,88,14,LAWFEEGEETITAF,0
3fpb,A,89,107,18,EPFVILLILIANAIVGVW,0
3fpb,A,254,274,20,EFGEQLSKVISLICVAVWLI,0
3fpb,A,275,295,20,IGHFNDPVHGGSWIRGAIYY,0
3fpb,A,296,317,21,KIAVALAVAAIPEGLPAVITT,0
3fpb,A,760,780,20,IRYLISSNVGEVVCIFLTAA,0
3fpb,A,781,786,5,GLPEA,0
3fpb,A,787,807,20,IPVQLLWVNLVTDGLPATAL,0
3fpb,A,832,852,20,LFFRYMAIGGYVGAATVGAA,0
3fpb,A,853,897,44,WWFMYAEDGPGVTYHQLTHFMQCTEDHPHFEGLDCEIFEAPEPM,0
3fpb,A,898,916,18,MALSVLVTIEMCNALNSL,0
3fpb,A,931,950,19,WLLGSICLSMSLHFLILYV,0
3fpb,A,951,956,5,PLPMI,0
3fpb,A,957,964,7,KLKALDL,0
3fpb,A,965,987,22,QWLMVLKISLPVIGLDEILKFI,0
1ldi,D,1,5,4,SQTS,0
1ldi,D,11,28,17,IAEFLGTGLLIFFGVGC,0
1ldi,D,29,42,13,AALKVAGASFGQW,0
1ldi,D,43,60,17,ISVIWGLGVAMAIYLTA,0
1ldi,D,64,78,14,AHLNPAVTIALWLF,0
1ldi,D,86,104,18,IPFIVSQVAGAFCAAALV,0
1ldi,D,105,148,43,GLYYNLFFDFEQTHHIVRGSVESVDLAGTFSTYPNPHINFVQA,0
1ldi,D,149,167,18,AVEMVITAILMGLILALT,0
1ldi,D,179,195,16,PLLIGLLIAVIGASMG,0
1ldi,D,196,198,2,LT,0
1ldi,D,199,213,14,FAMNPARDFGPKVF,0
1ldi,D,214,233,19,WLAGWGNVAFTGGRDIPYF,0
1ldi,D,234,255,21,VPLFGPIVGAIVGAFAYRKLI,0
1ldi,D,260,281,21,CDICVVEEKETTTPSEQKASL,0
2wlo,B,1,22,21,TGGMKPPARKPRILNSDGSSN,0
2wlo,B,23,27,4,TRLG,0
2wlo,B,28,32,4,EKRG,0
2wlo,B,33,36,3,LDD,0
2wlo,B,37,43,6,YHDLLT,0
2wlo,B,44,47,3,SWP,0
2wlo,B,48,70,22,FITLITGLYLVTNALFALAYLA,0
2wlo,B,84,99,15,DAFFFSVQTMATIGY,0
2wlo,B,109,129,20,NTLVTLEALCGMLGLAVAAS,0
2wlo,B,130,299,169,IYARFTRPTAGVLFSSRMVISDFEGKPTLMMRLANLRIEQIIEADVHLVLVRSEISQEGMVFRRFHDLTLTRSRSPIFSLSWTVMHPIDHHSPIYGETDETLRNSHSEFLVLFTGHHEAFAQNVHARHAYSCDEIIWGGHFVDVFTTLPDGRRALDLGKFHEIAQHHHH,0
2wlo,B,300,301,1,H,0
2i21,C,1,4,3,AQI,0
2i21,C,5,10,5,GRPEW,0
2i21,C,11,28,17,WLALGTALMGLGTLYFL,0
2i21,C,47,62,15,LVPAIAFTMYLSMLL,0
2i21,C,63,79,16,YGLTMVPFGGEQNPIY,0
2i21,C,80,94,14,ARYADWLFTTPLLL,0
2i21,C,111,127,16,VGADGIMIGTGLVGAL,0
2i21,C,128,133,5,KVYSY,0
2i21,C,134,150,16,FVWWAISTAAMLYILY,0
2i21,C,157,161,4,SKAE,0
2i21,C,178,192,14,VVLWSAYPVVWLIG,0
2i21,C,193,202,9,EGAGIVPLN,0
2i21,C,203,220,17,ETLLFMVLDVSAKVGFG,0
2i21,C,232,249,17,AEAPEPSAGDGAAATSD,0
4qry,C,18,20,2,VT,0
4qry,C,21,28,7,RELFEFV,0
4qry,C,29,36,7,NDPLLAS,0
4qry,C,37,57,20,LYINIALAGLSILLFVFMTR,0
4qry,C,66,86,20,IAVSTILVPVVSIASYTGLA,0
4qry,C,87,120,33,GLTISVLEMPAGHFAEGSSVMLGGEEVDGVVTM,0
4qry,C,121,141,20,GRYLTWALSTPMILLALGLL,0
4qry,C,147,168,21,KLFTAITFDIAMCVTGLAAAL,0
4qry,C,169,175,6,TSSHLM,0
4qry,C,176,199,23,WFWYAISCACFIVVLYILLVEWA,0
4qry,C,211,232,21,STLKLLTVVMWLGYPIVWALG,0
4qry,C,233,243,10,EGVAVLPVGY,0
4qry,C,244,268,24,SWAYSALDIVAKYIFAFLLLNYLT,0
4c9j,A,-14,9,23,HHHHHHHHHIEGRSMASDAKQQE,0
4c9j,A,14,34,20,NFLMGGVSAAIAKTAASPIE,0
4c9j,A,35,41,6,VKILIQ,0
4c9j,A,42,58,16,QDEMIKQGTLDKKYSG,0
4c9j,A,59,69,10,VDCFKRTAKQ,0
4c9j,A,70,78,8,GLISFWRG,0
4c9j,A,79,97,18,TANVIRYFPTQALNFAFK,0
4c9j,A,98,104,6,KIKLMF,0
4c9j,A,120,142,22,ASGGAAGALSLLFVYSLDFART,0
4c9j,A,143,150,7,LAADAKS,0
4c9j,A,151,155,4,KKGG,0
4c9j,A,156,161,5,RQFNG,0
4c9j,A,162,172,10,TDVYKKTLKS,0
4c9j,A,173,178,5,GIAGL,0
4c9j,A,179,200,21,RGFMPSVVGIVVYRGLYFGMF,0
4c9j,A,205,219,14,LVLTGSLDGSFLAS,0
4c9j,A,221,242,21,LGWVVTTGASTCSYPLDTVRR,0
4c9j,A,243,276,33,MMMTSGQAVKYNGAIDCLKKIVASEGVGSLFKG,0
4c9j,A,277,302,25,GANILRSVAGAGVISMYDQLQMILF,0
3m71,C,1,5,4,NITK,0
3m71,C,6,11,5,FPLPT,0
3m71,C,12,27,15,YFGIPLGLAALSLAW,0
3m71,C,41,61,20,DVLGIVASAVWILFILMYAY,0
3m71,C,62,66,4,LRYY,0
3m71,C,67,75,8,EEVRAEYH,0
3m71,C,76,81,5,PVRFS,0
3m71,C,82,97,15,IALIPITTMLVGDIL,0
3m71,C,105,125,20,EVLIWIGTIGQLLFSTLRVS,0
3m71,C,126,140,14,LWQGGVFEQKSTHP,0
3m71,C,141,154,13,FYLPAVAANFTSA,0
3m71,C,167,185,18,LFFGAGMIAWIIFEPVLL,0
3m71,C,186,200,14,HLRISSLEPQFRAT,0
3m71,C,201,215,14,GIVLAPAFVCVSAY,0
3m71,C,227,245,18,KILWGYGFLQLFFLLRLF,0
3m71,C,246,255,9,WIVEKGLNI,0
3m71,C,256,271,15,LWAFSFGLASMANSA,0
3m71,C,284,307,23,IFAFVFSNVMIGLLVLMTIYKLT,0
3m71,C,308,313,5,GQFFL,0
3qs5,B,1,4,3,EVK,0
3qs5,B,13,32,19,LILAMAGNAVGLGNFLRFP,0
3qs5,B,33,43,10,QAAENGGGAF,0
3qs5,B,44,63,19,IPYIIAFLLVGIPLMWIEW,0
3qs5,B,89,124,35,AKILGVFGLWIPLVVAIYYVYIESWTLGFAIKFLV,0
3qs5,B,125,132,7,LVPEPPP,0
3qs5,B,133,134,1,A,0
3qs5,B,135,166,31,DPDSILRPFKEFLYSYIGVPKGDEPILKPSL,0
3qs5,B,167,185,18,AYIVFLITMFINVSILIR,0
3qs5,B,191,212,21,ERFAKIAMPTLFILAVFLVIR,0
3qs5,B,213,222,9,FLLETPNGT,0
3qs5,B,223,231,8,ADGLNFLW,0
3qs5,B,232,241,9,PDFEKLKDP,0
3qs5,B,242,266,24,VWIAAVGQIFFTLSLGFGAIITYA,0
3qs5,B,277,298,21,SGLTAATLNEKAEVILGGSIS,0
3qs5,B,299,307,8,PAAVAFFG,0
3qs5,B,308,317,9,ANAVAIAKA,0
3qs5,B,319,324,5,FNLGF,0
3qs5,B,326,333,7,LPAIFSQ,0
3qs5,B,334,339,5,AGGTF,0
3qs5,B,340,367,27,GFLWFFLLFFAGLTSSIAQMQPMIAFL,0
3qs5,B,377,396,19,AVLWTAAIVFFSAHLVMFL,0
3qs5,B,397,399,2,KS,0
3qs5,B,400,426,26,DEMDFWAGTIGVVFFGLTELIIFFWI,0
3qs5,B,429,437,8,DKAWEEIN,0
3qs5,B,445,469,24,RIYYYVMRYITPAFLAVLLVVWAR,0
3qs5,B,470,483,13,YIPKIMEETHWTV,0
3qs5,B,484,502,18,ITRFYIIGLFLFLTFLVF,0
3qs5,B,602,604,2,PR,0
3cn6,E,-22,23,45,SHHHHHHSSGLVPRGSHMLEDLMSKEVSEEAQAHQHGKDYVDPPP,0
3cn6,E,41,58,17,IAEFIATLLFLYITVAT,0
3cn6,E,59,75,16,IGHSKETVVCGSVGLL,0
3cn6,E,76,93,17,IAWAFGGMIFVLVYCTA,0
3cn6,E,97,110,13,GHINPAVTFGLFL,0
3cn6,E,119,137,18,LVYMIAQCLGAICGVGLV,0
3cn6,E,138,141,3,AFM,0
3cn6,E,142,147,5,GPYNQ,0
3cn6,E,148,162,14,GGGANSVALGYNKG,0
3cn6,E,163,182,19,ALGAEIIGTFVLVYTVFSA,0
3cn6,E,198,214,16,PLPIGFAVFMVHLATI,0
3cn6,E,215,218,3,ITG,0
3cn6,E,219,232,13,GINPARSFGAAVI,0
3cn6,E,233,242,9,NSNKVWDDQ,0
3cn6,E,243,260,17,IFWVGPFIGAAVAAAYH,0
3cn6,E,267,281,14,AIKALGEFRSNPTN,0
2lz4,B,5,7,2,GA,0
2lz4,B,8,30,22,IGLMVGGVVIATMIVITLVMLK,0
1kb9,I,17,32,15,VGTIFAGAFVFQTVF,0
1kb9,I,33,58,25,TAITSWYENHNKGKLWKDVKARIAA,0
3qs4,B,1,4,3,EVK,0
3qs4,B,13,32,19,LILAMAGNAVGLGNFLRFP,0
3qs4,B,33,41,8,QAAENGGG,0
3qs4,B,42,63,21,FMIPYIIAFLLVGIPLMWIEW,0
3qs4,B,89,124,35,AKILGVFGLWIPLVVAIYYVYIESWTLGFAIKFLV,0
3qs4,B,125,131,6,LVPEPP,0
3qs4,B,132,134,2,,0
3qs4,B,135,166,31,DPDSILRPFKEFLYSYIGVPKGDEPILKPSL,0
3qs4,B,167,184,17,AYIVFLITMFINVSILI,0
3qs4,B,191,212,21,ERFAKIAMPTLFILAVFLVIR,0
3qs4,B,213,222,9,FLLETPNGT,0
3qs4,B,223,231,8,ADGLNFLW,0
3qs4,B,232,243,11,PDFEKLKDPGV,0
3qs4,B,244,265,21,IAAVGQIFFTLSLGVGAIITY,0
3qs4,B,278,297,19,GLTAATLNEKAEVILGGSI,0
3qs4,B,298,318,20,IPAAVAFFGVANAVAIAKAG,0
3qs4,B,319,324,5,FNLGF,0
3qs4,B,326,331,5,LPAIF,0
3qs4,B,332,339,7,QTAGGTF,0
3qs4,B,340,366,26,GFLWFFLLFFAGLTSSIAIMQPMIAF,0
3qs4,B,378,396,18,VLWTAAIVFFSAHLVMFL,0
3qs4,B,397,399,2,KS,0
3qs4,B,400,426,26,DEMDFWAGTIGVVFFGLTELIIFFWI,0
3qs4,B,429,437,8,DKAWEEIN,0
3qs4,B,445,469,24,RIYYYVMRYITPAFLAVLLVVWAR,0
3qs4,B,470,471,1,Y,0
3qs4,B,472,477,5,PKIME,0
3qs4,B,478,483,5,THWTV,0
3qs4,B,484,502,18,ITRFYIIGLFLFLTFLVF,0
3qs4,B,604,608,4,LVPR,0
1kby,H,1,10,9,VGVTAFGNF,0
1kby,H,15,32,17,AIYSFWIFLAGLIYYLQ,0
1kby,H,33,246,213,ENMREGYPLENEDGTPAANQGPFPLPKPKTFILPHGRGTLTVPGPESEDRPIALARTAVSEGFPHAPTGDPMKDGVGPASWVARRDLPELDGHGHNKIKPMKAAAGFHVSAGKNPIGLPVRGCDLEIAGKVVDIWVDIPEQMARFLEVELKDGSTRLLPMQMVKVQSNRVHVNALSSDLFAGIPTIKSPTEVTLLEEDKICGYVAGGLMYAAP,0
1kby,H,247,260,13,RKSVVAAMLAEYA,0
3tls,E,-3,4,7,SAAAQDM,0
3tls,E,5,198,193,SPPPPIADEPLTVNTGIYLIECYSLDDKAETFKVNAFLSLSWKDRRLAFDPVRSGVRVKTYEPEAIWIPEIRFVNVENARDADVVDISVSPDGTVQYLERFSARVLSPLDFRRYPFDSQTLHIYLIVRSVDTRNIVLAVDLEKVGKNDDVFLTGWDIESFTAVVKPANFALEDRLESKLDYQLRISRQYFSYI,0
3tls,E,199,218,19,NIILPMLFILFISWTAFWS,0
3tls,E,222,241,19,ANVTLVVSTLIAHIAFNIL,0
3tls,E,242,255,13,PTNLPKTPYMTYT,0
3tls,E,256,275,19,AIIFMIYLFYFVAVIEVTV,0
3tls,E,292,313,21,RASRIAFPVVFLLANIILAFL,0
3tls,E,314,315,1,F,0
3tls,E,316,317,1,F,0
4mbs,A,-1,18,19,APDYQVSSPIYDINYYTSE,0
4mbs,A,19,32,13,CQKINVKQIAARL,0
4mbs,A,33,57,24,PPLYSLVFIFGFVGNMLVILILIN,0
4mbs,A,65,88,23,DIYLLNLAISDLFFLLTVPFWAH,0
4mbs,A,89,99,10,AAAQWDFGNT,0
4mbs,A,100,127,27,CQLLTGLYFIGFFSGIFFIILLTIDRY,0
4mbs,A,133,139,6,VFALKA,0
4mbs,A,143,165,22,FGVVTSVITWVVAVFASLPNII,0
4mbs,A,166,192,26,TRSQKEGLHYTCSSHFPYSQYQFWKN,0
4mbs,A,193,216,23,QTLKIVILGLVLPLLVMVICYSG,0
4mbs,A,235,261,26,LIFTIMIVYFLFWAPYNIVLLLNTFQ,0
4mbs,A,262,278,16,FFGLNNCSSSNRLDQA,0
4mbs,A,279,301,22,QVTETLGMTHCCINPIIYAFVG,0
4mbs,A,302,312,10,EFRNYLLVFF,0
4mbs,A,314,361,47,HIAKRFCKCCSIFQQEAPERASSVYTRSTGEQEISVGLGRPLEVLFQ,0
2i20,C,1,4,3,AQI,0
2i20,C,5,10,5,GRPEW,0
2i20,C,11,34,23,WLALGTALMGLGTLYFLVKGMGV,0
2i20,C,41,62,21,FYAITTLVPAIAFTMYLSMLL,0
2i20,C,63,79,16,YGLTMVPFGGEQNPIY,0
2i20,C,80,100,20,ARYADWLFTTPLLLLALALL,0
2i20,C,106,127,21,TILALVGADGIMIGTGLVGAL,0
2i20,C,128,133,5,KVYSY,0
2i20,C,134,156,22,FVWWAISTAAMLYILYVLFFGF,0
2i20,C,157,161,4,SKAE,0
2i20,C,171,192,21,KVLRNVTVVLWSAYPVVWLIG,0
2i20,C,193,203,10,EGAGIVPLNI,0
2i20,C,204,226,22,TLLFMVLDVSAKVGFGLILLRS,0
2i20,C,232,249,17,AEAPEPSAGDGAAATSD,0
2wln,D,1,11,10,TGGMKPPARK,0
2wln,D,28,32,4,EKRG,0
2wln,D,37,43,6,YHDLLT,0
2wln,D,46,71,25,PVFITLITGLYLVTNALFALAYLAC,0
2wln,D,72,83,11,DVIENARPGSF,0
2wln,D,84,99,15,DAFFFSVQTMATIGY,0
2wln,D,100,107,7,KLIPIGP,0
2wln,D,108,132,24,ANTLVTLEALCGMLGLAVAASLIY,0
2wln,D,300,301,1,H,0
2ycy,A,31,39,8,GAELLSQQ,0
2ycy,A,41,63,22,AGMSLLMALVVLLIVAGNVLVI,0
2ycy,A,64,81,17,AIGSTQRLQTLTNLFIT,0
2ycy,A,82,103,21,LACADLVVGLLVVPFGATLVV,0
2ycy,A,113,133,20,CELWTSLDVLCVTASIETLC,0
2ycy,A,134,163,29,IAIDRYLAITSPFRYQSLMTRARAKVIIC,0
2ycy,A,164,183,19,VWAISALVSFLPIMMHWWR,0
2ycy,A,187,194,7,QALKCYQ,0
2ycy,A,200,224,24,FVTNRAYAIASSIISFYIPLLIMI,0
2ycy,A,225,239,14,VALRVYREAKEQIR,0
2ycy,A,240,241,1,I,0
2ycy,A,242,294,52,RASKRKRVMLMREHKALKTLGI,0
2ycy,A,295,317,22,MGVFTLCWLPFFLVNIVNVFNR,0
2ycy,A,320,342,22,PDWLFVAFNWLGYANSAMNPII,0
2ycy,A,343,346,3,CRS,0
2ycy,A,347,356,9,DFRKAFKRL,0
2ycy,A,357,359,2,AF,0
2ycy,A,360,373,13,RKADRRLHHHHHH,0
2n5s,A,44,66,22,SIATGMVGALLLLLVVALGIGL,0
2n5s,A,67,92,25,MRRRHIVRKRTLRRLLQERELVEGG,0
4tlm,D,26,29,3,HPN,0
4tlm,D,30,382,352,DIAVILVGTTEEVAIKDVHEKDDFHHLPVTPRVELVTMQESDPKSIITRICDLMSDKKVQGVVFGDDTDQEAIAQILDFISVQTLTPILGIHGGSSMIMADKEEASMFFQFGPSIEQQASVMLNIMEEYDWYIFSIVTTYFPGYQDFENKVRSTIENSFVGWELEEVIHLDMSLDDIDSKIQNQLCKLQSPVILLYCTKEEATYIFEVAHSVGLTGYGFTWIVPSLVAGDTDTVPDEFPTGLISVSYDEWDYDLPARVRDGIAIITTAASTMLSEHNSIPQSKSSCNNIQESRVYEAHMLKRYLINVTFEGRDLSFSEDGYQMHPKLVIILLNQERKWERVGKYKDRSLKMW,0
4tlm,D,383,396,13,VFDLYPNSEEHKD,0
4tlm,D,397,433,36,HLSIVTLEEAPFVIVEDVDPLSGTCMRNTVPCRKQI,0
4tlm,D,434,445,11,PENRTEEGGNY,0
4tlm,D,446,536,90,KRCCKGFCIDILKKIAKTVKFTYDLYLVTNGKHGKKINGVWNGMIGEVVTKRAYMAVGSLTINEERSEVVDFSVPFIETGISVMVSRSNG,0
4tlm,D,537,540,3,VSP,0
4tlm,D,541,551,10,AFLEPFSADV,0
4tlm,D,552,568,16,VMMFVMLLIVSAVAVF,0
4tlm,D,572,582,10,FSPVGYNGPS,0
4tlm,D,586,603,17,KAIWLLWGLVFNNSLPV,0
4tlm,D,611,627,16,KIMVSVWAFFAVIFLA,0
4tlm,D,628,788,160,YTANLAAFMIQRRYVDQVSGLSDKKFQRPNDFSPAFRFGTVPNGSTERNIRNNYLEMHSYMVKFNQRSVQDALLSLKSGKLDAFIYDAAVLNYMAGRDEGCKLVTIGSGKVFATTGYGIAIQKDSGWKRQVDLAILQLFGDGEMEELEALWLTGICHNEK,0
4tlm,D,789,793,4,EVMS,0
4tlm,D,794,805,11,QLDIDNMAGVF,0
4tlm,D,806,825,19,MLAAAMALSLITFIMEHLF,0
4tlm,D,829,843,14,AEAKRMKGLEVLFQ,0
2w8a,C,30,56,26,ENPTNLEGKLADAAAAIILEGEDTQA,0
2w8a,C,57,60,3,LNW,0
2w8a,C,61,76,15,VIVPALVIVLATVVW,0
2w8a,C,99,116,17,GWAFILFGTVFVFFIVV,0
2w8a,C,117,142,25,AASKFGTIRLGRIDEAPEFRTVSWI,0
2w8a,C,143,158,15,MMFAAGMGIGLMFYG,0
2w8a,C,183,201,18,TTMFHWTLHPWAIYAIVG,0
2w8a,C,202,236,34,AIAYSTFRVGRKQLLSSAFVPLIGEKGAEGWLGK,0
2w8a,C,237,258,21,IDILAIIATVFGTACSLGLGA,0
2w8a,C,273,274,1,P,0
2w8a,C,284,299,15,VLTLAFIFSAISGVG,0
2w8a,C,301,322,21,IQYLSNANMVLAALLAIFVFV,0
2w8a,C,330,351,21,NLLPGSIGNYLSNFFQMAGRT,0
2w8a,C,368,385,17,FYWAWWISWSPFVGMFL,0
2w8a,C,386,398,12,RISRGRSIREFI,0
2w8a,C,399,416,17,GVLLVPAGVSTVWFSIF,0
2w8a,C,456,477,21,AMILLGTFFITSADSASTVMG,0
2w8a,C,478,489,11,MSQHGQLEANK,0
2w8a,C,490,506,16,VTAAWGVATAAIGLTL,0
2w8a,C,519,538,19,NVTIVAATPFLFVVIGLMF,0
2w8a,C,539,568,29,LVKDLSNDVIYLEYREQQRFNARLARERR,0
2w8a,C,569,595,26,HNEHRKRELAAKRRRERKASGAGKRR,0
3ouf,E,18,20,2,AK,0
3ouf,E,25,45,20,VLFVLTILTLISGTIFYSTV,0
3ouf,E,46,50,4,GLRP,0
3ouf,E,51,67,16,DALYFSVVTLTTVGYG,0
3ouf,E,68,74,6,FSPQTD,0
3ouf,E,75,99,24,GKIFTILYIFIGIGLVFGFIHKLA,0
3ouf,E,103,109,6,LPSILS,0
2now,C,15,32,17,CTALVLFMTIPGIALFY,0
2now,C,33,45,12,GLIRGKNVLSML,0
2now,C,46,64,18,QVTVTFALVCILWVVYGY,0
2now,C,102,118,16,FQGSFACITVGLIVGA,0
2now,C,119,126,7,AERIRFS,0
2now,C,127,147,20,VLIFVVVWLTLSYIPIAHMV,0
2now,C,161,178,17,AGGTVVEINAAIAGLVG,0
2now,C,179,182,3,YLI,0
2now,C,183,194,11,KRVGFGKEAFK,0
2now,C,195,201,6,HNLPMV,0
2now,C,202,219,17,TGTAILYIGWFGFNAGS,0
2now,C,231,248,17,VNTVVATAAAILGWIFG,0
2now,C,249,260,11,WALRGKPSLLG,0
2now,C,261,276,15,CSGAIAGLVGVTPAC,0
2now,C,282,299,17,GALIIGVVAGLAGLWGV,0
2now,C,300,303,3,MLK,0
2now,C,304,308,4,LLRV,0
2now,C,309,313,4,DPCD,0
2now,C,314,332,18,FGVHGVCGIVGCIMTGIF,0
2now,C,353,377,24,VQLESIAITIVWSGVVAFIGYKLA,0
2now,C,378,386,8,LTVGLRVP,0
2now,C,387,424,37,EQEREGLDVNSHGENAYNADQAQQPAQADLEHHHHHH,0
5bz3,B,4,24,20,EHLLEIFYLLLAAQVCAFIF,0
5bz3,B,30,46,16,VVIGEVLAGVLVGPAL,0
5bz3,B,48,72,24,LVHEGEILEFLAELGAVFLLFMVG,0
5bz3,B,85,106,21,EAFLVAVLGVALPFLGGYLYG,0
5bz3,B,107,117,10,EIGFETLPAL,0
5bz3,B,118,134,16,LGTALVATSVGITARV,0
5bz3,B,149,167,18,LGAAVIDDVLGLIVLACV,0
5bz3,B,168,178,10,GVAETGQVEV,0
5bz3,B,179,198,19,AITRLIVLSVVFVGLAVFL,0
5bz3,B,218,233,15,ALALGVGMAALAASI,0
5bz3,B,235,245,10,APIVGAFLGG,0
5bz3,B,265,285,20,SFLAPIFFAMVGVRLELSAL,0
5bz3,B,286,290,4,SPVV,0
5bz3,B,291,313,22,VAGTVVTVIAILGKVLGGFLGA,0
5bz3,B,322,339,17,TVGCGMAPRGEVGLIVA,0
5bz3,B,340,354,14,LGLKAGAVNEEEYA,0
5bz3,B,355,372,17,VLFMVVFTTLFAPFALK,0
1k9n,E,40,49,9,CLLLICIIV,0
1k9n,E,50,52,2,LL,0
4xu4,C,9,26,17,VLFLLGAVAALIGDHSH,0
4xu4,C,27,40,13,VTGTTVYHTDAVP,0
4xu4,C,41,61,20,VWSSPFWFPILVGAATASLA,0
4xu4,C,80,97,17,GGVAAVVGTYVTTALVH,0
4xu4,C,98,101,3,FPV,0
4xu4,C,102,118,16,PVTALVCAAAAITWCV,0
4xu4,C,125,142,17,ACGVVIAVIGPAVEIAL,0
4xu4,C,143,160,17,QLGVFAYHPDSDGLFGV,0
4xu4,C,161,176,15,PFLAPLYFAFGVVAA,0
2kpf,A,73,95,22,TLIIFGVMAGVIGTILLISYGI,0
2kpf,A,96,98,2,RL,0
4ayt,B,151,153,2,AG,0
4ayt,B,155,165,10,EARKLLGLAY,0
4ayt,B,166,167,1,E,0
4ayt,B,168,189,21,RRLAAAVGFLTMSSVISMSAP,0
4ayt,B,219,239,20,AVFLCGAAANAIRVYLMQTS,0
4ayt,B,240,285,45,QRIVNRLRTSLFSSILRQEVAFFDKTRTGELINRLSSDTALLGRS,0
4ayt,B,286,308,22,TENLSDGLRAGAQASVGISMMF,0
4ayt,B,316,337,21,FVLSVVPPVSIIAVIYGRYLR,0
4ayt,B,338,391,53,LTKVTQDSLAQATQLAEERIGNVRTVRAFGKEMTEIEKYASKVDHVMQLARKE,0
4ayt,B,392,413,21,FARAGFFGATGLSGNLIVLSV,0
4ayt,B,435,455,20,MYAFWVGISIGGLSSFYSEL,0
4ayt,B,456,1717,1261,KGLGAGGRLWELLEREPKLPFNEGVILNEKSFQGALEFKNVHFAYPARPEVPIFQDFSLSIPSGSVTALVGPSGSGKSTVLSLLLRLYDPASGTISLDGHDIRQLNPVWLRSKIGTVSQEPILFSCSIAENIAYGADDPSSVTAEEIQRVAEVANAVAFIRNFPQGFNTVVGEKGVLLSGGQKQRIAIARALLKNPKILLLDEATSALDAENEYLVQEALDRLMDGRTVLVIAHRLSTIKNANMVAVLDQGKITEYGKHEEG,0
4ayt,B,1718,1744,26,SKPNGIYRKLMNKQSFISAAENLYFQ,0
4cbk,M,1,4,3,AFL,0
4cbk,M,5,17,12,AAIAAGLAAVAG,0
4cbk,M,55,68,13,VPIIAIVISLLIL,0
3d31,D,-22,12,34,GHHHHHHHHHHSSGENLYFQGHMKAKNRKTRKFE,0
3d31,D,13,16,3,LTF,0
3d31,D,17,39,22,FSFLLLVLFLFIFLTLSNMIFE,0
3d31,D,45,53,8,SGLVKAAG,0
3d31,D,62,83,21,LSLYAGFLATLLALLLGAPTG,0
3d31,D,84,95,11,ILARFDFPGKR,0
3d31,D,96,116,20,VESIIDVPVVVPHTVAGIAL,0
3d31,D,141,159,18,GIVVAMLFVSMPYLANSA,0
3d31,D,160,180,20,EGFKSVDPRLENAARSLGAP,0
3d31,D,181,187,6,WKAFFF,0
3d31,D,188,197,9,TLPLSARYL,0
3d31,D,198,215,17,IGSVMTWARAISEFGAV,0
3d31,D,246,260,14,LLILVTLSIFLVIR,0
3d31,D,261,272,11,LSAGWSIYDRD,0
3hpl,F,1,26,25,APMLSGLLARLVKLLLGRHGSALHW,0
3hpl,F,30,50,20,AATVLLVIVLLAGSYLAVLA,0
3hpl,F,51,62,11,RGAPGAQLITY,0
3hpl,F,63,79,16,RALWWSVHTATTVGYG,0
3hpl,F,80,86,6,LYPVTL,0
3hpl,F,87,107,20,GRCVAVVVMVAGITSAGLVT,0
3hpl,F,121,124,3,RGH,0
2boz,M,53,72,19,SLGVLSLFSGLMWFFTIGI,0
2boz,M,73,81,8,FWYQAGWN,0
2boz,M,82,87,5,AVFLR,0
2boz,M,88,117,29,LFFFSLEPPAPEYGLSFAAPLKEGGLWLI,0
2boz,M,118,134,16,SFFMFVAVWSWWGRTY,0
2boz,M,145,163,18,TAWAFLSAIWLWMVLGFI,0
2boz,M,164,178,14,PILMGSWSEAVPYG,0
2boz,M,179,192,13,FSHLDWTNNFSLV,0
2boz,M,193,200,7,GNLFYNP,0
2boz,M,201,221,20,HLLSIAFLYGSALLFAMHGA,0
2boz,M,268,285,17,AIWMAVLVTLTGGIGIL,0
2boz,M,286,293,7,SGTVVDN,0
2boz,M,294,299,5,YVWGQ,0
2boz,M,300,302,2,HG,0
2boz,M,303,307,4,APLN,0
4hfh,E,1,4,3,QDM,0
4hfh,E,5,198,193,SPPPPIADEPLTVNTGIYLIECYSLDDKAETFKVNAFLSLSWKDRRLAFDPVRSGVRVKTYEPEAIWIPEIRFVNVENARDADVVDISVSPDGTVQYLERFSARVLSPLDFRRYPFDSQTLHIYLIVRSVDTRNIVLAVDLEKVGKNDDVFLTGWDIESFTAVVKPANFALEDRLESKLDYQLRISRQYFSYI,0
4hfh,E,199,218,19,NIILPMLFILFISWTAFWS,0
4hfh,E,222,240,18,ANVTLVVSTLIAHIAFNI,0
4hfh,E,241,255,14,VETNLPKTPYMTYT,0
4hfh,E,256,275,19,AIIFMIYLFYFVAVIEVTV,0
4hfh,E,293,313,20,ASRIAFPVVFLLANIILAFL,0
4hfh,E,314,315,1,F,0
4hfh,E,316,317,1,F,0
3tu0,B,1,4,3,EVK,0
3tu0,B,13,32,19,LILAMAGNAVGLGNFLRFP,0
3tu0,B,33,43,10,QAAENGGGAF,0
3tu0,B,44,63,19,IPYIIAFLLVGIPLMWIEW,0
3tu0,B,89,124,35,AKILGVFGLWIPLVVAIYYVYIESWTLGFAIKFLV,0
3tu0,B,125,132,7,LVPEPPP,0
3tu0,B,133,134,1,A,0
3tu0,B,135,166,31,DPDSILRPFKEFLYSYIGVPKGDEPILKPSL,0
3tu0,B,167,184,17,AYIVFLITMFINVSILI,0
3tu0,B,191,212,21,ERFAKIAMPTLFILAVFLVIR,0
3tu0,B,213,222,9,FLLETPNGT,0
3tu0,B,223,230,7,ADGLNFL,0
3tu0,B,231,243,12,TPDFEKLKDPGV,0
3tu0,B,244,265,21,IAAVGQIFFTLSLGFGAIITY,0
3tu0,B,278,297,19,GLTAATLNEAAEVILGGSI,0
3tu0,B,298,325,27,IPAAVAFFGVANAVAIAKAGAFNLGFI,0
3tu0,B,326,331,5,LPAIF,0
3tu0,B,332,339,7,QTAGGTF,0
3tu0,B,340,367,27,GFLWFFLLFFAGLVASIAIMQPMIAFL,0
3tu0,B,378,396,18,VLWTAAIVFFSAHLVMFL,0
3tu0,B,397,399,2,KS,0
3tu0,B,400,426,26,DEMDFWAGTIGVVFFGLTELIIFFWI,0
3tu0,B,429,437,8,DKAWEEIN,0
3tu0,B,445,469,24,RIYYYVMRYITPAFLAVLLVVWAR,0
3tu0,B,470,472,2,YI,0
3tu0,B,473,478,5,KIMEE,0
3tu0,B,479,483,4,HWTV,0
3tu0,B,484,502,18,ITRFYIIGLFLFLTFLVF,0
3tu0,B,602,604,2,PR,0
2eik,Z,21,35,14,TFLSFLLPAGWVLY,0
2eik,Z,36,43,7,LDNYKKS,0
2eik,Z,44,46,2,AA,0
2kdc,C,1,6,5,NNTTG,0
2kdc,C,7,15,8,TRIIKAAG,0
2kdc,C,17,24,7,WKGLRAA,0
2kdc,C,25,33,8,INEAAFRQ,0
2kdc,C,34,51,17,GVAVLLAVVIACWLDVD,0
2kdc,C,53,66,13,TRVLLISSVMLVM,0
2kdc,C,67,99,32,VEILNSAIEAVVDRIGSEYHELSGRAKDMGSA,0
2kdc,C,100,119,19,VLIAIIVAVITWCILLWSH,0
5ule,B,18,21,3,HRN,0
5ule,B,22,35,13,LIVLADVALFLAL,0
5ule,B,51,64,13,LAFIAVLWLTEAL,0
5ule,B,66,76,10,TVTAILVPVM,0
5ule,B,90,106,16,NFANSIIFLFLGGFAL,0
5ule,B,107,190,83,AAMHHQGLDKVIADKVLAMAQGKMSVAVFMLFGVTALLSMWISNTATAAMMLPLVLGVLSKVDADKQRSTYVFVLLGVAYSAS,0
5ule,B,191,209,18,GGIATLVGTGPNAIAAAE,0
5ule,B,213,229,16,FTDWMKFGLPTAMMML,0
5ule,B,230,266,36,MAIAILYFLLKPTLNGMFELDRAPVNWDKGKVVTLG,0
5ule,B,267,278,11,FGLTVFLWIFS,0
5ule,B,291,306,15,DTLVALGAILMLSFA,0
5ule,B,307,318,11,VVHWKEIQKTA,0
5ule,B,319,332,13,WGILLLFGGGLCL,0
5ule,B,360,376,16,VILVVATFVVFLTEFT,0
5ule,B,378,389,11,VATTTLLIPVF,0
5ule,B,403,414,11,SVLIAVAASCA,0
5ule,B,415,445,30,MLPVATPPNAIVFASGHIKQSEMMRVGLYL,0
5ule,B,446,460,14,IACIGLLTAIAMLF,0
1nen,L,1,2,1,V,0
1nen,L,16,35,19,ILVRATAIVLTLYIIYMVG,0
1nen,L,36,56,20,FATSGELTYEVWIGFFASAF,0
1nen,L,57,80,23,KVFTLLALFSILIHAWIGMWQVL,0
1nen,L,89,110,21,RLMLQLVIVVALVVYVIYGFV,0
1nen,L,111,115,4,VWGV,0
5wue,C,9,25,16,DIFNYIGIVAFAISGA,0
5wue,C,26,35,9,KAVKKGMDL,0
5wue,C,36,57,21,GVLVLGFSTALGGGIISNLLL,0
5wue,C,63,83,20,NLIYYPYPITAFLASLATFV,0
5wue,C,84,94,10,YRIFTNVGKP,0
5wue,C,95,112,17,LYADAIGLGAFASSGAS,0
5wue,C,122,142,20,LVVIVGAITAVGGGVIRDIL,0
5wue,C,143,154,11,NEVPLILTREF,0
5wue,C,155,169,14,ATTAVIGSFVYFIA,0
5wue,C,180,195,15,IVSFLITLILRILAM,0
5wue,C,196,209,13,LKWELPRKKIEAA,0
3abw,D,1,17,16,TETLPPVTESAVALQA,0
3abw,D,18,20,2,VT,0
3abw,D,21,28,7,RELFEFV,0
3abw,D,29,36,7,NDPLLAS,0
3abw,D,37,55,18,LYINIALAGLSILLFVFM,0
3abw,D,69,87,18,STILVPVVSIASYTGLAS,0
3abw,D,88,120,32,LTISVLEMPAGHFAEGSSVMLGGEEVDGVVTM,0
3abw,D,121,138,17,GRYLTWALSTPMILLAL,0
3abw,D,150,168,18,TAITFDIAMCVTGLAAAL,0
3abw,D,169,174,5,TSSHL,0
3abw,D,175,195,20,RWFWYAISCACFIVVLYILL,0
3abw,D,214,232,18,KLLTVVMWLGYPIVWALG,0
3abw,D,233,243,10,EGVAVLPVGY,0
3abw,D,244,264,20,SWAYSALDIVAKYIFAFLLL,0
3abw,D,277,291,14,ILDVPSASGAPADD,0
5ee7,A,138,147,9,SSFQVMYTV,0
5ee7,A,148,167,19,YSLSLAALLLALAILGGLS,0
5ee7,A,173,190,17,NAIHANLFLSFVLKASA,0
5ee7,A,191,200,9,LFIDGLLRT,0
5ee7,A,212,230,18,STWLSDGAVAACRVAAVF,0
5ee7,A,231,248,17,QYGIVANYCWLLVEGLY,0
5ee7,A,263,281,18,FSLYLGIGWGAPALFVVP,0
5ee7,A,282,296,14,AVVKCLFENVQCWT,0
5ee7,A,300,306,6,MGFWWI,0
5ee7,A,307,323,16,RFPVFLAILINFFIFV,0
5ee7,A,350,368,18,TLTLIPLLGVHFVVFAFV,0
5ee7,A,369,372,3,DEH,0
5ee7,A,378,384,6,SAKLFF,0
5ee7,A,385,404,19,LALSSFQGLLVAVLYCFLN,0
5ee7,A,405,417,12,EVQSELRRRWHR,0
2b6r,A,1,15,14,EWDNGTGQALGLPP,0
2b6r,A,16,28,12,TCVYRENFKQLL,0
2b6r,A,29,53,24,PPVYSAVLAAGLPLNICVITQICT,0
2b6r,A,64,84,20,TLNLALADLLYACSLPLLIY,0
2b6r,A,85,100,15,YAQGDHWPFGDFACR,0
2b6r,A,101,119,18,VRFLFYANLHGSILFLTC,0
2b6r,A,146,169,23,VCVAVWLAVTTQCLPTAIFAATG,0
2b6r,A,170,189,19,QRNRTVCYDLSPPALATHY,0
2b6r,A,190,209,19,PYGMALTVIGFLLPFAALL,0
2b6r,A,244,264,20,AAAFAISFLPFHITKTAYLA,0
2b6r,A,265,282,17,RSTPGVPCTVLEAFAAA,0
2b6r,A,283,303,20,KGTRPFASANSVLDPILFYF,0
2b6r,A,306,314,8,KFRRRPHE,0
5egi,C,11,23,12,EILLDAGAQLHR,0
5egi,C,25,43,18,MYPYFDVAHYLLMIIEVR,0
5egi,C,44,54,10,DLGSAASIFS,0
5egi,C,55,82,27,KHPLSCWLSSMLMCFADAFLANFLLGE,0
5egi,C,84,110,26,IAPFKRHDDIILATIIWYLVFYAPFD,0
5egi,C,112,141,29,YKIAKITPVKCVLAVMKEVKRAYKVSHGV,0
5egi,C,153,178,25,VQVLVGTAKGAGSGIVRTLEQLVRG,0
5egi,C,179,187,8,WLPTHNEL,0
5egi,C,188,205,17,RPSFATKACVVAASVLA,0
5egi,C,220,237,17,YLVIVGFFVYFKLSAVI,0
5egi,C,238,239,1,H,0
2lou,A,1,30,29,EEGGDFDNYYGADNQSECEYTDWKSSGAL,0
2lou,A,31,52,21,PAIYMLVFLLGTTGNGLVLWT,0
3f3e,B,1,4,3,EVK,0
3f3e,B,13,35,22,LILAMAGNAVGLGNFLRFPVQA,0
3f3e,B,36,43,7,ENGGGAF,0
3f3e,B,44,63,19,IPYIIAFLLVGIPLMWIEW,0
3f3e,B,89,124,35,AKILGVFGLWIPLVVAIYYVYIESWTLGFAIKFLV,0
3f3e,B,125,132,7,LVPEPPP,0
3f3e,B,133,134,1,A,0
3f3e,B,135,166,31,DPDSILRPFKEFLYSYIGVPKGDEPILKPSL,0
3f3e,B,167,185,18,AYIVFLITMFINVSILIR,0
3f3e,B,191,212,21,ERFAKIAMPTLFILAVFLVIR,0
3f3e,B,213,222,9,FLLETPNGT,0
3f3e,B,223,231,8,ADGLNFLW,0
3f3e,B,232,241,9,PDFEKLKDP,0
3f3e,B,242,266,24,VWIAAVGQIFFTLSLGFGAIITYA,0
3f3e,B,277,298,21,SGLTAATLNEKAEVILGGSIS,0
3f3e,B,299,307,8,PAAVAFFG,0
3f3e,B,308,317,9,ANAVAIAKA,0
3f3e,B,318,325,7,AFNLGFI,0
3f3e,B,326,331,5,LPAIF,0
3f3e,B,332,339,7,QTAGGTF,0
3f3e,B,340,367,27,GFLWFFLLFFAGLTSSIAIMQPMIAFL,0
3f3e,B,378,396,18,VLWTAAIVFFSAHLVMFL,0
3f3e,B,397,399,2,KS,0
3f3e,B,400,426,26,DEMDFWAGTIGVVFFGLTELIIFFWI,0
3f3e,B,429,437,8,DKAWEEIN,0
3f3e,B,445,469,24,RIYYYVMRYITPAFLAVLLVVWAR,0
3f3e,B,470,483,13,YIPKIMEETHWTV,0
3f3e,B,484,502,18,ITRFYIIGLFLFLTFLVF,0
3f3e,B,602,604,2,PR,0
4x89,F,126,130,4,SHMG,0
4x89,F,136,153,17,LLTVVFYIAAVMATNLY,0
4x89,F,154,163,9,ATFPEWFGD,0
4x89,F,164,185,21,SKSLYTLFQVMTLESWSMGIV,0
4x89,F,186,193,7,PVMNVHP,0
4x89,F,194,211,17,AWVFFIPFIMLTTFTVL,0
4x89,F,221,274,53,MAITKEQEEEAKTGHHQEPISQTLLHLGDRLDRIEKQLAQNNELLQRQQPQKK,0
4jr9,A,-2,11,13,SHMSHSSAPERAT,0
4jr9,A,41,57,16,VPCLLLAFCVWMLFSA,0
4jr9,A,58,76,18,AVNLPKVGFNFTTDQLFM,0
4jr9,A,77,93,16,TALPSVSGALLRVPYS,0
4jr9,A,105,120,15,AFSTGILIIPCVWLG,0
4jr9,A,121,134,13,AVQDTSTPYSVFI,0
4jr9,A,135,150,15,ISLLCGFAGANFASS,0
4jr9,A,170,188,18,GGLGNMGVSVMQLVAPLV,0
4jr9,A,189,190,1,S,0
4jr9,A,191,211,20,SIFAVFGSQGVKQPDGTELY,0
4jr9,A,212,214,2,AN,0
4jr9,A,215,231,16,SWIWVPFLAIFTIAAW,0
4jr9,A,239,255,16,SKASIKEQLPVLKRGH,0
4jr9,A,258,277,19,MSLLYLATFGSFIGFSAGF,0
4jr9,A,278,292,14,MLSKTQFPDVQILQ,0
4jr9,A,293,309,16,AFFGPFIGALARSAGG,0
4jr9,A,319,335,16,VTLVNFILMAIFSGLL,0
4jr9,A,336,352,16,LTLPTDGQGGSFMAFF,0
4jr9,A,353,370,17,VFLALFLTAGLGSGSTF,0
4jr9,A,409,424,15,ISAIGAIGGFFIPKA,0
4jr9,A,425,438,13,GSSLALTGSPVGA,0
4jr9,A,439,456,17,KVFLIFYIACVVITWAV,0
4jr9,A,459,463,4,HSKK,0
2yvx,B,-22,6,28,GSSHHHHHHSSGLGVLPGGPLHMEEKLA,0
2yvx,B,7,281,274,SLQEALQEGDTRALREVLEEIHPQDLLALWDELKGEHRYVVLTLLPKAKAAEVLSHLSPEEQAEYLKTLPPWRLREILEELSLDDLADALQAVRKEDPAYFQRLKDLLDPRTRAEVEALARYEEDEAGGLMTPEYVAVREGMTVEEVLRFLRRAAPDAETIYYIYVVDEKGRLKGVLSLRDLIVADPRTRVAEIMNPKVVYVRTDTDQEEVARLMADYDFTVLPVVDEEGRLVGIVTVDDVLDVLEAEATEDIHKLGAVDVPDLVYSEAGPVAL,0
2yvx,B,282,305,23,LARVRWLVILILTGMVTSSILQG,0
2yvx,B,318,336,18,YVPVLLGTGGNTGNQSAT,0
2yvx,B,337,355,18,IIRALATRDLDLRDWRRV,0
2yvx,B,356,381,25,LKEMGVGLLLGLTLSFLLVGKVYWD,0
2yvx,B,388,409,21,VVGVSLVLIVFFANLVGAMLP,0
2yvx,B,410,422,12,LLRRLGVDPALV,0
2yvx,B,423,443,20,NPLVATLSDVTGLLIYLSVA,0
2yvx,B,449,450,1,V,0
4q2e,B,1,23,22,GSSHHHHHHSSGLVPRGSHMDD,0
4q2e,B,25,45,20,TRVITASVVAPFVVLCFVSY,0
4q2e,B,47,67,20,LIGLVSAILILAGYELITLE,0
4q2e,B,72,92,20,ARFFYVILLALYPVLYGLVF,0
4q2e,B,94,114,20,PTQPLSILFITGVVFSLITD,0
4q2e,B,121,145,24,KTVAAFSIALIYVTFFLSFFLPIY,0
4q2e,B,146,150,4,DFGA,0
4q2e,B,151,177,26,NALLVLTSTWVFDSFAYFTGLKFGRT,0
4q2e,B,185,206,21,RKSLEGVIGGFLGVVIYTFLY,0
4q2e,B,207,223,16,LVVNDLLSVNVICFRT,0
4q2e,B,224,246,22,LPFAATVAIMDTFGDIFECALK,0
4q2e,B,261,284,23,GGMLDRIDGLLFVAPVSYIVFKI,0
4q2e,B,285,290,5,EGVVR,0
3a7k,D,1,18,17,TETLPPVTESAVALQAE,0
3a7k,D,19,20,1,T,0
3a7k,D,21,28,7,RELFEFV,0
3a7k,D,29,36,7,NDPLLAS,0
3a7k,D,37,54,17,LYINIALAGLSILLFVF,0
3a7k,D,70,87,17,TILVPVVSIASYTGLAS,0
3a7k,D,88,120,32,LTISVLEMPAGHFAEGSSVMLGGEEVDGVVTM,0
3a7k,D,121,136,15,GRYLTWALSTPMILL,0
3a7k,D,152,168,16,ITFDIAMCVTGLAAAL,0
3a7k,D,169,174,5,TSSHL,0
3a7k,D,175,192,17,RWFWYAISCACFIVVLY,0
3a7k,D,217,232,15,TVVMWLGYPIVWALG,0
3a7k,D,233,243,10,EGVAVLPVGY,0
3a7k,D,244,261,17,SWAYSALDIVAKYIFAF,0
3a7k,D,278,291,13,LDVPSASGAPADD,0
4aa3,B,120,153,33,MRGPPAWAGDEAWRRGPAAPPGDKGRLRPAAAG,0
4aa3,B,155,168,13,EARKLLGLAYPER,0
4aa3,B,169,193,24,RLAAAVGFLTMSSVISMSAPFFLG,0
4aa3,B,194,214,20,IIDVIYTNPTVDYSDNLTRL,0
4aa3,B,215,237,22,LGLSAVFLCGAAANAIRVYLMQ,0
4aa3,B,288,312,24,NLSDGLRAGAQASVGISMMFFVSP,0
4aa3,B,314,336,22,ATFVLSVVPPVSIIAVIYGRYL,0
4aa3,B,393,417,24,ARAGFFGATGLSGNLIVLSVLYKG,0
4aa3,B,418,430,12,LLMGSAHMTVGE,0
4aa3,B,431,453,22,SSFLMYAFWVGISIGGLSSFYS,0
4aa3,B,660,663,3,TSA,0
4aa3,B,718,738,20,LSKPNGIYRKLMNKQSFISA,0
2bbj,F,-2,8,10,SHMEEKRLSA,0
2bbj,F,9,292,283,KGLPPGTLVYTGKYREDFEIEVMNYSIEEFREFKTTDVESVLPFRDSSTPTWINITGIHRTDVVQRVGEFFGIHPLVLEDILNVHQRPKVEFFENYVFIVLKMFTYDKNLHELESEQVSLILTKNCVLMFQEKIGDVFDPVRERIRYNRGIIRKKRADYLLYSLIDALVDDYFVLLEKIDDEIDVLEEEVLERPEKETVQRTHQLKRNLVELRKTIWPLREVLSSLYRDVPPLIEKETVPYFRDVYDHTIQIADTVETFRDIVSGLLDVYLSSVSNKTNEVMK,0
2bbj,F,293,313,20,LTIIATIFMPLTFIAGIYGM,0
2bbj,F,316,322,6,YMPELR,0
2bbj,F,327,347,20,PVVLAVMGVIAVIMVVYFKK,0
2bbj,F,348,349,1,K,0
2bbj,F,350,351,1,L,0
2lly,A,1,3,2,,0
2lly,A,4,11,7,ELPLFYT,0
2lly,A,12,32,20,NLIIPCLLISCLTVLVFYLP,0
2lly,A,38,57,19,ITLCISVLLSLTVFLLLIT,0
2lly,A,58,70,12,IIPSTSSVSPSI,0
2lly,A,71,91,20,EYLLFTMIFVTLSIVITVFV,0
2lly,A,109,129,20,DRIFLWMFIIVCLLGTVGLF,0
2lly,A,130,137,7,PPWLAGE,0
4rwa,B,1002,46,-956,LEDNWETLNDNLKVIEKADNAAQVKDALTKMRAAALDAQKATPPKLEDKSPDSPEMKDFRHGFDILVGQIDDALKLANEGKVKEAQAAAEQLKTTRNAYIQKYLGARSASSL,0
4rwa,B,47,68,21,LAIAITALYSAVCAVGLLGNV,0
4rwa,B,90,110,20,LALADALATSTLPFQSAKYL,0
4rwa,B,111,114,3,ETW,0
4rwa,B,115,141,26,FGELLCKAVLSIDYYNMFTSIFTLTM,0
4rwa,B,168,187,19,NICIWVLASGVGVPIMVMA,0
4rwa,B,188,211,23,TRPRDGAVVCMLQFPSPSWYWDT,0
4rwa,B,212,232,20,TKICVFLFAFVVPILIITVC,0
4rwa,B,266,284,18,VGAFVVCWAPIHIFVIVW,0
4rwa,B,285,295,10,LVDIDRRDPL,0
4rwa,B,296,316,20,VAALHLCIALGYANSSLNPV,0
1cwq,E,0,1,1,Q,0
1cwq,E,13,30,17,ALGTALMGLGTLYFLVK,0
1cwq,E,31,43,12,MGVSDPDAKKFY,0
1cwq,E,44,60,16,ITTLVPAIAFTMYLSM,0
1cwq,E,81,97,16,RYADWLFTTPLLLLDL,0
1cwq,E,98,108,10,LLVDADQGTI,0
1cwq,E,109,125,16,ALVGADGIMIGTGLVG,0
1cwq,E,136,153,17,WWAISTAAMLYILYVLF,0
1cwq,E,154,174,20,GFTSKAESMRPEVASTFKVL,0
1cwq,E,175,190,15,NVTVVLWSAYPVVWL,0
1cwq,E,205,223,18,LLFMVLDVSAKVGFGLIL,0
1cwq,E,224,239,15,RSRAIFGEAEAPEPS,0
1cwq,E,240,247,7,DGAAATS,0
5jaf,A,13,31,18,LILAMAGNAVGLGNFLRF,0
5jaf,A,32,43,11,VQAAENGGGAF,0
5jaf,A,44,63,19,IPYIIAFLLVGIPLMWIEW,0
5jaf,A,93,117,24,GVFGLWIPLVVAIYYVYIESWTLG,0
5jaf,A,118,124,6,AIKFLV,0
5jaf,A,125,130,5,LVPEP,0
5jaf,A,135,167,32,DPDSILRPFKEFLYSYIGVPKGDEPILKPSLF,0
5jaf,A,168,184,16,YIVFLITMFINVSILI,0
5jaf,A,191,211,20,ERFAKIAMPTLFILAVFLVI,0
5jaf,A,212,222,10,VFLLETPNGT,0
5jaf,A,223,230,7,ADGLNFL,0
5jaf,A,231,232,1,T,0
5jaf,A,235,243,8,EKLKDPGV,0
5jaf,A,244,265,21,IAAVGQIFFTLSLGFGAIITY,0
5jaf,A,279,296,17,LTAATLNEKAEVILGGS,0
5jaf,A,297,318,21,SIPAAVAFFGVANAVAIAKAG,0
5jaf,A,319,324,5,FNLGF,0
5jaf,A,326,333,7,LPAIFSQ,0
5jaf,A,334,342,8,AGGTFLGF,0
5jaf,A,343,364,21,WFFLLFFAGLTSSIAIMQPMI,0
5jaf,A,379,394,15,LWTAAIVFFSAHLVM,0
5jaf,A,395,399,4,LNKS,0
5jaf,A,400,422,22,DEMDFWAGTIGVVFFGLTELII,0
5jaf,A,429,437,8,DKAWEEIN,0
5jaf,A,448,469,21,YYVMRYITPAFLAVLLVVWAR,0
5jaf,A,470,473,3,YIP,0
5jaf,A,479,484,5,HWTVW,0
5jaf,A,485,500,15,TRFYIIGLFLFLTFL,0
2vpw,G,1,15,14,EFYGLPNAQEFWHW,0
2vpw,G,16,36,20,NALHFVLVGLAGGVALLAAL,0
2vpw,G,49,66,17,LYALMLIALDLFILWAE,0
2vpw,G,67,89,22,PARFRFTHIWLFLSFHPTSPIW,0
2vpw,G,90,105,15,GAWGLGLGFLTGGLL,0
2vpw,G,115,131,16,AWALLVFSLVALSYPG,0
2vpw,G,132,146,14,ALAVNLNRPLWNGL,0
2vpw,G,147,163,16,AGLFPLTALVLALGLA,0
2vpw,G,174,189,15,LRVLAGASLLLALLY,0
2vpw,G,190,206,16,LTLPPEARGHLLEEAG,0
2vpw,G,207,221,14,WYGLFLLLGLGTFW,0
2vpw,G,226,240,14,PWAGLLAAAGLRAL,0
2vpw,G,241,250,9,VLAGQWQGL,0
2vpw,G,251,252,1,L,0
4wit,B,19,129,110,VDFVIHYKVPAAERDEAEAGFVQLIRALTTVGLATEVRHGENESLLVFVKVASPDLFAKQVYRARLGDWLHGVRVSAPHNDIAQALQDEPVVEAERLRLIYLMITKPHNE,0
4wit,B,141,195,54,KHVESIFPLHSHSFNKEWIKKWSSKYTLEQTDIDNIRDKFGESVAFYFAFLRSY,0
4wit,B,196,215,19,RFLVIPSAFGFGAWLLLGQ,0
4wit,B,217,233,16,YLYALLCGLWSVVFFE,0
4wit,B,234,286,52,WKKQEVDLAVQWGVRGVSSIQQSRPEFEWEHEAEDPITGEPVKVYPPMKRVK,0
4wit,B,287,318,31,QLLQIPFALACVVALGALIVTCNSLEVFINE,0
4wit,B,325,354,29,QYLGFLPTIFLVIGTPTISGVLMGAAEKL,0
4wit,B,355,370,15,AMENYATVDAHDAAL,0
4wit,B,371,397,26,QKQFVLNFMTSYMALFFTAFVYIPFG,0
4wit,B,398,415,17,ILHPFLNFWRATAQTLT,0
4wit,B,430,455,25,ARISNQMFYFTVTAQIVNFATEVVV,0
4wit,B,456,463,7,YIKQQAF,0
4wit,B,483,505,22,EFLQRVREECTLEEYDVSGDYR,0
4wit,B,506,521,15,MVMQFGYVAMFSVAW,0
4wit,B,523,535,12,AACCFLVNNWVE,0
4wit,B,536,561,25,RSDALKIAISSRRPIPWRTDSIGPW,0
4wit,B,562,585,23,TALSFLSWLGSITSSAIVYLCSN,0
4wit,B,597,621,24,KAWGLLLSILFAEHFYLVVQLAVR,0
4wit,B,622,656,34,VLSKLDSPGLQKERKERFQTKKRLLQENLGQDAA,0
4wit,B,660,684,24,APGIEHSEKITREALEEEARQASI,0
4wit,B,692,719,27,MFWQRQRGMQETIEIGRRMIEQQLAAG,0
5j7a,C,5,9,4,GRPE,0
5j7a,C,10,32,22,IWLALGTALMGLGTLYFLVKGM,0
5j7a,C,41,62,21,FYAITTLVPAIAFTMYLSMLL,0
5j7a,C,63,79,16,YGLTMVPFGGEQNPIY,0
5j7a,C,80,99,19,ARYADWLFTTPLLLLDLAL,0
5j7a,C,106,127,21,TILALVGADGIMIGTGLVGAL,0
5j7a,C,128,133,5,KVYSY,0
5j7a,C,134,154,20,FVWWAISTAAMLYILYVLFF,0
5j7a,C,172,192,20,VLRNVTVVLWSAYPVVWLIG,0
5j7a,C,193,202,9,EGAGIVPLN,0
5j7a,C,203,225,22,ETLLFMVLDVSAKVGFGLILLR,0
4in5,H,-5,10,15,HHHHHMVGVTAFGNF,0
4in5,H,15,32,17,AIYSFWIFLAGLIYYLQ,0
4in5,H,33,250,217,ENMREGYPLENEDGTPAANQGPFPLPKPKTFILPHGRGTLTVPGPESEDRPIALARTAVSEGFPHAPTGDPMKDGVGPASWVARRDLPELDGHGHNKIKPMKAAAGFHVSAGKNPIGLPVRGCDLEIAGKVVDIWVDIPEQMARFLEVELKDGSTRLLPMQMVKVQSNRVHVNALSSDLFAGIPTIKSPTEVTLLEEDKICGYVAGGLMYAAPKRKS,0
4in5,H,251,260,9,VAAMLAEYA,0
2htl,B,1,17,16,KTDTPSLETPQAARLR,0
2htl,B,18,36,18,RQLIRQLLERDKTPLAIL,0
2htl,B,37,58,21,MAAVVGTLVGLAAVAFDKGVA,0
2htl,B,84,97,13,CSAVLAMFGYFLV,0
2htl,B,98,128,30,KYAPEAGGSGIPEIEGALEDQRPVRWWRVL,0
2htl,B,129,142,13,VKFFGGLGTLGGG,0
2htl,B,144,156,12,LGREGPTVQIGG,0
2htl,B,157,180,23,IGRMVLDIFRLKGDEARHTLLAT,0
2htl,B,181,203,22,AAAGLAAAFNAPLAGILFIIEE,0
2htl,B,204,215,11,RPQFRYTLISI,0
2htl,B,216,231,15,AVFIGVIMSTIMYRI,0
2htl,B,253,274,21,LYLILGIIFGIFGPIFNKWVL,0
2htl,B,275,284,9,MQDLLHRVH,0
2htl,B,285,289,4,GNIT,0
2htl,B,290,303,13,WVLMGGAIGGLCG,0
2htl,B,338,351,13,ARVITTLLCFSSG,0
2htl,B,353,365,12,GGIFAPMLALGT,0
2htl,B,393,415,22,MGALLAASIRAPLTGIILVLEM,0
2htl,B,423,439,16,PMIITGLGATLLAQFT,0
2htl,B,440,458,18,GKPLFSAILARTLAKQEA,0
2htl,B,459,473,14,QLARSKAASASENT,0
4g7s,C,1,3,2,EE,0
4g7s,C,4,6,2,PK,0
4g7s,C,7,24,17,ALAVILVLTLTILVFWL,0
4g72,C,1,3,2,EE,0
4g72,C,4,6,2,PK,0
4g72,C,7,24,17,ALAVILVLTLTILVFWL,0
3wg7,Z,17,37,20,GLSVTFLSFLLPAGWVLYHL,0
3wg7,Z,38,43,5,NYKKS,0
3wg7,Z,44,46,2,AA,0
3wgv,E,1,14,13,AGLSTDDGGSPKG,0
3wgv,E,30,46,16,LIFAALAFIVGLIIIL,0
3wgv,E,47,49,2,KR,0
3wgv,E,50,65,15,RCGGKKHRPINEDEL,0
3wfe,C,1,4,3,SET,0
3wfe,C,11,32,21,NIYFGGSVFFILLFLALTYHT,0
3wfe,C,33,146,113,KTLPERTNEAAMSAAVVRGKLVWEQNNCVGCHTLLGEGAYFAPELGNVVGRRGGEEGFNTFLQAWMKIQPLNVPGRRAMPQFHLSEGQVDDLAEFLKWSSKIDTNQWPPNKEG,0
4i9w,B,1,27,26,TTAPQEPPARPLQAGSGAGPAPGRAM,0
4i9w,B,28,31,3,STT,0
4i9w,B,32,50,18,LALLALVLLYLVSGALVF,0
4i9w,B,106,109,3,SQS,0
4i9w,B,117,133,16,SAFFFSGTIITTIGYG,0
4i9w,B,141,165,24,GRLFCIFYALVGIPLFGILLAGVG,0
4i9w,B,166,185,19,RLGSSLRHGIGHIEAIFLK,0
4i9w,B,186,199,13,HVPPELVRVLSAM,0
4i9w,B,200,220,20,FLLIGCLLFVLTPTFVFCYM,0
4i9w,B,225,242,17,LEAIYFVIVTLTTVGFG,0
4i9w,B,255,276,21,AYQPLVWFWILLGLAYFASVL,0
4i9w,B,277,284,7,TIGNWLR,0
4i9w,B,285,309,24,VSRRTRAEMGGLTAQSNSLEVLFQ,0
4ryj,B,10,27,17,FFLTYGLFYVSSVLFPI,0
4ryj,B,29,34,5,TWYDA,0
4ryj,B,35,42,7,EKPSWTP,0
4ryj,B,43,63,20,GMTIGMIWAVLFGLIALSVA,0
4ryj,B,75,96,21,FWFLFLLNYIFNQAFSYFQFS,0
4ryj,B,97,102,5,KNLFL,0
4ryj,B,103,122,19,TVDCLLVAITTLLLIMFSS,0
4ryj,B,127,146,19,SAWLLIPYFLWSAFATYLS,0
4ryj,B,147,153,6,TIYSIN,0
4pbu,z,8,24,16,LAALVILSFVMVIGVP,0
4pbu,z,25,39,14,AYASPQDWDRSKQL,0
4pbu,z,40,55,15,FLGSGLWIALVLVVG,0
4lds,A,1,6,5,KANKY,0
4lds,A,7,13,6,IFILGA,0
4lds,A,14,31,17,GGLLYGYDNGVISGALL,0
4lds,A,43,61,18,EGIVVSSMLIGAIVGAGS,0
4lds,A,62,76,14,GPLADKLGRRRLVM,0
4lds,A,77,91,14,IAIVFIIGALILAA,0
4lds,A,97,113,16,LIIGRLIIGLAVGGSM,0
4lds,A,114,137,23,TVPVYLSEMAPTEYRGSLGSLNQ,0
4lds,A,138,154,16,MITIGILAAYLVNYAF,0
4lds,A,161,177,16,WMLGLAVVPSVILLVG,0
4lds,A,178,247,69,YFMPESPRWLLENRNEEAARQVMKITYDDSEIDKELKEMKEINAISESTWTVIKSPWLGRILIVGCIFA,0
4lds,A,248,266,18,FQQFIGINAVIFYSSSIF,0
4lds,A,276,293,17,ILGSVGIGTINVLVTIV,0
4lds,A,294,309,15,IFVVDKIDRKKLLVG,0
4lds,A,310,326,16,NIGMIASLLIMAILIW,0
4lds,A,334,353,19,WIIIVCLSLFIVFFGISWG,0
4lds,A,354,378,24,VLWVMLPELFPMRARGAATGISAL,0
4lds,A,379,395,16,LNIGTLIVSLFFPILS,0
4lds,A,401,416,15,WVFLIFAFIGVLAMI,0
4lds,A,417,427,10,VIKFLPETRG,0
4lds,A,428,446,18,SLEEIEYELRERTGARTE,0
5svm,D,27,47,20,RVVQLLIISYFVGWVFLHEK,0
5svm,D,48,315,267,YQVRDTAIESSVVTKVKGSGLYANRVMDVSDYVTPPQGTSVFVIITKMIVTENQMQGFCPESEEKYRCVSDSQCGPERLPGGGILTGRCVNYSSVLRTCEIQGWCPTEVDTVETPIMMEAENFTIFIKNSIRFPLFNFEKGNLLPNLTARDMKTCRFHPDKDPFCPILRVGDVVKFAGQDFAKLARTGGVLGIKIGWVCDLDKAWDQCIPKYSFTRLDSVSEKSSVSPGYNFRFAKYYKMENGSEYRTLLKAFGIRFDVLVYGNAGK,0
5svm,D,316,339,23,NIIPTIISSVAAFTSVGVGTVLC,0
2xfu,A,3,108,105,KCDVVVVGGGISGMAAAKLLHDSGLNVVVLEARDRVGGRTYTLRNQKVKYVDLGGSYVGPTQNRILRLAKELGLETYKVNEVERLIHHVKGKSYPFRGPFPPVWN,0
2xfu,A,109,126,17,ITYLDHNNFWRTMDDMG,0
2xfu,A,127,485,358,EIPSDAPWKAPLAEEWDNMTMKELLDKLCWTESAKQLATLFVNLCVTAETHEVSALWFLWYVKQCGGTTRIISTTNGGQERKFVGGSGQVSERIMDLLGDRVKLERPVIYIDQTRENVLVETLNHEMYEAKYVISAIPPTLGMKIHFNPPLPMMRNQMITRVPLGSVIKCIVYYKEPFWRKKDYCGTMIIDGEEAPVAYTLDDTKPEGNYAAIMGFILAHKARKLARLTKEERLKKLCELYAKVLGSLEALEPVHYEEKNWCEEQYSGGCYTTYFPPGILTQYGRVLRQPVDRIYFAGTETATHWSGYMEGAVEAGERAAREILHAMGKIPEDEIWQSEPESVDVPAQPITTTFLERH,0
2xfu,A,486,498,12,PSVPGLLRLIGL,0
2xfu,A,502,520,18,SATALGFLAHKRGLLVRV,0
5fn2,C,8,26,18,CTFVAFGPAFALFLITVA,0
5fn2,C,27,32,5,DPLRV,0
5fn2,C,33,53,20,ILVAGAFFWLVSLLLASVVW,0
5fn2,C,75,90,15,AAVSVLLQEVFRFAY,0
5fn2,C,91,118,27,KLLKKADEGLASLSEDGRSPISIRQMA,0
5fn2,C,119,135,16,VSGLSFGIISGVFSVI,0
5fn2,C,162,179,17,LTAAIILLHTFWGVVFF,0
5fn2,C,180,187,7,ACERRRY,0
5fn2,C,188,203,15,ALGLVVGSHLLTSGL,0
5fn2,C,215,230,15,PIYAVTVSMGLWAFI,0
5fn2,C,231,235,4,AGGS,0
5fn2,C,236,242,6,RSIQRS,0
5fn2,C,243,244,1,L,0
1fqu,A,61,74,13,VRILLLAACISFV,0
1fqu,A,75,86,11,AWFEEGEETIT,0
1fqu,A,87,100,13,FVEPFVILLILIA,0
1fqu,A,262,276,14,VISLICVAVWLINI,0
1fqu,A,277,292,15,HFNDPVHGGSWIRGA,0
1fqu,A,293,309,16,YYFKIAVALAVAAIPE,0
1fqu,A,766,780,14,SNVGEVVCIFLTAA,0
1fqu,A,781,785,4,GLPE,0
1fqu,A,786,801,15,LIPVQLLWVNLVTDG,0
1fqu,A,835,851,16,RYMAIGGYVGAATVGA,0
1fqu,A,852,899,47,AWWFMYAEDGPGVTYHQLTHFMQCTEDHPHFEGLDCEIFEAPEPMTM,0
1fqu,A,900,915,15,LSVLVTIEMCNALNS,0
1fqu,A,934,950,16,GSICLSMSLHFLILYV,0
1fqu,A,951,967,16,PLPMIFKLKALDLTQW,0
1fqu,A,968,985,17,MVLKISLPVIGLDEILK,0
3rlb,A,-9,6,15,HHHHHHHHAMSNSKF,0
3rlb,A,7,11,4,VRLL,0
3rlb,A,12,31,19,EIAFMAALAFIISLIPNTV,0
3rlb,A,36,49,13,VEIACIPILLLSL,0
3rlb,A,50,53,3,RGL,0
3rlb,A,54,74,20,AGLVGGLIWGILSMITGHAY,0
3rlb,A,79,97,18,QAFLEYLVAPVSLGIAGL,0
3rlb,A,98,110,12,RQKTAPLKLAPV,0
3rlb,A,111,128,17,LGTFVAVLLKYFFHFIA,0
3rlb,A,149,169,20,VNGISGILTAIAAFVILIIF,0
3rlb,A,170,182,12,KKFPKLFIHSNY,0
5vhx,E,1,9,8,TSRRGRAL,0
5vhx,E,10,26,16,AVALNLLALLFATTAF,0
5vhx,E,129,146,17,SEVLYILLLVVGFSLMC,0
5vhx,E,147,153,6,ELLHSS,0
5vhx,E,157,164,7,GLKLNAF,0
5vhx,E,165,180,15,AVFTVLSGLLGMVAH,0
5vhx,E,210,225,15,LAWGSFTCCMAASVT,0
5vhx,E,226,232,6,LNSYTK,0
1zc7,A,1,18,17,NPQTGQSTGLLGNRWFY,0
1zc7,A,19,40,21,VLAVLLMCMISGVQYSWTLYA,0
1zc7,A,53,73,20,VQTAFTLSQVIQAGSQPGGG,0
1zc7,A,74,79,5,FVDKF,0
1zc7,A,80,100,20,PRIPLMFGGAMVLAGWTFMG,0
1zc7,A,111,130,19,YTLAGAGVGIVYGIAMNTA,0
1zc7,A,131,148,17,RWFPDKRGLASGFTAAG,0
1zc7,A,149,168,19,GLGVLPFLPLISSVLKVEG,0
1zc7,A,180,197,17,GILIILIAFVIRFPGQQ,0
1zc7,A,198,219,21,AKKQIVVTDKDFNSGEMLRTP,0
1zc7,A,220,240,20,FWVLWTAFFSVNFGGLLLVA,0
1zc7,A,256,275,19,TIGVSIQNLFNGGCRPFWG,0
1zc7,A,276,286,10,VSDKIGRYKT,0
1zc7,A,287,305,18,SVVFGINAVVLALFPTIA,0
1zc7,A,310,330,20,AFIAMLAIAFFTWGGSYALF,0
1zc7,A,331,347,16,STNSDIFGTAYSARNY,0
1zc7,A,348,368,20,FFWAAKATASIFGGGLGAAI,0
1zc7,A,376,394,18,AFLITAITSFIAFALATF,0
1zc7,A,395,412,17,IPRMGRPVKKMVKLSPE,0
1zc7,A,413,417,4,KAVH,0
4pv1,P,10,27,17,LSFGLIFVGWGLGVLLL,0
4pv1,P,28,32,4,IQGA,0
3e86,E,19,22,3,KDK,0
3e86,E,23,25,2,FQ,0
3e86,E,26,45,19,LFVLTILTLISGTIFYSTV,0
3e86,E,51,67,16,DALYFSVVTLTTVGDG,0
3e86,E,75,96,21,GKIFTILYIFIGIGLVFGFIH,0
3e86,E,97,103,6,LAVNVQ,0
3e86,E,104,111,7,PSILSNL,0
3e86,E,112,113,1,P,0
4uhr,A,6,8,2,SV,0
4uhr,A,9,29,20,ITVELAIAVLAILGNVLVCW,0
4uhr,A,45,65,20,VSAAAADILVGVLAIPFAIA,0
4uhr,A,66,79,13,STGFCAACHGCLF,0
4uhr,A,80,101,21,ACFVLVLTASSIFSLLAIAID,0
4uhr,A,123,141,18,IIAICWVLSFAIGLTPML,0
4uhr,A,142,154,12,WNNCGQPKEGKA,0
4uhr,A,158,176,18,CGEGQVACLFEDVVPMNY,0
4uhr,A,177,202,25,VYFNFFACVLVPLLLMLGVYLRIFL,0
4uhr,A,233,251,18,SLAIIVGLFALCWLPLHI,0
4uhr,A,252,262,10,NCFTFFCPDC,0
4uhr,A,264,271,7,APLWLMY,0
4uhr,A,272,291,19,AIVLSHTNSVVNPFIYAYR,0
4uhr,A,293,314,21,EFRQTFRKIIRSHVLRQQEPF,0
1oy6,C,1,6,5,PNFFI,0
1oy6,C,7,10,3,RPI,0
1oy6,C,11,27,16,AWVIAIIIMLAGGLAI,0
1oy6,C,341,357,16,KTLVEAIILVFLVMYL,0
1oy6,C,358,365,7,LQNFRAT,0
1oy6,C,366,386,20,IPTIAVPVVLLGTFAVLAAF,0
1oy6,C,395,411,16,FGMVLAIGLLVDDAIV,0
1oy6,C,412,441,29,VENVERVMAEEGLPPKEATRKSMGQIQGA,0
1oy6,C,442,458,16,VGIAMVLSAVFVPMAF,0
1oy6,C,469,489,20,FSITIVSAMALSVLVALILT,0
1oy6,C,490,498,8,ALCATMLK,0
1oy6,C,499,512,13,IAKGDHGEGKKGF,0
1oy6,C,514,524,10,WFNRMFEKST,0
1oy6,C,526,536,10,YTDSVGGILR,0
1oy6,C,537,540,3,TGR,0
1oy6,C,541,557,16,LVLYLIIVVGMAYLFV,0
1oy6,C,860,868,8,GMSYQERL,0
1oy6,C,874,892,18,SLYAISLIVVFLCLAALY,0
1oy6,C,893,897,4,SWSI,0
1oy6,C,898,919,21,FSVMLVVPLGVIGALLAATFR,0
1oy6,C,927,943,16,QVGLLTTIGLSAKNAI,0
1oy6,C,944,974,30,IVEFAKDLMDKEGKGLIEATLDAVRMRLRP,0
1oy6,C,975,993,18,LMTSLAFILGVMPLVIST,0
1oy6,C,1004,1021,17,TGVMGGMVTATVLAIFF,0
1oy6,C,1022,1025,3,PVF,0
1oy6,C,1026,1032,6,VVVRRR,0
1oy6,C,1033,1036,3,SRK,0
1oy6,C,1037,1049,12,EDIEHSHTVDHH,0
5jtg,E,-21,15,36,GSSHHHHHHSSGRENLYFQGHVEEKRLSAKKGLPPG,0
5jtg,E,16,293,277,LVYTGKYREDFEIEVMNYSIEEFREFKTTDVESVLPFRDSSTPTWINITGIHRTDVVQRVGEFFGIHPLVLEKILNVHQRPKVEFFENYVFIVLKMFTYDKNLHELESEQVSLILTKNCVLMFQEKIGDVFDPVRERIRYNRGIIRKKRADYLLYSLIDALVDDYFVLLEKIDDEIDVLEEEVLERPEKETVQRTHQLKRNLVELRKTIWPLREVLSSLYRDVPPLIEKETVPYFRKVYDHTIQIADTVETFRDIVSGLLDVYLSSVSNKTNEVMKV,0
5jtg,E,294,310,16,TIIATIFMPLTFIAGI,0
5jtg,E,313,326,13,NFEYMPELRWKWG,0
5jtg,E,331,346,15,AVMGVIAVIMVVYFK,0
5jtg,E,347,349,2,KK,0
5jtg,E,350,351,1,L,0
5f5d,A,94,113,19,PVTWVMMIACVVVFIAMQI,0
5f5d,A,114,115,1,G,0
5f5d,A,116,123,7,QEVMLWL,0
5f5d,A,124,136,12,WPFDPTLKFEFW,0
5f5d,A,137,143,6,YFTHAL,0
5f5d,A,144,166,22,HFSLMHILFNLLWWWYLGGAVE,0
5f5d,A,171,190,19,GKLIVITLISALLSGYVQQ,0
5f5d,A,191,197,6,FSGPWF,0
5f5d,A,198,216,18,GLSGVVFALMGYVWLRGE,0
5f5d,A,225,244,19,QRGLIIFALIWIVAGWFDL,0
5f5d,A,254,270,16,IAGLAVGLAMAFVDSL,0
3ns0,C,1,5,4,AQIT,0
3ns0,C,10,31,21,IWLALGTALMGLGTLYFLVKG,0
3ns0,C,32,43,11,GVSDPDAKKFY,0
3ns0,C,44,62,18,ITTLVPAIAFTMYLSMLL,0
3ns0,C,80,97,17,ARYADWLFTTPLLLLDL,0
3ns0,C,98,108,10,LLVDADQGTI,0
3ns0,C,109,127,18,ALVGADGIMIGTGLVGAL,0
3ns0,C,134,153,19,FVWWAISTAAMLYILYVLF,0
3ns0,C,154,155,1,G,0
3ns0,C,156,158,2,TS,0
3ns0,C,159,173,14,AESMRPEVASTFKV,0
3ns0,C,174,192,18,RNVTVVLWSAYPVVWLIG,0
3ns0,C,203,224,21,ETLLFMVLDVSAKVGFGLILL,0
3ns0,C,225,231,6,SRAIFG,0
3ns0,C,232,248,16,AEAPEPSAGDGAAATS,0
2zuq,A,1,9,8,LRFLNQAS,0
2zuq,A,10,12,2,GR,0
2zuq,A,13,31,18,AWLLMAFTALALELTALW,0
2zuq,A,48,63,15,VALFGVLGAALIGAI,0
2zuq,A,64,69,5,PKTPL,0
2zuq,A,70,86,16,YVAMVIWLYSAFRGVQ,0
2zuq,A,109,113,4,FPEW,0
2zuq,A,146,162,16,LGIFIAYLIVAVLVVI,0
2zuq,A,163,176,13,QPFKAKKRDLFGR,0
4llh,C,30,56,26,ENPTNLEGKLADAEEEIILEGEDTQA,0
4llh,C,61,76,15,VIVPALVIVLATVVW,0
4llh,C,77,80,3,IGF,0
4llh,C,81,98,17,DSFTNFASSALSAVVDN,0
4llh,C,99,116,17,GWAFILFGTVFVFFIVV,0
4llh,C,143,158,15,MMFAAGMGIDLMFYG,0
4llh,C,159,183,24,TEPLTFYRNGVPGHDEHNVGVAMS,0
4llh,C,184,201,17,TMFHWTLHPWAIYAIVG,0
4llh,C,237,258,21,IDILAIIATVFGTACSLGLGA,0
4llh,C,259,270,11,QIGAGLSAANI,0
4llh,C,271,273,2,ED,0
4llh,C,274,282,8,SDWTIVGI,0
4llh,C,283,296,13,SVLTLAFIFSAIS,0
4llh,C,297,300,3,VGK,0
4llh,C,302,322,20,QYLSNANMVLAALLAIFVFV,0
4llh,C,323,329,6,GPTVSI,0
4llh,C,330,350,20,NLLPGSIGNYLSNFFQMAGR,0
4llh,C,351,367,16,AMSADGTAGEWLGSWT,0
4llh,C,368,385,17,FYWAWWISWSPFVGMFL,0
4llh,C,399,415,16,GVLLVPAGVSTVWFSI,0
4llh,C,416,435,19,GGTAIVFEQNGESIWGDGA,0
4llh,C,436,445,9,EEQLFGLLH,0
4llh,C,446,456,10,LPGGQIMGII,0
4llh,C,457,477,20,MILLGTFFITSADSASTVMG,0
4llh,C,490,505,15,VTAAWGVATAAIGLT,0
4llh,C,506,521,15,LLSGGDNALSNLQNV,0
4llh,C,522,537,15,IVAATPFLFVVIGLM,0
4llh,C,554,595,41,EQQRFNARLARERRVHNEHRKRELAAKRRRERKASGAGKRR,0
5va1,D,1,2,1,P,0
5va1,D,3,131,128,RRGHVAPQNTFLDTIIRKFEGQSRKFIIANARVENCAVIYCNDGFCELCGYSRAEVMQRPCTCDFLHGPRTQRRAAAQIAQALLGAEERKVEIAFYRKDGSCFLCLVDVVPVKNEDGAVIMFILNFEV,0
5va1,D,132,157,25,MEKDMVGSGADVLPEYKLQAPRIHR,0
5va1,D,398,410,12,TILHYSPFKAVW,0
5va1,D,411,430,19,WLILLLVIYTAVFTPYSAA,0
5va1,D,433,448,15,KETEEGPPATECGYA,0
5va1,D,450,469,19,PLAVVDLIVDIMFIVDILI,0
5va1,D,470,497,27,FRTTYVNANEEVVSHPGRIAVHYFKGW,0
5va1,D,498,510,12,LIDMVAAIPFDL,0
5va1,D,511,519,8,IFGSGSEE,0
5va1,D,522,537,15,LLKTARLLRLVRVAR,0
5va1,D,538,547,9,LDRYSEYGA,0
5va1,D,548,568,20,VLFLLMCTFALIAHWLACIW,0
5va1,D,578,582,4,MDSR,0
5va1,D,598,602,4,SSGL,0
5va1,D,615,627,12,YFTFSSLTSVGF,0
5va1,D,639,660,21,FSICVMLIGSLMYASIFGNVS,0
5va1,D,661,863,202,IIQRLYSGTARYHTQMLRVREFIRFHQIPNPLRQRLEEYFQHAWSYTNGIDMNAVLKGFPECLQADICLHLNRSLLQHCKPFRGATKGCLRALAMKFKTTHAPPGDTLVHAGDLLTALYFISRGSIEILRGDVVVAILGKNDIFGEPLNLYARPGKSNGDVRALTYCDLHKIHRDDLLEVLDMYPEFSDHFWSSLEITFNLR,0
5va1,D,864,1035,171,TNMIPGGRQYQELPRCPAPTPSLLNIPLSSPGRRPRGDVESRLDALQRQLNRLETRLSADMATVLQLLQRQMTLVPPAYSAVTTPGPGPTSTSPLLPVSPLPTLTLDSLSQVSQFMACEELPPGAPELPQEGPTRRLSLPGQLGALTSQPLHRHGSDPGSEASNSLEVLFQ,0
4lml,E,-1,6,7,SQDMVSP,0
4lml,E,7,193,186,PPIADEPLTVNTGIYLIECYSLDDKAETFKVNAFLSLSWKDRRLAFDPVRSGVRVKTYEPEAIWIPEIRFVNVENARDADVVDISVSPDGTVQYLERFSARVLSPLDFRRYPFDSQTLHIYLIVRSVDTRNIVLAVDLEKVGKNDDVFLTGWDIESFTAVVKPANFALEDRLESKLDYQLRISRQY,0
4lml,E,194,216,22,SYIPNIILPMLFILFISWTAFW,0
4lml,E,221,243,22,ANVTLVVSTLAAHIAFNILVET,0
4lml,E,244,251,7,LPKAPYM,0
4lml,E,252,274,22,YTGAIIFMIYLFYFVAVIEVTV,0
4lml,E,294,316,22,RIAFPVVFLLANIILAFLFFGF,0
2hi7,B,1,13,12,LRFLNQASQGRG,0
2hi7,B,15,31,16,LLMAFTALALELTALW,0
2hi7,B,32,47,15,QHVMLLKPCVLCIYE,0
2hi7,B,48,65,17,VALFGVLGAALIGAIAP,0
2hi7,B,70,85,15,YVAMVIWLYSAFRGV,0
2hi7,B,86,126,40,LTYEHTMLQLYPSPFATCDFMVRFPEWLPLDKWVPQVFVA,0
2hi7,B,127,141,14,GDSAERQWDFLGLE,0
2hi7,B,142,145,3,PQW,0
2hi7,B,146,162,16,LGIFIAYLIVAVLVVI,0
2hi7,B,163,176,13,QPFKAKKRDLFGR,0
4nv2,A,1,16,15,ASYLKLKAQEETWLQ,0
4nv2,A,20,38,18,LILAILAGLGSLLTAYLT,0
4nv2,A,39,55,16,TKLTEQPAAFATGDGG,0
4nv2,A,56,61,5,DLVLS,0
4nv2,A,62,70,8,RWAEFLGI,0
4nv2,A,71,90,19,TAAVGLLGFLGVLALAVLP,0
4nv2,A,92,93,1,L,0
4nv2,A,100,124,24,WPALFGLVSAMTAFEMYMLYLMVA,0
4nv2,A,125,129,4,LRQF,0
4nv2,A,130,150,20,MYCTTAIILVAGLGLVTVLG,0
4nv2,A,160,180,20,FSYILVAFLTLVTTIGVYAN,0
4nv2,A,181,282,101,VPPPSPLAVGLAAHLRQIGGTMYGAYWCPHCQDQKELFGAAFDQVPYVECSPNGPGTPQAQECTEAGITSYPTWIINGRTYTGVRSLEALAVASGYPLEEG,0
4nv2,A,283,291,8,LEHHHHHH,0
2f1u,G,286,290,4,LFLL,0
2f1u,G,291,305,14,HLTAMISTCVNPIF,0
5hk6,D,137,152,15,PSSPSLLRAIPGIAW,0
5hk6,D,154,165,11,LLLLVIFYVFA,0
5hk6,D,166,216,50,MGTKLFAQSFPEWFGTLGASMYTLFQVMTLESWSMGIARPVIEAYPWAWI,0
5hk6,D,217,236,19,FVSFILVSSFTVLNLFIGI,0
5hk6,D,243,253,10,AHWEGGGAKR,0
5hk6,D,287,288,1,R,0
4u4f,D,10,518,508,SIQIGGLFPRGADQEYSAFRVGMVQFSTSEFRLTPHIDNLEVANSFAVTNAFCSQFSRGVYAIFGFYDKKSVNTITSFCGTLHVSFITPSFPTDGTHPFVIQMRPDLKGALLSLIEYYQWDKFAYLYDSDRGLSTLQAVLDSAAEKKWQVTAINVGNINNDKKDETYRSLFQDLELKKERRVILDCERDKVNDIVDQVITIGKHVKGYHYIIANLGFTDGDLLKIQFGGAEVSGFQIVDYDDSLVSKFIERWSTLEEKEYPGAHTATIKYTSALTYDAVQVMTEAFRNLRKQRIEISRRGNAGDCLANPAVPWGQGVEIERALKQVQVEGLSGNIKFDQNGKRINYTINIMELKTNGPRKIGYWSEVDKMVLTEDDTSGLEQKTVVVTTILESPYVMMKKNHEMLEGNERYEGYCVDLAAEIAKHCGFKYKLTIVGDGKYGARDADTKIWNGMVGELVYGKADIAIAPLTITLVREEVIDFSKPFMSLGISIMIKKPQKSKPGVFSFL,0
4u4f,D,519,539,20,PLAYEIWMCIVFAYIGVSVV,0
4u4f,D,576,586,10,LWFSLGAFMQ,0
4u4f,D,600,621,21,VGGVWWFFTLIIISSYTANLA,0
4u4f,D,622,773,151,FLTVERMVSPIESAEDLSKQTEIAYGTLDSGSTKEFFRRSKIAVFDKMWTYMRSAEPSVFVRTTAEGVARVRKSKGKYAYLLESTMNEYIEQRKPCDTMKVGGNLDSKGYGIATPKGSSLGTPVNLAVLKLSEQGVLDKLKNKWWYDKGEC,0
4u4f,D,785,787,2,AL,0
4u4f,D,788,808,20,LSNVAGVFYILVGGLGLAML,0
3rgb,G,1,44,43,HETKQGGEKRFTGAICRCSHRYNSMEVKMAATTIGGAAAAEAP,0
3rgb,G,45,53,8,LDKKWLTF,0
3rgb,G,54,66,12,LAIYTVFYLWVR,0
3rgb,G,93,106,13,YTEIVLEIVTASI,0
3rgb,G,107,140,33,WGYLWKTRDRNLAALTPREELRRNFTHLVWLVA,0
3rgb,G,141,154,13,AWAIYWGASYFTE,0
3rgb,G,175,189,14,EFYLSYPIYIITGF,0
3rgb,G,190,212,22,AFIYAKTRLPFFAKGISLPYLV,0
3rgb,G,213,222,9,VVGPFMILP,0
3rgb,G,225,253,28,LNEWGHTFWFMEELFVAPLHYGFVIFGW,0
3rgb,G,254,286,32,ALAVMGTLTQTFYSFAQGGLGQSLCEAVDEGL,0
3rgb,G,287,289,2,AK,0
3ir5,F,5,28,23,MFFFDIYPYIAGAVFLIGSWLRY,0
3ir5,F,29,47,18,YGQYTWRAASSQMLDRKG,0
3ir5,F,48,72,24,NLASNLFHIGILGIFVGHFFGMLT,0
3ir5,F,73,77,4,HWMY,0
3ir5,F,87,114,27,KMAMFAGGASGVLCLIGGVLLLKRRLF,0
3ir5,F,115,124,9,PRVRATTTG,0
3ir5,F,125,145,20,DILILSLLVIQCALGLLTIP,0
3ir5,F,183,204,21,FRLHLVLGMTLFLLFPFSRLI,0
3ir5,F,205,225,20,IWSVPVEYLTRKYQLVRARH,0
3b44,A,94,113,19,PVTWVMMIACVVVFIAMQI,0
3b44,A,114,115,1,G,0
3b44,A,116,123,7,QEVMLWL,0
3b44,A,124,136,12,WPFDPTLKFEFA,0
3b44,A,137,143,6,YFTHAL,0
3b44,A,144,166,22,HFSLMHILFNLLWWWYLGGAVE,0
3b44,A,172,190,18,KLIVITLISALLSGYVQQ,0
3b44,A,191,197,6,FSGPWF,0
3b44,A,198,214,16,GLSGVVYALMGYVWLR,0
3b44,A,228,245,17,LIIFALIWIVAGWFDLF,0
3b44,A,247,268,21,SMANGAHIAGLAVGLAMAFVD,0
1s5h,L,1,21,20,APMLSGLLARLVKLLLGRHG,0
1s5h,L,22,25,3,ALH,0
1s5h,L,26,50,24,RAAGAATVLLVIVLLAGSYLAVLA,0
1s5h,L,63,79,16,RALWWSVETATCVGYG,0
1s5h,L,87,112,25,GRLVAVVVMVAGITSFGLVTAALAT,0
1s5h,L,113,124,11,FVGREQERRGH,0
4uc3,B,6,23,17,LFLTFLAACGAPATTGA,0
4uc3,B,24,28,4,LKPD,0
4uc3,B,41,44,3,PRW,0
4uc3,B,45,62,17,FPLAWTSLYFLMSLAAM,0
4uc3,B,72,89,17,ALAFYAAQLAFNTLWTP,0
4uc3,B,90,99,9,FFGMKRMAT,0
4uc3,B,100,119,19,LAVVMVMWLFVAATMWAFF,0
4uc3,B,125,144,19,GVLFVPYLIWATAATGLNF,0
4uc3,B,145,146,1,A,0
4ret,G,27,46,19,NGGLIFAALAFIVGLIIIL,0
4ret,G,47,48,1,K,0
5jrw,E,12,294,282,PPGTLVYTGKYREDFEIEVMNYSIEEFREFKTTDVESVLPFRDSSTPTWINITGIHRTDVVQRVGEFFGIHPLVLERILNVHQRPKVEFFENYVFIVLKMFTYDKNLHELESEQVSLILTKNCVLMFQEKIGDVFDPVRERIRYNRGIIRKKRADYLLYSLIDALVDDYFVLLEKIDDEIDVLEEEVLERPEKETVQRTHQLKRNLVELRKTIWPLREVLSSLYRDVPPLIEKETVPYFRRVYDHTIQIADTVETFRDIVSGLLDVYLSSVSNKTNEVMKVL,0
5jrw,E,295,315,20,IIATIFMPLTFIAGIYGMNF,0
5jrw,E,326,344,18,YPVVLAVMGVIAVIMVVY,0
5jrw,E,345,349,4,KKKK,0
1z2r,B,1,9,8,HNDKDLST,0
1z2r,B,26,47,21,LIVAGIALILNAASDTFMLSL,0
1z2r,B,48,66,18,KPLLDDGFGKTDRSVLLW,0
1z2r,B,67,85,18,PLVVIGLMILRGITSYIS,0
1z2r,B,147,164,17,REGASIIGLFIMMFYYS,0
1z2r,B,165,167,2,QL,0
1z2r,B,168,188,20,IILVVLAPIVSIAIRVVSKR,0
1z2r,B,209,237,28,MLKGHKEVLIFGGQEVETKRFDKVSNKM,0
1z2r,B,254,273,19,IQLIASLALAFVLYAASFP,0
1z2r,B,274,279,5,VMDSL,0
1z2r,B,280,297,17,AGTITVVFSSMIALMRP,0
1z2r,B,315,342,27,QTLFAILDSEQEKDEGKRVIDRATGDL,0
1z2r,B,563,582,19,ELLAQHGVYAQLHKMQFGQ,0
1j4n,D,1,11,10,ASEFKKKLFW,0
1j4n,D,12,32,20,AVVAEFLAMILFIFISIGSA,0
1j4n,D,52,70,18,KVSLAFGLSIATLAQSVG,0
1j4n,D,71,72,1,I,0
1j4n,D,73,88,15,GAHLNPAVTLGLLLS,0
1j4n,D,89,93,4,QISV,0
1j4n,D,94,114,20,RAIMYIIAQCVGAIVATAIL,0
1j4n,D,142,159,17,IEIIGTLQLVLCVLATT,0
1j4n,D,160,168,8,RRRRDLGG,0
1j4n,D,169,186,17,GPLAIGFSVALGHLLAI,0
1j4n,D,191,204,13,GINPARSFGSSVI,0
1j4n,D,212,233,21,IFWVGPFIGAALAVLIYDFIL,0
1j4n,D,234,239,5,PRSSD,0
1j4n,D,240,247,7,TDRVKVW,0
1j4n,D,248,249,1,S,0
1j4n,D,250,271,21,QVEEYDLDADDINSRVEMKPK,0
5h2h,C,4,11,7,TGRPEWI,0
5h2h,C,12,28,16,LALGTALMGLGTLYFL,0
5h2h,C,47,61,14,LVPAIAFTMYLSML,0
5h2h,C,62,79,17,GYGLTMVPFGGEQNPIY,0
5h2h,C,80,94,14,ARYADWLFTTPLLL,0
5h2h,C,111,126,15,VGADGIMIGTGLVGA,0
5h2h,C,127,134,7,TKVYSYR,0
5h2h,C,135,150,15,VWWAISTAAMLYILY,0
5h2h,C,178,192,14,VVLWSAYPVVWLIG,0
5h2h,C,193,203,10,EGAGIVPLNI,0
5h2h,C,204,220,16,TLLFMVLDVSAKVGFG,0
4nyk,C,-3,41,44,SRGTMDLKVDEEEVDSGQPVSIQAFASSSTLHGISHIFSYERLS,0
4nyk,C,47,72,25,ALCFMGSLALLALVCTNRIQYYFLY,0
4nyk,C,73,424,351,HVTKLDEVAATRLTFPAVTFCNLNEFRFSRVTKNDLYHAGELLALLNNRYEIPDTQTADEKQLEILQDKANFRNFKPKPFNMLEFYDRAGHDIREMLLSCFFRGEQCSPEDFKVVFTRYGKCYTFNAGQDGKPRLITMKGGTGNGLEIMLDIQQDEYLPVWGETDETSFEAGIKVQIHSQDEPPLIDQLGFGVAPGFQTFVSCQEQRLIYLPPPWGDCKATTGDSEFYDTYSITACRIDCETRYLVENCNCRMVHMPGDAPYCTPEQYKECADPALDFLVEKDNEYCVCEMPCNVTRYGKELSMVKIPSKASAKYLAKKYNKSEQYIGENILVLDIFFEALNYETIEQKKA,0
4nyk,C,425,444,19,EVAGLLGDIGGQMGLFIGA,0
4nyk,C,456,466,10,YEVIKHRLCR,0
2x6b,D,1,7,6,TGGMKP,0
2x6b,D,8,27,19,ARKPRILNSDGSSNITRLG,0
2x6b,D,28,33,5,EKRGW,0
2x6b,D,34,36,2,DD,0
2x6b,D,37,43,6,YHDLLT,0
2x6b,D,44,47,3,SWP,0
2x6b,D,48,71,23,FITLITGLYLVTNALFALAYLAC,0
2x6b,D,87,99,12,FFSVQTMATIGY,0
2x6b,D,108,128,20,ANTLVTLEALCGMLGLAVAA,0
2x6b,D,129,300,171,LIYARFTRPTAGVLFSSRMVISDFEGKPTLMMRLANLRIEAIIEADVHLVLVRSEISQEGMVFRRFHDLTLTRSRSPIFSLSWTVMHPIDHHSPIYGETDETLRNSHSEFLVLFTGHHEAFAQNVHARHAYSCDEIIWGGHFVDVFTTLPDGRRALDLGKFHEIAQHHHHH,0
4k0j,C,1,3,2,IE,0
4k0j,C,17,31,14,LVFAMVALYGWYAW,0
4k0j,C,32,115,83,QLPLEAYPDIADTTSQVVTQVNGLAAEEVEQQITIPLEREIMGVPGMHVMRSKSTFGLSLITVVFKDGAEDYWSRQRLQERIN,0
4k0j,C,116,122,6,VSLPYG,0
4k0j,C,123,241,118,QPSLDPLTSPIGEIYRYTLVSKTRDLRELSELQFWKVIPRLKQVAGVVDVANFGGLTTQFMLEFDPVMLSKYNISLNQITQAISENNANAGGSILNRGEQGLVVRGVGLIRNLDDLGN,0
4k0j,C,242,256,14,VVTQKNGVPVLVKD,0
4k0j,C,257,335,78,GRVVLGNPQRHGILGMDRNPDTIQGITLLLKNENPSVVMEGVHAAVRDLNDNILPKDVKVVPYIDRSNLVDATVHTVG,0
4k0j,C,336,351,15,TLMEGMFLVSLVLLL,0
4k0j,C,360,380,20,IVAVTIPLSLLMAFILMHHF,0
4k0j,C,381,389,8,IPANLLSL,0
4k0j,C,390,402,12,AIDFGIIVDGAI,0
4k0j,C,414,422,8,DAEKELHG,0
4k0j,C,438,451,13,GMIVIITAYLPLF,0
4k0j,C,452,464,12,FQRIEYKLFSPM,0
4k0j,C,465,479,14,FAVGFALFGALLVA,0
4k0j,C,488,501,13,WAYRKPRKVFHNP,0
4k0j,C,503,516,13,VWLAPRYESVLNR,0
4k0j,C,526,540,14,IAVATLVGVMILGA,0
4k0j,C,541,838,297,IGRDFLPYLDEGSIWLQVTLPPGISLEKAGQMADNLRAATMEFPEVEHVVTQVGRNDEGTDPFSPSHIETAVTLHPYSTWTSGRDKQQLIEAMATRFRDLPGTQVGFSQPMIDGVLDKLAGAHSDLVVKVYGNDFAETRQVATAITRLLKTVPGAQDVIIDQEPPLPQVRIDVDRAAAARLGINVADVMALIQTGIGGSPVTQVFVEDRSYNVVARFIGSSRNDPEAIGNLTLTAANGAHVALAQVAHIRLAEGETTITREMNKRHLTVRLNLRGRDLSTFLEEARMRIDKEVPYDR,0
4k0j,C,839,840,1,H,0
4k0j,C,841,860,19,QVAWGGQFENQQRAQARLA,0
4k0j,C,861,875,14,ILPMVLALMFVLLF,0
4k0j,C,878,882,4,KNLR,0
4k0j,C,885,905,20,LILMAVPLATLGGLVALHLR,0
4k0j,C,906,913,7,MTLNVSS,0
4k0j,C,914,928,14,VGFIALFGVAVLNA,0
4k0j,C,941,943,2,SG,0
4k0j,C,963,977,14,TATVAALGLIPAAL,0
4k0j,C,978,988,10,HGLGSDVQRP,0
4k0j,C,989,1004,15,ATVVVGGLITATALT,0
4k0j,C,1018,1045,27,AAKQVREEPPVQFGPTSEGDLHHHHHH,0
3b9r,A,55,74,19,QFEDLLVRILLLAACISFV,0
3b9r,A,75,88,13,AWFEEGEETITAF,0
3b9r,A,89,107,18,EPFVILLILIANAIVGVW,0
3b9r,A,254,275,21,EFGEQLSKVISLICVAVWLIN,0
3b9r,A,276,295,19,GHFNDPVHGGSWIRGAIYY,0
3b9r,A,296,317,21,KIAVALAVAAIPEGLPAVITT,0
3b9r,A,760,781,21,IRYLISSNVGEVVCIFLTAAL,0
3b9r,A,782,785,3,LPE,0
3b9r,A,786,807,21,LIPVQLLWVNLVTDGLPATAL,0
3b9r,A,832,852,20,LFFRYMAIGGYVGAATVGAA,0
3b9r,A,853,897,44,WWFMYAEDGPGVTYHQLTHFMQCTEDHPHFEGLDCEIFEAPEPM,0
3b9r,A,898,916,18,MALSVLVTIEMCNALNSL,0
3b9r,A,927,951,24,WVNIWLLGSICLSMSLHFLILYVD,0
3b9r,A,952,966,14,LPMIFKLKALDLTQ,0
3b9r,A,967,987,20,LMVLKISLPVIGLDEILKFI,0
4yl1,C,5,13,8,LVMSSPAL,0
4yl1,C,14,36,22,AFLLCSTLLVIKMYVVAIITGQ,0
4yl1,C,47,52,5,EDALR,0
4yl1,C,69,90,21,RAHRNDMETIYPFLFLGFVYS,0
4yl1,C,91,97,6,LGPNPF,0
4yl1,C,98,119,21,AWMHFLVFLVGRVAHTVAYLG,0
4yl1,C,125,149,24,RSVTYTLAQLPCASMALQILWEAA,0
4yl1,C,150,152,2,HL,0
2c64,A,1,2,1,S,0
2c64,A,3,108,105,KCDVVVVGGGISGMAAAKLLHDSGLNVVVLEARDRVGGRTYTLRNQKVKYVDLGGSYVGPTQNRILRLAKELGLETYKVNEVERLIHHVKGKSYPFRGPFPPVWN,0
2c64,A,109,126,17,ITYLDHNNFWRTMDDMG,0
2c64,A,127,485,358,EIPSDAPWKAPLAEEWDNMTMKELLDKLCWTESAKQLATLFVNLCVTAETHEVSALWFLWYVKQCGGTTRIISTTNGGQERKFVGGSGQVSERIMDLLGDRVKLERPVIYIDQTRENVLVETLNHEMYEAKYVISAIPPTLGMKIHFNPPLPMMRNQMITRVPLGSVIKCIVYYKEPFWRKKDYCGTMIIDGEEAPVAYTLDDTKPEGNYAAIMGFILAHKARKLARLTKEERLKKLCELYAKVLGSLEALEPVHYEEKNWCEEQYSGGCYTTYFPPGILTQYGRVLRQPVDRIYFAGTETATHWSGYMEGAVEAGERAAREILHAMGKIPEDEIWQSEPESVDVPAQPITTTFLERH,0
2c64,A,486,501,15,PSVPGLLRLIGLTTI,0
2c64,A,502,520,18,SATALGFLAHKRGLLVRV,0
1vfp,A,58,77,19,DLLVRILLLAACISFVLAW,0
1vfp,A,78,85,7,EEGEETI,0
1vfp,A,86,103,17,AFVEPFVILLILIANAI,0
1vfp,A,257,273,16,EQLSKVISLICVAVWL,0
1vfp,A,274,295,21,NIGHFNDPVHGGSWIRGAIYY,0
1vfp,A,296,311,15,KIAVALAVAAIPEGL,0
1vfp,A,760,777,17,IRYLISSNVGEVVCIFL,0
1vfp,A,778,787,9,AALGLPEAL,0
1vfp,A,788,807,19,PVQLLWVNLVTDGLPATAL,0
1vfp,A,832,851,19,LFFRYMAIGGYVGAATVGA,0
1vfp,A,852,898,46,AWWFMYAEDGPGVTYHQLTHFMQCTEDHPHFEGLDCEIFEAPEPMT,0
1vfp,A,899,916,17,ALSVLVTIEMCNALNSL,0
1vfp,A,934,954,20,GSICLSMSLHFLILYVDPLP,0
1vfp,A,955,964,9,IFKLKALDL,0
1vfp,A,965,988,23,QWLMVLKISLPVIGLDEILKFIA,0
2mn7,A,2,18,16,GISIWQLLIIAVIVVL,0
2mn7,A,19,24,5,FGTKK,0
2mn7,A,25,45,20,GSIGSDLGASIKGFKKAMSD,0
2c70,A,1,2,1,S,0
2c70,A,3,108,105,KCDVVVVGGGISGMAAAKLLHDSGLNVVVLEARDRVGGRTYTLRNQKVKYVDLGGSYVGPTQNRILRLAKELGLETYKVNEVERLIHHVKGKSYPFRGPFPPVWN,0
2c70,A,109,127,18,ITYLDHNNFWRTMDDMGR,0
2c70,A,128,489,361,IPSDAPWKAPLAEEWDNMTMKELLDKLCWTESAKQLATLFVNLCVTAETHEVSALWFLWYVKQCGGTTRIISTTNGGQERKFVGGSGQVSERIMDLLGDRVKLERPVIYIDQTRENVLVETLNHEMYEAKYVISAIPPTLGMKIHFNPPLPMMRNQMITRVPLGSVIKCIVYYKEPFWRKKDYCGTMIIDGEEAPVAYTLDDTKPEGNYAAIMGFILAHKARKLARLTKEERLKKLCELYAKVLGSLEALEPVHYEEKNWCEEQYSGGCYTTYFPPGILTQYGRVLRQPVDRIYFAGTETATHWSGYMEGAVEAGERAAREILHAMGKIPEDEIWQSEPESVDVPAQPITTTFLERHLPSV,0
2c70,A,490,501,11,GLLRLIGLTTI,0
2c70,A,502,520,18,SATALGFLAHKRGLLVRV,0
4ymt,B,16,44,28,SGLIMTLKLTFLAVTIGVLMGLFIALMK,0
4ymt,B,45,48,3,SSI,0
4ymt,B,49,74,25,PIKLVASSYIEVIRGTPLLVQLLLI,0
4ymt,B,89,107,18,AGVSALAINSSAYVAEII,0
4ymt,B,108,146,38,AGIQAVDPGQNEAARSLGMTHAMAMRYVIIPQAIKNIL,0
4ymt,B,147,164,17,ALGNEFIVMLKESAIVS,0
4ymt,B,190,207,17,IIAAIYFVMTLTFSKLL,0
4ymt,B,208,215,7,LFERRLR,0
4p30,F,126,130,4,SHMG,0
4p30,F,135,153,18,ALLTVVFYIAAVMATNLY,0
4p30,F,154,163,9,ATFPEWFGD,0
4p30,F,164,186,22,SKSLYTLFQVMTLESWSMGIVR,0
4p30,F,187,193,6,VMNVHP,0
4p30,F,194,214,20,AWVFFIPFIMLTAFTVLNLA,0
4p30,F,223,274,51,ITKEQEEEAKTGHHQEPISQTLLHLGDRLDRIEKQLAQNNELLQRQQPQKK,0
4uxx,C,17,27,10,WKGLRAAWIN,0
4uxx,C,28,32,4,AAFR,0
4uxx,C,33,48,15,EGVAVLLAVVIACWL,0
4uxx,C,53,67,14,TRVLLISSVMLVMI,0
4uxx,C,68,101,33,ELLNSAIEAVVDRIGSEYHELSGRAKDLGSAAV,0
4uxx,C,102,117,15,IAIIDAVITWCILLW,0
1q5j,C,1,4,3,AQI,0
1q5j,C,5,9,4,GRPE,0
1q5j,C,10,32,22,IWLALGTALMGLGTLYFLVKGM,0
1q5j,C,43,62,19,AITTLVPAIAFTMYLSMLL,0
1q5j,C,63,79,16,YGLTMVPFGGEQNPIY,0
1q5j,C,80,98,18,ARYADWLFTTALLLLDLA,0
1q5j,C,108,127,19,LALVGADGIMIGTGLVGAL,0
1q5j,C,128,133,5,KVYSY,0
1q5j,C,134,154,20,FVWWAISTAAMLYILYVLFF,0
1q5j,C,174,192,18,RNVTVVLWSAYPVVWLIG,0
1q5j,C,193,202,9,EGAGIVPLN,0
1q5j,C,203,224,21,ETLLFMVLDVSAKVGFGLILL,0
1q5j,C,232,249,17,AEAPEPSAGDGAAATSD,0
4pdr,H,19,21,2,KD,0
4pdr,H,22,45,23,EFQVLFVLTILTLISGTIFYSTV,0
4pdr,H,51,67,16,DALYFSVVTLTTVGYG,0
4pdr,H,75,102,27,GKIFTILYIFIGIGLVFGFIHKLAVNV,0
4pdr,H,103,111,8,LPSILSNL,0
4pdr,H,112,114,2,PR,0
3lut,H,1,31,30,TVATGDPVDEAAALPGHPQDTYDPEADHEC,0
3lut,H,164,181,17,IAIVSVMVILISIVSFC,0
3lut,H,182,221,39,ETLPIFRDENEDMHGGGVTFHTYSQSTIGYQQSTSFTDP,0
3lut,H,222,241,19,FIVETLCIIWFSFEFLVRF,0
3lut,H,254,271,17,MNIIDIVAIIPYFITLG,0
3lut,H,272,294,22,ELAEKPEDAQQGQQAMSLAILR,0
3lut,H,295,312,17,IRLVRVFRIFKLSRHSK,0
3lut,H,313,323,10,LQILGQTLKA,0
3lut,H,326,349,23,ELGLLIFFLFIGVILFSSAVYFA,0
3lut,H,350,364,14,ADERDSQFPSIPDA,0
3lut,H,365,377,12,WWAVVSMTTVGY,0
3lut,H,378,386,8,DMVPTTIG,0
3lut,H,387,406,19,KIVGSLCAIAGVLTIALPV,0
3lut,H,407,420,13,VIVSNFNYFYHRE,0
3lut,H,422,499,77,GEEQAQYLQVTSCPKIPSSPDLKKSRSASTISKSDYMEIQEGVNNSNEDFREENLKTANCTLANTNYVNITKMLTDV,0
5dgy,A,-159,-123,36,IFEMLRIDEGLRLKIYKDTEGYYTIGIGHLLTKSPS,0
5dgy,A,-122,-111,11,NAAKSELDKAI,0
5dgy,A,-110,39,149,RNTNGVITKDEAEKLFNQDVDAAVRGILRNAKLKPVYDSLDAVRRAALINMVFQMGETGVAGFTNSLRMLQQKRWDEAAVNLAKSRWYNQTPNRAKRVITTFRTGTWDAYMCGTEGPNFYVPFSNATGVVRSPFEYPQYYLAEPWQFSM,0
5dgy,A,40,65,25,AAYMFLLIVLGFPINFLTLYVTVQH,0
5dgy,A,69,96,27,TPLNYILLNLAVADLFMVLGGFTSTLY,0
5dgy,A,97,112,15,SLHGYFVFGPTGCNL,0
5dgy,A,113,138,25,GFFATLGGEIALWSLVVLAIERYVV,0
5dgy,A,149,171,22,ENHAIMGVAFTWVMALACAAPP,0
5dgy,A,172,203,31,AGWSRYIPEGLQCSCGIDYYTLKPEVNNESF,0
5dgy,A,204,228,24,IYMFVVHFTIPMIIIFFCYGQLVF,0
5dgy,A,251,274,23,RMVIIYVIAFLICWVPYASVAFY,0
5dgy,A,275,289,14,FTHQGSCFGPIFMT,0
5dgy,A,290,314,24,PAFFAKSAAIYNPVIYIMMNKQFR,0
5dgy,A,315,321,6,CMLTTI,0
2hqg,C,1,6,5,PNFFI,0
2hqg,C,7,11,4,RPIF,0
2hqg,C,12,25,13,WVIAIIIMLAGGL,0
2hqg,C,342,357,15,TLVEAIILVFLVMYL,0
2hqg,C,358,365,7,LQNFRAT,0
2hqg,C,366,382,16,IPTIAVPVVLLGTFAV,0
2hqg,C,398,410,12,VLAIGLLVDDAI,0
2hqg,C,411,441,30,VVENVERVMAEEGLPPKEATRKSMGQIQGA,0
2hqg,C,442,456,14,VGIAMVLSAVFVPM,0
2hqg,C,472,489,17,TIVSAMALSVLVALILT,0
2hqg,C,490,498,8,ALCATMLK,0
2hqg,C,499,512,13,IAKGDHGEGKKGF,0
2hqg,C,513,516,3,GWF,0
2hqg,C,517,523,6,RMFEKS,0
2hqg,C,524,527,3,HHY,0
2hqg,C,528,535,7,DSVGGIL,0
2hqg,C,536,541,5,STGRY,0
2hqg,C,542,556,14,VLYLIIVVGMAYLF,0
2hqg,C,877,890,13,AISLIVVFLCLAA,0
2hqg,C,891,897,6,YESWSI,0
2hqg,C,898,915,17,FSVMLVVPLGVIGALLA,0
2hqg,C,930,943,13,LLTTIGLSAKNAI,0
2hqg,C,944,975,31,IVEFAKDLMDKEGKGLIEATLDAVRMRLRPI,0
2hqg,C,976,990,14,MASLAFILGVMPLV,0
2hqg,C,1005,1019,14,GVMGGMVTATVLAI,0
2hqg,C,1020,1036,16,FVPVFFVVVRRRFSRK,0
2hqg,C,1037,1053,16,EDIEHSHTVDHHHHHH,0
2c9m,A,54,71,17,EQFEDLLVRILLLAACI,0
2c9m,A,72,89,17,FVLAWFEEGEETITAFV,0
2c9m,A,90,108,18,PFVILLILIANAIVGVWQ,0
2c9m,A,257,274,17,EQLSKVISLICVAVWLI,0
2c9m,A,275,293,18,IGHFNDPVHGGSWIRGAI,0
2c9m,A,294,311,17,YFKIAVALAVAAIPEGL,0
2c9m,A,761,780,19,RYLISSNVGEVVCIFLTAA,0
2c9m,A,781,786,5,GLPEA,0
2c9m,A,787,807,20,IPVQLLWVNLVTDGLPATAL,0
2c9m,A,832,851,19,LFFRYMAIGGYVGAATVGA,0
2c9m,A,852,898,46,AWWFMYAEDGPGVTYHQLTHFMQCTEDHPHFEGLDCEIFEAPEPMT,0
2c9m,A,899,916,17,ALSVLVTIEMCNALNSL,0
2c9m,A,932,950,18,LLGSICLSMSLHFLILYV,0
2c9m,A,951,964,13,PLPMIFKLKALDL,0
2c9m,A,965,987,22,QWLMVLKISLPVIGLDEILKFI,0
3n5k,A,49,56,7,WELVIEQ,0
3n5k,A,58,74,16,DLLVRILLLAACISFV,0
3n5k,A,75,88,13,AWFEEGEETITAF,0
3n5k,A,89,108,19,EPFVILLILIANAIVGVWQ,0
3n5k,A,254,276,22,EFGEQLSKVISLICVAVWLINI,0
3n5k,A,277,295,18,HFNDPVHGGSWIRGAIYY,0
3n5k,A,296,318,22,KIAVALAVAAIPEGLPAVITTC,0
3n5k,A,760,781,21,IRYLISSNVGEVVCIFLTAAL,0
3n5k,A,782,785,3,LPE,0
3n5k,A,786,808,22,LIPVQLLWVNLVTDGLPATALG,0
3n5k,A,833,853,20,FFRYMAIGGYVGAATVGAAA,0
3n5k,A,854,897,43,WFMYAEDGPGVTYHQLTHFMQCTEDHPHFEGLDCEIFEAPEPM,0
3n5k,A,898,916,18,MALSVLVTIEMCNALNSL,0
3n5k,A,927,950,23,WVNIWLLGSICLSMSLHFLILYV,0
3n5k,A,951,964,13,PLPMIFKLKALDL,0
3n5k,A,965,987,22,QWLMVLKISLPVIGLDEILKFI,0
4nc3,A,26,47,21,YKDDDDGAPTESIPEEMKQIV,0
4nc3,A,55,77,22,WAALLILMVIIPTIGGNTLVIL,0
4nc3,A,78,93,15,VSLEKKLQYATNYFL,0
4nc3,A,94,115,21,SLAVADLLVGLFVMPIALLTI,0
4nc3,A,124,148,24,LVLCPAWLFLDVLFSTASIWHLCA,0
4nc3,A,149,176,27,SVDRYIAIKKPIQANQYNSRATAFIKI,0
4nc3,A,177,195,18,VVWLISIGIAIPVPIKGI,0
4nc3,A,214,235,21,GDFMLFGSLAAFFTPLAIMIV,0
4nc3,A,236,1035,799,YFLTIHALQKKAADLEDNWETLNDNLKVIEKADNAAQVKDALTKMRA,0
4nc3,A,1036,1058,22,ALDAQKATPPKLEDKSPDSPEM,0
4nc3,A,1059,328,-731,DFRHGFDILVGQIDDALKLANEGKVKEAQAAAEQLKTTRNAYIQKYLQTISNEQRASKVLGI,0
4nc3,A,329,350,21,FFLFLLMWCPFFITNITLVLC,0
4nc3,A,359,380,21,MLLEIFVWIGYVSSGVNPLVY,0
4nc3,A,381,400,19,LFNKTFRDAFGRYITCNYR,0
4nc3,A,401,414,13,TKSVGRPLEVLFQ,0
5aw1,G,4,24,20,GPDNDERFTYDYYRLRVVGL,0
5aw1,G,25,40,15,VAAVLCVIGIIILLA,0
5dir,A,2,12,10,DVDRFGRLPW,0
5dir,A,13,27,14,WITVLVFVLDQVSK,0
5dir,A,72,86,14,FALIAIVVSASLVV,0
5dir,A,87,100,13,LKRLKKGETWLAI,0
5dir,A,101,117,16,LALVLGGALGNLYDRM,0
5dir,A,140,155,15,LADSAITVGAVMLAL,0
5dir,A,156,158,2,MF,0
5m5h,A,1,332,331,DSQRNLLVIALLFVSFMIWQAWEQDKNPQPQAQQTTQTTTTAAGSAADQGVPASGQGKLISVKTDVLDLTINTRGGDVEQALLPAYPKELNSTQPFQLLETSPQFIYQAQSGLTGRDGPDNPANGPRPLYNVEKDAYVLAEGQNELQVPMTYTDAAGNTFTKTFVLKRGDYAVNVNYNVQNAGEKPLEISTFGQLKQSITLPPHLDTGSSNFALHTFRGAAYSTPDEKYEKYKFDTIADNENLNISSKGGWVAMLQQYFATAWIPHNDGTNNFYTANLGNGIAAIGYKSQPVLVQPGQTGAMNSTLWVGPEIQDKMAAVAPHLDLTVDYGW,0
5m5h,A,334,348,14,FISQPLFKLLKWIH,0
5m5h,A,349,355,6,FVGNWG,0
5m5h,A,356,370,14,SIIIITFIVRGIMY,0
5m5h,A,372,422,50,TKAQYTSMAKMRMLQPKIQAMRERLGDDKQRISQEMMALYKAEKVNPLGG,0
5m5h,A,427,440,13,IQMPIFLALYYML,0
5m5h,A,441,464,23,GSVELRQAPFALWIHDLSAQDPY,0
5m5h,A,465,476,11,ILPILMGVTMF,0
5m5h,A,480,492,12,MSPTTVTDPMQQ,0
5m5h,A,498,511,13,PVIFTVFFLWFPS,0
5m5h,A,513,523,10,VLYYIVSNLV,0
5m5h,A,529,551,22,LIYRGLEKRGLLESSGENLYFQ,0
1su4,A,54,71,17,EQFEDLLVRILLLAACI,0
1su4,A,72,89,17,FVLAWFEEGEETITAFV,0
1su4,A,90,106,16,PFVILLILIANAIVGV,0
1su4,A,258,274,16,QLSKVISLICVAVWLI,0
1su4,A,275,293,18,IGHFNDPVHGGSWIRGAI,0
1su4,A,294,310,16,YFKIAVALAVAAIPEG,0
1su4,A,762,780,18,YLISSNVGEVVCIFLTAA,0
1su4,A,781,786,5,GLPEA,0
1su4,A,787,806,19,IPVQLLWVNLVTDGLPATA,0
1su4,A,832,851,19,LFFRYMAIGGYVGAATVGA,0
1su4,A,852,898,46,AWWFMYAEDGPGVTYHQLTHFMQCTEDHPHFEGLDCEIFEAPEPMT,0
1su4,A,899,915,16,ALSVLVTIEMCNALNS,0
1su4,A,932,950,18,LLGSICLSMSLHFLILYV,0
1su4,A,951,967,16,PLPMIFKLKALDLTQW,0
1su4,A,968,987,19,MVLKISLPVIGLDEILKFI,0
1fnp,H,1,10,9,VGVTAFGNF,0
1fnp,H,12,31,19,ASLAIYSFWIFLAGLIYYL,0
1fnp,H,32,250,218,TENMREGYPLENEDGTPAANQGPFPLPKPKTFILPHGRGTLTVPGPESEDRPIALARTAVSEGFPHAPTGDPMKDGVGPASWVARRDLPELDGHGHNKIKPMKAAAGFHVSAGKNPIGLPVRGCDLEIAGKVVDIWVDIPEQMARFLEVELKDGSTRLLPMQMVKVQSNRVHVNALSSDLFAGIPTIKSPTEVTLLEEDKICGYVAGGLMYAAPKRKS,0
1fnp,H,251,260,9,VAAMLAEYA,0
5avt,G,4,21,17,GPDNDERFTYDYYRLRV,0
5avt,G,22,38,16,GLIVAAVLCVIGIIIL,0
4bwz,A,1,2,1,H,0
4bwz,A,4,24,20,EHLLEIFYLLLAAQVCAFIF,0
4bwz,A,25,29,4,RLNQ,0
4bwz,A,30,46,16,VVIGEVLAGVLVGPAL,0
4bwz,A,48,72,24,LVHEGEILEFLAELGAVFLLFMVG,0
4bwz,A,73,84,11,ETRLKDILAVG,0
4bwz,A,85,105,20,EAFLVAVLGVALPFLGGYLY,0
4bwz,A,120,134,14,TALVATSVGITARV,0
4bwz,A,135,148,13,QELGVLSRPYSRI,0
4bwz,A,149,165,16,LGAAVIDDVLGLIVLA,0
4bwz,A,182,198,16,RLIVLSVVFVGLAVFL,0
4bwz,A,199,217,18,TLIARLPLERLPVGSPLG,0
4bwz,A,218,233,15,ALALGVGMAALAASI,0
4bwz,A,235,247,12,APIVGAFLGGML,0
4bwz,A,248,264,16,SEVREKYRLEEPIFAI,0
4bwz,A,265,282,17,SFLAPIFFAMVGVRLEL,0
4bwz,A,292,313,21,AGTVVTVIAILGKVLGGFLGA,0
4bwz,A,314,321,7,TQGVRSA,0
4bwz,A,322,339,17,TVGCGMAPRGEVGLIVA,0
4bwz,A,356,371,15,LFMVVFTTLFAPFAL,0
4bwz,A,372,386,14,PLIAWTERERAAKE,0
4bwz,A,387,394,7,SENLYFQ,0
1ogv,M,1,54,53,EYQNIFSQVQVRGPADLGMTEDVNLANRSGVGPFSTLLGWFGNAQLGPIYLGS,0
1ogv,M,55,72,17,GVLSLFSGLMWFFTIGI,0
1ogv,M,82,88,6,AVFLRD,0
1ogv,M,118,133,15,SFFMFVAVWSWWGRT,0
1ogv,M,134,145,11,LRAQALGMGKH,0
1ogv,M,146,163,17,AWAFLSAIWLWMVLGFI,0
1ogv,M,179,192,13,FSHLDWTNNFSLV,0
1ogv,M,202,221,19,GLSIAFLYGSALLFAMHGA,0
1ogv,M,222,267,45,ILAVSRFGGERELEQIADRGTAAERAALFWRWTMGFNATMEGIHR,0
1ogv,M,268,283,15,AIWMAVLVTLTGGIG,0
1ogv,M,302,307,5,MAPLN,0
1qlb,F,29,50,21,QSATGLFLGLFMIGHMFFVST,0
1qlb,F,51,54,3,LLG,0
1qlb,F,55,64,9,NVMLWVTKK,0
1qlb,F,65,76,11,ELDFIFEGGKP,0
1qlb,F,77,101,24,VVSFLAAFVFAVFIAHAFLAMRKF,0
1qlb,F,105,118,13,RQYLTFKTHKDLM,0
1qlb,F,125,151,26,WWIQAMTGFAMFFLGSVHLYIMMTQP,0
1qlb,F,152,157,5,TIGPV,0
1qlb,F,158,164,6,SSFRMV,0
1qlb,F,165,166,1,E,0
1qlb,F,167,192,25,MWPLYLVLLFAVELHGSVGLYRLAV,0
1qlb,F,206,232,26,ANLKKLKTLMSAFLIVLGLLTFGAYV,0
1qlb,F,233,254,21,KGLEQTDPNIDYKYFDYKRTH,0
1qlb,F,255,256,1,R,0
5jdm,A,4,24,20,GVGYFLLGLILLYYGSDWFV,0
5jdm,A,25,40,15,GSERIARHFNVSNFV,0
5jdm,A,41,57,16,GATVMAIGTSLPEILT,0
5jdm,A,74,91,17,IGSCICNIGLVLGLSAI,0
5jdm,A,92,102,10,SPIIVDKNLQ,0
5jdm,A,103,117,14,NILVYLLFVIFAAV,0
5jdm,A,129,143,14,VLLILFIIYLRWTV,0
5jdm,A,144,151,7,NGSAEIE,0
5jdm,A,158,168,10,PSVVFSLVLL,0
5jdm,A,169,186,17,IGLIGVLVGAELFVDGA,0
5jdm,A,205,219,14,AFGTSLPELMVSLA,0
5jdm,A,220,229,9,AKRNLGGMV,0
5jdm,A,230,247,17,GNVIGSNIADIGGALAV,0
5jdm,A,261,275,14,AVLVIMSLLLYLFA,0
5jdm,A,276,282,6,YSKIGR,0
5jdm,A,283,297,14,QGILFLALYIIAIA,0
3wme,B,93,101,8,SGPESAYT,0
3wme,B,103,117,14,VTARRIFALAWSSS,0
3wme,B,118,140,22,TMIVIGFIASILEGATLPAFAI,0
3wme,B,141,166,25,FGRMFQVFTKSKSQIEGETWKYSVG,0
3wme,B,167,188,21,VGIGVFEFIVAGSRTALFGIA,0
3wme,B,236,257,21,KLGAVLFNLAQCVVGIIVAFI,0
3wme,B,258,263,5,APALT,0
3wme,B,264,284,20,VLIALSPLVVLAGAAQMIEM,0
3wme,B,339,361,22,YISDGLFFGLSMLVIFCVYALA,0
3wme,B,362,381,19,WWGGQLIARGSLNLGNLLT,0
3wme,B,382,403,21,FFSAILGFMGVGQAAQVWPDV,0
3wme,B,690,704,14,GDMSAAGSENLYFQ,0
1xfh,C,1,11,10,GLYRKYIEYP,0
1xfh,C,13,32,19,QKILIGLILGAIVGLILGH,0
1xfh,C,33,35,2,GY,0
1xfh,C,36,67,31,HAVHTYVKPFGDLFVRLLKMLVMPIVFASLV,0
1xfh,C,79,108,29,RVGVKIVVYYLLTSAFAVTLGIIMARLFN,0
1xfh,C,109,127,18,GAGIHLAVGGQQFQPHQA,0
1xfh,C,128,140,12,PLVHILLDIVPT,0
1xfh,C,141,150,9,PFGALANGQ,0
1xfh,C,151,161,10,LPTIFFAIIL,0
1xfh,C,174,197,23,KVRKSAETLLDAINGLAEAMYKI,0
1xfh,C,198,222,24,NGVMQYAPIGVFALIAYVMAEQGV,0
1xfh,C,223,229,6,VVGELA,0
1xfh,C,230,254,24,VTAAVYVGLTLQILLVYFVLLKIY,0
1xfh,C,262,289,27,KHAKDAMLTAFVTRSSSGTLPVTMRVA,0
1xfh,C,299,321,22,SFTLPLGATINMDGTALYQGVC,0
1xfh,C,322,335,13,FFIANALGSHLTV,0
1xfh,C,336,366,30,QQLTIVLTAVLASIGTAGVPGAGAIMLAMV,0
1xfh,C,367,389,22,HSVGLPLTDPNVAAAYAMILGI,0
1xfh,C,390,412,22,AILDMGRTMVNVTGDLTGTAIV,0
1xfh,C,417,422,5,TLVPR,0
2dhh,C,2,7,5,NFFID,0
2dhh,C,11,25,14,AWVIAIIIMLAGGL,0
2dhh,C,26,343,317,ILKLPVAQYPTIAPPAVTISASYPGADAKTVQDTVTQVIEQNMNGIDNLMYMSSNSDSTGTVQITLTFESGTDADIAQVQVQNKLQLAMPLLPQEVQQQGVSVEKSSSSFLMVVGVINTDGTMTQEDISDYVAANMKDAISRTSGVGDVQLFGSQYAMRIWMNPNELNKFQLTPVDVITAIKAQNAQVAAGQLGGTPPVKGQQLNASIIAQTRLTSTEEFGKILLKVNQDGSRVLLRDVAKIELGGENYDIIAEFNGQPASGLGIKLATGANALDTAAAIRAELAKMEPFFPSGLKIVYPYDTTPFVKISIHEVVKT,0
2dhh,C,344,357,13,VEAIILVFLVMYL,0
2dhh,C,366,382,16,IPTIAVPVVLLGTFAV,0
2dhh,C,383,397,14,AAFGFSINTLTMFG,0
2dhh,C,398,411,13,VLAIGLLVDDAIV,0
2dhh,C,443,456,13,GIAMVLSAVFVPM,0
2dhh,C,457,471,14,FFGGSTGAIYRQFS,0
2dhh,C,472,489,17,TIVSAMALSVLVALILT,0
2dhh,C,499,512,13,IAKGDHGEGKKGF,0
2dhh,C,518,533,15,MFEKSTHHYTDSVGG,0
2dhh,C,542,556,14,VLYLIIVVGMAYLF,0
2dhh,C,557,874,317,RLPSSFLPDEDQGVFMTMVQLPAGATQERTQKVLNEVTHYYLTKEKNNVESVFAVNGFGFAGRGQNTGIAFVSLKDWADRPGEENKVEAITMRATRAFSQIKDAMVFAFNLPAIVELGTATGFDFELIDQAGLGHEKLTQARNQLLAEAAKHPDMLTSVRPNGLEDTPQFKIDIDQEKAQALGVSINDINTTLGAAWGGSYVNDFIDRGRVKKVYVMSEAKYRMLPDDIGDWYVRAADGQMVPFSAFSSSRWEYGSPRLERYNGLPSMEILGQAAPGKSTGEAMELMEQLASKLPTGVGYDWTGMSYQERLSGNQAP,0
2dhh,C,875,890,15,LYAISLIVVFLCLAA,0
2dhh,C,899,915,16,SVMLVVPLGVIGALLA,0
2dhh,C,916,928,12,TFRGLTNDVYFQ,0
2dhh,C,929,943,14,GLLTTIGLSAKNAI,0
2dhh,C,976,990,14,MTSLAFILGVMPLV,0
2dhh,C,991,1004,13,STGAGSGAQNAVG,0
2dhh,C,1005,1019,14,GVMGGMVTATVLAI,0
2dhh,C,1022,1033,11,PVFFVVVRRRF,0
2dhh,C,1037,1053,16,EDIEHSHTVDHHHHHH,0
3w9j,C,1,11,10,SKFFIDRPIF,0
3w9j,C,12,26,14,WVIALVIMLAGGLS,0
3w9j,C,343,357,14,LGEAILLVFLVMYL,0
3w9j,C,358,365,7,LQNFRAT,0
3w9j,C,366,383,17,IPTIAVPVVLLGTFGVL,0
3w9j,C,397,410,13,MVLAIGLLVDDAI,0
3w9j,C,411,428,17,VVENVERVMAEEGLSPR,0
3w9j,C,429,438,9,AARKSMGQI,0
3w9j,C,439,441,2,GA,0
3w9j,C,442,455,13,VGIAMVLSAVFLP,0
3w9j,C,471,489,18,ITIVSAMALSVIVALILT,0
3w9j,C,490,513,23,ALCATMLKPIEKGDHGEHKGGFF,0
3w9j,C,514,536,22,WFNRMFLSTTHGYERGVASILK,0
3w9j,C,537,540,3,RAP,0
3w9j,C,541,556,15,LLIYVVIVAGMIWMF,0
3w9j,C,876,893,17,ALSLLVVFLCLAALYES,0
3w9j,C,895,915,20,IPFSVMLVVPLGVIGALLAT,0
3w9j,C,929,943,14,LLTTIGLSAKNAIL,0
3w9j,C,944,957,13,VEFAKELHEQGKG,0
3w9j,C,958,969,11,VEAAIEACRMR,0
3w9j,C,970,973,3,RPI,0
3w9j,C,974,989,15,MTSLAFILGVVPLAI,0
3w9j,C,1003,1020,17,GVIGGMVTATVLAIFWV,0
3w9j,C,1021,1028,7,LFYVAVS,0
3w9j,C,1029,1030,1,L,0
3w9j,C,1031,1052,21,KDEASKQQASVEKGQHHHHHH,0
2b2j,C,11,28,17,STALVMLMVPGVGFFYA,0
2b2j,C,29,39,10,MVRRKNAVNM,0
2b2j,C,40,62,22,ALSFISLIITVLLWIFYGYSVS,0
2b2j,C,91,108,17,YQMMFAAVTIAILTSAI,0
2b2j,C,109,114,5,ERAKV,0
2b2j,C,115,136,21,SFILLSALWLTFVYAPFAHWL,0
2b2j,C,150,170,20,AGGMVVHISSGFAALAVAMT,0
2b2j,C,171,188,17,GKRAGFEEYSIEPHSIP,0
2b2j,C,189,208,19,TLIGAALLWFGWFGFNGGS,0
2b2j,C,220,240,20,VVTNTSAAVAGFVWMVIGWI,0
2b2j,C,241,246,5,GKPGS,0
2b2j,C,247,264,17,GIVSGAIAGLAAITPAA,0
2b2j,C,270,290,20,GAIVIGLVAGIVCYLAMDFR,0
2b2j,C,291,297,6,KKKIDE,0
2b2j,C,298,319,21,LDAWAIHGIGGLWGSVAVGIL,0
2b2j,C,342,367,25,IAVASTTAYAFLVTLILAKAVDAAV,0
2b2j,C,368,379,11,LRVSSQEEYVG,0
2b2j,C,380,385,5,DLSQH,0
2b2j,C,386,391,5,EVAYT,0
2b2j,C,392,399,7,EHHHHHH,0
3ae5,D,35,41,6,SKAASL,0
3ae5,D,42,61,19,WTGERVVSVLLLGLLPAAY,0
3ae5,D,69,88,19,YSLAAALTLHGHWGIGQVV,0
3ae5,D,89,99,10,DYVRGDALQK,0
3ae5,D,100,118,18,AKAGLLALSAFTFAGLCY,0
3ae5,D,126,134,8,CKAVAMLW,0
2e76,Q,1,6,5,EIDVL,0
2e76,Q,7,25,18,WVALLVVFTWSIAMVVWG,0
2e76,Q,28,29,1,L,0
4v1h,I,18,40,22,LIMGGGAIGAGIGDGIAGNALI,0
4v1h,I,41,54,13,GIARQPEAQGRLF,0
4v1h,I,55,76,21,PFFITVGLVEAAYFINLAFMA,0
1y8s,A,1,4,3,LKR,0
1y8s,A,5,35,30,KVKPITLRDVTIIDDGKLRKAITAASLGNA,0
1y8s,A,36,52,16,EWFDFGVYGFVAYALG,0
1y8s,A,67,83,16,ALATFSVPFLIRPLGG,0
1y8s,A,84,99,15,FFGMLGDKYGRQKIL,0
1y8s,A,100,116,16,ITIVIMSISTFCIGLI,0
1y8s,A,124,140,16,WAPILLLICKMAQGFS,0
1y8s,A,141,168,27,GGEYTGASIFVAEYSPDRKRGFMGSWL,0
1y8s,A,169,186,17,FGSIAGFVLGAGVVVLI,0
1y8s,A,200,216,16,RIPFFIALPLGIIGLY,0
1y8s,A,217,236,19,RHALEETPAFQQHVDKLEQ,0
1y8s,A,237,245,8,DREGLQDG,0
1y8s,A,246,263,17,KVSFKEIATKYWRSLLT,0
1y8s,A,264,283,19,IGLVIATNVTYYMLLTYMP,0
1y8s,A,299,316,17,IIIAIMIGMLFVQPVMG,0
1y8s,A,317,329,12,LSDRFGRRPFVL,0
1y8s,A,330,346,16,GSVALFVLAIPAFILI,0
1y8s,A,354,372,18,FAGLLMLAVILNCFTGVM,0
1y8s,A,373,392,19,STLPAMFPTHIRYSALAAA,0
1y8s,A,393,410,17,NISVLVAGLTPTLAAWL,0
1y8s,A,417,434,17,MMPAYYLMVVAVVGLIT,0
1y8s,A,435,452,17,VTMKETANRPLKGATPA,0
1y8s,A,453,500,47,SDIQEAKEILVEHYDNIEQKIDDIDHEIADLQAKRTRLVQQHPRIDE,0
3fb7,F,21,25,4,SALQ,0
3fb7,F,31,50,19,ATVLLVIVLLAGSYLAVLA,0
3fb7,F,51,62,11,RGAPGAQLITY,0
3fb7,F,63,79,16,RALWWSVETATTVGYG,0
3fb7,F,80,86,6,LYPVTL,0
3fb7,F,87,110,23,GRCVAVVVMVAGITSFGLVTAAL,0
3fb7,F,115,124,9,GQEQQQQGQ,0
4mrn,B,1,8,7,PPETATN,0
4mrn,B,16,27,11,WQTLKRFLPYL,0
4mrn,B,34,58,24,LRRRVVGAILMVLLGKATTLALPF,0
4mrn,B,59,85,26,YKKAVDAMTLGGGAQPALTVALAFVL,0
4mrn,B,86,108,22,YALGRFSGVLFDNLRNIVFERV,0
4mrn,B,155,177,22,YFLLFNIAPTVIELTAVIVIFW,0
4mrn,B,178,182,4,NFGL,0
4mrn,B,183,206,23,LVTATILAVIAYVWTTRTITEWR,0
4mrn,B,263,284,21,SLGLLNIAQALIVNLLMAGAM,0
4mrn,B,285,302,17,WTVYGWSQGKLTVGDLV,0
4mrn,B,303,323,20,VNTYLTQLFRPLDMLGMVYR,0
4mrn,B,607,614,7,EHHHHHH,0
3qbl,D,1,17,16,TETLPPVTESAVALQA,0
3qbl,D,18,20,2,VT,0
3qbl,D,21,28,7,RELFEFV,0
3qbl,D,29,36,7,NDPLLAS,0
3qbl,D,37,57,20,LYINIALAGLSILLFVFMTR,0
3qbl,D,66,87,21,IAVSTILVPVVSIASYTGLAS,0
3qbl,D,88,120,32,LTISVLEMPAGHFAEGSSVMLGGEEVDGVVTM,0
3qbl,D,121,141,20,GRYLTWALSTPMILLALGLL,0
3qbl,D,147,168,21,KLFTAITFDIAMCVTGLAAAL,0
3qbl,D,169,174,5,TSSHL,0
3qbl,D,175,199,24,RWFWYAISCACFIVVLYILLVEWA,0
3qbl,D,211,232,21,STLKLLTVVMWLGYPIVWALG,0
3qbl,D,233,243,10,EGVAVLPVGY,0
3qbl,D,244,267,23,SWAYSALDIVAKYIFAFLLLNYL,0
3qbl,D,277,291,14,ILDVPSASGAPADD,0
3a0h,z,5007,5022,15,ALAALVILSFVMVIG,0
3a0h,z,5023,5040,17,PVAYASPQDWDRSKQLI,0
3a0h,z,5041,5055,14,LGSGLWIALVLVVG,0
5u1u,C,21,33,12,SSTNYGTIKWIF,0
5u1u,C,36,49,13,VFSYISFALISDK,0
5u1u,C,50,328,278,YQKKEPLISSVHTKVKGIAEVKAEILENGMKKMVSGVFDTADYTFPLQGNSFFVMTNFIKTEGQQQGLCPDFPTARTICSSDRGCKKGRMDPQSKGIQTGRCVVYKERLKTCEVSAWCPIEEVKDAPRPALLNSAENFTVLIKNNIDFPGHNYTTRNILPGVNITCTFHKTQNPQCPIFRLGDIFQETGDSFSDVAIQGGIMGIEIYWDCNLDGWFHHCRPKYSFRRLDDKTTSESLYPGYNFRYAKYYKENNVEKRTLIKVFGIRFDILVFGTGGKF,0
5u1u,C,329,344,15,VIQLAVYIGSVISYF,0
5u1u,C,348,362,14,VFIDILINTYSASS,0
3aec,D,35,40,5,SKAAS,0
3aec,D,41,61,20,HWTGERVVSVLLLGLLPAAY,0
3aec,D,69,89,20,YSLAAALTLHGHWGIGQVVT,0
3aec,D,90,98,8,YVRGDALQ,0
3aec,D,99,118,19,AAKAGLLALSAFTFAGLCY,0
3aec,D,126,134,8,CKAVAMLW,0
5iwn,D,137,147,10,PSSPSLLRAI,0
5iwn,D,148,150,2,GI,0
5iwn,D,151,170,19,WIALLLLVIFYVFAVMGTK,0
5iwn,D,187,200,13,YTLFQVMTLESWS,0
5iwn,D,216,234,18,YFVSFILVSSFTVLNLFI,0
5iwn,D,235,285,50,IIIESMQSAHWEAEDAKRIEQEQRAHDERLEMLQLIRDLSSKVDRLERRS,0
5iwn,D,286,288,2,KR,0
2npe,C,15,32,17,CTALVLFMTIPGIALFY,0
2npe,C,33,45,12,GLIRGKNVLSML,0
2npe,C,46,64,18,QVTVTFALVCILWVVYGY,0
2npe,C,102,119,17,FQGSFACITVGLIVGAL,0
2npe,C,120,126,6,ERIRFS,0
2npe,C,127,147,20,VLIFVVVWLTLSYIPIAHMV,0
2npe,C,161,178,17,AGGTVVHINAAIAGLVG,0
2npe,C,179,181,2,YL,0
2npe,C,182,194,12,GKRVGFGKEAFK,0
2npe,C,195,200,5,HNLPM,0
2npe,C,201,219,18,FTGTAILYIGWFGFNAGS,0
2npe,C,231,249,18,VNTVVATAAAILGWIFGE,0
2npe,C,250,259,9,ALRGKPSLL,0
2npe,C,260,276,16,ACSGAIAGLVGVTPAC,0
2npe,C,282,299,17,GALIIGVVAGLAGLWGV,0
2npe,C,300,304,4,MLKR,0
2npe,C,305,309,4,LRVD,0
2npe,C,310,312,2,PC,0
2npe,C,313,332,19,VFGVAGVCGIVGCIMTGIF,0
2npe,C,353,377,24,VQLESIAITIVWSGVVAFIGYKLA,0
2npe,C,378,386,8,LTVGLRVP,0
2npe,C,387,424,37,EQEREGLDVNSHGENAYNADQAQQPAQADLEHHHHHH,0
1kpl,B,1,11,10,KTDTSTFLAQ,0
1kpl,B,36,61,25,FMAAVVGTLTGLVGVAFEKAVSWVQ,0
1kpl,B,62,80,18,MRIGALVQVADHAFLLWP,0
1kpl,B,81,102,21,AFILSALLAMVGYFLVRKFAP,0
1kpl,B,125,142,17,RVLPVKFIGGMGTLGAG,0
1kpl,B,144,159,15,LGREGPTVQIGGNLG,0
1kpl,B,181,201,20,AAAGLSAAFNAPLAGILFII,0
1kpl,B,215,233,18,KAVFTGVIMSSIVFRIFN,0
1kpl,B,234,249,15,EAPIIEVGKLSDAPV,0
1kpl,B,250,277,27,TLWLYLILGIIFGVVGPVFNSLVLRTQ,0
1kpl,B,278,284,6,MFQRFH,0
1kpl,B,289,306,17,KWVLMGGAIGGLCGILG,0
1kpl,B,307,334,27,IEPAAAGGGFNLIPIAAAGNFSVGLLL,0
1kpl,B,335,351,16,IFITRVVTTLLCFSSG,0
1kpl,B,353,368,15,GGIFAPMLALGTLLG,0
1kpl,B,369,379,10,AFGMAAAVLF,0
1kpl,B,380,391,11,QYHLEAGTFAI,0
1kpl,B,392,416,24,GMGALMAASVRAPLTGIVLVLEMT,0
1kpl,B,417,421,4,NYQL,0
1kpl,B,422,442,20,LPMIITCLGATLLAQFLGGK,0
1kpl,B,463,473,10,NQNAPADENT,0
4xdl,B,73,76,3,WKT,0
4xdl,B,77,98,21,VAIFVVVVVYLVTGGLVFRAL,0
4xdl,B,159,176,17,GSAFFFAGTVITTIGYG,0
4xdl,B,184,208,24,GKIFCILYAIFGIPLFGFLLAGIG,0
4xdl,B,209,241,32,QLGTIFGKSIARVEKVFRKKQVSQTKIRVIST,0
4xdl,B,242,263,21,LFILAGCIVFVTIPAVIFKYI,0
4xdl,B,269,281,12,ESIYFVVVTLTT,0
4xdl,B,299,321,22,WYKPLVWFWILVGLAYFAAVLS,0
4xdl,B,322,329,7,IGDWLRV,0
3h5m,B,1,5,4,SSDA,0
3h5m,B,6,10,4,AHKV,0
3h5m,B,11,31,20,LIPVTLMVSGNIMGSGVFLL,0
3h5m,B,44,62,18,GWLVTIIGALGLSMVYAK,0
3h5m,B,63,84,21,SFLDPSPGGSYAYARRCFGPF,0
3h5m,B,85,112,27,GYQTNVLYWLACWIGNIAMVVIGVGYL,0
3h5m,B,125,144,19,TITCVVVLWIFVLLNIVGP,0
3h5m,B,146,171,25,ITRVQAVATVLALIPIVGIAVFGWF,0
3h5m,B,197,218,21,NVTLWSFIGVESASVAAGVVK,0
3h5m,B,219,228,9,PKRNVPIAT,0
3h5m,B,229,249,20,GGVLIAAVCYVLSTTAIMGM,0
3h5m,B,257,276,19,SASPFGDAARMALGDTAGA,0
3h5m,B,282,306,24,AAGCLGSLGGWTLLAGQTAKAAAD,0
3h5m,B,307,323,16,GLFPPIFARVNKAGTP,0
3h5m,B,324,342,18,AGLIIVGILMTIFQLSSI,0
3h5m,B,350,370,20,GLVSSVSVIFTLVPYLYTCA,0
3h5m,B,371,385,14,LLLLGHGHFGKARP,0
3h5m,B,386,407,21,YLAVTTIAFLYCIWAVVGSGA,0
3h5m,B,409,426,17,VMWSFVTLMVITAMYAL,0
3h5m,B,427,435,8,YNRLHKNP,0
3h5m,B,436,445,9,PLDAPISKD,0
4tq6,A,1,14,13,DSSLANINQIDVP,0
4tq6,A,16,40,24,YLRLLRPVAWLCFLLPYAVGFGFG,0
4tq6,A,41,51,10,TPNASLQHAV,0
4tq6,A,52,71,19,GLLSFAFWMAFSFTINALY,0
4tq6,A,73,90,17,DVDRLHDGRVKDLNLSM,0
4tq6,A,98,119,21,SVREAWLYCIAFLALSLATAA,0
4tq6,A,120,124,4,INEK,0
4tq6,A,125,146,21,FLAMLGANIIGYVYSAPPRFK,0
4tq6,A,151,169,18,DVICNALAAVLAFYAGLS,0
4tq6,A,170,175,5,GGAEV,0
4tq6,A,176,194,18,IAIYPAAFFLAATFYIPT,0
4tq6,A,199,204,5,EFDKK,0
4tq6,A,224,241,17,PLSAITVILWAYVFLMA,0
4tq6,A,242,245,3,RIE,0
4tq6,A,246,263,17,KVISPLIIAYTLIYTFI,0
4tq6,A,270,272,2,EK,0
4tq6,A,277,294,17,NLILTPFGIISALFIAY,0
4tq6,A,295,301,6,FAVISV,0
4tq6,A,302,303,1,G,0
4mhw,A,6,11,5,NVRLL,0
4mhw,A,12,31,19,EIAFMAALAFIISLIPNTV,0
4mhw,A,36,49,13,VEIACIPILLLSL,0
4mhw,A,50,53,3,RGL,0
4mhw,A,54,73,19,AGLVGGLIWGILSMITGHA,0
4mhw,A,80,97,17,AFLEYLVAPVSLGIAGL,0
4mhw,A,98,110,12,RQKTAPLKLAPV,0
4mhw,A,111,128,17,LGTFVAVLLKYFFHFIA,0
4mhw,A,148,169,21,AVNGISGILTAIAAFVILIIF,0
4mhw,A,170,182,12,KKFPKLFIHSNY,0
3t1c,E,18,20,2,AK,0
3t1c,E,25,45,20,VLFVLTILTLISGTIFYSTV,0
3t1c,E,46,50,4,GLRP,0
3t1c,E,51,67,16,DALYFSVVTLTTVGYG,0
3t1c,E,68,74,6,FSPQTD,0
3t1c,E,75,99,24,GKIFTILYIFIGIGLVFGFIHKLA,0
3t1c,E,103,111,8,LPSILSNL,0
2lp1,A,671,682,11,DAEFRHDSGYE,0
2lp1,A,686,696,10,KLVFFAEDVG,0
2lp1,A,697,701,4,NKGA,0
2lp1,A,702,717,15,IGLMVGGVVIATVIV,0
2lp1,A,729,792,63,SIHHGVVEVDAAVTPEERHLSKMQQNGYENPTYKFFEQMQNQGRILQISITLAAALEHHHHHH,0
1kju,A,55,73,18,QFEDLLVRILLLAACISF,0
1kju,A,74,89,15,LAWFEEGEETITAFV,0
1kju,A,90,107,17,PFVILLILIANAIVGVW,0
1kju,A,260,276,16,SKVISLICVAVWLINI,0
1kju,A,277,292,15,HFNDPVHGGSWIRGA,0
1kju,A,293,311,18,YYFKIAVALAVAAIPEGL,0
1kju,A,762,781,19,YLISSNVGEVVCIFLTAAL,0
1kju,A,782,785,3,LPE,0
1kju,A,786,807,21,LIPVQLLWVNLVTDGLPATAL,0
1kju,A,835,855,20,RYMAIGGYVGAATVGAAAWW,0
1kju,A,856,897,41,MYAEDGPGVTYHQLTHFMQCTEDHPHFEGLDCEIFEAPEPM,0
1kju,A,898,916,18,MALSVLVTIEMCNALNSL,0
1kju,A,932,950,18,LLGSICLSMSLHFLILYV,0
1kju,A,951,963,12,PLPMIFKLKALD,0
1kju,A,964,984,20,TQWLMVLKISLPVIGLDEIL,0
2w2e,D,1,10,9,PDIENQAAD,0
2w2e,D,48,66,18,SGEFVGTFLFLWSAFVIA,0
2w2e,D,67,86,19,IANQAPETPDGGSNPAQLI,0
2w2e,D,87,104,17,ISFGFGFGVMVGVFITY,0
2w2e,D,108,121,13,GNLNPAVTLALVL,0
2w2e,D,131,148,17,LMAFTQIVAGMAAAGAA,0
2w2e,D,149,171,22,AMTPGEIAFANALGGGASRTRG,0
2w2e,D,172,189,17,FLEAFGTAILCLTVLML,0
2w2e,D,200,216,16,PFVIGIALLIAHLICI,0
2w2e,D,217,221,4,YTGA,0
2w2e,D,222,234,12,LNPARSFGPAVA,0
2w2e,D,235,242,7,RSFPNYH,0
2w2e,D,243,260,17,IYWLGPILGAFLAYSIW,0
2w2e,D,274,279,5,QDSDA,0
4cg6,D,2,17,15,IVSVGSFISVLFIVI,0
3d4s,A,-7,31,38,YKDDDDAMGQPGNGSAFLLAPNRSHAPDHDVTQQRDEV,0
3d4s,A,36,59,23,GIVMSLIVLAIVFGNVLVITAIA,0
3d4s,A,60,68,8,FERLQTVT,0
3d4s,A,69,91,22,YFITSLACADLVMGLAVVPFGA,0
3d4s,A,109,130,21,TSIDVLCVTASIWTLCVIAVD,0
3d4s,A,131,148,17,YFAITSPFKYQSLLTKN,0
3d4s,A,149,168,19,ARVIILMVWIVSGLTSFLP,0
3d4s,A,201,221,20,ASSIVSFYVPLVIMVFVYSR,0
3d4s,A,222,274,52,FQEAKRQLNIFEMLRIDEGLRLKIYKDTEGYYTIGIGHLLTKSPSLNAAKSELDKAIGRNTNGVITKDEAEKLFNQDVDAAVRGILRNAKLKPVYDSLDAVRRAALINMVFQMGETGVAGFTNSLRMLQQKRWDEAAVNLAKSRWYNQTPNRAKRVITTFRTGTWDAYKFCLKEHKALKT,0
3d4s,A,275,295,20,GIIMGTFTLCWLPFFIVNIV,0
3d4s,A,310,327,17,LNWIGYVNSGFNPLIYC,0
3d4s,A,328,329,1,S,0
3d4s,A,330,339,9,DFRIAFQEL,0
3d4s,A,340,342,2,CL,0
3d4s,A,343,354,11,RSSLKHHHHHH,0
1u5n,A,54,74,20,ELILNQFDDLLVKILLLAAF,0
1u5n,A,75,97,22,SFVLTLLDMKHKKIEICDFIEP,0
1u5n,A,98,116,18,VIVLILILNAAVGVWQEC,0
1u5n,A,264,283,19,GQQLSKIIFVICVTVWIIN,0
1u5n,A,284,302,18,KHFSDPIHGSFLYGCLYY,0
1u5n,A,303,321,18,KISVALAVAAIPEGLPAV,0
1u5n,A,972,993,21,IRYLISSNIGEVASIFITALL,0
1u5n,A,994,997,3,IPD,0
1u5n,A,998,1020,22,LAPVQLLWVNLVTDGLPATALG,0
1u5n,A,1044,1065,21,TLLRYIIIGTYVGIATVSIFV,0
1u5n,A,1066,1082,16,WFLFYPDSDMHTLINF,0
1u5n,A,1083,1088,5,QLSHY,0
1u5n,A,1089,1122,33,QCKAWNNFRVNKVYDMSEDHCSYFSAGKIKAST,0
1u5n,A,1123,1141,18,SLSVLVLIEMFNALNALS,0
1u5n,A,1155,1174,19,YLVLATIGSLLLHVLILYI,0
1u5n,A,1175,1181,6,PLARIF,0
1u5n,A,1182,1188,6,VVPLSA,0
1u5n,A,1189,1212,23,DWFLVFLWSFPVIILDEIIKFYA,0
4aq9,E,165,171,6,VVEWIH,0
4aq9,E,227,243,16,PCVLISSLVVLVYFLP,0
4aq9,E,244,250,6,QAGGQK,0
4aq9,E,251,268,17,TLSISVLLAQTIFLFLI,0
4aq9,E,289,308,19,MFVSLVIVTNCVIVLNVSL,0
4aq9,E,309,314,5,TPNTH,0
4aq9,E,315,413,98,LSEKIKHLFLEFLPKYLGMHLEPSEETPEKPQPRRRSSFGIMIKAEEYILKKPRSELMFEEQKDRHGLKRVNKMTSDIDIGTTVDLYKDLANFAPEIK,0
4aq9,E,414,448,34,CVEACNFIAKSTKEQNDSGSENENWVLIGKVIDK,0
4aq9,E,449,467,18,CFWIALLLFSLGTLAIFL,0
4aq9,E,477,488,11,PFPGDPRKYVP,0
1wu0,A,12,35,23,GLGALGAGIGNGLIVSRTIEGIA,0
1wu0,A,36,43,7,QPELRPV,0
1wu0,A,44,67,23,QTTMFIGVALVEALPIIGVVFSF,0
4j7y,C,-5,-2,3,HHH,0
4j7y,C,8,28,20,AAVTLLGVLLQAYFSLQVIS,0
4j7y,C,29,50,21,RRAFRVSPPLTTGPPEFERVY,0
4j7y,C,51,71,20,AQVNCSEYFPLFLATLWVAG,0
4j7y,C,79,97,18,ALCGLVYLFARLRYFQGY,0
4j7y,C,98,103,5,RSAQL,0
4j7y,C,104,124,20,LAPLYASARALWLLVALAAL,0
4j7y,C,150,154,4,LPWA,0
2wie,P,1,10,9,ESNLTTAAS,0
2wie,P,11,33,22,IAAALAVGIGSIGPGLGQGQAA,0
2wie,P,55,78,23,LSLAFMEALTIYGLVVALVLLFA,0
2wie,P,79,82,3,PFV,0
4jc7,C,-4,5,9,HHHHHKDEV,0
4jc7,C,6,28,22,LLAAVTLLGVLLQAYFSLQVIS,0
4jc7,C,51,74,23,AQVNCSEYFPLFLATLWVAGIFF,0
4jc7,C,76,97,21,GAAALCGLVYLFARLRYFQGY,0
4jc7,C,104,131,27,LAPLYASARALALLVALAALGLLAHFL,0
4jc7,C,132,141,9,AALRAALLG,0
4jc7,C,142,149,7,LRTLLPW,0
3asn,Z,17,35,18,GLSVTFLSFLLPAGWVLY,0
3asn,Z,36,43,7,LDNYKKS,0
3asn,Z,44,46,2,AA,0
4m2s,A,1,29,28,ELEEDLKGRADKNFSKMGKKSKKEKKEK,0
4m2s,A,39,68,29,RYAGWLDRLYMLVGTLAAIIHGVALPLMM,0
4m2s,A,69,117,48,IFGDMTDSFASVGQVSKQSTQMSEADKRAMFAKLEEEMTTYAYYYTGI,0
4m2s,A,118,139,21,AGVLIVAYIQVSFWCLAAGRQ,0
4m2s,A,181,204,23,IGDKIGMFFQAMATFFGGFIIGF,0
4m2s,A,205,210,5,RGWKL,0
4m2s,A,211,230,19,LVILAISPVLGLSAGIWAK,0
4m2s,A,290,312,22,ANISMGAAFLLIYASYALAFWY,0
4m2s,A,313,329,16,TSLVISKEYSIGQVLT,0
4m2s,A,330,352,22,FFSVLIGAFSVGQASPNIEAFA,0
4m2s,A,627,680,53,GNEIELGNEACKSKDEIDNLDMSSKDSGSSLIRRRSTRKSICGPHDQDRKLST,0
4m2s,A,706,728,22,FVVGIFCAIINGGLQPAFSVIF,0
4m2s,A,729,751,22,KVVGVFTNGGPPETQRQNSNLF,0
4m2s,A,752,773,21,LLFLILGIISFITFFLQGFTF,0
4m2s,A,827,847,20,RLAVIFQNIANLGTGIIISL,0
4m2s,A,848,854,6,YGWQLT,0
4m2s,A,855,879,24,LLLAIVPIIAIAGVVEMKMLSGQA,0
4m2s,A,926,950,24,AMKKAHVFGITFSFTQAMMYFSYA,0
4m2s,A,951,972,21,CFRFGAYLVTQQLMTFENVLL,0
4m2s,A,973,994,21,FSAIVFGAMAVGQVSSFAPDY,0
4m2s,A,1272,1282,10,AKRSHHHHHH,0
2bs2,F,29,50,21,QSATGLFLGLFMIGHMFFVST,0
2bs2,F,51,54,3,LLG,0
2bs2,F,55,64,9,NVMLWVTKK,0
2bs2,F,65,76,11,ELDFIFEGGKP,0
2bs2,F,77,99,22,VVSFLAAFVFAVFIAHAFLAMR,0
2bs2,F,105,118,13,RQYLTFKTHKDLM,0
2bs2,F,125,151,26,WWIQAMTGFAMFFLGSVHLYIMMTQP,0
2bs2,F,152,157,5,TIGPV,0
2bs2,F,158,164,6,SSFRMV,0
2bs2,F,165,166,1,E,0
2bs2,F,167,192,25,MWPLYLVLLFAVELHGSVGLYRLAV,0
2bs2,F,206,231,25,ANLKKLKTLMSAFLIVLGLLTFGAY,0
2bs2,F,232,254,22,KKGLEQTDPNIDYKYFDYKRTH,0
2bs2,F,255,256,1,E,0
2y04,A,31,32,1,G,0
2y04,A,43,63,20,MSLLMALVVLLIVAGNVLVI,0
2y04,A,64,81,17,AIGSTQRLQTLTNLFIT,0
2y04,A,82,103,21,LACADLVVGLLVVPFGATLVV,0
2y04,A,108,133,25,WGSFLCELWTSLDVLCVTASIETLC,0
2y04,A,134,163,29,IAIDRYLAITSPFRYQSLMTRARAKVIIC,0
2y04,A,164,183,19,VWAISALVSFLPIMMHWWR,0
2y04,A,187,194,7,QALKCYQ,0
2y04,A,200,228,28,FVTNRAYAIASSIISFYIPLLIMIFVAL,0
2y04,A,229,237,8,VYREAKEQ,0
2y04,A,238,249,11,RKIDRASKRKT,0
2y04,A,278,293,15,RVMLMREHKALKTLG,0
2y04,A,294,315,21,IMGVFTLCWLPFFLVNIVNVF,0
2y04,A,324,344,20,FVAFNWLGYANSAMNPIIYC,0
2y04,A,345,346,1,S,0
2y04,A,347,357,10,DFRKAFKRLL,0
2y04,A,359,373,14,PRKADRRLHHHHHH,0
3jch,E,1,16,15,EEKRLSAKKGLPPGT,0
3jch,E,17,295,278,VYTGKYREDFEIEVMNYSIEEFREFKTTDVESVLPFRDSSTPTWINITGIHRTDVVQRVGEFFGIHPLVLEDILNVHQRPKVEFFENYVFIVLKMFTYDKNLHELESEQVSLILTKNCVLMFQEKIGDVFDPVRERIRYNRGIIRKKRADYLLYSLIDALVDDYFVLLEKIDDEIDVLEEEVLERPEKETVQRTHQLKRNLVELRKTIWPLREVLSSLYRDVPPLIEKETVPYFRDVYDHTIQIADTVETFRDIVSGLLDVYLSSVSNKTNEVMKVLT,0
3jch,E,296,310,14,IATIFMPLTFIAGI,0
3jch,E,330,343,13,LAVMGVIAVIMVV,0
3jch,E,344,347,3,FKK,0
3jch,E,348,351,3,KWL,0
3ze5,C,-8,15,23,HHHHHHELANNTTGFTRIIKAAG,0
3ze5,C,17,27,10,WKGLRAAWIN,0
3ze5,C,28,32,4,AAFR,0
3ze5,C,33,47,14,EGVAVLLAVVIACW,0
3ze5,C,53,68,15,TRVLLISSVMLVMIV,0
3ze5,C,69,101,32,LLNSAIEAVVDRIGSEYHELSGRAKDLGSAAV,0
3ze5,C,102,117,15,IAIIDAVITWCILLW,0
3ze5,C,120,121,1,G,0
1lbn,A,100,111,11,GCRLCRFMGVV,0
1lbn,A,112,132,20,IFFGLSPLLLGAAMASERYL,0
1lbn,A,144,165,21,SQRRAWATVGLVWAAALALGL,0
1lbn,A,166,201,35,PLLGVGRYTVQYPGSWCFLTLGAESGDVAFGLLFS,0
1lbn,A,202,225,23,LGGLSVGLSFLLNTVSVATLCHV,0
1lbn,A,243,263,20,MAQLLGIMVVASVCWLPLLV,0
1lbn,A,264,265,1,I,0
3ze4,C,-8,27,35,HHHHHHELANNTTGFTRIIKAAGYSWKGLRAAWIN,0
3ze4,C,28,33,5,AAFRQ,0
3ze4,C,34,48,14,GVAVLLAVVIACWL,0
3ze4,C,53,67,14,TRVLLISSVMLVMI,0
3ze4,C,68,102,34,EILNSAIEAVVDRIGSEYHELSGRAKDMGSAAVL,0
3ze4,C,103,117,14,AIIVAVITWCILLW,0
3ze4,C,120,121,1,G,0
5gmy,A,12,25,13,HLSVLVIAALISV,0
5gmy,A,26,83,57,LRILNPWNSVFTWTVRLGGNDPWYYYRLIENTIHNFPHRIWFDPFTYYPYGSYTHFG,0
5gmy,A,84,96,12,FLVYLGSIAGII,0
5gmy,A,97,116,19,SATSGESLRAVLAFIPAIG,0
5gmy,A,117,131,14,VLAILPVYLLTREV,0
5gmy,A,135,148,13,AAVIAAFLIAIVP,0
5gmy,A,149,164,15,QFLQRSILGFNDHHI,0
5gmy,A,165,180,15,EAFWQVSALGTFLLA,0
5gmy,A,199,216,17,YPVIAGITIGLYVLSWG,0
5gmy,A,218,230,12,FIIAPIILAFMF,0
5gmy,A,250,265,15,VVTFAVSALIYLPFA,0
5gmy,A,266,278,12,NYPGFSTIFYSP,0
5gmy,A,279,291,12,QLLVLLGSAVIA,0
5gmy,A,325,334,9,LIMGLFFVI,0
5gmy,A,351,374,23,KGGALTIAEVYPFFFTHNGEFTL,0
5gmy,A,375,380,5,NAVLH,0
5gmy,A,381,396,15,GALFFFGMAGILYSA,0
5gmy,A,410,423,13,LIWAIAMFIALWG,0
5gmy,A,424,427,3,NRF,0
5gmy,A,428,444,16,YYFAAVSAVYSALALS,0
5gmy,A,472,486,14,FALLIALAAIYPTY,0
5gmy,A,487,868,381,LADAQSSYAGGPNKQWYDALTWMRENTPDGEKYDEYYLQLYPTPQSNKEPFSYPFETYGVISWWDYGHWIEAVAHRMPIANPFQAGIGNKYNNVPGASSFFTAENESYAEFVAEKLNVKYVVSDIEMETCKYYAMAVWAEGDLPLAEKYYGGYFYYSPTGTFGYANSQWDIPLNSIIIPLRIPSELYYSTMEAKLHLFDGSGLSHYRMIYESDYPAEWKSYSSQVNLNNESQVLQTALYEAVMRARYGVSPTMGTQEVLYKYAYTQLYEKKMGIPVKIAPSGYVKIFERVKGAVVTGKVSANVTEVSVNATIKTNQNRTFEYWQTVEVKNGTYTVVLPYSHNSDYPVKPITPYHIKAGNVVKEITIYESQVQNGEIIQLDL,0
2bs3,F,29,50,21,QSATGLFLGLFMIGHMFFVST,0
2bs3,F,51,54,3,LLG,0
2bs3,F,55,65,10,NVMLWVTKKF,0
2bs3,F,66,76,10,LDFIFEGGKP,0
2bs3,F,77,99,22,VVSFLAAFVFAVFIAHAFLAMR,0
2bs3,F,105,118,13,RQYLTFKTHKDLM,0
2bs3,F,125,151,26,WWIQAMTGFAMFFLGSVHLYIMMTQP,0
2bs3,F,152,157,5,TIGPV,0
2bs3,F,158,164,6,SSFRMV,0
2bs3,F,165,166,1,E,0
2bs3,F,167,192,25,MWPLYLVLLFAVQLHGSVGLYRLAV,0
2bs3,F,206,232,26,ANLKKLKTLMSAFLIVLGLLTFGAYV,0
2bs3,F,233,254,21,KGLEQTDPNIDYKYFDYKRTH,0
2bs3,F,255,256,1,R,0
1kf6,P,13,38,25,WGLFGAGGMWSAIIAPVMILLVGIL,0
1kf6,P,39,61,22,PLGLFPGDALSYERVLAFAQSF,0
1kf6,P,62,83,21,GRVFLFLMIVLPLWCGLHRMH,0
1kf6,P,94,116,22,AGKWVFYGLAAILTVVTLIGVV,0
1kf6,P,117,118,1,I,0
3zdq,B,151,152,1,A,0
3zdq,B,154,165,11,PEARKLLGLAY,0
3zdq,B,166,167,1,E,0
3zdq,B,168,189,21,RRLAAAVGFLTMSSVISMSAP,0
3zdq,B,219,239,20,AVFLCGAAANAIRVYLMQTS,0
3zdq,B,240,285,45,QRIVNRLRTSLFSSILRQEVAFFDKTRTGELINRLSSDTALLGRS,0
3zdq,B,286,308,22,TENLSDGLRAGAQASVGISMMF,0
3zdq,B,316,337,21,FVLSVVPPVSIIAVIYGRYLR,0
3zdq,B,338,390,52,LTKVTQDSLAQATQLAEERIGNVRTVRAFGKEMTEIEKYASKVDHVMQLARK,0
3zdq,B,391,413,22,AFARAGFFGATGLSGNLIVLSV,0
3zdq,B,435,455,20,MYAFWVGISIGGLSSFYSEL,0
3zdq,B,456,722,266,KGLGAGGRLWELLEREPKLPFNEGVILNEKSFQGALEFKNVHFAYPARPEVPIFQDFSLSIPSGSVTALVGPSGSGKSTVLSLLLRLYDPASGTISLDGHDIRQLNPVWLRSKIGTVSQEPILFSCSIAENIAYGADDPSSVTAEEIQRVAEVANAVAFIRNFPQGFNTVVGEKGVLLSGGQKQRIAIARALLKNPKILLLDEATSALDAENEYLVQEALDRLMDGRTVLVIAHRLSTIKNANMVAVLDQGKITEYGKHEELLSKP,0
3zdq,B,723,745,22,GIYRKLMNKQSFISAAENLYFQ,0
3jav,D,1,4,3,SDK,0
3jav,D,5,319,314,SSFLHIGDICSLYAEGSTNGFISTLGLVDDRCVVQPEAGDLNNPPKKFRDCLFKLCPMNRYSAQKQFWKAAKPGANSTTDAVLLNKLHHAADLEKKQNETENRKLLGTVIQYGNVIQLLHLKSNKYLTVNKRLPALLEKNAMRVTLDEAGNEGSWFYIQPFYKLRSIGDSVVIGDKVVLNPVNAGQPLHASSHQLVDNPGCNEVNSVNCNTSWKIVLFMKWSDNKDDILKGGDVVRLFHAEQEKFLTCDEHRKKQHVFLRTTGRQSATSATSSKALWEVEVVQHDPCRGGAGYWNSLFRFKHLATGHYLAAEVD,0
3jav,D,320,347,27,DFEEECLEFQPSVDPDQDASRSRLRNA,0
3jav,D,348,791,443,EKMVYSLVSVPEGNDISSIFELDPTTLRGGDSLVPRNSYVRLRHLCTNTWVHSTNIPIDKEEEKPVMLKIGTSPLKEDKEAFAIVPVSPAEVRDLDFANDASKVLGSIAGKLEKGTITQNERRSVTKLLEDLVYFVTGGTNSGQDVLEVVFSKPNRERQKLMREQNILKQIFKLLQAPFTDCGDGPMLRLEELGDQRHAPFRHICRLCYRVLRHSQQDYRKNQEYIAKQFGFMQKQIGYDVLAEDTITALLHNNRKLLEKHITAAEIDTFVSLVRKNREPRFLDYLSDLCVSMNKSIPVTQELICKAVLNPTNADILIETKLVLSRFEFEGVSTGENALEAGEDEEEVWLFWRDSNKEIRSKSVRELAQDAKEGQKEDRDVLSYYRYQLNLFARMCLDRQYLAINEISGQLDVDLILRCMSDENLPYDLRASFCRLMLHMHVD,0
3jav,D,792,824,32,DPQEQVTPVKYARLWSEIPSEIAIDDYDSSGA,0
3jav,D,825,900,75,KDEIKERFAQTMEFVEEYLRDVVCQRFPFSDKEKNKLTFEVVNLARNLIYFGFYNFSDLLRLTKILLAILDCVHV,0
3jav,D,901,959,58,TIFPISKMTKGEENKGSNVMRSIHGVGELMTQVVLRGGGFLPMTPMAAAPEGNVKQAE,0
3jav,D,960,1134,174,EKEDIMVMDTKLKIIEILQFILNVRLDYRISCLLCIFKREFDESNSQSSETSSGNSSQEGPSNVPGALDFEHIEEQAEGIFGGSEENTPLDLDDHGGRTFLRVLLHLTMHDYPPLVSGALQLLFRHFSQRQEVLQAFKQVQLLVTSQDVDNYKQIKQDLDQLRSIVEKSELWVY,0
3jav,D,1135,1174,39,GQGPDEPMDGASGENEHKKTEEGTSKPLKHESTSSYNYR,0
3jav,D,1175,1494,319,VKEILIRLSKLCVQESASVRKSRKQQQRLLRNMGAHAVVLELLQIPYEKAEDTKMQEIMRLAHEFLQNFCAGNQQNQALLHKHINLFLNPGILEAVTMQHIFMNNFQLCSEINERVVQHFVHCIETHGRNVQYIKFLQTIVKAEGKFIKKCQDMVMAELVNSGEDVLVFYNDRASFQTLIQMMRSERDRMDENSPLFMYHIHLVELLAVCTEGKNVYTEIKCNSLLPLDDIVRVVTHEDCIPEVKIAYINFLNHCYVDTEVEMKEIYTSNHMWKLFENFLVDICRACNNTSDRKHADSVLEKYVTEIVMSIVTTFFSSP,0
3jav,D,1495,1593,98,SDQSTTLQTRQPVFVQLLQGVFRVYHCNWLMPSQKASVESCIRVLSDVAKSRAIAIPVDLDSQVNNLFLKSHNIVQKTAMNWRLSARNAARRDSVLAA,0
3jav,D,1594,1688,94,RDYRNIIERLQDIVSALEDRLRPLVQAELSVLVDVLHRPELLFPENTDARRKCESGGFICKLIKHTKQLLEENEEKLCIKVLQTLREMMTKDRG,0
3jav,D,1689,1787,98,GEKQISIDELENAELPQPPEAENSTEQELEPSPPLRQLEDHKRGEALRQILVNRYYGNIRPSGRRESLTSFGNGPLSPGGPSKPGGGGGGPGSGSTSR,0
3jav,D,1788,1890,102,EMSLAEVQCHLDKEGASNLVIDLIMNASSDRVFHESILLAIALLEGGNTTIQHSFFCRLTEDKKSEKFFKVFYDRMKVAQQEIKATVTVNTSDLGNKKKDDE,0
3jav,D,1891,1951,60,DRDAPSRKKAKEPTTQITEEVRDQLLEASAATRKAFTTFRREADPDDHYQSGEGTQATTD,0
3jav,D,1952,2272,320,AKDDLEMSAVITIMQPILRFLQLLCENHNRDLQNFLRCQNNKTNYNLVCETLQFLDCICGSTTGGLGLLGLYINEKNVALINQTLESLTEYCQGPCHENQNCIATHESNGIDIITALILNDINPLGKKRMDLVLELKNNASKLLLAIMESRHDSENAERILYNMRPKELVEVIKKAYMQGEVEFEDGENGEDGAASPRNVGHNIYILAHQLARHNKELQTMLKPGGQVDGDEALEFYAKHTAQIEIVRLDRTMEQIVFPVPSICEFLTKESKLRIYYTTERDEQGSKINDFFLRSEDLFNEMNWQKKLRAQPVLYWCARN,0
3jav,D,2273,2295,22,SFWSSISFNLAVLMNLLVAFFY,0
3jav,D,2303,2321,18,TLEPHWSGLLWTAMLISL,0
3jav,D,2323,2346,23,VIALPKPHGIRALIASTILRLIF,0
3jav,D,2347,2360,13,VGLQPTLFLLGAF,0
3jav,D,2361,2381,20,VCNKIIFLMSFVGNCGTFTR,0
3jav,D,2408,2428,20,HEFFYSLLLFDLVYREETLL,0
3jav,D,2429,2439,10,VIKSVTRNGR,0
3jav,D,2440,2459,19,IILTAALALILVYLFSIVG,0
3jav,D,2535,2548,13,VTVLSHGLRSGGG,0
3jav,D,2565,2597,32,RVIYDLLFFFMVIIIVLNLIFGVIIDTFADLR,0
3jav,D,2598,2750,152,EKQKKEEILKTTCFICGLERDKFDNKTVTFEEHIKEEHNMWHYLCFIVLVKVKDSTEYTGPESYVAEMIRERNLDWFPRMRAMSLVSSDSEGEQNELRNLQEKLESTMKLVTNLSGQLSELKDQMTEQRKQKQRIGLLGHPPHMNVNPQQPA,0
3aso,Z,17,37,20,GLSVTFLSFLLPAGWVLYHL,0
3aso,Z,38,43,5,NYKKS,0
3aso,Z,44,46,2,AA,0
4jc6,D,1,22,21,SKEVSEEAQAHQHGKDYVDPP,0
4jc6,D,41,58,17,IAEFIATLLFLYITVAT,0
4jc6,D,59,75,16,IGHSKETVVCGSVGLL,0
4jc6,D,76,93,17,IAWAFGGMIFVLVYCTA,0
4jc6,D,97,110,13,GHINPAVTFGLFL,0
4jc6,D,119,137,18,LVYMIAQCLGAICGVGLV,0
4jc6,D,138,141,3,AFM,0
4jc6,D,142,147,5,GPYNQ,0
4jc6,D,148,162,14,GGGANSVALGYNKG,0
4jc6,D,163,182,19,ALGAEIIGTFVLVYTVFSA,0
4jc6,D,198,214,16,PLPIGFAVFMVHLATI,0
4jc6,D,215,217,2,IT,0
4jc6,D,218,232,14,TGINPARSFGAAVI,0
4jc6,D,233,242,9,NSNKVWDDQ,0
4jc6,D,243,260,17,IFWVGPFIGAAVAAAYH,0
4jc6,D,274,281,7,FRSNPTN,0
3zeb,A,92,93,1,A,0
3zeb,A,94,112,18,PVTWVMMIACVVVFIAMQ,0
3zeb,A,116,123,7,QEVMLWL,0
3zeb,A,134,144,10,FWRYFTHALM,0
3zeb,A,148,163,15,MHILFNLLWWWYLGG,0
3zeb,A,164,171,7,VEKRLGS,0
3zeb,A,172,189,17,KLIVITLISALLSGYVQ,0
3zeb,A,199,213,14,LSGVVYALMGYVWL,0
3zeb,A,214,227,13,GERDPQSGIYLQR,0
3zeb,A,228,245,17,LIIFALIWIVAGWFDLF,0
3zeb,A,250,267,17,NGAHIAGLAVGLAMAFV,0
3zeb,A,268,270,2,SL,0
3aqp,A,10,24,14,LLGVFLLALLFVWK,0
3aqp,A,25,273,248,WAPEEPKVRLGLDLKGGLRIVLEADVENPTLDDLEKARTVLENRINALGVAEPLIQIQGQKRIVVELPGLSQADQDRALKLIGQRAVLEFRIVKEGATGTTVAQINQALRENPRLNREELEKDLIKPEDLGPPLLTGADLADARAVFDQFGRPQVSLTFTPEGAKKFEEVTRQNIGKRLAIVLDGRVYTAPVIRQAITGGQAVIEGLSSVEEASEIALVLRSGSLPVPLKVAEIRAIGPTLGQDAIQA,0
3aqp,A,274,289,15,IRSALIGTLAIFLLI,0
3aqp,A,302,319,17,LGLLYTSALILGLLSGL,0
3aqp,A,320,326,6,ATLTLP,0
3aqp,A,327,342,15,IAGLVLTLGAAVDGN,0
3aqp,A,375,391,16,DVNIAHLLAAAALYQY,0
3aqp,A,392,397,5,TGPVR,0
3aqp,A,398,414,16,FAVILAIGVVASVFSN,0
3aqp,A,452,468,16,AATLLLAALAAGVVFA,0
3aqp,A,469,515,46,GFNYSIDFTGGTAYTLRAEPNVEVETLRRFLEEKGFPGKEAVITQV,0
3aqp,A,516,521,5,APTAA,0
3aqp,A,522,570,48,REFLVKLPPLSDERRLELERLFASELKATVLASETVGPAIGEELRRNA,0
3aqp,A,571,587,16,MAVLVGLGLILLYVAF,0
3aqp,A,595,615,20,ASILAVAHDVAIVAGMYSLL,0
3aqp,A,616,622,6,LEFSIP,0
3aqp,A,623,638,15,IAALLTIVGYSINDS,0
3aqp,A,675,690,15,SLTTLLPILALLFLG,0
3aqp,A,691,694,3,SVL,0
3aqp,A,695,712,17,DFALAIFVGIFVGTYSS,0
3aqp,A,713,725,12,YVVSALVVAWKN,0
3aqp,A,727,741,14,KAQEASKAHHHHHH,0
3d9b,C,1,10,9,PNFFIDRPI,0
3d9b,C,11,25,14,AWVIAIIIMLAGGL,0
3d9b,C,342,357,15,TLVEAIILVFLVMYL,0
3d9b,C,358,365,7,LQNFRAT,0
3d9b,C,366,383,17,IPTIAVPVVLLGTFAVL,0
3d9b,C,398,411,13,VLAIGLLVDDAIV,0
3d9b,C,412,426,14,VENVERVMAEEGLP,0
3d9b,C,427,438,11,KEATRKSMGQI,0
3d9b,C,439,441,2,GA,0
3d9b,C,442,456,14,VGIAMVLSAVFVPM,0
3d9b,C,472,489,17,TIVSAMALSVLVALILT,0
3d9b,C,490,511,21,ALCATMLKPIAKGDHGEGKKG,0
3d9b,C,512,536,24,FGWFNRMFEKSTHHYTDSVGGILR,0
3d9b,C,537,541,4,TGRY,0
3d9b,C,542,556,14,VLYLIIVVGMAYLF,0
3d9b,C,876,891,15,YAISLIVVFLCLAAL,0
3d9b,C,892,898,6,ESWSIP,0
3d9b,C,899,916,17,SVMLVVPLGVIGALLAA,0
3d9b,C,929,943,14,GLLTTIGLSAKNAI,0
3d9b,C,944,974,30,IVEFAKDLMDKEGKGLIEATLDAVRMRLRP,0
3d9b,C,975,991,16,LMTSLAFILGVMPLVI,0
3d9b,C,1004,1019,15,TGVMGGMVTATVLAI,0
3d9b,C,1020,1032,12,FVPVFFVVVRRR,0
3d9b,C,1033,1045,12,SRKNEDIEHSHT,0
3d9b,C,1046,1049,3,DHH,0
5g54,A,14,38,24,FEFIDHLLTMGVGVHFAALIFFLV,0
5g54,A,39,49,10,SQFVAPKYRI,0
5g54,A,50,74,24,TALSCIVMVSAGLILNSQAVMWTD,0
5g54,A,91,112,21,NGYRYVNWMATIPCLLLQLLI,0
5g54,A,113,120,7,LNLKGKE,0
5g54,A,121,144,23,FSTATWLILAAWGMIITGYVGQL,0
5g54,A,154,176,22,IWGAVSTAFFVVMNWIVGTKIF,0
5g54,A,177,190,13,NRATMLGGTDSTI,0
5g54,A,191,214,23,KVFWLMMFAWTLYPIAYLVPAFM,0
5g54,A,219,243,24,VVLRQLLFTIADISSKVIYGLMIT,0
5g54,A,244,266,22,IAIQQSAAAGYVPAQQALGRIG,0
4cg7,C,61,71,10,DSPGLKVGPV,0
4cg7,C,72,83,11,VLVMSLLFIAS,0
1r3i,K,1,21,20,APMLSGLLARLVKLLLGRHG,0
1r3i,K,22,25,3,ALH,0
1r3i,K,26,50,24,RAAGAATVLLVIVLLAGSYLAVLA,0
1r3i,K,63,79,16,RALWWSVETATTVGYG,0
1r3i,K,87,111,24,GRCVAVVVMVAGITSFGLVTAALA,0
1r3i,K,112,124,12,WFVGREQERRGH,0
2lpf,A,29,50,21,QNLFINFALILIFLLLIAIIV,0
2lpf,A,51,53,2,LL,0
1u7g,C,1,2,1,P,0
1u7g,C,16,33,17,TALVLFMTIPGIALFYG,0
1u7g,C,34,44,10,LIRGKNVLSM,0
1u7g,C,45,63,18,TQVTVTFALVCILWVVYG,0
1u7g,C,103,120,17,QGSFACITVGLIVGALA,0
1u7g,C,121,125,4,RIRF,0
1u7g,C,126,144,18,AVLIFVVVWLTLSYIPIA,0
1u7g,C,163,180,17,GTVVHINAAIAGLVGAY,0
1u7g,C,181,199,18,IGKRVGFGKEAFKPHNLP,0
1u7g,C,200,216,16,VFTGTAILYIGWFGFN,0
1u7g,C,232,251,19,NTVVATAAAILGWIFGEWA,0
1u7g,C,252,258,6,RGLPSL,0
1u7g,C,259,276,17,GACSGAIAGLVGVTPAC,0
1u7g,C,282,302,20,GALIIGVVAGLAGLWGVTML,0
1u7g,C,303,311,8,RLLRVDDP,0
1u7g,C,312,329,17,DVFGVHGVCGIVGCIMT,0
1u7g,C,356,381,25,ESIAITIVWSGVVAFIGYKLADLTV,0
1u7g,C,382,385,3,LRV,0
4xph,A,35,57,22,FLLSVIGFAVDLANVWRFPYLC,0
4xph,A,58,62,4,KNGG,0
4xph,A,63,82,19,AFLVPYGIMLAVGGIPLFY,0
4xph,A,110,133,23,YAVVLIAFYVGFYYNVIIAWSLR,0
4xph,A,134,237,103,FFASFTNSLPWTSCNNIWNTPNCRPFEGHVEGFQSAASEYFNRYILELNRSEGIHDLGAIKW,0
4xph,A,238,255,17,MALCLLIVYLICYFSLW,0
4xph,A,261,281,20,GKVVWFTALFPYAVLLILLI,0
4xph,A,282,288,6,GLTLPG,0
4xph,A,289,297,8,FLGIQYYL,0
4xph,A,298,303,5,PNFSA,0
4xph,A,304,328,24,YKAEVWVDAATQVFFSLGPGFGVL,0
4xph,A,345,363,18,LLTSFINSATSFIAGFVI,0
4xph,A,364,391,27,SVLGYMAHTLGVRIEDVATEGPGLVFV,0
4xph,A,392,399,7,YPAAIAT,0
4xph,A,400,408,8,PASTFWAL,0
4xph,A,409,430,21,FFMMLATLGLDSSFGGMEAII,0
4xph,A,446,464,18,FVAGLFSLYFVVGLASCT,0
4xph,A,465,470,5,GGFYF,0
4xph,A,471,492,21,HLLDRYAAGYSILVAVFFEAI,0
4xph,A,522,543,21,WRFVAPIFLLFITVYGLIGYE,0
4xph,A,544,554,10,LTYADYVYPS,0
4xph,A,555,573,18,ANALGWCIAGSSVVMIPA,0
2l0l,A,1,2,1,K,0
2l0l,A,8,21,13,VALFGVLGAALIG,0
2l0l,A,22,27,5,IAPKK,0
2leg,B,1,13,12,LRFLNQASQGRG,0
2leg,B,15,31,16,LLMAFTALALELTALW,0
2leg,B,32,47,15,QHVMLLKPCVLCIYE,0
2leg,B,48,66,18,VALFGVLGAALIGAIAPK,0
2leg,B,71,86,15,VAMVIWLYSAFRGVQ,0
2leg,B,87,126,39,TYEHTMLQLYPSPFATCDFMVRFPEWLPLDKWVPQVFVA,0
2leg,B,127,141,14,GDSAERQWDFLGLE,0
2leg,B,142,146,4,PQWL,0
2leg,B,147,162,15,GIFIAYLIVAVLVVI,0
2leg,B,163,176,13,QPFKAKKRDLFGR,0
1rqk,H,1,9,8,VGVTAFGN,0
1rqk,H,11,31,20,LASLAIYSFWIFLAGLIYYL,0
1rqk,H,251,260,9,VAAMLAEYA,0
5ws5,z,1,7,6,TILFQL,0
5ws5,z,8,25,17,LAALVILSFVMVIGVPV,0
5ws5,z,39,54,15,IFLGSGLWIALVLVV,0
5ws5,z,55,62,7,VLNFFVV,0
1yce,K,11,32,21,AASAVGAGTAMIAGIGPGVGQ,0
1yce,K,33,62,29,YAAGKAVESVARQPEAKGDIISTMVLGQA,0
1yce,K,63,84,21,AESTGIYSLVIALILLYANPF,0
2npd,C,1,2,1,P,0
2npd,C,15,32,17,CTALVLFMTIPGIALFY,0
2npd,C,33,45,12,GLIRGKNVLSML,0
2npd,C,46,64,18,QVTVTFALVCILWVVYGY,0
2npd,C,102,119,17,FQGSFACITVGLIVGAL,0
2npd,C,120,126,6,ERIRFS,0
2npd,C,127,147,20,VLIFVVVWLTLSYIPIAHMV,0
2npd,C,161,178,17,AGGTVVFINAAIAGLVG,0
2npd,C,179,181,2,YL,0
2npd,C,182,194,12,GKRVGFGKEAFK,0
2npd,C,195,201,6,HNLPMV,0
2npd,C,202,219,17,TGTAILYIGWFGFNAGS,0
2npd,C,231,249,18,VNTVVATAAAILGWIFGE,0
2npd,C,250,260,10,ALRGKPSLLG,0
2npd,C,261,276,15,CSGAIAGLVGVTPAC,0
2npd,C,282,299,17,GALIIGVVAGLAGLWGV,0
2npd,C,300,305,5,MLKRL,0
2npd,C,306,308,2,RV,0
2npd,C,309,312,3,DPC,0
2npd,C,313,332,19,VFGVHGVCGIVGCIMTGIF,0
2npd,C,353,377,24,VQLESIAITIVWSGVVAFIGYKLA,0
2npd,C,378,386,8,LTVGLRVP,0
2npd,C,387,424,37,EQEREGLDVNSHGENAYNADQAQQPAQADLEHHHHHH,0
5iwo,D,137,147,10,PSSPSLLRAI,0
5iwo,D,148,153,5,GIAWI,0
5iwo,D,154,170,16,LLLLVIFYVFAVMGTK,0
5iwo,D,184,200,16,ASMYTLFQVMTLESWS,0
5iwo,D,214,233,19,WIYFVSFILVSSFTVLNLF,0
5iwo,D,234,285,51,GIIIESMQSAHWEAEDAKRIEQEQRAHDERLEMLQLIRDLSSKVDRLERRS,0
5iwo,D,286,288,2,KR,0
3mpn,B,13,32,19,LILAMAGNAVGLGNFLRFP,0
3mpn,B,33,43,10,QAAENGGGAF,0
3mpn,B,44,63,19,IPYIIAFLLVGIPLMWIEW,0
3mpn,B,90,124,34,KILGVFGLWIPLVVAIYYVYIESWTLGFAIKFLV,0
3mpn,B,125,132,7,LVPEPPP,0
3mpn,B,133,134,1,A,0
3mpn,B,135,166,31,DPDSILRPFKEFLYSYIGVPKGDEPILKPSL,0
3mpn,B,167,185,18,AYIVFLITMCINVSILIR,0
3mpn,B,191,212,21,ERFAKIAMPTLFILAVFLVIR,0
3mpn,B,213,222,9,FLLETPNGT,0
3mpn,B,223,231,8,ADGLNFLW,0
3mpn,B,232,243,11,PDFEKLKDPGV,0
3mpn,B,244,266,22,IAAVGQIFFTLSLGFGAIITYA,0
3mpn,B,277,297,20,SGLTAATLNEKAEVILGGSI,0
3mpn,B,298,325,27,IPAAVAFFGVANAVAIAKAGAFNLGFI,0
3mpn,B,326,331,5,LPAIF,0
3mpn,B,332,339,7,QTAGGTF,0
3mpn,B,340,367,27,GFLWFFLLFFAGLTSSIAIMQPMIAFL,0
3mpn,B,378,396,18,VLWTAAIVFFSAHLVMFL,0
3mpn,B,397,399,2,KS,0
3mpn,B,400,426,26,DEMDFWAGTIGVVFFGLTELIIFFWI,0
3mpn,B,429,437,8,DKAWEEIN,0
3mpn,B,445,469,24,RIYYYVMRYITPAFLAVLLVVWAR,0
3mpn,B,470,471,1,Y,0
3mpn,B,472,477,5,PKIME,0
3mpn,B,478,483,5,THWTV,0
3mpn,B,484,502,18,ITRFYIIGLFLFLTFLVF,0
3aeb,D,35,40,5,SKAAS,0
3aeb,D,41,61,20,HWTGERVVSVLLLGLLPAAY,0
3aeb,D,69,89,20,YSLAAALTLHGHWGIGQVVT,0
3aeb,D,90,98,8,YVRGDALQ,0
3aeb,D,99,118,19,AAKAGLLALSAFTFAGLCY,0
3aeb,D,126,134,8,CKAVAMLW,0
5ec1,F,26,50,24,RAAGAATVLLVIVLLAGSYLAVLA,0
5ec1,F,51,62,11,RGAPGAQLITY,0
5ec1,F,79,86,7,DLCPVTL,0
5ec1,F,87,111,24,GRLVAVVVMVAGITSFGLVTAALA,0
3fb6,F,21,24,3,SAL,0
3fb6,F,25,27,2,WR,0
3fb6,F,28,50,22,AGAATVLLVIVLLAGSYLAVLA,0
3fb6,F,63,78,15,RALWWSVETATTVGY,0
3fb6,F,87,111,24,GRCVAVVVMVAGITSFGLVTAALA,0
3fb6,F,112,114,2,WF,0
3fb6,F,115,124,9,GQEQQQQGQ,0
5itc,C,18,36,18,WLALGTIGMLLGMLYFIA,0
5itc,C,37,51,14,GLDVQDPRQKEFYV,0
5itc,C,52,69,17,TILIPAIAAASYLSMFF,0
5itc,C,87,103,16,WARYADWLFTTPLLLL,0
5itc,C,104,117,13,IGLLAGASQRDIG,0
5itc,C,118,136,18,LVGIDAFMIVTGLVATLT,0
5itc,C,141,160,19,RYAFWTISTISMVFLLYYL,0
5itc,C,161,182,21,AVFGEAVSDADEDTRSTFNAL,0
5itc,C,183,200,17,NIILVTWAIYPVAWLVG,0
5itc,C,212,230,18,TLLFMVLDLVAKVGFGFI,0
5itc,C,231,238,7,LRSRAIM,0
3ae4,D,35,41,6,SKAASL,0
3ae4,D,42,61,19,WTGERVVSVLLLGLLPAAY,0
3ae4,D,69,89,20,YSLAAALTLHGHWGIGQVVT,0
3ae4,D,90,96,6,YVRGDA,0
3ae4,D,97,117,20,QKAAKAGLLALSAFTFAGLC,0
3ae4,D,126,135,9,CKAVAMLWK,0
4n7k,M,1,52,51,EYQNIFSQVQVRGPADLGMTEDVNLANRSGVGPFSTLLGWFGNAQLGPIYL,0
4n7k,M,53,71,18,SLGVLSLFSGLMWFFTIG,0
4n7k,M,82,87,5,AVFLR,0
4n7k,M,118,135,17,SFFMFVAVWSWWGRTYL,0
4n7k,M,136,144,8,AQALGMGK,0
4n7k,M,145,163,18,TAWAFLSAIWLWMVLGFI,0
4n7k,M,179,191,12,FSHLDWTNNFSL,0
4n7k,M,201,221,20,HGLSIAFLYGSALLFAMHGA,0
4n7k,M,222,265,43,ILAVSRFGGERELEQIADRGTAAERAALFWRWTMGFNATMEGI,0
4n7k,M,266,285,19,RWAIWMAVLVTLTGGIGIL,0
4n7k,M,294,299,5,YVWGQ,0
4uv3,I,135,142,7,SGGVGAR,0
4uv3,I,145,146,1,I,0
4uv3,I,147,154,7,ADTQYQL,0
4uv3,I,183,190,7,YEVQAGV,0
4uv3,I,200,201,1,E,0
4uv3,I,202,209,7,EVGYTSN,0
5jdl,A,10,27,17,LGLILLYYGSDWFVLGS,0
5jdl,A,28,39,11,RIARHFNVSNF,0
5jdl,A,40,56,16,IGATVMAIGTSLPEIL,0
5jdl,A,74,92,18,IGSCICNIGLVLGLSAII,0
5jdl,A,93,104,11,PIIVDKNLQKN,0
5jdl,A,105,120,15,LVYLLFVIFAAVIGI,0
5jdl,A,127,143,16,GVVLLILFIIYLRWTV,0
5jdl,A,144,153,9,NGSAEIEEN,0
5jdl,A,156,162,6,NNPSVV,0
5jdl,A,163,182,19,SLVLLIIGLIGVLVGAELF,0
5jdl,A,207,222,15,GTSLPELMVSLAAAK,0
5jdl,A,223,228,5,NLGGM,0
5jdl,A,229,247,18,LGNVIGSNIADIGGALAV,0
5jdl,A,259,274,15,QMAVLVIMSLLLYLF,0
5jdl,A,275,282,7,KYSKIGR,0
5jdl,A,283,298,15,QGILFLALYIIAIAS,0
1fnq,H,1,10,9,VGVTAFGNF,0
1fnq,H,12,29,17,ASLAIYSFWIFLAGLIY,0
1fnq,H,30,249,219,LQTENMREGYPLENEDGTPAANQGPFPLPKPKTFILPHGRGTLTVPGPESEDRPIALARTAVSEGFPHAPTGDPMKDGVGPASWVARRDLPELDGHGHNKIKPMKAAAGFHVSAGKNPIGLPVRGCDLEIAGKVVDIWVDIPEQMARFLEVELKDGSTRLLPMQMVKVQSNRVHVNALSSDLFAGIPTIKSPTEVTLLEEDKICGYVAGGLMYAAPKRK,0
1fnq,H,250,260,10,VVAAMLAEYA,0
5avu,G,4,22,18,GPDNDERFTYDYYRLRVV,0
5avu,G,23,39,16,LIVAAVLCVIGIIILL,0
4uwa,D,1,8,7,GDGGEGE,0
4uwa,D,128,129,1,D,0
4uwa,D,692,705,13,SPYPGGGEGWGGN,0
4uwa,D,799,850,51,FKFLPPPGYAPCHEAVLPRERLRLEPIKEYRREGPRGPHLVGPSRCLSHTD,0
4uwa,D,1009,1014,5,VQDIP,0
4uwa,D,1054,1072,18,PPDQEPSQVENQSRWDRV,0
4uwa,D,1210,1419,209,LRFFAICGLQEGFEPFAINMQRPVTTWFSKSLPQFEPVPPEHPHYEVARMDGTVDTPPCLRLAHRTWGSQNSLVEMLFLRLSLPVQFHQHFRCTAGATPLAPPGLQPPAEDEARAAEPDPDYENLRRSAGGWGEAEGGKEGTAKEGTPGGTPQPGVEAQPVRAENEKDATTEKNKKRGFLFKAKKAAMMTQPPATPALPRLPHDVVPAD,0
4uwa,D,1479,1490,11,QGNVHSSLKCS,0
4uwa,D,1498,1508,10,DFVSPGQQGR,0
4uwa,D,2831,2854,23,ERTEKKKTRKISQTAQTYDPREG,0
4wmz,A,8,23,15,GEALEYVNIGLSHFL,0
4wmz,A,24,27,3,LPL,0
4wmz,A,28,53,25,QRISLIIIIPFIYNIVWQLLYSLRK,0
4wmz,A,58,71,13,VFYWIPWVGSAVV,0
4wmz,A,77,87,10,EFFEECQKKY,0
5aw0,G,4,22,18,GPDNDERFTYDYYRLRVV,0
5aw0,G,23,39,16,LIVAAVLCVIGIIILL,0
3uu6,E,-3,4,7,SAAAQDM,0
3uu6,E,5,198,193,SPPPPIADEPLTVNTGIYLIESYSLDDCAETFKVNAFLSLSWKDRRLAFDPVRSGVRVKTYEPEAIWIPEIRFVNVENARDADVVDISVSPDGTVQYLERFSARVLSPLDFRRYPFDSQTLHIYLIVRSVDTRNIVLAVDLEKVGKNDDVFLTGWDIESFTAVVKPANFALEDRLESKLDYQLRISRQYFSYI,0
3uu6,E,199,218,19,NIILPMLFILFISWTAFWS,0
3uu6,E,222,240,18,ANVTLVVSTLIAHIAFNI,0
3uu6,E,241,256,15,VETNCPKTPYMTYTG,0
3uu6,E,257,275,18,IIFMIYLFYFVAVIEVTV,0
3uu6,E,292,313,21,RASRIAFPVVFLLANIILAFL,0
3uu6,E,314,315,1,F,0
3uu6,E,316,317,1,F,0
5t4o,V,1,2,1,E,0
5t4o,V,3,16,13,LNMDLLYMAAAVM,0
5t4o,V,17,30,13,GLAAIGAAIGIGI,0
5t4o,V,55,69,14,VMGLVDAIPMIAVG,0
5t4o,V,70,77,7,GLYVMFA,0
5t4o,V,78,79,1,A,0
3kss,C,-7,4,11,GHHHHHHMIEW,0
3kss,C,5,14,9,IRRSVANRF,0
3kss,C,15,32,17,VLMGALFLSIWGTWTII,0
3kss,C,338,355,17,SGKLLEEFIVVAVVCAL,0
3kss,C,356,361,5,LWHVR,0
3kss,C,362,383,21,ALVAIISLPLGLCIAFIVMHF,0
3kss,C,394,409,15,GIAIAVGAMVDAAIV,0
3kss,C,410,424,14,IENAHKRLEEWQHQ,0
3kss,C,425,432,7,PDATLDN,0
3kss,C,433,449,16,TRWQVITDASVEVGPA,0
3kss,C,450,465,15,FISLLIITLSFIPIF,0
3kss,C,479,499,20,FTKTYAMAGAALLAIVVIPI,0
3kss,C,500,503,3,MGY,0
3kss,C,504,515,11,IRGKIPPESSN,0
3kss,C,516,518,2,LN,0
3kss,C,519,534,15,FLIRVYHPLLLKVLH,0
3kss,C,535,538,3,PKT,0
3kss,C,539,555,16,LLVAALSVLTVLWPLN,0
3kss,C,873,889,16,LMVPMTLMIIFVLLYL,0
3kss,C,890,896,6,FRRVGE,0
3kss,C,897,919,22,LLIISSVPFALVGGIWLLWWMG,0
3kss,C,926,943,17,GTGFIALAGVAAEFGVV,0
3kss,C,944,984,40,LMYLRHAIEAVPSLNNPQTFSEQKLDEALYHGAVLRVRPK,0
3kss,C,985,1001,16,MTVAVIIAGLLPILWG,0
3kss,C,1010,1027,17,RIAAPMIGGMITAPLLS,0
3kss,C,1028,1032,4,FIIP,0
3kss,C,1033,1038,5,AYKLM,0
3kss,C,1040,1047,7,HRHRVRK,0
2hqf,C,1,6,5,PNFFI,0
2hqf,C,7,11,4,RPIF,0
2hqf,C,12,24,12,WVIAIIIMLAGG,0
2hqf,C,343,357,14,LVEAIILVFLVMYL,0
2hqf,C,358,365,7,LQNFRAT,0
2hqf,C,366,382,16,IPTIAVPVVLLGTFAV,0
2hqf,C,399,410,11,LAIGLLVDDAI,0
2hqf,C,411,441,30,VVENVERVMAEEGLPPKEATRKSMGQIQGA,0
2hqf,C,442,455,13,VGIAMVLSAVFVP,0
2hqf,C,472,489,17,TIVSAMALSVLVALILT,0
2hqf,C,490,498,8,ALCATMLK,0
2hqf,C,499,512,13,IAKGDHGEGKKGF,0
2hqf,C,513,515,2,GW,0
2hqf,C,516,523,7,NRMFEKS,0
2hqf,C,524,541,17,HHYTDSVGGILRSTGRY,0
2hqf,C,542,555,13,VLYLIIVVGMAYL,0
2hqf,C,878,890,12,ISLIVVFLCLAA,0
2hqf,C,891,897,6,YESWSI,0
2hqf,C,898,915,17,FSVMLVVPLGVIGALLA,0
2hqf,C,930,943,13,LLTTIGLSAANAI,0
2hqf,C,944,975,31,IVEFAKDLMDKEGKGLIEATLDAVRMRLRPI,0
2hqf,C,976,990,14,MTSLAFILGVMPLV,0
2hqf,C,1005,1019,14,GVMGGMVTATVLAI,0
2hqf,C,1020,1036,16,FVPVFFVVVRRRFSRK,0
2hqf,C,1037,1053,16,EDIEHSHTVDHHHHHH,0
1f50,C,5,10,5,GRPEW,0
1f50,C,11,32,21,WLALGTALMGLGTLYFLVKGM,0
1f50,C,43,62,19,AITTLVPAIAFTMYLSMLL,0
1f50,C,63,79,16,YGLTMVPFGGEQNPIY,0
1f50,C,80,98,18,ARYADWLFTTPLLLLDLA,0
1f50,C,107,127,20,ILALVGADGIMIGTGLVGAL,0
1f50,C,128,133,5,KVYSY,0
1f50,C,134,153,19,FVWWAISTAAMLYILYVLF,0
1f50,C,157,161,4,SKAE,0
1f50,C,174,192,18,RNVTVVLWSAYPVVWLIG,0
1f50,C,193,203,10,EGAGIVPLNI,0
1f50,C,204,224,20,TLLFMVLDVSAKVGFGLILL,0
4p19,C,1,5,4,GLYR,0
4p19,C,14,29,15,KILIGLILGAIVGLI,0
4p19,C,30,42,12,GHYGYAHAVHTY,0
4p19,C,43,64,21,KPFGDLFVRLLCMLVMPIVFA,0
4p19,C,94,110,16,FAVTLGIIMARLFNPG,0
4p19,C,111,130,19,GIHLAVGGQQFQPHQAPPL,0
4p19,C,131,140,9,HILLDIVPT,0
4p19,C,141,150,9,PFGALANGQ,0
4p19,C,151,161,10,LPTIFFAIIL,0
4p19,C,174,200,26,KVRKSAETLLDAINGLAEAMYKIVNG,0
4p19,C,201,217,16,MQYAPIGVFALIAYVM,0
4p19,C,218,224,6,EQGVHV,0
4p19,C,225,242,17,GELAKVTAAVYVGLTLQ,0
4p19,C,312,327,15,GTALYQGVATFFIAN,0
4p19,C,328,333,5,LGSHL,0
4p19,C,334,350,16,VGQQLTIVLTAVLASI,0
4p19,C,357,375,18,AGAIMLCMVLHSVGLPLT,0
4p19,C,376,379,3,PNV,0
4p19,C,380,397,17,AAYAMILGIDAILDMGR,0
4p19,C,419,422,3,VPR,0
1zp0,D,42,61,19,WTGERVVSVLLLGLLPAAY,0
1zp0,D,62,67,5,NPCSA,0
1zp0,D,68,89,21,DYSLAAALTLHGHWGIGQVVT,0
1zp0,D,98,118,20,KAAKAGLLALSAFTFAGLCY,0
1zp0,D,119,125,6,NYHDVG,0
1zp0,D,126,134,8,CKAVAMLW,0
1zp0,D,135,136,1,L,0
5hs1,A,7,8,1,V,0
5hs1,A,9,22,13,EALEYVNIGLSHF,0
5hs1,A,23,27,4,ALPL,0
5hs1,A,28,52,24,QRISLIIIIPFIYNIVWQLLYSLR,0
5hs1,A,59,71,12,FYWIPWVGSAVV,0
5hs1,A,76,87,11,YEFFEECQKKY,0
1jvm,D,1,23,22,APMLSGLLARLVKLLLGRHGSA,0
1jvm,D,27,50,23,AAGAATVLLVIVLLAGSYLAVLA,0
1jvm,D,51,65,14,RGAPGAQLITYPRA,0
1jvm,D,66,79,13,WWSVETATTVGYG,0
1jvm,D,80,86,6,LYPVTL,0
1jvm,D,87,111,24,GRCVAVVVMVAGITSFGLVTAALA,0
1jvm,D,124,125,1,F,0
5c78,D,2,8,6,KKLFFI,0
5c78,D,9,11,2,SK,0
5c78,D,12,36,24,DKNFLFFLLVFSVFVSFIETFAIS,0
5c78,D,80,101,21,VFYVFRALLNAYYFHLLARFS,0
5c78,D,102,146,44,GRKHAIAYKVFSKFLNINYEKFTQKNQSEILKSITGEVYNLSTM,0
5c78,D,147,168,21,SSFLLLMSEIFVVLLLYALML,0
5c78,D,175,197,22,LFLSIFMVLNAFILVKILSPII,0
5c78,D,198,250,52,KAGLRREEAMKNFFEILNTNLNNFKFIKLKTKEDGVLSLFKAQSEAFSKANI,0
5c78,D,251,273,22,NESVAAVPRIYLEGIGFCVLVF,0
5c78,D,295,317,22,FVLALYRLMPSANRIITSYHDL,0
5c78,D,318,564,246,YYHSSLNIIYQNLRQEEENLGEGKLSFNQELKICNLSFGYEGKKYLFKNLNLNIKKGEKIAFIGESGCGKSTLVDLIIGLLKPKEGQILIDKQELNASNAKNYRQKIGYIPQNIYLFNDSIAKNITFGDAVDEEKLNKVIKQANLEHFIKNLPQGVQTKVGDGGSNLSGGQKQRIAIARALYLEPEILVLDQATSALDTQSEAKIMDEIYKISKDKTMIIIAHRLSTITQCDKVYRLEHGKLKEEK,0
2xtv,A,96,111,15,TWVMMIACVVVFIAM,0
2xtv,A,112,139,27,ILGDQEVMLWLAWPFDPTLKFEFWRYF,0
2xtv,A,140,163,23,HALMHFSLMHILFNLLWWWYLGG,0
2xtv,A,175,189,14,VITLISALLSGYVQ,0
2xtv,A,190,198,8,KFSGPWFG,0
2xtv,A,199,213,14,LTGVVYALMGYVWL,0
2xtv,A,228,245,17,LIIFALIWIVAGWFDLF,0
2xtv,A,246,247,1,M,0
2xtv,A,248,250,2,MA,0
2xtv,A,251,266,15,GAHIAGLAVGLAMAF,0
4ymu,C,6,11,5,SMVKY,0
4ymu,C,16,44,28,SGLIMTLKLTFLAVTIGVLMGLFIALMK,0
4ymu,C,45,48,3,SSI,0
4ymu,C,49,74,25,PIKLVASSYIEVIRGTPLLVQLLLI,0
4ymu,C,89,107,18,AGVSALAINSSAYVAEII,0
4ymu,C,108,146,38,AGIQAVDPGQNEAARSLGMTHAMAMRYVIIPQAIKNIL,0
4ymu,C,147,164,17,ALGNEFIVMLKESAIVS,0
4ymu,C,190,208,18,IIAAIYFVMTLTFSKLLS,0
4ymu,C,209,214,5,FERRL,0
5aym,A,15,31,16,GRLLTRSGDQAWDFVV,0
5aym,A,32,49,17,FALLVIFPGKLQVAAFY,0
5aym,A,50,65,15,LIVKIGTFLLTPSSG,0
5aym,A,80,95,15,VWLQFFAILAGMVFF,0
5aym,A,96,114,18,MLDGLVRAGGRESWLLSV,0
5aym,A,115,135,20,FIALALSGVMASLGSQITDI,0
5aym,A,156,173,17,WLRRIDLATEVGAPILA,0
5aym,A,174,177,3,ALF,0
5aym,A,185,189,4,LAGL,0
5aym,A,190,204,14,LIGLWNLVSFVPEY,0
5aym,A,245,261,16,LILSYALLWLSVLSPH,0
5aym,A,262,285,23,VLLAAYLKDEMRLPETEIGLFRG,0
5aym,A,286,301,15,GAVFGLISTVSFPYL,0
5aym,A,310,324,14,SRWHLGFQGVTLGI,0
5aym,A,325,343,18,VTAFAMGSTASVYVFLGC,0
5aym,A,344,359,15,LLSRVGLYGFSNGEF,0
5aym,A,376,391,15,LSSLTTTSATLILFS,0
5aym,A,392,408,16,GSLLPQTEDFKYLVYV,0
5aym,A,409,423,14,LAAVLLANVVFIKW,0
4byg,A,1,73,72,KHDHHQGHTHSGKGHACHHEHNSPKTQQASSKMEGPIVYTCPMHPEIRQSAPGHCPLCGMALEPETVTVSEV,0
4byg,A,85,104,19,WIALMLTIPVVILEMGGHG,0
4byg,A,105,112,7,KHFISGN,0
4byg,A,113,135,22,SSWIQLLLATPVVLWGGWPFFK,0
4byg,A,136,141,5,GWQSL,0
4byg,A,147,169,22,MFTLIAMGIGVAWIYSMVAVLW,0
4byg,A,170,184,14,GVFPHAFRSQEGVV,0
4byg,A,185,201,16,VYFEAAAVITTLVLLG,0
4byg,A,340,359,19,GWFVPAVILVAVLSFIVWA,0
4byg,A,360,370,10,LGPQPALSYG,0
4byg,A,371,389,18,IAAVSVLIIACPCALGLA,0
4byg,A,681,700,19,LFFAFIYNVLGVPLAAGVL,0
4byg,A,701,707,6,PLTGLL,0
4byg,A,708,727,19,SPMIAAAAMALSSVSVIIN,0
2c65,A,1,2,1,S,0
2c65,A,3,108,105,KCDVVVVGGGISGMAAAKLLHDSGLNVVVLEARDRVGGRTYTLRNQKVKYVDLGGSYVGPTQNRILRLAKELGLETYKVNEVERLIHHVKGKSYPFRGPFPPVWN,0
2c65,A,109,126,17,ITYLDHNNFWRTMDDMG,0
2c65,A,127,485,358,EIPSDAPWKAPLAEEWDNMTMKELLDKLCWTESAKQLATLFVNLCVTAETHEVSALWFLWYVKQCGGTTRIISTTNGGQERKFVGGSGQVSERIMDLLGDRVKLERPVIYIDQTRENVLVETLNHEMYEAKYVISAIPPTLGMKIHFNPPLPMMRNQMITRVPLGSVIKCIVYYKEPFWRKKDYCGTMIIDGEEAPVAYTLDDTKPEGNYAAIMGFILAHKARKLARLTKEERLKKLCELYAKVLGSLEALEPVHYEEKNWCEEQYSGGCYTTYFPPGILTQYGRVLRQPVDRIYFAGTETATHWSGYMEGAVEAGERAAREILHAMGKIPEDEIWQSEPESVDVPAQPITTTFLERH,0
2c65,A,486,498,12,PSVPGLLRLIGL,0
2c65,A,502,520,18,SATALGFLAHKRGLLVRV,0
4lto,D,137,147,10,PSSPSLLRAI,0
4lto,D,151,170,19,WIALLLLVIFYVFAVMGTK,0
4lto,D,171,183,12,FAQSFPEWFGTL,0
4lto,D,184,200,16,ASMYTLFQVMTLESWS,0
4lto,D,201,213,12,GIARPVIEAYPW,0
4lto,D,214,236,22,WIYFVSFILVSSFTVLNLFIGI,0
4lto,D,286,288,2,KR,0
1okc,A,5,30,25,SFLKDFLAGGVAAAISKTAVAPIER,0
1okc,A,31,37,6,KLLLQV,0
1okc,A,38,52,14,HASKQISAEKQYKG,0
1okc,A,53,64,11,IDCVVRIPKEQ,0
1okc,A,65,72,7,FLSFWRG,0
1okc,A,73,99,26,LANVIRYFPTQALNFAFKDKYKQIFL,0
1okc,A,109,138,29,RYFAGNLASGGAAGATSLCFVYPLDFART,0
1okc,A,139,155,16,LAADVGKGAAQREFTG,0
1okc,A,156,167,11,GNCITKIFKSD,0
1okc,A,168,172,4,LRGL,0
1okc,A,173,202,29,QGFNVSVQGIIIYRAAYFGVYDTAKGMLP,0
1okc,A,208,235,27,IIVSWMIAQTVTAVAGLVSYPFDTVRR,0
1okc,A,236,272,36,MMMQSGRKGADIMYTGTVDCWRKIAKDEGPKAFFKG,0
1okc,A,273,293,20,WSNVLRGMGGAFVLVLYDEI,0
1okc,A,294,297,3,KFV,0
4yl0,C,5,15,10,LVMSSPALPA,0
4yl0,C,16,35,19,LLCSTLLVIKMYVVAIITG,0
4yl0,C,47,52,5,EDALR,0
4yl0,C,69,90,21,RAHRNDMETIYPFLFLGFVYS,0
4yl0,C,91,98,7,LGPNPFV,0
4yl0,C,99,119,20,WMHFLVFLVGRVAHTVAYLG,0
4yl0,C,125,146,21,RSVTYTLAQLPCASMALQILW,0
4yl0,C,147,152,5,AARHL,0
2mn6,B,4,18,14,SIWQLLIIAVIVVL,0
2mn6,B,19,24,5,FGTKK,0
2mn6,B,25,40,15,GSIGSDLGASIKGFK,0
5tua,B,1,31,30,EDPLIGRDSLGGGGTDRVRRSEAITHGTPF,0
5tua,B,32,53,21,KAAALVDLAEDGIGLPVEILD,0
5tua,B,54,56,2,SS,0
5tua,B,57,73,16,GESARYYFIFTRLDLI,0
5tua,B,74,92,18,SLNYFALLFLNFFEQPLW,0
5tua,B,120,136,16,IIYEVITLAILLVHTF,0
5tua,B,137,154,17,PISYEGSRIFWTSRLNL,0
5tua,B,155,172,17,KVACVVILFVDVLVDFL,0
5tua,B,174,183,9,SPLAFDFLP,0
5tua,B,185,199,14,IAPYVRVIIFILSI,0
5tua,B,200,216,16,ELRDTLVLLSGMLGTY,0
5tua,B,217,239,22,NILALWMLFLLFASWIAFVMFE,0
5tua,B,251,268,17,GATLYQMFILFTTANNP,0
5tua,B,280,302,22,SSVFFVLYVLIGVYFVTNLILA,0
5tua,B,303,405,102,VYDSFKEQLAKQVSGMDQMKRRMLEKAFGLIDSDKNGEIDKNQCIKLFEQLTNYRTLPKISKEEFGLIFDELDDTRDFKINKDEFADLCQAIALRFQKEEVP,0
5tua,B,406,412,6,LFEHFP,0
5tua,B,413,434,21,IYHSALSQQLRAFVRSPNFGY,0
5tua,B,435,452,17,ISFILIINFIAVVVETT,0
5tua,B,464,483,19,QVAEFVFGWIYVLEMALKI,0
5tua,B,484,495,11,TYGFENYWREG,0
5tua,B,496,516,20,NRFDFLVTWVIVIGETATFI,0
5tua,B,519,523,4,ENTF,0
5tua,B,528,545,17,WIRYLLLARMLRLIRLL,0
5tua,B,546,561,15,NVQRYRAFIATFITL,0
5tua,B,562,586,24,PSLMPYLGTIFCVLCIYCSIGVQV,0
5tua,B,591,593,2,,0
5tua,B,617,633,16,NGMVTLFNLLVVNNWQ,0
5tua,B,647,671,24,SITYFVSFYVITILLLLNLVVAFV,0
5tua,B,672,686,14,EAFFTELDLEEEEK,0
5tua,B,687,739,52,QGQDSQEKRNRRRSAGSKSRSQRVDTLLHHMLGDELSKPECSTSDTSTAGLV,0
5hej,E,11,201,190,VDVSVSIFINKIYGVNTLEQTYKVDGYIVAQWTGKPRKTPGDKPLIVENTQIERWINNGLWVPALEFINVVGSPDTGNKRLMLFPDGRVIYNARFLGSFSNDMDARLFPFDRQQFVLELEPFSYNNQQLRFSDIQVYTENIDNEEIDEWWIRGKASTHISDIRYDHLSSVQPNQNEFSRITVRIDAVRNP,0
5hej,E,202,225,23,YYLWSFILPLGLIIAASWSVFWL,0
5hej,E,231,253,22,LQTSFTLMLTVVAYAFYTSNIL,0
5hej,E,254,259,5,RLPYT,0
5hej,E,260,282,22,VIDQMIIAGYGSIFAAILLIIF,0
5hej,E,297,317,20,QRCRLAFPLGFLAIGCVLVI,0
2x6c,D,1,11,10,TGGMKPPARK,0
2x6c,D,12,27,15,RILNSDGSSNITRLG,0
2x6c,D,28,36,8,EKRGWLDD,0
2x6c,D,38,43,5,HDLLT,0
2x6c,D,44,45,1,S,0
2x6c,D,46,70,24,PVFITLITGLYLVTNALFALAYLA,0
2x6c,D,78,85,7,RPGSFTD,0
2x6c,D,87,100,13,FFSVQTMATIGYG,0
2x6c,D,105,110,5,GPLAN,0
2x6c,D,112,132,20,VTLEALCGMLGLAVAASLIY,0
2x6c,D,133,299,166,RFTRPTAGVLFSSRMVISDFEGKPTLMMRLANLRIEAIIEADVHLVLVRSEISQEGMVFRRFHDLTLTRSRSPIFSLSWTVMHPIDHHSPIYGETDETLRNSHSEFLVLFTGHHEAFAQNVHARHAYSCDEIIWGGHFVDVFTTLPDGRRALDLGKFHEIAQHHHH,0
2x6c,D,300,301,1,H,0
3uon,A,1,19,18,DDSTDSSDNSLALTSPYK,0
3uon,A,20,24,4,FEVV,0
3uon,A,25,43,18,IVLVAGSLSLVTIIGNIL,0
3uon,A,65,84,19,ACADLIIGVFSMNLYTLYT,0
3uon,A,85,94,9,IGYWPLGPV,0
3uon,A,95,115,20,CDLWLALDYVVSNASVMNLL,0
3uon,A,146,166,20,AWVLSFILWAPAILFWQFIV,0
3uon,A,167,176,9,VRTVEDGEC,0
3uon,A,177,203,26,IQFFSNAAVTFGTAIAAFYLPVIIMT,0
3uon,A,393,414,21,LAFIITWAPYNVMVLINTFCA,0
3uon,A,415,416,1,C,0
3uon,A,417,439,22,PNTVWTIGYWLCYINSTINPAC,0
3uon,A,445,454,9,TFKKTFKHL,0
3uon,A,457,466,9,HYKNIGATR,0
2zxw,Z,13,35,22,EQAIGLSVTFLSFLLPAGWVLY,0
2zxw,Z,36,43,7,LDNYKKS,0
2zxw,Z,44,46,2,AA,0
5hd8,B,40,64,24,VVGTLVGLAAVAFDKGVAWLQNQR,0
5hd8,B,65,79,14,GALVHTADNYPLLL,0
5hd8,B,80,96,16,VAFLCSAVLAMFGYFL,0
5hd8,B,129,142,13,VKFFGGLGTLGGG,0
5hd8,B,144,155,11,LGREGPTVQIG,0
5hd8,B,181,203,22,AAAGLAAAFNAPLAGILFIIEE,0
5hd8,B,216,233,17,AVFIGVIMSTIMYRIFN,0
5hd8,B,243,249,6,LSDAPL,0
5hd8,B,250,273,23,TLWLYLILGIIFGIFGPIFNKWV,0
5hd8,B,274,282,8,GMQDLLHR,0
5hd8,B,292,306,14,LMGGAIGGLCGLLG,0
5hd8,B,307,334,27,VAPATSGGGFNLIPIATAGNFSMGMLV,0
5hd8,B,335,351,16,IFVARVITTLLCFSSG,0
5hd8,B,353,368,15,GGIFAPMLALGTVLG,0
5hd8,B,369,389,20,AFGMVAVELFPQYHLEAGTF,0
5hd8,B,390,403,13,IAGMGALLAASIR,0
5hd8,B,405,419,14,LTGIILVLEMTCNY,0
5hd8,B,421,439,18,ILPMIITGLGATLLAQFT,0
3k04,E,18,22,4,AKDK,0
3k04,E,26,45,19,LFVLTILTLISGTIFYSTV,0
3k04,E,46,50,4,GLRP,0
3k04,E,51,67,16,DALYFSVVTLTTVGDT,0
3k04,E,68,73,5,PPQTD,0
3k04,E,74,98,24,GKIFTILYIFIGIGLVFGFIHKLA,0
3k04,E,102,110,8,LPSILSNL,0
5h1r,H,8,25,17,NSVNALISRVFVQPKGD,0
5h1r,H,27,46,19,DRLNSRVTVVILAVSSALL,0
5h1r,H,110,133,23,VFALQAFLFYIPRFIWKAMIAYS,0
5h1r,H,134,188,54,YDLAAAVKYVDRFWSENRDKDDKFKTRLAAFEGRPSVYIWDGIRLARKKRSRNM,0
5h1r,H,189,212,23,LFYTLSTVWQAVNAWIQFYILTQ,0
5h1r,H,277,303,26,IFLWFWLVFVAVVSTVNCFKWIYYLC,0
5h1r,H,304,336,32,KTKAQKTIKNYLSTAPIKSTISDDQFFSALGE,0
5h1r,H,337,348,11,GLFIMDQMALN,0
5h1r,H,349,368,19,GDIPASYLTISMRNICQDF,0
5h2i,C,4,11,7,TGRPEWI,0
5h2i,C,12,28,16,LALGTALMGLGTLYFL,0
5h2i,C,47,61,14,LVPAIAFTMYLSML,0
5h2i,C,62,79,17,GYGLTMVPFGGEQNPIY,0
5h2i,C,80,94,14,ARYADWLFTTPLLL,0
5h2i,C,111,126,15,VGADGIMIGTGLVGA,0
5h2i,C,127,134,7,TKVYSYR,0
5h2i,C,135,150,15,VWWAISTAAMLYILY,0
5h2i,C,178,192,14,VVLWSAYPVVWLIG,0
5h2i,C,193,203,10,EGAGIVPLNI,0
5h2i,C,204,220,16,TLLFMVLDVSAKVGFG,0
5cth,C,11,28,17,AGLAGNIFALALFLSPV,0
5cth,C,29,46,17,TFKRILKAKSTERFDGL,0
5cth,C,47,63,16,YLFSLLNCLICLWYGL,0
5cth,C,72,90,18,VATVNGIGAVFQLAYICL,0
5cth,C,91,104,13,IFYADSRKTRMKI,0
5cth,C,105,122,17,GLLVLVVCGFALVSHAS,0
5cth,C,134,152,18,VGAVSMASLISMFASPLA,0
5cth,C,153,168,15,MGVVIRSESVEFMPF,0
5cth,C,169,186,17,LSLSTFLMSASFALYGL,0
5cth,C,191,212,21,FIYFPNGLGLILGAMQLALYA,0
5cth,C,213,217,4,YSSN,0
2qjy,F,1,8,7,SNAEDHA,0
2qjy,F,9,11,2,TR,0
2qjy,F,12,31,19,DFLYYATAGAGAVATGAAV,0
4uc2,B,3,5,2,DW,0
4uc2,B,6,24,18,LFLTFLAACGAPATTGAL,0
4uc2,B,40,62,22,PPRWVFPLAWTSLYFLMSLAAM,0
4uc2,B,63,71,8,VAQLEGSG,0
4uc2,B,72,91,19,ALAFYAAQLAFNTLWTPVF,0
4uc2,B,99,119,20,ALAVVMVMWLFVAATMWAFF,0
4uc2,B,120,124,4,LDTW,0
4uc2,B,125,145,20,GVLFVPYLIWATATTGLNFE,0
5tzy,A,8,32,24,FGLYVAAFALGFPLNVLAIRGATA,0
5tzy,A,33,41,8,ARLRLTPS,0
5tzy,A,42,65,23,VYALNLGCSDLLLTVSLPLKAVE,0
5tzy,A,78,102,24,CPVFAVAHFFPLYAGGGFLAALSA,0
5tzy,A,103,123,20,RYLGAAFPLGYQAFRRPCYS,0
5tzy,A,124,149,25,GVCAAIWALVLCHLGLVFGLEAPGG,0
5tzy,A,179,203,24,GPARFSLSLLLFFLPLAITAFCFV,0
5tzy,A,204,1012,808,CLRALARGSNIFEMLRIDEG,0
5tzy,A,1022,1037,15,GYYTIGIGHLLTKSP,0
5tzy,A,1039,1054,15,NAAKSELDKAIGRNT,0
5tzy,A,1062,1155,93,AEKLFNQDVDAAVRGILRNAKLKPVYDSLDAVRRAALINMVFQMGETGVAGFTNSLRMLQQKRWDEAAVNLAKSRWYNQTPNRAKRVITTFRT,0
5tzy,A,1158,1162,4,DAYG,0
5tzy,A,2214,2223,9,THRRKLRAA,0
5tzy,A,2224,2250,26,VAGGALLTLLLCVGPYNASNVASFLY,0
5tzy,A,2258,2278,20,KLGLITGAWSVVLNPLVTGY,0
5fgz,A,73,86,13,IVFAVLIAIYGVY,0
5fgz,A,87,234,147,DQKIRSRIDGKVWQLPAAVYGRMVNLEPDMTISKNEMVKLLEATQYRQVSKMTRPGEFTVQANSIEMIRRPFDFPDSKEGQVRARLTFDGDHLATIVNMENNRQFGFFRLDPRLITMISSPNGEQRLFVPRSGFPDLLVDTLLATED,0
5fgz,A,267,283,16,LTQQLVKNLFLSSERS,0
5fgz,A,284,300,16,WRKANEAYMALIMDAR,0
5fgz,A,301,800,499,SKDRILELYMNEVYLGQSGDNEIRGFPLASLYYFGRPVEELSLDQQALLVGMVKGASIYNPWRNPKLALERRNLVLRLLQQQQIIDQELYDMLSARPLGVQPRGGVISPQPAFMQLVRQELQAKLGDKVKDLSGVKIFTTFDSVAQDAAEKAAVEGIPALKKQRKLSDLETAIVVVDRFSGEVRAMVGGSEPQFAGYNRAMQARRSIGSLAKPATYLTALSQPKIYRLNTWIADAPIALRQPNGQVWSPQNDDRRYSESGRVMLVDALTRSMNVPTVNLGMALGLPAVTETWIKLGVPKDQLHPVPAMLLGALNLTPIEVAQAFQTIASGGNRAPLSALRSVIAEDGKVLYQSFPQAERAVPAQAAYLTLWTMQQVVQRGTGRQLGAKYPNLHLAGKTGTTNNNVDTWFAGIDGSTVTITWVGRDNNQPTKLYGASGAMSIYQRYLANQTPTPLNLVPPEDIADMGVDYDGNFVCSGGMRILPVWTSDPQSLCQQSEMQ,0
4rdq,E,28,33,5,YKLLY,0
4rdq,E,34,55,21,EFLIFISLYFAISLVYRLILS,0
4rdq,E,56,58,2,SQ,0
4rdq,E,59,80,21,LMFEKLALYCNSYAELIPVSF,0
4rdq,E,243,260,17,VYSFFLACLIGRQFLDP,0
4rdq,E,261,264,3,KAY,0
4rdq,E,265,285,20,GHELDLFVPVFTFLQFFFYA,0
4u4g,D,522,541,19,YEIWMCIVFAYIGVSVVLF,0
4u4g,D,542,544,2,VS,0
4u4g,D,568,576,8,NEFGIFNS,0
4u4g,D,577,586,9,WFSLGAFMQ,0
4u4g,D,593,598,5,RSLSG,0
4u4g,D,599,621,22,IVGGVWWFFTLIIISSYTANLA,0
4u4g,D,789,810,21,SNVAGVFYILVGGLGLAMLVA,0
4u4g,D,811,817,6,IEFCYK,0
5hk7,D,137,147,10,PSSPSLLRAI,0
5hk7,D,148,153,5,GIAWI,0
5hk7,D,154,168,14,LLLLVIFYVFAVMG,0
5hk7,D,187,197,10,YTLFQVMTLE,0
5hk7,D,216,233,17,YFVSFILVSSFTVLNLF,0
5hk7,D,234,285,51,GIIIESMQSAHWEAEDAKRIEQEQRAHDERLEMLQLIRDLSSKVDRLERRS,0
5hk7,D,286,288,2,KR,0
3b45,A,94,113,19,PVTWVMMIACVVVFIAMQI,0
3b45,A,114,115,1,G,0
3b45,A,116,123,7,QEVMLWL,0
3b45,A,124,143,19,WPFDPTLKFEFWRYFTHAL,0
3b45,A,144,166,22,HFSLMHILFNLLWWWYLGGAVE,0
3b45,A,172,190,18,KLIVITLISALLSGYVQQ,0
3b45,A,191,197,6,FSGPWF,0
3b45,A,198,214,16,GLSGVVYALMGYVWLR,0
3b45,A,228,245,17,LIIFALIWIVAGWFDLF,0
3b45,A,247,268,21,SMANGAHIAGLAVGLAMAFVD,0
4ub6,z,8,24,16,LAALVILSFVMVIGVP,0
4ub6,z,25,39,14,AYASPQDWDRSKQL,0
4ub6,z,40,55,15,FLGSGLWIALVLVVG,0
5x9r,B,11,20,9,SKGVSDLLG,0
5x9r,B,32,45,13,FALITLLLSHFYN,0
5x9r,B,47,69,22,PTDIVGGFAIMFIIGAIFGEIG,0
5x9r,B,81,96,15,APVMIFLVAAYFVYA,0
5x9r,B,97,102,5,IFTQK,0
5x9r,B,103,127,24,IDAISNVMDKSNFLNLFIAVLITG,0
5x9r,B,142,165,23,GYIPTILMGIVGASIFGIAIGLV,0
5x9r,B,166,177,11,GIPVDRIMMLY,0
5x9r,B,178,189,11,LPIMGGGNGAG,0
5x9r,B,190,215,25,VPLSEIYHSVTGRSREEYYSTAIAI,0
5x9r,B,216,230,14,TIANIFAIVFAAVL,0
5x9r,B,248,262,14,KASFKVEEDEKTGQ,0
5x9r,B,273,289,16,LSTTCFLLAYVVAKKI,0
5x9r,B,291,311,20,SIGGVAIHYFAWMVLIVAAL,0
5x9r,B,337,351,14,WVLMVGVGVCYTDL,0
5x9r,B,352,360,8,EIINAITF,0
5x9r,B,361,381,20,NVVIAAIIVIGAVLGAAIGG,0
5x9r,B,392,414,22,ITAGLCMANRGGSGDLEVLSAC,0
5x9r,B,420,438,18,SYAQISSRLGGGIVLVIA,0
5x9r,B,439,444,5,IVFGM,0
5x9r,B,445,448,3,IPR,0
2xok,T,13,28,15,ISTIGLLGAGIGIAI,0
2xok,T,29,53,24,FAALINGVSRNPSIKDTVFPMAIL,0
2xok,T,54,71,17,FALSEATGLFCLMVSFL,0
2xok,T,74,76,2,GV,0
2zup,B,1,13,12,LRFLNQASQGRG,0
2zup,B,15,31,16,LLMAFTALALELTALW,0
2zup,B,32,47,15,QHVMLLKPCVLCIYE,0
2zup,B,48,65,17,VALFGVLGAALIGAIAP,0
2zup,B,71,89,18,VAMVIWLYSAFRGVQLTY,0
2zup,B,90,130,40,HTMLQLYPSPFATCDFMVRFPEWLPLDKWVPQVFVASGDS,0
2zup,B,131,134,3,ERQ,0
2zup,B,135,145,10,DFLGLEMPQW,0
2zup,B,146,162,16,LGIFIAYLIVAVLVVI,0
2zup,B,163,176,13,QPFKAKKRDLFGR,0
1s6e,A,1,13,12,DAEVPGGRGWAS,0
1s6e,A,20,41,21,KAISRALFAEFLATGLYVFFG,0
1s6e,A,42,54,12,GSVMRWPTALPS,0
1s6e,A,55,73,18,LQIAITFNLVTAMAVQVT,0
1s6e,A,79,92,13,HANPAVTLAFLVG,0
1s6e,A,99,123,24,AVAYVAAQLVGATVGAALLYGVMP,0
1s6e,A,124,144,20,DIRETLGINVVRNSVSTGQA,0
1s6e,A,145,163,18,AVELLLTLQLVLCVFAST,0
1s6e,A,171,189,18,PATMIGISWALGHLIGIL,0
1s6e,A,190,191,1,T,0
1s6e,A,192,206,14,CSMNPARSFGPAII,0
1s6e,A,207,211,4,GKFT,0
1s6e,A,212,235,23,HWVFWVGPLMGALLASLIYNFVL,0
1s6e,A,238,282,44,TKTLAQRLAILTGTVEVGTGARAGAEPLKKESQPGSGAVEMESV,0
2cyd,J,18,34,16,MATATIFSGIGSAKGV,0
2cyd,J,35,60,25,MTGEAAAALTTSQPEKFGQALILQL,0
2cyd,J,61,77,16,PGTQGLYGFVIAFLIF,0
2cyd,J,94,110,16,ASLPIAFTGLFSGIAQ,0
2cyd,J,111,136,25,KVAAAGIQILAKKPEHATKGIIFAA,0
2cyd,J,137,153,16,VETYAILGFVISFLLV,0
2f2m,A,-2,4,6,SHMNPY,0
2f2m,A,11,28,17,LAEVIGTTLMKFSEGFT,0
2f2m,A,29,33,4,LWPS,0
2f2m,A,34,55,21,GTIICYCASFWLLAQTLAYIP,0
2f2m,A,59,80,21,YAIWSGVGIVLISLLSWGFFG,0
2f2m,A,81,86,5,RLDLP,0
2f2m,A,87,105,18,IIGMMLICAGVLIINLLS,0
5va2,D,3,131,128,RRGHVAPQNTFLDTIIRKFEGQSRKFIIANARVENCAVIYCNDGFCELCGYSRAEVMQRPCTCDFLHGPRTQRRAAAQIAQALLGAEERKVEIAFYRKDGSCFLCLVDVVPVKNEDGAVIMFILNFEV,0
5va2,D,398,409,11,TILHYSPFKAV,0
5va2,D,410,429,19,DWLILLLVIYTAVFTPYSA,0
5va2,D,453,471,18,VVDLIVDIMFIVDILINF,0
5va2,D,472,493,21,TTYVNANEEVVSHPGRIAVHY,0
5va2,D,494,510,16,KGWFLIDMVAAIPFDL,0
5va2,D,523,539,16,LKTARLLRLVRVARKL,0
5va2,D,540,546,6,RYSEYG,0
5va2,D,547,568,21,AVLFLLMCTFALIAHWLACIW,0
5va2,D,616,627,11,FTFSSLTSVGF,0
5va2,D,640,664,24,SICVMLIGSLMYASIFGNVSAIIQ,0
5va2,D,665,863,198,LYSGTARYHTQMLRVREFIRFHQIPNPLRQRLEEYFQHAWSYTNGIDMNAVLKGFPECLQADICLHLNRSLLQHCKPFRGATKGCLRALAMKFKTTHAPPGDTLVHAGDLLTALYFISRGSIEILRGDVVVAILGKNDIFGEPLNLYARPGKSNGDVRALTYCDLHKIHRDDLLEVLDMYPEFSDHFWSSLEITFNLR,0
2a65,B,1,4,3,EVK,0
2a65,B,13,32,19,LILAMAGNAVGLGNFLRFP,0
2a65,B,33,43,10,QAAENGGGAF,0
2a65,B,44,63,19,IPYIIAFLLVGIPLMWIEW,0
2a65,B,90,124,34,KILGVFGLWIPLVVAIYYVYIESWTLGFAIKFLV,0
2a65,B,125,132,7,LVPEPPP,0
2a65,B,133,134,1,A,0
2a65,B,135,166,31,DPDSILRPFKEFLYSYIGVPKGDEPILKPSL,0
2a65,B,167,185,18,AYIVFLITMFINVSILIR,0
2a65,B,191,212,21,ERFAKIAMPTLFILAVFLVIR,0
2a65,B,213,222,9,FLLETPNGT,0
2a65,B,223,231,8,ADGLNFLW,0
2a65,B,232,241,9,PDFEKLKDP,0
2a65,B,242,265,23,VWIAAVGQIFFTLSLGFGAIITY,0
2a65,B,277,297,20,SGLTAATLNEKAEVILGGSI,0
2a65,B,298,325,27,IPAAVAFFGVANAVAIAKAGAFNLGFI,0
2a65,B,326,331,5,LPAIF,0
2a65,B,332,339,7,QTAGGTF,0
2a65,B,340,367,27,GFLWFFLLFFAGLTSSIAIMQPMIAFL,0
2a65,B,378,396,18,VLWTAAIVFFSAHLVMFL,0
2a65,B,397,399,2,KS,0
2a65,B,400,426,26,DEMDFWAGTIGVVFFGLTELIIFFWI,0
2a65,B,429,437,8,DKAWEEIN,0
2a65,B,445,469,24,RIYYYVMRYITPAFLAVLLVVWAR,0
2a65,B,470,471,1,Y,0
2a65,B,472,477,5,PKIME,0
2a65,B,478,483,5,THWTV,0
2a65,B,484,502,18,ITRFYIIGLFLFLTFLVF,0
2a65,B,602,604,2,PR,0
5a44,C,6,9,3,RPE,0
5a44,C,10,32,22,IWLALGTALMGLGTLYFLVKGM,0
5a44,C,41,62,21,FYAITTLVPAIAFTMYLSMLL,0
5a44,C,63,79,16,YGLTMVPFGGEQNPIY,0
5a44,C,80,99,19,ARYADWLFTTPLLLLDLAL,0
5a44,C,106,127,21,TILALVGADGIMIGTGLVGAL,0
5a44,C,128,133,5,KVYSY,0
5a44,C,134,152,18,FVWWAISTAAMLYILYVL,0
5a44,C,171,192,21,KVLRNVTVVLWSAYPVVWLIG,0
5a44,C,193,202,9,EGAGIVPLN,0
5a44,C,203,225,22,ETLLFMVLDVSAKVGFGLILLR,0
3ir6,F,5,27,22,MFFFDIYPYIAGAVFLIGSWLR,0
3ir6,F,28,50,22,DYGQYTWRAASSQMLDRKGMNL,0
3ir6,F,51,73,22,SNLFHIGILGIFVGHFFGMLTP,0
3ir6,F,87,113,26,KMAMFAGGASGVLCLIGGVLLLKRRL,0
3ir6,F,114,124,10,SPRVRATTTG,0
3ir6,F,125,145,20,DILILSLLVIQCALGLLTIP,0
3ir6,F,183,204,21,FRLHLVLGMTLFLLFPFSRLI,0
3ir6,F,205,225,20,IWSVPVEYLTRKYQLVRARH,0
5hkt,D,137,147,10,PSSPSLLRAI,0
5hkt,D,148,153,5,GIAWI,0
5hkt,D,154,170,16,LLLLVIFYVFAVMGTK,0
5hkt,D,187,200,13,YTLFQVMTLESWS,0
5hkt,D,216,233,17,YFVSFILVSSFTVLNLF,0
5hkt,D,234,285,51,GIIIESMQSAHWEAEDAKRIEQEQRAHDERLEMLQLIRDLSSKVDRLERRS,0
5hkt,D,286,288,2,KR,0
1c3w,C,5,10,5,GRPEW,0
1c3w,C,11,33,22,WLALGTALMGLGTLYFLVKGMG,0
1c3w,C,41,62,21,FYAITTLVPAIAFTMYLSMLL,0
1c3w,C,63,79,16,YGLTMVPFGGEQNPIY,0
1c3w,C,80,100,20,ARYADWLFTTPLLLLDLALL,0
1c3w,C,106,127,21,TILALVGADGIMIGTGLVGAL,0
1c3w,C,128,133,5,KVYSY,0
1c3w,C,134,156,22,FVWWAISTAAMLYILYVLFFGF,0
1c3w,C,171,192,21,KVLRNVTVVLWSAYPVVWLIG,0
1c3w,C,193,203,10,EGAGIVPLNI,0
1c3w,C,204,226,22,TLLFMVLDVSAKVGFGLILLRS,0
4eiy,A,-24,-2,22,KTIIALSYIFCLVFADYKDDDD,0
4eiy,A,-1,4,5,APPIM,0
4eiy,A,5,25,20,SSVYITVELAIAVLAILGNV,0
4eiy,A,47,68,21,LAAADIAVGVLAIPFAITIST,0
4eiy,A,69,74,5,FCAAC,0
4eiy,A,75,96,21,GCLFIACFVLVLTQSSIFSLL,0
4eiy,A,125,144,19,AICWVLSFAIGLTPMLGWN,0
4eiy,A,145,171,26,CGQPKEGKNHSQGCGEGQVACLFEDV,0
4eiy,A,172,195,23,PMNYMVYFNFFACVLVPLLLMLG,0
4eiy,A,1043,1057,14,TPPKLEDKSPDSPE,0
4eiy,A,238,259,21,VGLFALCWLPLHIINCFTFFC,0
4eiy,A,260,264,4,DCSH,0
4eiy,A,265,286,21,PLWLMYLAIVLSHTNSVVNPF,0
4eiy,A,293,305,12,EFRQTFRKIIRS,0
4eiy,A,308,326,18,RQQEPFKAHHHHHHHHHH,0
3nya,A,-7,31,38,YKDDDDAMGQPGNGSAFLLAPNRSHAPDHDVTQQRDEV,0
3nya,A,32,35,3,VVG,0
3nya,A,36,57,21,GIVMSLIVLAIVFGNVLVITA,0
3nya,A,71,91,20,ITSLACADLVMGLAVVPFGA,0
3nya,A,92,108,16,HILMKMWTFGNFWCEF,0
3nya,A,109,129,20,TSIDVLCVTASIWTLCVIAV,0
3nya,A,151,170,19,VIILMVWIVSGLTSFLPIQ,0
3nya,A,171,199,28,HWYRATHQEAINCYAEETCCDFFTNQAY,0
3nya,A,200,220,20,IASSIVSFYVPLVIMVFVYS,0
3nya,A,275,295,20,GIIMGTFTLCWLPFFIVNIV,0
3nya,A,296,308,12,VIQDNLIRKEVY,0
3nya,A,309,327,18,LLNWIGYVNSGFNPLIYC,0
3nya,A,330,339,9,DFRIAFQEL,0
3nya,A,343,354,11,RSSLKHHHHHH,0
5h3o,D,124,146,22,TCVVTVAYIYNLLFVIARQVFN,0
5h3o,D,147,161,14,LIGPSSQSLCRFYN,0
5h3o,D,167,198,31,TQVECTYNMLTNMKEMPTYSQYPDLGWSKYW,0
5h3o,D,199,220,21,FRMLWVFFDLLMDCVYLIDTF,0
5h3o,D,252,269,17,DGISLIPLDYILGWPIP,0
5h3o,D,270,273,3,INW,0
5h3o,D,274,291,17,GLPILRLNRLIRYKRVR,0
5h3o,D,292,298,6,CLERTE,0
5h3o,D,306,330,24,FRVVVVVWYIVIIIHWNACLYFWI,0
5h3o,D,331,363,32,EWIGLGTDAWVYGHLNKQSLPDDITDTLLRRY,0
5h3o,D,364,380,16,YSFYWSTLILTTIGEV,0
5h3o,D,381,387,6,SPVRNI,0
5h3o,D,388,415,27,YAFVTLDLMCGVLIFATIVGNVGSMIS,0
5h3o,D,419,437,18,ARTEFQNKMDGIKQYMEL,0
3l74,W,5,12,7,LRQAYSA,0
3l74,W,13,18,5,FRRTS,0
3l74,W,19,40,21,FALTVVLGAVLFERAFDQGAD,0
3l74,W,63,64,1,E,0
4yzi,B,39,90,51,DYVFHRAHERMLFQTSYTLENNGSVICIPNNGQCFCLAWLKSNGTNAEKLA,0
4yzi,B,91,109,18,NILQWITFALSALCLMFY,0
4yzi,B,120,138,18,EEIYVATIEMIKFIIEYF,0
4yzi,B,139,155,16,EFDEPAVIYSSNGNKT,0
4yzi,B,156,174,18,WLRYAEWLLTCPVILIHL,0
4yzi,B,188,207,19,MGLLVSDIGGIVWATTAAL,0
4yzi,B,208,211,3,KGY,0
4yzi,B,212,232,20,RVIFFLMGLCYGIYTFFNAA,0
4yzi,B,253,272,19,MAWLFFVSWGMFPILFILG,0
4yzi,B,273,283,10,EGFGVLSVYG,0
4yzi,B,284,304,20,TVGHTIIDLMSKNCWGLLGH,0
2x6a,D,1,11,10,TGGMKPPARK,0
2x6a,D,12,27,15,RILNSDGSSNITRLG,0
2x6a,D,28,33,5,EKRGW,0
2x6a,D,34,36,2,DD,0
2x6a,D,37,43,6,YHDLLT,0
2x6a,D,44,46,2,SW,0
2x6a,D,47,71,24,VFITLITGLYLVTNALFALAYLAC,0
2x6a,D,84,99,15,DAFFFSVQTMATIGY,0
2x6a,D,108,129,21,ANTLVTLEALCGMLGLAVAAS,0
2x6a,D,130,185,55,IYARFTRPTAGVLFSSRMVISDFEGKPTLMMRLANLRIEAIIEADVHLVLVRSEV,0
2x6a,D,186,191,5,QEGMV,0
2x6a,D,192,297,105,RRFHDLTLTRSRSPIFSLSWTVMHPIDHHSPIYGETDETLRNSHSEFLVLFTGHHEAFAQNVHARHAYSCDEIIWGGHFVDVFTTLPDGRRALDLGKFHEIAQHH,0
2x6a,D,298,301,3,HHH,0
5h2k,C,4,11,7,TGRPEWI,0
5h2k,C,12,28,16,LALGTALMGLGTLYFL,0
5h2k,C,47,61,14,LVPAIAFTMYLSML,0
5h2k,C,62,79,17,GYGLTMVPFGGEQNPIY,0
5h2k,C,80,94,14,ARYADWLFTTPLLL,0
5h2k,C,111,126,15,VGADGIMIGTGLVGA,0
5h2k,C,127,134,7,TKVYSYR,0
5h2k,C,135,150,15,VWWAISTAAMLYILY,0
5h2k,C,178,192,14,VVLWSAYPVVWLIG,0
5h2k,C,193,203,10,EGAGIVPLNI,0
5h2k,C,204,220,16,TLLFMVLDVSAKVGFG,0
3eh5,C,2,4,2,EK,0
3eh5,C,5,25,20,KGALAVILVLTLTILVFWLG,0
4gp8,C,1,3,2,EE,0
4gp8,C,4,6,2,PK,0
4gp8,C,7,25,18,ALAVILVLTLTILVFWLG,0
3k06,E,18,22,4,AKDK,0
3k06,E,26,45,19,LFVLTILTLISGTIFYSTV,0
3k06,E,46,50,4,GLRP,0
3k06,E,51,70,19,DALYFSVVTLTTVGNTPPP,0
3k06,E,71,73,2,TD,0
3k06,E,74,98,24,GKIFTILYIFIGIGLVFGFIHKLA,0
3k06,E,102,110,8,LPSILSNL,0
5heh,E,198,217,19,NIILPMLFILFISWTAFWS,0
5heh,E,218,220,2,SY,0
5heh,E,221,239,18,ANVTLVVSTLIAHIAFNI,0
5heh,E,255,274,19,AIIFMIYLFYFVAVIEVTV,0
5heh,E,275,293,18,HYLKVESQPARAASITRA,0
5heh,E,294,312,18,RIAFPVVFLLANIILAFL,0
4ej4,A,36,40,4,SPGA,0
4ej4,A,41,48,7,SASSLAL,0
4ej4,A,49,73,24,IAITALYSAVCAVGLLGNVLVMFG,0
4ej4,A,88,109,21,FNLALADALATSTLPFQSAKY,0
4ej4,A,110,116,6,METWPF,0
4ej4,A,117,141,24,ELLCKAVLSIDYYNMFTSIFTLTM,0
4ej4,A,170,189,19,CIWVLASGVGVPIMVMAVT,0
4ej4,A,190,198,8,PRDGAVVC,0
4ej4,A,199,230,31,LQFPSPSWYWDTVTKICVFLFAFVVPILIIT,0
4ej4,A,264,288,24,VVVGAFVVCWAPIHIFVIVWTLVD,0
4ej4,A,289,295,6,NRRDPL,0
4ej4,A,296,320,24,VAALHLCIALGYANSSLNPVLYAF,0
4ej4,A,329,342,13,RQLCRTPCGRQEP,0
1m3x,H,1,10,9,VGVTAFGNF,0
1m3x,H,12,29,17,ASLAIYSFWIFLAGLIY,0
1m3x,H,30,248,218,LQTENMREGYPLENEDGTPAANQGPFPLPKPKTFILPHGRGTLTVPGPESEDRPIALARTAVSEGFPHAPTGDPMKDGVGPASWVARRDLPELDGHGHNKIKPMKAAAGFHVSAGKNPIGLPVRGCDLEIAGKVVDIWVDIPEQMARFLEVELKDGSTRLLPMQMVKVQSNRVHVNALSSDLFAGIPTIKSPTEVTLLEEDKICGYVAGGLMYAAPKR,0
1m3x,H,249,260,11,SVVAAMLAEYA,0
1s8l,A,1,3,2,AQ,0
1s8l,A,4,10,6,TGRPEW,0
1s8l,A,11,32,21,WLALGTALMGLGTLYFLVKGM,0
1s8l,A,42,62,20,YAITTLVPAIAFTMYLSMLL,0
1s8l,A,63,64,1,Y,0
1s8l,A,65,74,9,LTMVPFGGE,0
1s8l,A,75,79,4,NPIY,0
1s8l,A,80,100,20,ARYASWLFTTPLLLLDLALL,0
1s8l,A,104,125,21,QGTILALVGADGIMIGTGLVG,0
1s8l,A,126,136,10,LTKVYSYRFV,0
1s8l,A,137,157,20,WAISTAAMLYILYVLFFGFT,0
1s8l,A,171,190,19,KVLRNVTVVLWSAYPVVWL,0
1s8l,A,191,203,12,GSEGAGIVPLNI,0
1s8l,A,204,225,21,TLLFMVLDVSAKVGFGLILLR,0
1s8l,A,233,249,16,EAPEPSAGDGAAATSD,0
5ayo,A,12,36,24,LLLGRLLTRSGDQAWDFVVPFALL,0
5ayo,A,37,43,6,IFPGKL,0
5ayo,A,44,64,20,VAAFYYLIVKIGTFLLTPSS,0
5ayo,A,78,98,20,WGVWLQFFAILAGMVFFGML,0
5ayo,A,99,110,11,GLVRAGGRESW,0
5ayo,A,111,134,23,LSVLFIALALSGVMASLGSQITD,0
5ayo,A,158,178,20,RRIDLATEVGAPILAGALFA,0
5ayo,A,179,186,7,HPEQLPL,0
5ayo,A,187,206,19,GLFLIGLWNLVSFVPEYFL,0
5ayo,A,246,270,24,ILSYALLWLSVLSPHGVLLAAYLK,0
5ayo,A,271,277,6,EMRLPE,0
5ayo,A,278,301,23,EIGLFRGLGAVFGLISTVSFPYL,0
5ayo,A,309,329,20,SSRWHLGFQGVTLGIAVTAF,0
5ayo,A,330,337,7,MGSTASV,0
5ayo,A,338,358,20,VFLGCILLSRVGLYGFSNGE,0
5ayo,A,379,396,17,LTTTSATLILFSAGSLL,0
5ayo,A,397,401,4,QTED,0
5ayo,A,402,424,22,KYLVYVSLAAVLLANVVFIKWS,0
2c73,A,1,2,1,S,0
2c73,A,3,108,105,KCDVVVVGGGISGMAAAKLLHDSGLNVVVLEARDRVGGRTYTLRNQKVKYVDLGGSYVGPTQNRILRLAKELGLETYKVNEVERLIHHVKGKSYPFRGPFPPVWN,0
2c73,A,109,126,17,ITYLDHNNFWRTMDDMG,0
2c73,A,127,485,358,EIPSDAPWKAPLAEEWDNMTMKELLDKLCWTESAKQLATLFVNLCVTAETHEVSALWFLWYVKQCGGTTRIISTTNGGQERKFVGGSGQVSERIMDLLGDRVKLERPVIYIDQTRENVLVETLNHEMYEAKYVISAIPPTLGMKIHFNPPLPMMRNQMITRVPLGSVIKCIVYYKEPFWRKKDYCGTMIIDGEEAPVAYTLDDTKPEGNYAAIMGFILAHKARKLARLTKEERLKKLCELYAKVLGSLEALEPVHYEEKNWCEEQYSGGCYTTYFPPGILTQYGRVLRQPVDRIYFAGTETATHWSGFMEGAVEAGERAAREILHAMGKIPEDEIWQSEPESVDVPAQPITTTFLERH,0
2c73,A,486,499,13,PSVPGLLRLIGLT,0
2c73,A,502,520,18,SATALGFLAHKRGLLVRV,0
4ymw,C,4,44,40,FLSMVKYTPLFISGLIMTLKLTFLAVTIGVLMGLFIALMK,0
4ymw,C,45,48,3,SSI,0
4ymw,C,49,78,29,PIKLVASSYIEVIRGTPLLVQLLLIYNGL,0
4ymw,C,86,107,21,AFTAGVSALAINSSAYVAEII,0
4ymw,C,108,148,40,AGIQAVDPGQNEAARSLGMTHAMAMRYVIIPQAIKNILPA,0
4ymw,C,149,168,19,GNEFIVMLKESAIVSVIGF,0
4ymw,C,186,207,21,EPYIIIAAIYFVMTLTFSKLL,0
4ymw,C,208,214,6,LFERRL,0
5jje,D,23,38,15,AVFIFVGALTVLFGA,0
5jje,D,65,83,18,GLIILLGINLGLVAATLG,0
5d0y,B,18,33,15,LAMVIAIKVVLGQFK,0
5d0y,B,34,39,5,GDATL,0
5d0y,B,40,52,12,VGLGFIGSVMLG,0
5d0y,B,61,77,16,AGGALSDLVSSAIFGN,0
5d0y,B,78,81,3,GGF,0
5d0y,B,82,96,14,IGFTLTAALESMIY,0
5d0y,B,111,132,21,ASVICVTVICYIGLNTLWVSM,0
5d0y,B,133,137,4,GGTN,0
5d0y,B,138,145,7,MVALSSR,0
5d0y,B,146,167,21,LKEMITPWIHMVVVWFILEGL,0
2c67,A,1,2,1,S,0
2c67,A,3,108,105,KCDVVVVGGGISGMAAAKLLHDSGLNVVVLEARDRVGGRTYTLRNQKVKYVDLGGSYVGPTQNRILRLAKELGLETYKVNEVERLIHHVKGKSYPFRGPFPPVWN,0
2c67,A,109,127,18,ITYLDHNNFWRTMDDMGR,0
2c67,A,128,485,357,IPSDAPWKAPLAEEWDNMTMKELLDKLCWTESAKQLATLFVNLCVTAETHEVSALWFLWYVKQCGGTTRIISTTNGGQERKFVGGSGQVSERIMDLLGDRVKLERPVIYIDQTRENVLVETLNHEMYEAKYVISAIPPTLGMKIHFNPPLPMMRNQMITRVPLGSVIKCIVYYKEPFWRKKDYCGTMIIDGEEAPVAYTLDDTKPEGNYAAIMGFILAHKARKLARLTKEERLKKLCELYAKVLGSLEALEPVHYEEKNWCEEQYSGGCYTTYFPPGILTQYGRVLRQPVDRIYFAGTETATHWSGYMEGAVEAGERAAREILHAMGKIPEDEIWQSEPESVDVPAQPITTTFLERH,0
2c67,A,486,498,12,PSVPGLLRLIGL,0
2c67,A,502,520,18,SATALGFLAHKRGLLVRV,0
5azc,A,24,45,21,WYGLMYLVGFIFAMWLATRRA,0
5azc,A,46,54,8,RPGSGWTK,0
5azc,A,55,79,24,EVENLLYAGFLGVFLGGRIGYVLF,0
5azc,A,82,87,5,PQFMA,0
5azc,A,100,119,19,SFHGGLIGVIVVMIIFARR,0
5azc,A,120,123,3,KRS,0
5azc,A,124,146,22,FQVSDFIAPLIPFGLGAGRLGN,0
5azc,A,199,219,20,LYELLLEGVVLFIILNLYIR,0
5azc,A,220,225,5,PRPMG,0
5azc,A,226,244,18,VSGLFLIGYGAFRIIVEF,0
5azc,A,256,281,25,VQYISMGQILSIPMIVAGVIMMVWA,0
5azc,A,282,286,4,RRSP,0
2hqd,C,1,6,5,PNFFI,0
2hqd,C,7,11,4,RPIF,0
2hqd,C,12,25,13,WVIAIIIMLAGGL,0
2hqd,C,343,357,14,LVEAIILVFLVMYL,0
2hqd,C,358,365,7,LQNFRAT,0
2hqd,C,366,382,16,IPTIAVPVVLLGTFAV,0
2hqd,C,399,410,11,LAIGLLVDAAI,0
2hqd,C,411,441,30,VVENVERVMAEEGLPPKEATRKSMGQIQGA,0
2hqd,C,442,455,13,VGIAMVLSAVFVP,0
2hqd,C,472,489,17,TIVSAMALSVLVALILT,0
2hqd,C,490,498,8,ALCATMLK,0
2hqd,C,499,512,13,IAKGDHGEGKKGF,0
2hqd,C,513,540,27,GWFNRMFEKSTHHYTDSVGGILRSTGR,0
2hqd,C,541,555,14,LVLYLIIVVGMAYL,0
2hqd,C,878,890,12,ISLIVVFLCLAA,0
2hqd,C,891,897,6,YESWSI,0
2hqd,C,898,915,17,FSVMLVVPLGVIGALLA,0
2hqd,C,930,944,14,LLTTIGLSAKNAIL,0
2hqd,C,945,974,29,VEFAKDLMDKEGKGLIEATLDAVRMRLRP,0
2hqd,C,975,990,15,LMTSLAFILGVMPLV,0
2hqd,C,1005,1019,14,GVMGGMVTATVLAI,0
2hqd,C,1020,1036,16,FVPVFFVVVRRRFSRK,0
2hqd,C,1037,1053,16,EDIEHSHTVDHHHHHH,0
5cbg,E,6,19,13,MFKRFFGAVRTSW,0
5cbg,E,20,27,7,DPSTRGA,0
5cbg,E,28,45,17,LSLAIIVTAATIFYTLA,0
5cbg,E,51,67,16,DSLFYAVSVGLPMGNG,0
5cbg,E,75,96,21,SKIFTLVYAILVVGLFVTVGG,0
5cbg,E,97,103,6,LASAIV,0
5cbg,E,104,106,2,NN,0
2mof,A,369,382,13,ADDDNFLVPIAVG,0
2mof,A,383,403,20,ALAGVLILVLLAYFIGLKHH,0
5t77,A,14,26,12,FFSRILGLFRDV,0
5t77,A,27,42,15,FAKYFGVSYELDAYF,0
5t77,A,43,56,13,AIMFPFFLRKVFG,0
5t77,A,86,99,13,FSLIILALVILSY,0
5t77,A,100,102,2,FP,0
5t77,A,103,110,7,LIINLFG,0
5t77,A,111,125,14,GSSHETKILAKKLL,0
5t77,A,126,139,13,ITSPSIYFIFLWA,0
5t77,A,157,168,11,PSISNITIIIG,0
5t77,A,169,180,11,FLSTKYGIISP,0
5t77,A,181,194,13,IGFLIGSILMFFS,0
5t77,A,211,222,11,PHFLKLFFPTF,0
5t77,A,223,237,14,TMVVSQINTVVDMN,0
5t77,A,238,250,12,VSFYDKGSISYL,0
5t77,A,251,265,14,YASRFYLLPYGLFA,0
5t77,A,298,309,11,IPSMVGLIFLS,0
5t77,A,310,317,7,PIIRFFY,0
5t77,A,318,333,15,HGAFTSKDTLITSKI,0
5t77,A,334,345,11,IAYTLGLPFYG,0
5t77,A,367,380,13,TIVSLSNIILDII,0
5t77,A,381,389,8,GLKYGPIG,0
5t77,A,390,404,14,ALATSIAGIIGVLY,0
5t77,A,421,435,14,LNSLIMLFVIYLTD,0
5t77,A,436,441,5,TDNEF,0
5t77,A,442,457,15,FLIQILIGILVYLIF,0
1q5i,C,1,4,3,AQI,0
1q5i,C,5,9,4,GRPE,0
1q5i,C,10,34,24,IWLALGTALMGLGTLYFLVKGMGV,0
1q5i,C,41,62,21,FYAITTLVPAIAFTMYLSMLL,0
1q5i,C,63,78,15,YGLTMVPFGGEQNPI,0
1q5i,C,79,100,21,WARYADWLFTTPLLLLDLALL,0
1q5i,C,104,128,24,QGTILALVGADGIMIGTGLVGALT,0
1q5i,C,129,133,4,VYSY,0
1q5i,C,134,157,23,FVWWAISTAAMLYILYVLFFGFT,0
1q5i,C,171,195,24,KVLRNVTVVLWSAYAVVWLIGSEG,0
1q5i,C,196,202,6,GIVPLN,0
1q5i,C,203,226,23,ETLLFMVLDVSAKVGFGLILLRS,0
1q5i,C,232,249,17,AEAPEPSAGDGAAATSD,0
1msr,B,74,77,3,LII,0
1msr,B,78,89,11,GVMAGVIGTIL,0
2z5x,A,499,519,20,GLLKIIGFSTSVTALGFVLY,0
2z5x,A,520,523,3,YKL,0
3pjs,N,-5,21,26,HHHHHHPPMLSGLLARLVKLLLGRHG,0
3pjs,N,30,48,18,AATVLLVIVLLAGSYLAV,0
3pjs,N,49,65,16,AERGAPGAQLITYPRA,0
3pjs,N,66,79,13,WWSVETATTVGYG,0
3pjs,N,80,86,6,LYPVTL,0
3pjs,N,87,107,20,GRLVAVVVMVAGITSFGLVT,0
3iga,F,1,21,20,APMLSGLLARLVKLLLGRHG,0
3iga,F,22,25,3,ALH,0
3iga,F,26,50,24,RAAGAATVLLVIVLLAGSYLAVLA,0
3iga,F,63,79,16,RALWWSVETATTVGYG,0
3iga,F,87,112,25,GRCVAVVVMVAGITSFGLVTAALAT,0
3iga,F,113,124,11,FVGREQERRGH,0
5avw,G,4,22,18,GPDNDERFTYDYYRLRVV,0
5avw,G,23,39,16,LIVAAVLCVIGIIILL,0
1dv6,H,1,10,9,VGVTAFQNF,0
1dv6,H,12,29,17,ASLAIYSFWIFLAGLIY,0
1dv6,H,30,256,226,LQTENMREGYPLENEDGTPAANQGPFPLPKPKTFILPHGRGTLTVPGPESEDRPIALARTAVSEGFPHAPTGDPMKDGVGPASWVARRDLPELDGHGHNKIKPMKAAAGFHVSAGKNPIGLPVRGCDLEIAGKVVDIWVDIPEQMARFLEVELKDGSTRLLPMQMVKVQSNRVHVNALSSDLFAGIPTIKSPTEVTLLEEDKICGYVAGGLMYAAPKRKSVVAAML,0
1dv6,H,257,260,3,EYA,0
3uu4,E,-3,4,7,SAAAQDM,0
3uu4,E,5,198,193,SPPPPIADEPLTVNTGIYLIESYSLDDCAETFKVNAFLSLSWKDRRLAFDPVRSGVRVKTYEPEAIWIPEIRFVNVENARDADVVDISVSPDGTVQYLERFSARVLSPLDFRRYPFDSQTLHIYLIVRSVDTRNIVLAVDLEKVGKNDDVFLTGWDIESFTAVVKPANFALEDRLESKLDYQLRISRQYFSYI,0
3uu4,E,199,218,19,NIILPMLFILFISWTAFWS,0
3uu4,E,222,242,20,ANVTLVVSTLIAHIAFNILV,0
3uu4,E,243,255,12,TCLPKTPYMTYT,0
3uu4,E,256,275,19,AIIFMIYLFYFVAVIEVTV,0
3uu4,E,292,313,21,RASRIAFPVVFLLANIILAFL,0
3uu4,E,314,315,1,F,0
3uu4,E,316,317,1,F,0
5aw2,G,4,22,18,GPDNDERFTYDYYRLRVV,0
5aw2,G,23,39,16,LIVAAVLCVIGIIILL,0
4yb9,D,19,27,8,ATLIAAFG,0
4yb9,D,28,42,14,SFQYGYNVAAINSP,0
4yb9,D,43,55,12,EFMKDFYAYTYY,0
4yb9,D,72,88,16,VTVSMFPFGGFLGSLM,0
4yb9,D,89,103,14,GPLVNNLGRKGTLL,0
4yb9,D,104,119,15,NNIFSIVPALLMGFS,0
4yb9,D,127,143,16,IIVARVLVGICAGLSS,0
4yb9,D,144,166,22,VVPMYLGELAPKNWRGALGVVP,0
4yb9,D,167,182,15,LFITIGILVAQIFGL,0
4yb9,D,194,209,15,LLGLTGIPAVLQLLF,0
4yb9,D,210,237,27,PFFPESPRYLLIQKKDEAAAKSALRRL,0
4yb9,D,245,283,38,EIEEILEEDRAEKAVGFISVLKLFKMRSLRWQVISIIV,0
4yb9,D,284,301,17,MAGQQLSGVNAIYYYAD,0
4yb9,D,316,332,16,VTAGTGAVNVLITVCA,0
4yb9,D,333,347,14,FVVELMGRRFLLLL,0
4yb9,D,348,363,15,FSVCFTACCVLTGAL,0
4yb9,D,375,393,18,SIACVISYVIGHALGPSP,0
4yb9,D,394,416,22,PALLVTEIFLQSSRPAAYMVAG,0
4yb9,D,417,434,17,VHWLSNFTVGLVFPFIQ,0
4yb9,D,441,454,13,FVIFAVICLLTTV,0
4yb9,D,455,462,7,IFLIIPE,0
3w9i,C,1,11,10,SKFFIDRPIF,0
3w9i,C,12,26,14,WVIALVIMLAGGLS,0
3w9i,C,344,357,13,GEAILLVFLVMYL,0
3w9i,C,358,365,7,LQNFRAT,0
3w9i,C,366,382,16,IPTIAVPVVLLGTFGV,0
3w9i,C,398,410,12,VLAIGLLVDDAI,0
3w9i,C,411,442,31,VVENVERVMAEEGLSPREAARKSMGQIQGAL,0
3w9i,C,443,455,12,GIAMVLSAVFLP,0
3w9i,C,471,485,14,ITIVSAMALSVIVA,0
3w9i,C,486,511,25,ILTPALCATMLKPIEKGDHGEHKGG,0
3w9i,C,512,519,7,FGWFNRM,0
3w9i,C,520,522,2,LS,0
3w9i,C,523,534,11,THGYERGVASI,0
3w9i,C,535,541,6,KHRAPY,0
3w9i,C,542,556,14,LIYVVIVAGMIWMF,0
3w9i,C,876,890,14,ALSLLVVFLCLAAL,0
3w9i,C,891,896,5,ESWSI,0
3w9i,C,897,915,18,FSVMLVVPLGVIGALLAT,0
3w9i,C,929,942,13,LLTTIGLSAKNAI,0
3w9i,C,943,973,30,IVEFAKELHEQGKGIVEAAIEACRMRLRPI,0
3w9i,C,974,989,15,MTSLAFILGVVPLAI,0
3w9i,C,1003,1017,14,GVIGGMVTATVLAI,0
3w9i,C,1018,1028,10,WVPLFYVAVS,0
3w9i,C,1029,1030,1,L,0
3w9i,C,1031,1046,15,KDEASKQQASVEKGQ,0
4wo1,A,16,38,22,AGIVVGDLVLTVLIALAVYFLG,0
4wo1,A,39,40,1,L,0
1o0a,C,1,4,3,AQI,0
1o0a,C,5,10,5,GRPEW,0
1o0a,C,11,32,21,WLALGTALMGLGTLYFLVKGM,0
1o0a,C,42,62,20,YAITTLVPAIAFTMYLSMLL,0
1o0a,C,63,79,16,YGLTMVPFGGEQNPIY,0
1o0a,C,80,98,18,ARYADWLFTTPLLLLDLA,0
1o0a,C,106,127,21,TILALVGADGIMIGTGLVGAL,0
1o0a,C,128,133,5,KVYSY,0
1o0a,C,134,155,21,FVWWAISTAAMLYILYVLFFG,0
1o0a,C,157,161,4,SKAE,0
1o0a,C,172,192,20,VLRNVTVVLWSAYPVVWLIG,0
1o0a,C,193,202,9,EGAGIVPLN,0
1o0a,C,203,225,22,ETLLFMVLDVSAKVGFGLILLR,0
1o0a,C,232,249,17,AEAPEPSAGDGAAATSD,0
1qla,F,29,50,21,QSATGLFLGLFMIGHMFFVST,0
1qla,F,51,76,25,LLGDNVMLWVTKKFELDFIFEGGKP,0
1qla,F,77,99,22,VVSFLAAFVFAVFIAHAFLAMR,0
1qla,F,125,151,26,WWIQAMTGFAMFFLGSVHLYIMMTQP,0
1qla,F,152,166,14,TIGPVSSSFRMVSE,0
1qla,F,167,191,24,MWPLYLVLLFAVELHGSVGLYRLA,0
1qla,F,206,232,26,ANLKKLKTLMSAFLIVLGLLTFGAYV,0
1qla,F,233,254,21,KGLEQTDPNIDYKYFDYKRTH,0
1qla,F,255,256,1,R,0
5jdn,A,4,24,20,GVGYFLLGLILLYYGSDWFV,0
5jdn,A,25,39,14,GSERIARHFNVSNF,0
5jdn,A,40,59,19,IGATVMAIGTSLPEILTSA,0
5jdn,A,72,92,20,NAIGSCICNIGLVLGLSAII,0
5jdn,A,93,102,9,PIIVDKNLQ,0
5jdn,A,103,120,17,NILVYLLFVIFAAVIGI,0
5jdn,A,127,144,17,GVVLLILFIIYLRWTVK,0
5jdn,A,145,151,6,GSAEIE,0
5jdn,A,156,165,9,NNPSVVFSL,0
5jdn,A,166,186,20,LLIIGLIGVLVGAELFVDGA,0
5jdn,A,204,222,18,VAFGTSLPELMVSLAAAK,0
5jdn,A,223,228,5,NLGGM,0
5jdn,A,229,248,19,LGNVIGSNIADIGGALAVG,0
5jdn,A,258,275,17,VQMAVLVIMSLLLYLFA,0
5jdn,A,276,280,4,YSKI,0
5jdn,A,281,299,18,RWQGILFLALYIIAIASL,0
3wmf,B,93,101,8,SGPESAYT,0
3wmf,B,103,117,14,VTARRIFALAWSSS,0
3wmf,B,118,140,22,TMIVIGFIASILEGATLPAFAI,0
3wmf,B,141,165,24,FGRMFQVFTKSKSQIEGETWKYSV,0
3wmf,B,166,188,22,FVGIGVFEFIVAGSRTALFGIA,0
3wmf,B,236,257,21,KLGAVLFNLAQCVVGIIVAFI,0
3wmf,B,258,263,5,APALT,0
3wmf,B,264,284,20,VLIALSPLVVLAVVVQMIEM,0
3wmf,B,339,361,22,YISDGLFFGLSMLVIFCVYALA,0
3wmf,B,362,381,19,WWGGQLIARGSLNLGNLLT,0
3wmf,B,382,403,21,FFSAILGFMGVGQAAQVWPDV,0
3wmf,B,690,713,23,GDMSAASGRDYKDDDDKHHHHHH,0
3uub,E,-3,4,7,SAAAQDM,0
3uub,E,5,198,193,SPPPPIADEPLTVNTGIYLIESYSLDDCAETFKVNAFLSLSWKDRRLAFDPVRSGVRVKTYEPEAIWIPEIRFVNVENARDADVVDISVSPDGTVQYLERFSARVLSPLDFRRYPFDSQTLHIYLIVRSVDTRNIVLAVDLEKVGKNDDVFLTGWDIESFTAVVKPANFALEDRLESKLDYQLRISRQYFSYI,0
3uub,E,199,218,19,NIILPMLFILFISWTAFWS,0
3uub,E,222,240,18,ANVTLVVSTLIAHIAFNI,0
3uub,E,241,255,14,VETCLPKTPYMTYT,0
3uub,E,256,275,19,AIIFMIYLFYFVAVIEVTV,0
3uub,E,292,313,21,RASRIAFPVVFLLANIILAFL,0
3uub,E,314,315,1,F,0
3uub,E,316,317,1,F,0
4f4l,D,1,7,6,SHMGVG,0
4f4l,D,8,9,1,V,0
4f4l,D,10,28,18,ALLTVVFYIAAVMATNLY,0
4f4l,D,39,57,18,SKSLYTLFQVMTLESWSM,0
4f4l,D,70,89,19,WVFFIPFIMLTTFTVLNLF,0
4f4l,D,90,98,8,GIIVDAMA,0
4f4l,D,99,112,13,TKEQEEEAKTGHH,0
5uen,B,6,8,2,AF,0
5uen,B,9,31,22,AAYIGIEVLIALVSVPGNVLVI,0
5uen,B,48,69,21,VSLAVADVAVGALVIPLAILI,0
5uen,B,70,81,11,IGPQTYFHTCL,0
5uen,B,82,100,18,VACPVLILTQSSILALLA,0
5uen,B,127,146,19,IAGCWILSFVVGLTPMFGW,0
5uen,B,147,177,30,NLSAVERAWAAAGSMGEPVIKCEFEKVISM,0
5uen,B,178,199,21,YMVYFNFFVWVLPPLLLMVLI,0
5uen,B,238,256,18,ILFLFALSWLPLHILNCI,0
5uen,B,257,268,11,LFCPSCHKPSI,0
5uen,B,269,287,18,TYIAIFLTHGNSAMNPIV,0
5uen,B,293,306,13,KFRVTFLKIWNDH,0
3v2y,A,-17,15,32,KTIIALSYIFCLVFAGAPGPTSVPLVKAHRSS,0
3v2y,A,16,22,6,SDYVNY,0
3v2y,A,23,31,8,IIVRHYNY,0
3v2y,A,32,43,11,GKLNISADKEN,0
3v2y,A,44,67,23,IKLTSVVFILICCFIILENIFVL,0
3v2y,A,85,106,21,NLALSDLLAGVAYTANLLLSG,0
3v2y,A,107,114,7,TTYKLTP,0
3v2y,A,115,137,22,QWFLREGSMFVALSASVFSLLA,0
3v2y,A,149,155,6,KLHNGS,0
3v2y,A,162,184,22,LISACWVISLILGGLPIMGWNC,0
3v2y,A,185,190,5,SALSS,0
3v2y,A,191,219,28,STVLPLYHKHYILFCTTVFTLLLLSIVI,0
3v2y,A,261,283,22,LSVFIACWAPLFILLLLDVGCK,0
3v2y,A,284,287,3,KTC,0
3v2y,A,288,310,22,ILFRAEYFLVLAVLNSGTNPII,0
3v2y,A,316,323,7,EMRRAFI,0
3v2y,A,331,355,24,VLFQGPHHHHHHHHHHDYKDDDDK,0
3syp,D,50,54,4,AKRK,0
3syp,D,70,75,5,NVRET,0
3syp,D,91,113,22,RFNLLIFVMVYTVTWLFFGMIW,0
3syp,D,114,117,3,LIA,0
3syp,D,118,133,15,IRGDMDHIEDPSWTP,0
3syp,D,134,144,10,VTNLNGFVSA,0
3syp,D,145,156,11,LFSIETETTIG,0
3syp,D,157,168,11,GYRVITDKCPE,0
3syp,D,169,192,23,IILLLIQSVLGSIVNAFMVGCMF,0
3syp,D,382,389,7,SLEVLFQ,0
1kpx,A,1,55,54,AQQWSLQRLAGRHPQDSYEDSTQSSIFTYTNSNSTRGPFEGPNYHIAPRWVYHL,0
1kpx,A,56,81,25,SVWMIFVVTASVFTNGLVLAATMKF,0
1kpx,A,85,111,26,HPLNWILVNLAVADLAETVIASTISI,0
1kpx,A,112,127,15,NQVSGYFVLGHPMCV,0
1kpx,A,128,152,24,EGYTVSLCGITGLWSLAIISWERW,0
1kpx,A,167,189,22,LAIVGIAFSWIWSAVWTAPPIF,0
1kpx,A,190,217,27,WSRYWPHGLKTSCGPDVFSGSSYPGVQ,0
1kpx,A,218,243,25,YMIVLMVTCCIIPLAIIMLCYLQVW,0
1kpx,A,267,290,23,RMVVVMIFAYCVCWGPYTFFACF,0
1kpx,A,291,305,14,AANPGYAFHPLMAA,0
1kpx,A,306,327,21,PAYFAKSATIYNPVIYVFMNR,0
1kpx,A,328,336,8,FRNCILQL,0
1pf4,B,1,9,8,SLHSDESN,0
1pf4,B,10,25,15,QTFKRLWTYIRLYKA,0
1pf4,B,26,49,23,LVVSTIALVINAAADTYMISLLK,0
1pf4,B,68,91,23,FMILGLMFVRGLSGFASSYCLSW,0
1pf4,B,92,143,51,SGNVVMQMRRRLFNHFMHMPVRFFDQESTGGLLSRITYDSEQVAGATSRAL,0
1pf4,B,144,162,18,SIVREGASIIGLLTLMFW,0
1pf4,B,169,187,18,VLIVVAPVVAFAISFVSK,0
1pf4,B,188,202,14,FRKISRNMQTAMGH,0
1pf4,B,203,237,34,TSSAEQMLKGHKVVLSYGGQEVERKRFDKVSNSM,0
1pf4,B,238,252,14,QQTMKLVSAQSIAD,0
1pf4,B,253,274,21,VIQMIASLALFAVLFLASVDS,0
1pf4,B,279,300,21,TPGTFTVVFSAMFGLMRPLKA,0
1pf4,B,301,564,263,TSVTSEFQRGMAACQTLFGLMDLETERDNGKYEAERVNGEVDVKDVTFTYQGKEKPALSHVSFSIPQGKTVALVGRSGSGKSTIANLFTRFYDVDSGSICLDGHDVRDYKLTNLRRHFALVSQNVHLFNDTIANNIAYAAEGEYTREQIEQAARQAHAMEFIENMPQGLDTVIGENGTSLSGGQRQRVAIARALLRDAPVLILDEATSALDTESERAIQAALDELQKNKTVLVIAHRLSTIEQADEILVVDEGEIIERGRHAD,0
1pf4,B,565,582,17,LAQDGAYAQLHRIQFGE,0
3ae6,D,35,41,6,SKAASL,0
3ae6,D,42,61,19,WTGERVVSVLLLGLLPAAY,0
3ae6,D,68,88,20,DYSLAAALTLHGHWGIGQVV,0
3ae6,D,89,99,10,DYVRGDALQK,0
3ae6,D,100,119,19,AKAGLLALSAFTFAGLCYF,0
3ae6,D,126,134,8,CKAVAMLW,0
2e75,Q,1,6,5,EIDVL,0
2e75,Q,7,25,18,WVALLVVFTWSIAMVVWG,0
4hmk,B,1,3,2,EV,0
4hmk,B,14,32,18,ILAMAGNAVGLGNFLRFP,0
4hmk,B,33,43,10,QAAENGGGAF,0
4hmk,B,44,63,19,IPYIIAFLLVGIPLMWIEW,0
4hmk,B,90,120,30,KILGVFGLWIPLVVAIYYVYIESWTLGFAI,0
4hmk,B,121,131,10,FLVGLVPEPP,0
4hmk,B,132,134,2,,0
4hmk,B,135,166,31,DPDSILRPFKEFLYSYIGVPKGDEPILKPSL,0
4hmk,B,167,184,17,AYIVFLITMFINVSILI,0
4hmk,B,191,212,21,ERFAKIAMPTLFILAVFLVIR,0
4hmk,B,213,222,9,FLLETPNGT,0
4hmk,B,223,230,7,ADGLNFL,0
4hmk,B,231,244,13,TPDFEKLKDPGVW,0
4hmk,B,245,265,20,AAVGQIFFTLSLGFGAIITY,0
4hmk,B,278,297,19,GLTAATLNEKASVILGGSI,0
4hmk,B,298,318,20,IPAAVAFFGVANAVAIAKAG,0
4hmk,B,319,324,5,FNLGF,0
4hmk,B,326,331,5,LPAIF,0
4hmk,B,332,342,10,QTAGGTFLGF,0
4hmk,B,343,364,21,WFFLLFFAGLTSSIAIMQPMI,0
4hmk,B,378,394,16,VLWTAAIVFFSAHLVM,0
4hmk,B,395,399,4,LNKS,0
4hmk,B,400,425,25,DEMDFWAGTIGVVFFGLTELIIFFW,0
4hmk,B,429,437,8,DKAWEEIN,0
4hmk,B,446,469,23,IYYYVMRYITPAFLAVLLVVWAR,0
4hmk,B,470,471,1,Y,0
4hmk,B,472,477,5,PKIME,0
4hmk,B,478,484,6,THWTVW,0
4hmk,B,485,501,16,TRFYIIGLFLFLTFLV,0
2b2i,C,11,28,17,STALVMLMVPGVGFFYA,0
2b2i,C,29,39,10,MVRRKNAVNM,0
2b2i,C,40,62,22,ALSFISLIITVLLWIFYGYSVS,0
2b2i,C,91,108,17,YQMMFAAVTIAILTSAI,0
2b2i,C,109,114,5,ERAKV,0
2b2i,C,115,136,21,SFILLSALWLTFVYAPFAHWL,0
2b2i,C,150,170,20,AGGMVVHISSGFAALAVAMT,0
2b2i,C,171,188,17,GKRAGFEEYSIEPHSIP,0
2b2i,C,189,208,19,TLIGAALLWFGWFGFNGGS,0
2b2i,C,220,240,20,VVTNTSAAVAGFVWMVIGWI,0
2b2i,C,241,246,5,GKPGS,0
2b2i,C,247,264,17,GIVSGAIAGLAAITPAA,0
2b2i,C,270,290,20,GAIVIGLVAGIVCYLAMDFR,0
2b2i,C,291,297,6,KKKIDE,0
2b2i,C,298,319,21,LDAWAIHGIGGLWGSVAVGIL,0
2b2i,C,342,367,25,IAVASTTAYAFLVTLILAKAVDAAV,0
2b2i,C,368,379,11,LRVSSQEEYVG,0
2b2i,C,380,385,5,DLSQH,0
2b2i,C,386,391,5,EVAYT,0
2b2i,C,392,399,7,EHHHHHH,0
4q4a,B,1,9,8,PEIRRRPH,0
4q4a,B,21,29,8,TATLRRLL,0
4q4a,B,33,58,25,PHTFTLIMVFVFVTVSSILGVLSPY,0
4q4a,B,59,83,24,IGKTIDVVFVPRRFDLLPRYMLIL,0
4q4a,B,84,105,21,TIYALTSLLFWLQGKIMLTLS,0
4q4a,B,151,173,22,GNSIIQFFSGIVTLAGAVIMMF,0
4q4a,B,174,179,5,VNVIL,0
4q4a,B,180,200,20,LVTLSIVPLTVLITQIVSSQ,0
4q4a,B,259,279,20,SGVLPPLMNMVNNLGFALIS,0
4q4a,B,280,298,18,FGGWLALKDIITVGTIAT,0
4q4a,B,299,320,21,IGYSRQFTRPLNELSNQFNMI,0
4q4a,B,594,598,4,VEKE,0
1lvi,A,1,29,28,TKSSKDICSENEGKKNGKSGFFSTSFKY,0
1lvi,A,30,49,19,LSACIASFIFGYQVSVLNT,0
1lvi,A,80,97,17,LASVFIGAVLGCGFSGY,0
1lvi,A,98,103,5,VQFGR,0
1lvi,A,104,121,17,LSLLIIYNFFFLVSILT,0
1lvi,A,133,149,16,RLLSGFGIGLVTVSVP,0
1lvi,A,150,167,17,YISEMTHKDKKGAYGVM,0
1lvi,A,168,185,17,QLFITFGIFVAVMLGLA,0
1lvi,A,212,228,16,PSVISLIGILALVVFF,0
1lvi,A,229,242,13,EETPYFLFEKGRI,0
1lvi,A,243,248,5,ESKNI,0
1lvi,A,249,298,49,KKIYETDNVDEPLNAIKEAVEQNESAKKNSLSLLSALKIPSYRYVIILG,0
1lvi,A,299,316,17,LLSGLQQFTGINVLVSN,0
1lvi,A,334,351,17,VVMTAVNFLMTFPAIYI,0
1lvi,A,352,369,17,EKLGRKTLLLWGCVGVL,0
1lvi,A,370,384,14,AYLPTAIANEINRN,0
1lvi,A,389,403,14,ILSIVATFVMIISF,0
1lvi,A,404,426,22,VSYGPVLWIYLHEMFPSEIKDS,0
1lvi,A,427,442,15,ASLASLVNWVCAIIV,0
1lvi,A,448,466,18,IIKKSPSILFIVFSVMSI,0
1lvi,A,467,504,37,TFFFIFFFIKETKGGEIGTSPYITMEERQKHMTKSVV,0
5b3s,Z,17,37,20,GLSVTFLSFLLPAGWVLYHL,0
5b3s,Z,38,43,5,NYKKS,0
5u1v,C,21,31,10,SSTNYGTIKW,0
5u1v,C,33,46,13,HALVFSYISFALI,0
5u1v,C,47,330,283,DKRYQKKEPLISSVHTKVKGIAEVKAEILENGMKKMVSGVFDTADYTFPLQGNSFFVMTNFIKTEGQQQGLCPDFPTARTICSSDRGCKKGRMDPQSKGIQTGRCVVYKERLKTCEVSAWCPIEEVKDAPRPALLNSAENFTVLIKNNIDFPGHNYTTRNILPGVNITCTFHKTQNPQCPIFRLGDIFQETGDSFSDVAIQGGIMGIEIYWDCNLDGWFHHCRPKYSFRRLDDKTTSESLYPGYNFRYAKYYKENNVEKRTLIKVFGIRFDILVFGTGGKFNV,0
5u1v,C,331,348,17,QLAVYIGSVISYFGLAT,0
5u1v,C,352,362,10,ILINTYSASS,0
1y9c,A,1,13,12,QAVDNLTSAPGN,0
1y9c,A,14,27,13,SLCTRDYKITQVL,0
1y9c,A,28,52,24,PLLYTVLFFVGLITNGLAMRIFFQ,0
1y9c,A,59,83,24,IIFLKNTVISDLLMILTFPFKILS,0
1y9c,A,84,96,12,AKLGTGPLRTFV,0
1y9c,A,97,123,26,QVTSVIFYFTMYISISFLGLITIDRY,0
1y9c,A,140,166,26,AKILSVVIWAFMFLLSLPNMILTNRQ,0
1y9c,A,167,188,21,RDKNVKKCSFLKSEFGLVWHE,0
1y9c,A,189,213,24,VNYICQVIFWINFLIVIVCYTLIT,0
1y9c,A,235,258,23,VKVFIIIAVFFICFVPFHFARIP,0
1y9c,A,259,280,21,TLSQTRDVFDCTAENTLFYVK,0
1y9c,A,281,302,21,STLWLTSLNACLDPFIYFFLC,0
1y9c,A,303,314,11,SFRNSLISMLK,0
1y9c,A,316,342,26,NSATSLSQDNRKKEQDGGDPNEETPM,0
2k9p,A,31,47,16,NGSTITFDELQGLVNS,0
2k9p,A,48,71,23,VTQAILFGVRSGAAALTLIVVWI,0
2k9p,A,78,105,27,PIFIINQVSLFLIILHSALYFKYLLSN,0
2k9p,A,106,110,4,SSVT,0
2eas,A,51,56,5,VIEQF,0
2eas,A,58,74,16,LLVRILLLAACISFVL,0
2eas,A,75,88,13,WFEEGEETITAFV,0
2eas,A,89,107,18,PFVILLILIANAIVGVWQ,0
2eas,A,254,275,21,FGEQLSKVISLICVAVWLINI,0
2eas,A,276,295,19,HFNDPVHGGSWIRGAIYYF,0
2eas,A,296,318,22,IAVALAVAAIPEGLPAVITTCL,0
2eas,A,760,781,21,RYLISSNVGEVVCIFLTAALG,0
2eas,A,782,785,3,PEA,0
2eas,A,786,808,22,IPVQLLWVNLVTDGLPATALGF,0
2eas,A,830,854,24,WLFFRYMAIGGYVGAATVGAAAWW,0
2eas,A,855,897,42,MYAEDGPGVTYHQLTHFMQCTEDHPHFEGLDCEIFEAPEPMT,0
2eas,A,898,916,18,ALSVLVTIEMCNALNSLS,0
2eas,A,927,950,23,VNIWLLGSICLSMSLHFLILYVD,0
2eas,A,951,964,13,LPMIFKLKALDLT,0
2eas,A,965,987,22,WLMVLKISLPVIGLDEILKFIA,0
4tpg,B,1,7,6,TLGTNQ,0
4tpg,B,8,19,11,SKTHSFMTVSL,0
4tpg,B,20,33,13,ELWERFGYYGMQA,0
4tpg,B,55,68,13,ACAALIYVSPAIG,0
4tpg,B,69,81,12,WVGDKILGTKRT,0
4tpg,B,82,95,13,LLGAGILSVGYAL,0
4tpg,B,109,122,13,LGVIVVGNGLFKP,0
4tpg,B,123,133,10,AGNLVRKIYE,0
4tpg,B,134,136,2,DD,0
4tpg,B,137,147,10,KIDSAFTIYY,0
4tpg,B,148,161,13,AVNVGSTFSMLLT,0
4tpg,B,183,197,14,VCCVGILVGLGNYA,0
4tpg,B,198,220,22,MHKSLANYGSEPDTRPVNKKSL,0
4tpg,B,221,238,17,IVLALAALSVVASAIIL,0
4tpg,B,244,260,16,RVFVYAAGVAVLGIFF,0
4tpg,B,261,264,3,LIR,0
4tpg,B,265,267,2,SE,0
4tpg,B,268,278,10,SERAGLIAAL,0
4tpg,B,279,295,16,LTVQTVFFFIFYQQMS,0
4tpg,B,325,340,15,QALNPIWIMVLSPVL,0
4tpg,B,341,342,1,W,0
4tpg,B,343,355,12,YSWAGRNNKDFS,0
4tpg,B,356,358,2,AA,0
4tpg,B,359,373,14,FALGFAVVAIGFFI,0
4tpg,B,393,406,13,GYASYSLGELLVS,0
4tpg,B,407,416,9,LGLAMIARY,0
4tpg,B,417,423,6,PARMGG,0
4tpg,B,424,428,4,MMGA,0
4tpg,B,429,441,12,FVASGISQYLGG,0
4tpg,B,471,484,13,VAAVVCTIIALAV,0
4tpg,B,485,492,7,PLMRRLT,0
4tpg,B,493,523,30,SHHAHSSIENNAAASLRDVKAEQAENLYFQ,0
1i15,G,203,207,4,PPVL,0
1i15,G,208,224,16,SAFTWLGYVNSAVNPI,0
3oe9,B,-9,34,43,YKDDDDAGAPEGISIYTSDNYTEEMGSGDYDSMKEPCFREENA,0
3oe9,B,40,61,21,LPTIYSIIFLTGIVGNGLVIL,0
3oe9,B,62,65,3,MGY,0
3oe9,B,66,69,3,KKL,0
3oe9,B,70,77,7,SMTDKYR,0
3oe9,B,78,98,20,HLSVADLLFVITLPFWAVDA,0
3oe9,B,107,129,22,LCKAVHVIYTVNLYSSVWILAF,0
3oe9,B,130,156,26,SLDRYLAIVHATNSQRPRKLLAEKVV,0
3oe9,B,157,175,18,VGVWIPALLLTIPDFIFA,0
3oe9,B,195,217,22,VVVFQFQHIMVGLILPGIVILS,0
3oe9,B,218,1020,802,YCIIISKLSHNIFEMLRIDEGLRLKIYKD,0
3oe9,B,1021,1023,2,EG,0
3oe9,B,1024,1161,137,YTIGIGHLLTKSPSLNAAKSELDKAIGRNTNGVITKDEAEKLFNQDVDAAVRGILRNAKLKPVYDSLDAVRRAALINMVFQMGETGVAGFTNSLRMLQQKRWDEAAVNLAKSRWYNQTPNRAKRVITTFRTGTWDAY,0
3oe9,B,1161,1161,0,GSGHQKR,0
3oe9,B,236,243,7,ALKPTVI,0
3oe9,B,244,265,21,ILAFFACWLPYYIGISIDSFI,0
3oe9,B,281,301,20,KWISITEALAFFHCCLNPIL,0
3oe9,B,302,303,1,A,0
3oe9,B,304,328,24,LGAKFKTSAQHALTSGRPLEVLFQ,0
2r9r,E,-18,31,49,AHHHHHHHHHHGLVPRGSMTVATGDPVDEAAALPGHPQDTYDPEADHES,0
2r9r,E,32,163,131,ERVVINISGLRFETQLKTLAQFPETLLGDPKKRMRYFDPLRNEYFFDRNRPSFDAILYYYQSGGRLRRPVNVPLDIFSEEIRFYELGEEAMEMFREDEGYIKEEERPLPENEFQRQVWLLFEYPESSGPAR,0
2r9r,E,164,182,18,IAIVSVMVILISIVSFCL,0
2r9r,E,223,242,19,IVETLCIIWFSFEFLVRFF,0
2r9r,E,243,251,8,CPSKAGFF,0
2r9r,E,252,272,20,NIMNIIDIVAIIPYYVTIFL,0
2r9r,E,289,307,18,QIFRIMRILRIFKLSRHS,0
2r9r,E,308,319,11,GLQILGQTLKA,0
2r9r,E,320,321,1,M,0
2r9r,E,322,345,23,ELGLLIFFLFIGVILFSSAVYFA,0
2r9r,E,358,373,15,DAFWWAVVSMTTVGY,0
2r9r,E,382,402,20,GKIVGSLCAIAGVLTIALPV,0
2r9r,E,403,416,13,VIVSNFNYFYHRE,0
2r9r,E,418,495,77,GEEQAQYLQVTSSPKIPSSPDLKKSRSASTISKSDYMEIQEGVNNSNEDFREENLKTANSTLANTNYVNITKMLTDV,0
2wpd,S,1,5,4,QLVL,0
2wpd,S,6,27,21,AKYIGAGISTIGLLGAGIGIA,0
2wpd,S,56,76,20,LSEATGLFCLMVSFLLLFGV,0
4od4,A,-18,2,20,GSSHHHHHHSSGLVPAGSMR,0
4od4,A,5,19,14,IEHTIFSLPFAYVG,0
4od4,A,20,33,13,LLSRYPFTLADAI,0
4od4,A,34,49,15,MAAAVVGLRMAGMAY,0
4od4,A,82,95,13,VAAGSAIYFASAA,0
4od4,A,96,101,5,LNTYA,0
4od4,A,102,115,13,LLSPLVLAIALTY,0
4od4,A,125,140,15,HLHLGIVLGSVVFGG,0
4od4,A,141,151,10,VAASGDEASS,0
4od4,A,152,157,5,GEVLR,0
4od4,A,158,161,3,VPW,0
4od4,A,162,175,13,YVAAVSLWVAGFD,0
4od4,A,206,221,15,SLAMHAAAVALFIAG,0
4od4,A,222,233,11,EAYGLGAIATV,0
4od4,A,234,247,13,TALTALVIILVQA,0
4od4,A,258,273,15,NLNLAVPIIIGAGII,0
4od4,A,274,277,3,DML,0
4od4,A,278,284,6,HMIRLL,0
5uja,A,215,220,5,LSRIT,0
5uja,A,226,233,7,MMVQGYR,0
5uja,A,330,346,16,FKAVHDLMMFAGPEIL,0
5uja,A,347,367,20,LLINFVNDKKAPEWQGYFYT,0
5uja,A,368,384,16,LLFISACLQTLVLHQY,0
5uja,A,443,459,16,IWSAPLQVILALYLLW,0
5uja,A,460,466,6,NLGPSV,0
5uja,A,467,483,16,AGVAVMVLMVPLNAVM,0
5uja,A,545,564,19,AAVGTFTWVCTPFLVALST,0
5uja,A,565,584,19,AVYVTVDENNILDAQKAFV,0
5uja,A,585,600,15,LALFNILRFPLNILP,0
5uja,A,959,969,10,SVYWDYMKAI,0
5uja,A,972,992,20,ISFLSIFLFLCNHVASLVSN,0
5uja,A,993,1019,26,WLSLWTDDPIVNGTQEHTQVRLSVYG,0
5uja,A,1020,1036,16,LGISQGITVFGYSMAV,0
5uja,A,1091,1108,17,MFMGSLFNVIGACIIIL,0
5uja,A,1109,1114,5,ATPMA,0
5uja,A,1115,1129,14,VIIPPLGLIYFFVQ,0
5uja,A,1199,1214,15,VRLECVGNCIVLFAS,0
5uja,A,1215,1232,17,FAVISRHSLSAGLVGLS,0
5uja,A,1233,1247,14,SYSLQVTTYLNWLV,0
3h6b,C,1,5,4,SSDA,0
3h6b,C,6,16,10,AHKVGLIPVT,0
3h6b,C,17,31,14,MVSGNIMGSGVFLL,0
3h6b,C,44,58,14,GWLVTIIGALGLSM,0
3h6b,C,59,91,32,YAKMSFLDPSPGGSYAYARRCFGPFLGYQTNV,0
3h6b,C,92,109,17,YWLACWIGNIAMVVIGV,0
3h6b,C,127,140,13,TCVVVLWIFVLLN,0
3h6b,C,141,147,6,VGPKMI,0
3h6b,C,148,168,20,RVQAVATVLALIPIVGIAVF,0
3h6b,C,200,213,13,LWSFIGVESASVA,0
3h6b,C,214,232,18,GVVKNPKRNVPIATIGGV,0
3h6b,C,233,248,15,IAAVCYVLSTTAIMG,0
3h6b,C,257,276,19,SASPFGDAARMALGDTAGA,0
3h6b,C,285,301,16,CLGSLGGWTLLAGQTA,0
3h6b,C,302,327,25,AAADDGLFPPIFARVNKAGTPVAGL,0
3h6b,C,328,342,14,IVGILMTIFQLSSI,0
3h6b,C,350,366,16,GLVSSVSVIFTLVPYL,0
3h6b,C,367,389,22,TCAALLLLGHGHFGKARPAYLA,0
3h6b,C,390,407,17,TTIAFLYCIWAVVGSGA,0
3h6b,C,409,423,14,VMWSFVTLMVITAM,0
3h6b,C,424,436,12,ALNYNRLHKNPY,0
3h6b,C,437,445,8,LDAPISKD,0
4tq5,A,1,14,13,DSSLANINQIDVP,0
4tq5,A,16,39,23,YLRLLRPVAWLCFLLPYAVGFGF,0
4tq5,A,40,51,11,ITPNASLQHAV,0
4tq5,A,52,71,19,GLLSFAFWMAFSFTINALY,0
4tq5,A,74,85,11,VDRLHDGRVKD,0
4tq5,A,98,119,21,SVREAWLYCIAFLALSLATAA,0
4tq5,A,120,124,4,INEK,0
4tq5,A,125,146,21,FLAMLGANIIGYVYSAPPRFK,0
4tq5,A,151,169,18,DVICNALAAVLAFYAGLS,0
4tq5,A,170,175,5,GGAEV,0
4tq5,A,176,192,16,IAIYPAAFFLAATFYI,0
4tq5,A,224,241,17,PLSAITVILWAYVFLMA,0
4tq5,A,242,245,3,RIE,0
4tq5,A,246,263,17,KVISPLIIAYTLIYTFI,0
4tq5,A,278,295,17,LILTPFGIISALFIAYG,0
4tq5,A,296,301,5,AVISV,0
4tq5,A,302,303,1,G,0
2rn0,A,685,690,5,ESPKG,0
2rn0,A,691,713,22,DILVVLLSVMGAILLIGLAALL,0
2l34,B,5,26,21,PGVLAGIVVGDLVLTVLIALA,0
2l34,B,27,33,6,YFLGRL,0
4zjq,C,14,26,12,IAIIIMLAGGLA,0
4zjq,C,27,341,314,LKLPVAQYPTIAPPAVTISASYPGADAKTVQDTVTQVIEQNMNGIDNLMYMSSNSDSTGTVQITLTFESGTDADIAQVQVQNKLQLAMPLLPQEVQQQGVSVEKSSSSFLMVVGVINTDGTMTQEDISDYVAANMKDAISRTSGVGDVQLFGSQYAMRIWMNPNELNKFQLTPVDVITAIKAQNAQVAAGQLGGTPPVKGQQLNASIIAQTRLTSTEEFGKILLKVNQDGSRVLLRDVAKIELGGENYDIIAEFNGQPASGLGIKLATGANALDTAAAIRAELAKMEPFFPSGLKIVYPYDTTPFVKISIHEVV,0
4zjq,C,342,355,13,TLVEAIILVFLVM,0
4zjq,C,369,383,14,IAVPVVLLGTFAVL,0
4zjq,C,384,395,11,AFGFSINTLTM,0
4zjq,C,396,408,12,GMVLAIGLLVDD,0
4zjq,C,444,456,12,IAMVLSAVFVPM,0
4zjq,C,457,470,13,FFGGSTGAIYRQF,0
4zjq,C,471,484,13,ITIVSAMALSVLV,0
4zjq,C,543,556,13,LYLIIVVGMAYLF,0
4zjq,C,557,871,314,RLPSSFLPDEDQGVFMTMVQLPAGATQERTQKVLNEVTHYYLTKEKNNVESVFAVNGGGQNTGIAFVSLKDWADRPGEENKVEAITMRATRAFSQIKDAMVFAFNLPAIVELGTATGFDFELIDQAGLGHEKLTQARNQLLAEAAKHPDMLTSVRPNGLEDTPQFKIDIDQEKAQALGVSINDINTTLGAAWGGSYVNDFIDRGRVKKVYVMSEAKYRMLPDDIGDWYVRAADGQMVPFSAFSSSRWEYGSPRLERYNGLPSMEILGQAAPGKSTGEAMELMEQLASKLPTGVGYDWTGMSYQERLSGNQAPSL,0
4zjq,C,872,886,14,AISLIVVFLCLAAL,0
4zjq,C,894,913,19,SVMLVVPLGVIGALLAATF,0
4zjq,C,914,924,10,GLTNDVYFQV,0
4zjq,C,925,937,12,LLTTIGLSAKNA,0
4zjq,C,974,986,12,LAFILGVMPLVI,0
4zjq,C,987,998,11,TGAGSGAQNAV,0
4zjq,C,999,1013,14,TGVMGGMVTATVLA,0
4zjq,C,1014,1025,11,FFVPVFFVVVR,0
4cfg,A,194,271,77,SADLEATLRHKLTVMYSQINGASRALDDVRNRQQDVRMTANRKVEQLQQEYTEMKALLDASETTSTRKIKEEEKRVN,0
4cfg,A,272,295,23,QFDTIYQILLKKKSEIQTLKEEI,0
4cfg,A,312,326,14,KLRGISTQPVYIPE,0
4cfg,A,327,357,30,ELNHKLIKGIHQSTIDLKNELKQCIGRLQE,0
1r3k,L,1,21,20,APMLSGLLARLVKLLLGRHG,0
1r3k,L,22,25,3,ALH,0
1r3k,L,26,50,24,RAAGAATVLLVIVLLAGSYLAVLA,0
1r3k,L,63,78,15,RALWWSVETATTVGY,0
1r3k,L,87,111,24,GRCVAVVVMVAGITSFGLVTAALA,0
1r3k,L,112,124,12,WFVGREQERRGH,0
4cg5,C,61,71,10,DSPGLKVGPV,0
4cg5,C,72,82,10,VLVMSLLFIA,0
1nu1,K,1,21,20,LTRFLGPRYRQLARNWVPTA,0
1nu1,K,22,38,16,LWGAVGAVGLVWATDW,0
1nu1,K,54,56,2,DD,0
2wgm,K,11,32,21,AASAVGAGTAMIAGIGPGVGQ,0
2wgm,K,33,61,28,YAAGKAVESVARQPEAKGDIISTMVLGQ,0
2wgm,K,62,85,23,VAESTGIYSLVIALILLYANPFV,0
2wdv,L,1,10,9,VSNASALGR,0
2wdv,L,15,35,20,FILVRATAIVLTLYIIYMVG,0
2wdv,L,36,58,22,FATSGELTYEVWIGFFASAFTK,0
2wdv,L,59,80,21,FTLLALFSILIHAWIGMWQVL,0
2wdv,L,89,109,20,RLMLQLVIVVALVVYVIYGF,0
2wdv,L,110,115,5,VVWGV,0
4mes,A,7,11,4,VRLL,0
4mes,A,12,31,19,EIAFMAALAFIISLIPNTV,0
4mes,A,36,51,15,VEIACIPILLLSLRR,0
4mes,A,53,75,22,TAGLVGGLIWGILSMITGHAYI,0
4mes,A,79,98,19,QAFLEYLVAPVSLGIAGLF,0
4mes,A,99,107,8,QKTAPLKL,0
4mes,A,108,130,22,PVLLGTFVAVLLKYFFHFIAGI,0
4mes,A,148,173,25,AVNGISGILTAIAAFVILIIFVKKF,0
4mes,A,174,182,8,KLFIHSNY,0
3jac,C,1966,1981,15,HTKYRAATDVYALMF,0
3jac,C,1982,2004,22,ADIVDIIIIIFGFWAFGKHSAA,0
3jac,C,2005,2020,15,DIASSLSDDQVPQAF,0
3jac,C,2032,2046,14,IDRALYLRKTVLGK,0
3jac,C,2047,2062,15,AFQVVLVVAIHIWMF,0
3jac,C,2063,2077,14,ILPAVTERMFSQNA,0
3jac,C,2083,2096,13,FVKCIYFALSAYQ,0
3jac,C,2097,2134,37,RCGYPTRILGNFLTKKYNHLNLFLFQGFRLVPFLVEL,0
3jac,C,2135,2148,13,AVMDWVWTDTTLS,0
3jac,C,2149,2198,49,SNWMCVEDIYANIFIIKCSRETEKKYPQPKGQKKKKIVKYGMGGLIILF,0
3jac,C,2199,2213,14,IAIIWFPLLFMSLI,0
3jac,C,2463,2479,16,YGIVGLYVSIVLVVGK,0
3jac,C,2480,2544,64,VRGFFSEISHSIMFEELPCVDRILKLCQDIFLVRETRELELEEELYAKLIFLYRSPETMIKWTR,0
1pst,H,13,30,17,SLAIYSFWIFLAGLIYY,0
4hzu,S,1,55,54,TKGSLKENTIAAVLIAMTVALSILVVIPIPATKGIVTLCEVGIYTSAILYGRRM,0
4hzu,S,56,70,14,LLVGGASGFLIDIL,0
4hzu,S,71,77,6,GYPVWC,0
4hzu,S,78,95,17,FSLVIHGTQGLVVGWLL,0
4hzu,S,96,113,17,RHHKGIRSMLLPLLVGS,0
4hzu,S,114,130,16,VMVIGYCLATTLLFGW,0
4hzu,S,132,142,10,GLASIFGNVV,0
4hzu,S,143,164,21,VGFGAGVTLSIVGPLTRLKPD,0
4hzu,S,165,166,1,V,0
1l6t,A,8,29,21,LYMAAAVMMGLAAIGDAIGIG,0
1l6t,A,30,54,24,LGGKFLEGAARQPDLIPLLRTQFF,0
1l6t,A,55,77,22,VMGLVNAIPMIAVGLGLYVMFA,0
4z3n,A,33,53,20,RMALPMFVGMLTQVTYAIAD,0
4z3n,A,54,59,5,FWLSH,0
4z3n,A,66,74,8,IIAGVGLV,0
4z3n,A,75,94,19,PVGMGLFAIANGIQIGMGS,0
4z3n,A,115,134,19,IIIALFFAIVITVLGYVYA,0
4z3n,A,135,154,19,PLLRSLGATKSIIGYATEF,0
4z3n,A,155,176,21,YYSLLTVFSIMLIGVMMGLFQ,0
4z3n,A,182,202,20,VIMKASLLGALVNIMLDPIM,0
4z3n,A,203,211,8,FVFDFGVK,0
4z3n,A,212,231,19,VALASFLAQLSMVAYFIYT,0
4z3n,A,257,277,20,SVGMAQMLMQLIIAVGIVIY,0
4z3n,A,278,295,17,FFIVRLDVNAMAAFTLT,0
4z3n,A,296,314,18,RIDYFIITPMLAIATALL,0
4z3n,A,334,355,21,AAVALAFSIVLVLAVMHIVLA,0
4z3n,A,356,375,19,WMYPLFTRVVAVSDYAVLQ,0
4z3n,A,376,397,21,RIMALALPFVAISLLASEYYQ,0
4z3n,A,402,424,22,WYSVLLTLMRHVFISVPVVYLL,0
4z3n,A,425,434,9,IVLEMRITG,0
4z3n,A,435,453,18,YFGAMSGTFVAALLAWRL,0
2gmr,H,1,10,9,VGVTAFGNF,0
2gmr,H,12,28,16,ASLAIYSFWIFLAGLI,0
2gmr,H,259,260,1,A,0
5i6c,B,84,105,21,QHALAMLAGVVTPPLIISSSL,0
5i6c,B,106,109,3,LPS,0
5i6c,B,110,129,19,LQQYLVSTSLIVCGLLSMV,0
5i6c,B,151,167,16,GVSFSIISVASGAFNQ,0
5i6c,B,168,186,18,YSNGFCQLDEAGNRLPCP,0
5i6c,B,187,206,19,AYGALIGTSACCALVEILL,0
5i6c,B,211,217,6,KVIQKI,0
5i6c,B,222,246,24,TGPTVMLIGISLIGTGFKDWAGGS,0
5i6c,B,247,269,22,CMDDGMLCPSATAPRPLPWGSP,0
5i6c,B,270,289,19,FIGLGFLVFVSIILCERFG,0
5i6c,B,293,315,22,KSCSVVIGLLVGCIVAAACGYF,0
5i6c,B,316,323,7,HADIDAA,0
5i6c,B,324,334,10,AASFIWVKTF,0
5i6c,B,336,357,21,SVYGPMVLPIIAVFIICACEC,0
5i6c,B,387,400,13,DGINSVVAALATM,0
5i6c,B,401,408,7,PMTTFAQ,0
5i6c,B,426,448,22,CCLILIVAGIFAKFAAAIVAIP,0
5i6c,B,450,469,19,VMGGMKTFLFASVVISGQA,0
5i6c,B,482,500,18,ILTASMALGYGATLVPTW,0
5i6c,B,501,512,11,GNVFPQTENRD,0
5i6c,B,513,541,28,EGFENAIELVLETGFAVTAFVAMLLNAI,0
1pp9,W,5,12,7,TARLYSL,0
1pp9,W,22,39,17,TIVVGALFFERAFDQGA,0
1pp9,W,40,62,22,AIYEHINEGKLWKHIKHKYENK,0
4hyx,A,-12,5,17,LELLPTAVEGVSQAQIT,0
4hyx,A,10,32,22,IWLALGTALMGLGTLYFLVKGM,0
4hyx,A,33,41,8,VSDPDAKK,0
4hyx,A,42,62,20,YAITTLVPAIAFTMYLSMLL,0
4hyx,A,80,99,19,ARYADWLFTTPLLLLDLAL,0
4hyx,A,100,103,3,VDA,0
4hyx,A,104,126,22,QGTILALVGADGIMIGTGLVGA,0
4hyx,A,135,157,22,VWWAISTAAMLYILYVLFFGFT,0
4hyx,A,158,171,13,KAESMRPEVASTF,0
4hyx,A,172,192,20,VLRNVTVVLWSAYPVVWLIG,0
4hyx,A,202,224,22,IETLLFMVLDVSAKVGFGLILL,0
4hyx,A,225,231,6,SRAIFG,0
4hyx,A,232,249,17,AEAPEPSAGDGAAATSD,0
4ftp,B,1,28,27,KTDTPSLETPQAARLRRRQLIRQLLER,0
4ftp,B,37,57,20,MAAVVGTLVGLAAVAFDKGV,0
4ftp,B,58,83,25,WLQNQRMGALVHTADNYPLLLTVAF,0
4ftp,B,84,97,13,CSAVLAMFGYFLV,0
4ftp,B,129,141,12,VKFFGGLGTLGG,0
4ftp,B,143,156,13,VLGREGPTVQIGG,0
4ftp,B,181,202,21,AAAGLAAAFNAPLAGILFIIY,0
4ftp,B,216,231,15,AVFIGVIMSTIMYRI,0
4ftp,B,232,252,20,NHEVALIDVGKLSDAPLNTL,0
4ftp,B,253,270,17,LYLILGIIFGIFGPIFN,0
4ftp,B,290,303,13,WVLMGGAIGGLCG,0
4ftp,B,304,336,32,LGFVAPATSGGGFNLIPIATAGNFSMGMLVFI,0
4ftp,B,337,351,14,VARVITTLLCFSSG,0
4ftp,B,353,368,15,GGIFAPMLALGTVLG,0
4ftp,B,369,391,22,AFGMVAVELFPQYHLEAGTFAI,0
4ftp,B,392,415,23,GMGALLAASIRAPLTGIILVLEM,0
4ftp,B,416,421,5,DNYQL,0
4ftp,B,422,436,14,LPMIITGLGATLLA,0
4ftp,B,461,465,4,ARSK,0
2wjk,C,1,4,3,AQI,0
2wjk,C,5,9,4,GRPE,0
2wjk,C,10,32,22,IWLALGTALMGLGTLYFLVKGM,0
2wjk,C,34,37,3,SDP,0
2wjk,C,41,62,21,FYAITTLVPAIAFTMYLSMLL,0
2wjk,C,63,71,8,YGLTMVPF,0
2wjk,C,72,74,2,GE,0
2wjk,C,75,79,4,NPIY,0
2wjk,C,80,99,19,ARYADWLFTTPLLLLDLAL,0
2wjk,C,106,127,21,TILALVGADGIMIGTGLVGAL,0
2wjk,C,128,133,5,KVYSY,0
2wjk,C,134,155,21,FVWWAISTAAMLYILYVLFFG,0
2wjk,C,156,165,9,TSKAESMRP,0
2wjk,C,172,192,20,VLRNVTVVLWSAYPVVWLIG,0
2wjk,C,193,203,10,EGAGIVPLNI,0
2wjk,C,204,225,21,TLLFMVLDVSAKVGFGLILLR,0
2wjk,C,232,249,17,AEAPEPSAGDGAAATSD,0
1b9u,A,1,5,4,NLNA,0
1b9u,A,6,30,24,ILGQAIAFVLFVLFCMKYVWPPLM,0
3zev,A,46,50,4,PGSG,0
3zev,A,51,61,10,NSDLDVNTDI,0
3zev,A,62,83,21,SKVLVTAIYLALFVVGTVGNS,0
3zev,A,94,96,2,LQ,0
3zev,A,109,132,23,ALSDLLILLLAMPVELYNFIWVH,0
3zev,A,133,135,2,PW,0
3zev,A,136,161,25,FGDAGCRGYYFLRDACTYATALNVV,0
3zev,A,192,210,18,IWLASALLAIPMLFTMGL,0
3zev,A,211,231,20,NLSGDGTHPGGLVCTPIVDT,0
3zev,A,232,255,23,TLKVVIQVNTFMSFLFPMLVASI,0
3zev,A,271,280,9,AEQGRVCTE,0
3zev,A,313,333,20,VIAFVVCWLPYHVRRLMFCY,0
3zev,A,334,346,12,SDEQWTTFLFDF,0
3zev,A,347,367,20,HYFYMLTNALVYVSAAINPI,0
3zev,A,374,383,9,NFRQVFLST,0
3zev,A,387,399,12,CPGTRELEVLFQ,0
5etz,D,18,20,2,VT,0
5etz,D,21,28,7,RELFEFV,0
5etz,D,29,36,7,NDPLLAS,0
5etz,D,37,53,16,LYINIALAGLSILLFV,0
5etz,D,72,87,15,LVPVVSIASYTGLAS,0
5etz,D,88,120,32,LTISVLEMPAGHFAEGSSVMLGGEEVDGVVTM,0
5etz,D,121,135,14,GRYLTWALSTPMIL,0
5etz,D,153,168,15,TFDIAMCVTGLAAAL,0
5etz,D,169,174,5,TSSHL,0
5etz,D,175,191,16,RWFWYAISCACFIVVL,0
5etz,D,218,232,14,VVMWLGYPIVWALG,0
5etz,D,233,243,10,EGVAVLPVGY,0
5etz,D,244,261,17,SWAYSALDIVAKYIFAF,0
5bqg,B,5,15,10,LVMSSPALPA,0
5bqg,B,16,35,19,LLCSTLLVIKMYVVAIITG,0
5bqg,B,47,52,5,EDALR,0
5bqg,B,69,90,21,RAHRNDMETIYPFLFLGFVYS,0
5bqg,B,91,98,7,LGPNPFV,0
5bqg,B,99,119,20,WMHFLVFLVGRVAHTVAYLG,0
5bqg,B,125,146,21,RSVTYTLAQLPCASMALQILW,0
5bqg,B,147,152,5,AARHL,0
4hyo,D,11,17,6,LPRVLK,0
4hyo,D,24,41,17,LLVLAVIIYGTAGFHFI,0
4hyo,D,42,46,4,GESW,0
4hyo,D,47,63,16,VSLYWTFVTIATVGYG,0
4hyo,D,64,70,6,YSPHTP,0
4hyo,D,71,92,21,GMYFTCTLIVLGIGTFAVAVE,0
4hyo,D,93,98,5,LLEFL,0
4hyo,D,100,101,1,R,0
5gli,A,85,99,14,SPPPCQGPIEIKET,0
5gli,A,100,124,24,KYINTVVSCLVFVLGIIGNSTLLY,0
5gli,A,140,163,23,ASLALGDLLHIVIAIPINVYKLL,0
5gli,A,164,172,8,EDWPFGAE,0
5gli,A,173,195,22,CKLVPFIQKASVGITVLSLCAL,0
5gli,A,220,240,20,EIVLIWVVSVVLAVPEAIGF,0
5gli,A,241,265,24,IITMDYKGSYLRICLLHPVQKTAF,0
5gli,A,266,291,25,QFYATAKDWWLFSFYFCLPLAITAF,0
5gli,A,327,349,22,LVLVFALCWLPLHLARILKLTL,0
5gli,A,350,363,13,NQNDPNRCELLSF,0
5gli,A,364,386,22,LVLDYIGINMASLNSCANPIAL,0
5gli,A,391,402,11,RFKNAFKSALC,0
2ydo,A,1,5,4,PIMG,0
2ydo,A,9,29,20,ITVELAIAVLAILGNVLVCW,0
2ydo,A,30,43,13,VWLNSNLQNVTNY,0
2ydo,A,44,64,20,VVSAAAADILVGVLAIPFAI,0
2ydo,A,80,101,21,ACFVLVLTASSIFSLLAIAID,0
2ydo,A,102,121,19,YIAIRIPLRYNGLVTGTRA,0
2ydo,A,122,138,16,GIIAICWVLSFAIGLT,0
2ydo,A,178,202,24,YFNFFACVLVPLLLMLGVYLRIFL,0
2ydo,A,203,213,10,ARRQLKQMES,0
2ydo,A,214,223,9,PLPGERARS,0
2ydo,A,224,232,8,LQKEVHAA,0
2ydo,A,233,251,18,SLAIIVGLFALCWLPLHI,0
2ydo,A,272,290,18,AIVLSHTNSVVNPFIYAY,0
2ydo,A,291,292,1,I,0
2ydo,A,293,310,17,EFRQTFRKIIRSHVLRQ,0
2ydo,A,312,323,11,PFKAAAAENLY,0
1r2n,A,9,32,23,WIWLALGTALMGLGTLYFLVKGM,0
1r2n,A,33,41,8,VSDPDAKK,0
1r2n,A,42,66,24,YAITTLVPAIAFTMYLSMLLGYGL,0
1r2n,A,79,99,20,WARYADWLFTTPLLLLDLAL,0
1r2n,A,100,103,3,VDA,0
1r2n,A,104,127,23,QGTILALVGADGIMIGTGLVGAL,0
1r2n,A,134,157,23,FVWWAISTAAMLYILYVLFFGFT,0
1r2n,A,158,171,13,KAESMRPEVASTF,0
1r2n,A,172,195,23,VLRNVTVVLWSAYPVVWLIGSEG,0
1r2n,A,199,225,26,PLNIETLLFMVLDVSAKVGFGLILLR,0
1r2n,A,226,232,6,RAIFGE,0
1r2n,A,233,249,16,EAPEPSAGDGAAATSD,0
5nil,K,1,226,225,TPLLELKDIRRSYPAGDEQVEVLKGISLDIYAGEMVAIVGASGSGKSTLMNILGCLDKATSGTYRVAGQDVATLDADALAQLRREHFGFIFQRYHLLSHLTAEQNVEVPAVYAGLERKQRLLRAQELLQRLGLEDRTEYYPAQLSGGQQQRVSIARALMNGGQVILADEPTGALDSHSGEEVMAILHQLRDRGHTVIIVTHDPQVAAQAERVIEIRDGEIVRNPP,0
5nil,K,246,247,1,W,0
5nil,K,248,267,19,QFVSGFNEALTMAWRALAA,0
5nil,K,268,269,1,K,0
5nil,K,270,294,24,RTLLTMLGIIIGIASVVSIVVVGD,0
5nil,K,523,545,22,FLTLVAVISLVVGGIGVMNIML,0
5nil,K,546,572,26,SVTERTREIGIRMAVGARASDVLQQF,0
5nil,K,573,601,28,IEAVLVCLVGGALGITLSLLIAFTLQLF,0
5nil,K,608,632,24,FSPLALLLAFLCSTVTGILFGWLP,0
5nil,K,633,648,15,RNAARLDPVDALARE,0
5nj6,A,59,62,3,SVD,0
5nj6,A,63,68,5,FSASV,0
5nj6,A,69,71,2,TG,0
5nj6,A,72,101,29,LTTVFLPIVYTIVFVVALPSNGMALWVFL,0
5nj6,A,113,137,24,MANLALADLLSVIWFPLKIAYHIH,0
5nj6,A,138,146,8,NNWIYGEA,0
5nj6,A,147,171,24,CNVLIGFFYANMYCSILFLTCLSV,0
5nj6,A,190,212,22,AIGISLAIWLLILLVTIPLYVV,0
5nj6,A,213,238,25,QTIFIPALQITTCHDVLPEQLLVGD,0
5nj6,A,239,261,22,FNYFLSLAIGVFLFPAFLTASA,0
5nj6,A,289,313,24,VTVAAMYLICFTPSNLLLVVHYFL,0
5nj6,A,314,321,7,KSQGQSH,0
5nj6,A,322,344,22,YALYIVALCLSTLNSCIDPFVY,0
5nj6,A,349,358,9,DFRDHAKNA,0
3t2m,E,18,20,2,AK,0
3t2m,E,25,45,20,VLFVLTILTLISGTIFYSTV,0
3t2m,E,46,50,4,GLRP,0
3t2m,E,51,67,16,DALYFSVVTLTTVGDG,0
3t2m,E,68,74,6,FSPQTD,0
3t2m,E,75,99,24,GKIFTILYIFIGIGLVFGFIHKLA,0
3t2m,E,103,111,8,LPSILSNL,0
1r3j,L,1,21,20,APMLSGLLARLVKLLLGRHG,0
1r3j,L,22,25,3,ALH,0
1r3j,L,26,50,24,RAAGAATVLLVIVLLAGSYLAVLA,0
1r3j,L,63,79,16,RALWWSVETATTVGYG,0
1r3j,L,87,111,24,GRCVAVVVMVAGITSFGLVTAALA,0
1r3j,L,112,124,12,WFVGREQERRGH,0
3org,A,86,87,1,G,0
3org,A,93,121,28,RLVCFLTLLGVTAALFIFAVDLAVHGLE,0
3org,A,122,141,19,LRMKISRLAGRFAGYILYV,0
3org,A,142,160,18,SGVALCLLSTFWCAVLST,0
3org,A,188,203,15,VLFAKALGLICAIGG,0
3org,A,205,221,16,PVGWEGPNVHIACIIA,0
3org,A,228,235,7,VFKELCT,0
3org,A,244,258,14,AAACAVGLASSFGA,0
3org,A,260,271,11,GGVLYSIETIA,0
3org,A,277,295,18,AFWKGVLSALSGAIVYEL,0
3org,A,296,313,17,YTTPLVEAFEGTNFDAS,0
3org,A,314,320,6,VSRTQT,0
3org,A,321,348,27,LYAILGALMGVLGALFIRCVRSIYELR,0
3org,A,356,371,15,RYFLVGVVALFASAL,0
3org,A,372,375,3,YPF,0
3org,A,376,381,5,LFALD,0
3org,A,383,390,7,ATINDLF,0
3org,A,391,393,2,AV,0
3org,A,394,403,9,LYQTDHFGW,0
3org,A,404,410,6,ELILMP,0
3org,A,411,424,13,IKFILVALSIGLP,0
3org,A,426,441,15,AGVFVPSFLIGAGFG,0
3org,A,442,463,21,LYGELMRVVFGNAIVPGSYAV,0
3org,A,464,486,22,GAAAFTAGVTRALSCAVIIFEV,0
3org,A,487,492,5,GQIRH,0
3org,A,493,511,18,VPVLISVLLAVIVGNAFN,0
3org,A,601,655,54,EDVPEPIAGHRTLVLLDAADLSENIEGLVDETPSGEHSSKGKRTATVLEPTSSL,0
3org,A,711,717,6,LEVLFQ,0
5kuf,D,520,547,27,VFSFLNPLSPDIWMYVLLAYLGVSVVL,0
5kuf,D,548,552,4,VIAR,0
5kuf,D,599,602,3,LST,0
5kuf,D,603,625,22,IVGGIWWFFTLIIISSYTANLA,0
5kuf,D,788,805,17,IGGIFIVLAAGLVLSVF,0
5kuf,D,806,808,2,AV,0
3fyi,B,26,29,3,QQS,0
3fyi,B,30,60,30,EIIGRPQPGGTGFQPSASPVATQIHWLDGF,0
3fyi,B,61,79,18,LVIIAAITIFVTLLILYA,0
3fyi,B,100,116,16,EIAWTIVPIVILVAIG,0
3fyi,B,117,285,168,FSLPVLFNQQEIPEADVTVKVTGYQWYWGYEYPDEEISFESYMIGSPATGGDNRMSPEVEQQLIEAGYSRDEFLLATDTAMVVPVNKTVVVQVTGADVIHSWTVPAFGVKQDAVPGRLAQLWFRAEREGIFFGQCSELCGISHAYMPITVKVVSEEAYAAWLEQHHHH,0
3fyi,B,286,287,1,H,0
3odj,A,1,7,6,ENFLAQ,0
3odj,A,8,9,1,G,0
3odj,A,10,28,18,ITLILTALCVLIYIAQQL,0
3odj,A,31,38,7,DDIMYLM,0
3odj,A,52,58,6,YISHTL,0
3odj,A,62,78,16,NLHILFNLSWFFIFGG,0
3odj,A,79,86,7,IERTFGS,0
3odj,A,87,106,19,KLLMLYVVASAITGYVQNY,0
3odj,A,113,128,15,GLSGVVYAVLGYVFI,0
3odj,A,129,134,5,DKLNH,0
3odj,A,135,165,30,LFDLPEGFFTMLLVGIALGFISPLFGVEMG,0
3odj,A,167,182,15,AHISGLIVGLIWGFI,0
3odj,A,183,195,12,SKLRKNSLELVP,0
4h44,P,7,26,19,AALLSFGLIFVGWALGALL,0
4h44,P,27,32,5,KIQGA,0
4h44,P,33,34,1,E,0
4crt,A,1,2,1,S,0
4crt,A,3,108,105,KCDVVVVGGGISGMAAAKLLHDSGLNVVVLEARDRVGGRTYTLRNQKVKYVDLGGSYVGPTQNRILRLAKELGLETYKVNEVERLIHHVKGKSYPFRGPFPPVWN,0
4crt,A,109,127,18,ITYLDHNNFWRTMDDMGR,0
4crt,A,128,485,357,IPSDAPWKAPLAEEWDNMTMKELLDKLCWTESAKQLATLFVNLCVTAETHEVSALWFLWYVKQCGGTTRIISTTNGGQERKFVGGSGQVSERIMDLLGDRVKLERPVIYIDQTRENVLVETLNHEMYEAKYVISAIPPTLGMKIHFNPPLPMMRNQMITRVPLGSVIKCIVYYKEPFWRKKDYCGTMIIDGEEAPVAYTLDDTKPEGNYAAIMGFILAHKARKLARLTKEERLKKLCELYAKVLGSLEALEPVHYEEKNWCEEQYSGGCYTTYFPPGILTQYGRVLRQPVDRIYFAGTETATHWSGYMEGAVEAGERAAREILHAMGKIPEDEIWQSEPESVDVPAQPITTTFLERH,0
4crt,A,486,501,15,PSVPGLLRLIGLTTI,0
4crt,A,502,520,18,SATALGFLAHKRGLLVRV,0
2l0o,A,4,22,18,VAMVIWLYSAFRGVQLTY,0
2l0o,A,23,30,7,HTMLQKK,0
2l35,B,9,30,21,AGIVVGDLVLTVLIALAVYFL,0
2l35,B,31,32,1,R,0
4tq4,A,1,13,12,DSSLANINQIDV,0
4tq4,A,14,20,6,SKYLRL,0
4tq4,A,21,39,18,RPVAWLCFLLPYAVGFGF,0
4tq4,A,52,67,15,GLLSFAFWMAFSFTI,0
4tq4,A,68,101,33,ALYDRDVDRLHDGRVKDLNLSMQPLVTGEISVR,0
4tq4,A,102,119,17,AWLYCIAFLALSLATAA,0
4tq4,A,125,139,14,FLAMLGANIIGYVY,0
4tq4,A,140,153,13,APPRFKAWPVMDV,0
4tq4,A,154,169,15,CNALAAVLAFYAGLS,0
4tq4,A,176,191,15,IAIYPAAFFLAATFY,0
4tq4,A,192,226,34,PTAVSDYEFDKKAGLKNTPVFFGPERALKSLYPL,0
4tq4,A,227,241,14,AITVILWAYVFLMA,0
4tq4,A,246,260,14,KVISPLIIAYTLIY,0
4tq4,A,261,280,19,FIINSRWDGEKLNVSPNLI,0
4tq4,A,281,295,14,TPFGIISALFIAYG,0
4tq4,A,302,303,1,G,0
5lg3,E,11,201,190,VDVSVSIFINKIYGVNTLEQTYKVDGYIVAQWTGKPRKTPGDKPLIVENTQIERWINNGLWVPALEFINVVGSPDTGNKRLMLFPDGRVIYNARFLGSFSNDMDFRLFPFDRQQFVLELEPFSYNNQQLRFSDIQVYTENIDNEEIDEWWIRGKASTHISDIRYDHLSSVQPNQNEFSRITVRIDAVRNP,0
5lg3,E,202,225,23,YYLWSFILPLGLIIAASWSVFWL,0
5lg3,E,230,253,23,RLQTSFTLMLTVVAYAFYTSNIL,0
5lg3,E,254,259,5,RLPYT,0
5lg3,E,260,283,23,VIDQMIIAGYGSIFAAILLIIFA,0
5lg3,E,298,317,19,RCRLAFPLGFLAIGCVLVI,0
5l1b,D,526,543,17,MCIVFAYIGVSVVLFLV,0
5l1b,D,544,547,3,DTD,0
5l1b,D,548,553,5,TNEFG,0
5l1b,D,573,576,3,FNS,0
5l1b,D,577,590,13,WFSLGAFMQQGAD,0
5l1b,D,591,596,5,SPRSL,0
5l1b,D,597,614,17,GRIVGGVWWFFTLIIIS,0
5l1b,D,794,810,16,VFYILVGGLGLAMLVA,0
5l1b,D,811,817,6,IEFCYK,0
5l1b,D,818,831,13,RAEAKRMKGLVPR,0
5ws6,z,1,7,6,TILFQL,0
5ws6,z,8,24,16,LAALVILSFVMVIGVP,0
5ws6,z,40,55,15,FLGSGLWIALVLVVG,0
5ws6,z,56,62,6,LNFFVV,0
4od5,A,-18,1,19,GSSHHHHHHSSGLVPAGSM,0
4od5,A,5,22,17,IEHTIFSLPFAYVGALL,0
4od5,A,23,30,7,RYPFTLA,0
4od5,A,31,48,17,AILMAAAVVGLRMAGMA,0
4od5,A,82,99,17,VAAGSAIYFASAALLNT,0
4od5,A,101,115,14,LLLSPLVLAIALTY,0
4od5,A,125,144,19,HLHLGIVLGSVVFGGAVAA,0
4od5,A,145,159,14,GDEASSLGEVLRSV,0
4od5,A,160,176,16,WLYVAAVSLWVAGFDT,0
4od5,A,206,222,16,SLAMHAAAVALFIAGV,0
4od5,A,223,230,7,AYGLGAI,0
4od5,A,231,248,17,TVSTALTALVIILVQAM,0
4od5,A,258,274,16,NLNLAVPIIIGAGIIV,0
4od5,A,276,284,8,LHHMIRLL,0
3dww,C,-5,10,15,HHHHHMPAHSLVMSS,0
3dww,C,11,15,4,ALPA,0
3dww,C,16,40,24,LLCSTLLVIKMYVVAIITGQVRLR,0
3dww,C,68,90,22,LRAHRNDMETIYPFLFLGFVYS,0
3dww,C,91,97,6,LGPNPF,0
3dww,C,98,119,21,AWMHFLVFLVGRVAHTVAYLG,0
3dww,C,125,146,21,RSVTYTLAQLPCASMALQILW,0
3dww,C,147,152,5,AARHL,0
3o0r,C,1,4,3,SET,0
3o0r,C,10,29,19,RNIYFGGSVFFILLFLALT,0
3o0r,C,30,146,116,HTEKTLPERTNEAAMSAAVVRGKLVWEQNNCVGCHTLLGEGAYFAPELGNVVGRRGGEEGFNTFLQAWMKIQPLNVPGRRAMPQFHLSEGQVDDLAEFLKWSSKIDTNQWPPNKEG,0
4qnd,B,2,14,12,LIERIGKALEPL,0
4qnd,B,15,35,20,LVMGLISPLATMPQLYKLYV,0
4qnd,B,36,43,7,HSEHALG,0
4qnd,B,44,64,20,SLTTWLLYSFIALLWTIYGI,0
4qnd,B,70,91,21,IWVGNCLGFLMYVAMVVGIIA,0
4qnd,B,92,94,2,TG,0
4qnd,B,95,97,2,TY,0
3oe8,C,-15,26,41,YKDDDDAGAPEGISIYTSDNYTEEMGSGDYDSMKEPCFREE,0
3oe8,C,27,39,12,CFFNKI,0
3oe8,C,40,60,20,LPTIYSIIFLTGIVGNGLVI,0
3oe8,C,78,98,20,HLSVADLLFVITLPFWAVDA,0
3oe8,C,99,104,5,ANWYF,0
3oe8,C,105,129,24,NFLCKAVHVIYTVNLYSSVWILAF,0
3oe8,C,142,144,2,NS,0
3oe8,C,157,175,18,VGVWIPALLLTIPDFIFA,0
3oe8,C,176,180,4,VSEA,0
3oe8,C,181,182,1,D,0
3oe8,C,183,195,12,YICDRFYPNDLW,0
3oe8,C,196,217,21,VVFQFQHIMVGLILPGIVILS,0
3oe8,C,228,231,3,SGS,0
3oe8,C,243,264,21,LILAFFACWLPYYIGISIDSF,0
3oe8,C,265,282,17,LLEIIKQGCEFENTVHK,0
3oe8,C,283,301,18,ISITEALAFFHCCLNPIL,0
3oe8,C,306,328,22,AKFKTSAQHALTSGRPLEVLFQ,0
3f5w,F,21,29,8,SALQWRAA,0
3f5w,F,30,32,2,AA,0
3f5w,F,33,50,17,VLLVIVLLAGSYLAVLA,0
3f5w,F,63,79,16,RALWWSVETATTVGYG,0
3f5w,F,87,106,19,GRCVAVVVMVAGITSFGLV,0
3f5w,F,107,115,8,AALATWFV,0
3f5w,F,116,117,1,Q,0
3f5w,F,118,124,6,QQQQGQ,0
2nr9,A,1,3,2,EN,0
2nr9,A,11,24,13,TLILTALCVLIYI,0
2nr9,A,25,30,5,QQLGF,0
2nr9,A,31,38,7,DDIMYLM,0
2nr9,A,39,50,11,YPAYEEQDSEV,0
2nr9,A,51,60,9,RYISHTLVH,0
2nr9,A,61,63,2,SN,0
2nr9,A,64,78,14,HILFNLSWFFIFGG,0
2nr9,A,88,104,16,LLMLYVVASAITGYVQ,0
2nr9,A,105,114,9,YVSGPAFFG,0
2nr9,A,115,125,10,SGVVYAVLGY,0
2nr9,A,144,157,13,TMLLVGIALGFIS,0
2nr9,A,158,166,8,LFGVEMGN,0
2nr9,A,167,179,12,AHISGLIVGLIW,0
3aea,D,39,61,22,SLHWTGERVVSVLLLGLLPAAY,0
3aea,D,62,68,6,NPCSAM,0
3aea,D,69,89,20,YSLAAALTLHGHWGIGQVVT,0
3aea,D,98,118,20,KAAKAGLLALSAFTFAGLCY,0
3aea,D,119,125,6,NYHDVG,0
3aea,D,126,134,8,CKAVAMLW,0
3aea,D,135,136,1,L,0
5u1w,C,21,30,9,SSTNYGTIK,0
5u1w,C,33,47,14,HALVFSYISFALIS,0
5u1w,C,48,329,281,KRYQKKEPLISSVHTKVKGIAEVKAEILENGMKKMVSGVFDTADYTFPLQGNSFFVMTNFIKTEGQQQGLCPDFPTARTICSSDRGCKKGRMDPQSKGIQTGRCVVYKERLKTCEVSAWCPIEEVKDAPRPALLNSAENFTVLIKNNIDFPGHNYTTRNILPGVNITCTFHKTQNPQCPIFRLGDIFQETGDSFSDVAIQGGIMGIEIYWDCNLDGWFHHCRPKYSFRRLDDKTTSESLYPGYNFRYAKYYKENNVEKRTLIKVFGIRFDILVFGTGGKFN,0
5u1w,C,330,348,18,IQLAVYIGSVISYFGLAT,0
5u1w,C,352,362,10,ILINTYSASS,0
2ear,A,50,56,6,LVIEQF,0
2ear,A,58,74,16,LLVRILLLAACISFVL,0
2ear,A,75,88,13,WFEEGEETITAFV,0
2ear,A,89,109,20,PFVILLILIANAIVGVWQER,0
2ear,A,254,275,21,FGEQLSKVISLICVAVWLINI,0
2ear,A,276,295,19,HFNDPVHGGSWIRGAIYYF,0
2ear,A,296,318,22,IAVALAVAAIPEGLPAVITTCL,0
2ear,A,760,781,21,RYLISSNVGEVVCIFLTAALG,0
2ear,A,782,785,3,PEA,0
2ear,A,786,808,22,IPVQLLWVNLVTDGLPATALGF,0
2ear,A,833,854,21,FRYMAIGGYVGAATVGAAAWW,0
2ear,A,855,897,42,MYAEDGPGVTYHQLTHFMQCTEDHPHFEGLDCEIFEAPEPMT,0
2ear,A,898,916,18,ALSVLVTIEMCNALNSLS,0
2ear,A,927,950,23,VNIWLLGSICLSMSLHFLILYVD,0
2ear,A,951,967,16,LPMIFKLKALDLTQWL,0
2ear,A,968,987,19,VLKISLPVIGLDEILKFIA,0
1kpn,A,1,35,34,RKMSEEEFYLFKNISSVGPWDGPQYHIAPVWAFY,0
1kpn,A,36,61,25,QAAFMGTVFLIGFPLNAMVLVATLR,0
1kpn,A,69,93,24,NYILVNVSFGGFLLCIFSVFPVFV,0
1kpn,A,94,106,12,SCNGYFVFGRHV,0
1kpn,A,107,133,26,ALEGFLGTVAGLVTGWSLAFLAFERY,0
1kpn,A,149,173,24,ALTVVLATWTIGIGVSIPPFFGWS,0
1kpn,A,174,197,23,FIPEGLQCSCGPDWYTVGTKYRS,0
1kpn,A,198,222,24,SYTWFLFIFCFIVPLSLICFSYTQ,0
1kpn,A,249,274,25,MVVVMVGSFCVCYVPYAAFAMYMVN,0
1kpn,A,275,284,9,RNHGLDLRL,0
1kpn,A,285,307,22,TIPSFFSKSACIYNPIIYCFMN,0
1kpn,A,308,319,11,QFQACIMKMVC,0
2npg,C,15,32,17,CTALVLFMTIPGIALFY,0
2npg,C,33,45,12,GLIRGKNVLSML,0
2npg,C,46,64,18,QVTVTFALVCILWVVYGY,0
2npg,C,102,119,17,FQGSFACITVGLIVGAL,0
2npg,C,120,126,6,ERIRFS,0
2npg,C,127,147,20,VLIFVVVWLTLSYIPIAHMV,0
2npg,C,161,178,17,AGGTVVHINAAIAGLVG,0
2npg,C,179,181,2,YL,0
2npg,C,182,194,12,GKRVGFGKEAFK,0
2npg,C,195,200,5,HNLPM,0
2npg,C,201,219,18,FTGTAILYIGWFGFNAGS,0
2npg,C,231,249,18,VNTVVATAAAILGWIFGE,0
2npg,C,250,259,9,ALRGKPSLL,0
2npg,C,260,276,16,ACSGAIAGLVGVTPAC,0
2npg,C,282,299,17,GALIIGVVAGLAGLWGV,0
2npg,C,300,303,3,MLK,0
2npg,C,304,309,5,LLRVD,0
2npg,C,310,312,2,PC,0
2npg,C,313,332,19,VFGVFGVCGIVGCIMTGIF,0
2npg,C,353,377,24,VQLESIAITIVWSGVVAFIGYKLA,0
2npg,C,378,386,8,LTVGLRVP,0
2npg,C,387,424,37,EQEREGLDVNSHGENAYNADQAQQPAQADLEHHHHHH,0
2e74,Q,9,25,16,ALLVVFTWSIAMVVWG,0
2e74,Q,26,27,1,N,0
2e74,Q,28,29,1,L,0
3ae7,D,39,61,22,SLHWTGERVVSVLLLGLLPAAY,0
3ae7,D,62,68,6,NPCSAM,0
3ae7,D,69,92,23,YSLAAALTLHGHWGIGQVVTDYV,0
3ae7,D,97,117,20,QKAAKAGLLALSAFTFAGLC,0
3ae7,D,118,125,7,FNYHDVG,0
3ae7,D,126,134,8,CKAVAMLW,0
3ae7,D,135,136,1,L,0
5ebw,F,1,19,18,APMLSGLLARLVKLLLGR,0
5ebw,F,20,28,8,GSALHWRA,0
5ebw,F,29,50,21,GAATVLLVIVLLAGSYLAVLA,0
5ebw,F,63,76,13,RALWWACETATTV,0
5ebw,F,87,108,21,GRLVAVVVMVAGITSFGLVTA,0
5ebw,F,109,121,12,LATWFVGREQER,0
5ebw,F,122,123,1,G,0
2b2h,C,1,10,9,SDGNVAWIL,0
2b2h,C,11,28,17,STALVMLMVPGVGFFYA,0
2b2h,C,40,62,22,ALSFISLIITVLLWIFYGYSVS,0
2b2h,C,63,90,27,GNDISGIIGGLNYALLSGVKGEDLLFM,0
2b2h,C,91,108,17,YQMMFAAVTIAILTSAI,0
2b2h,C,115,136,21,SFILLSALWLTFVYAPFAHWL,0
2b2h,C,137,149,12,GGGWLAKLGALD,0
2b2h,C,150,170,20,AGGMVVHISSGFAALAVAMT,0
2b2h,C,189,208,19,TLIGAALLWFGWFGFNGGS,0
2b2h,C,209,219,10,LAANDVAINA,0
2b2h,C,220,238,18,VVTNTSAAVAGFVWMVIG,0
2b2h,C,247,264,17,GIVSGAIAGLAAITPAA,0
2b2h,C,265,269,4,FVDV,0
2b2h,C,270,290,20,GAIVIGLVAGIVCYLAMDFR,0
2b2h,C,300,319,19,AWAIHGIGGLWGSVAVGIL,0
2b2h,C,320,341,21,NPEVNGYAGLLFGNPQLLVSQ,0
2b2h,C,342,366,24,IAVASTTAYAFLVTLILAKAVDAA,0
2b2h,C,380,385,5,DLSQH,0
2b2h,C,392,399,7,EHHHHHH,0
3syq,D,50,54,4,AKRK,0
3syq,D,55,66,11,QRYVRKDGKCN,0
3syq,D,67,81,14,HHGNVRETYRYLTD,0
3syq,D,83,88,5,TTLVD,0
3syq,D,90,116,26,WRFNLLIFVMVYTVTWLFFGMIWWLI,0
3syq,D,118,133,15,IRGDMDHIEDPSWTP,0
3syq,D,145,156,11,LFSIETETTIG,0
3syq,D,168,192,24,GIILLLIQSVLGSIVNAFMVGCMF,0
3syq,D,193,378,185,KISQPKKAAETLVFSTHAVISMRDGKLCLMFRVGDLRNSHIVEASIRAKLIKSKQTSEGEFIPLNQTDINVGYYTGDDRLFLVSPLIISHEINQQSPFWEISKAQLPKEELEIVVILEGMVEATGMTCQARSSYITSEILWGYRFTPVLTLEDGFYEVDYNSFHETYETSTPSLSAKELAELANR,0
3syq,D,379,389,10,ESNSLEVLFQ,0
3fb5,F,21,24,3,SAL,0
3fb5,F,25,29,4,WRAA,0
3fb5,F,30,50,20,AATVLLVIVLLAGSYLAVLA,0
3fb5,F,63,79,16,RALWWSVETATTVGYG,0
3fb5,F,87,108,21,GRCVAVVVMVAGITSFGLVTA,0
3fb5,F,109,114,5,LATWF,0
3fb5,F,115,124,9,GQEQQQQGQ,0
5ec2,F,1,22,21,APMLSGLLARLVKLLLGRHGS,0
5ec2,F,23,29,6,LHWRAA,0
5ec2,F,30,50,20,AATVLLVIVLLAGSYLAVLA,0
5ec2,F,86,107,21,WGRLVAVVVMVAGITSFGLVT,0
5ec2,F,108,124,16,ALATWFVGREQERRGH,0
1aig,H,1,10,9,VGVTAFQNF,0
1aig,H,16,32,16,IYSFWIFLAGLIYYLQ,0
1aig,H,33,258,225,ENMREGYPLENEDGTPAANQGPFPLPKPKTFILPHGRGTLTVPGPESEDRPIALARTAVSEGFPHAPTGDPMKDGVGPASWVARRDLPELDGHGHNKIKPMKAAAGFHVSAGKNPIGLPVRGCDLEIAGKVVDIWVDIPEQMARFLEVELKDGSTRLLPMQMVKVQSNRVHVNALSSDLFAGIPTIKSPTEVTLLEEDKICGYVAGGLMYAAPKRKSVVAAMLAE,0
1aig,H,259,260,1,A,0
4uuj,F,11,17,6,AVALLL,0
4uuj,F,21,29,8,SALHWRAA,0
4uuj,F,30,50,20,AATVLLVIVLLAGSYLAVLA,0
4uuj,F,63,79,16,RALWWSVETATTVGYG,0
4uuj,F,86,107,21,WGRCVAVVVMVAGITSFGLVT,0
4uuj,F,108,124,16,ALATWFVGREQERRGH,0
3w9h,C,1,13,12,PNFFIDRPIFAW,0
3w9h,C,14,27,13,IAIIIMLAGGLAI,0
3w9h,C,342,357,15,TLVEAIILVFLVMYL,0
3w9h,C,358,365,7,LQNFRAT,0
3w9h,C,366,386,20,IPTIAVPVVLLGTFAVLAAF,0
3w9h,C,395,410,15,FGMVLAIGLLVDDAI,0
3w9h,C,411,442,31,VVENVERVMAEEGLPPKEATRKSMGQIQGAL,0
3w9h,C,443,457,14,GIAMVLSAVFVPMA,0
3w9h,C,471,485,14,ITIVSAMALSVLVA,0
3w9h,C,486,511,25,ILTPALCATMLKPIAKGDHGEGKKG,0
3w9h,C,512,536,24,FGWFNRMFEKSTHHYTDSVGGILR,0
3w9h,C,537,541,4,TGRY,0
3w9h,C,542,556,14,VLYLIIVVGMAYLF,0
3w9h,C,875,891,16,LYAISLIVVFLCLAAL,0
3w9h,C,892,898,6,ESWSIP,0
3w9h,C,899,919,20,SVMLVVPLGVIGALLAATFR,0
3w9h,C,928,943,15,VGLLTTIGLSAKNAI,0
3w9h,C,944,975,31,IVEFAKDLMDKEGKGLIEATLDAVRMRLRPI,0
3w9h,C,976,991,15,MTSLAFILGVMPLVI,0
3w9h,C,1004,1018,14,TGVMGGMVTATVLA,0
3w9h,C,1019,1032,13,FFVPVFFVVVRRR,0
3ncy,B,1,9,8,SSDADAHK,0
3ncy,B,10,14,4,GLIP,0
3ncy,B,15,28,13,TLMVSGNIMGSGV,0
3ncy,B,30,35,5,LPANL,0
3ncy,B,46,58,12,LVTIIGALALSM,0
3ncy,B,59,73,14,YAKMSSLDPSPGGS,0
3ncy,B,74,81,7,AYARRCF,0
3ncy,B,82,91,9,PFLGYQTNV,0
3ncy,B,92,106,14,YWLACWIGNIAMVV,0
3ncy,B,128,140,12,CVAVLWIFVLLN,0
3ncy,B,141,146,5,VGPKM,0
3ncy,B,147,164,17,TRVQAVATVLALVPIVG,0
3ncy,B,175,181,6,ETYMAA,0
3ncy,B,189,197,8,FGAIQSTL,0
3ncy,B,198,209,11,VTLWSFIGVES,0
3ncy,B,210,228,18,SVAAGVVKNPKRNVPIAT,0
3ncy,B,229,242,13,GGVLIAAVCYVLS,0
3ncy,B,282,297,15,AAGCLGSLGGWTLLA,0
3ncy,B,298,321,23,QTAKAAADDGLFPPIFARVNKAG,0
3ncy,B,322,325,3,PVA,0
3ncy,B,326,327,1,L,0
3ncy,B,328,340,12,IVGVLMTIFQFS,0
3ncy,B,353,366,13,SSVSVIFTLVPYL,0
3ncy,B,367,389,22,TCAALLLLGHGHFGKARPLYLL,0
3ncy,B,390,405,15,TFVAFVYCIWAVIGS,0
3ncy,B,408,423,15,EVMWSFVTLMVITAL,0
3ncy,B,424,440,16,ALNYNRIHKNPYPLDA,0
3ncy,B,441,445,4,VKQD,0
3uu5,E,-3,4,7,SAAAQDM,0
3uu5,E,5,198,193,SPPPPIADEPLTVNTGIYLIESYSLDDCAETFKVNAFLSLSWKDRRLAFDPVRSGVRVKTYEPEAIWIPEIRFVNVENARDADVVDISVSPDGTVQYLERFSARVLSPLDFRRYPFDSQTLHIYLIVRSVDTRNIVLAVDLEKVGKNDDVFLTGWDIESFTAVVKPANFALEDRLESKLDYQLRISRQYFSYI,0
3uu5,E,199,218,19,NIILPMLFILFISWTAFWS,0
3uu5,E,222,240,18,ANVTLVVSTLIAHIAFNI,0
3uu5,E,241,255,14,VECNLPKTPYMTYT,0
3uu5,E,256,275,19,AIIFMIYLFYFVAVIEVTV,0
3uu5,E,292,313,21,RASRIAFPVVFLLANIILAFL,0
3uu5,E,314,315,1,F,0
3uu5,E,316,317,1,F,0
5aw3,G,4,24,20,GPDNDERFTYDYYRLRVVGL,0
5aw3,G,25,40,15,VAAVLCVIGIIILLA,0
5avv,G,4,22,18,GPDNDERFTYDYYRLRVV,0
5avv,G,23,38,15,LIVAAVLCVIGIIIL,0
2c8k,A,49,56,7,WELVIEQ,0
2c8k,A,57,77,20,EDLLVRILLLAACISFVLAW,0
2c8k,A,78,86,8,EEGEETIT,0
2c8k,A,87,104,17,FVEPFVILLILIANAIV,0
2c8k,A,257,279,22,EQLSKVISLICVAVWLINIGHF,0
2c8k,A,280,292,12,DPVHGGSWIRGA,0
2c8k,A,293,314,21,YYFKIAVALAVAAIPEGLPAV,0
2c8k,A,761,784,23,RYLISSNVGEVVCIFLTAALGLP,0
2c8k,A,786,807,21,LIPVQLLWVNLVTDGLPATAL,0
2c8k,A,834,852,18,FRYMAIGGYVGAATVGAA,0
2c8k,A,853,897,44,WWFMYAEDGPGVTYHQLTHFMQCTEDHPHFEGLDCEIFEAPEPM,0
2c8k,A,898,916,18,MALSVLVTIEMCNALNSL,0
2c8k,A,926,950,24,PWVNIWLLGSICLSMSLHFLILYV,0
2c8k,A,951,967,16,PLPMIFKLKALDLTQW,0
2c8k,A,968,987,19,MVLKISLPVIGLDEILKFI,0
2z5y,A,495,519,24,PSVSGLLKIIGFSTSVTALGFVLY,0
2z5y,A,520,523,3,YKL,0
4n4d,A,7,11,4,VRLL,0
4n4d,A,12,31,19,EIAFMAALAFIISLIPNTV,0
4n4d,A,36,49,13,VEIACIPILLLSL,0
4n4d,A,50,53,3,RGL,0
4n4d,A,54,75,21,AGLVGGLIWGILSMITGHAYI,0
4n4d,A,79,96,17,QAFLEYLVAPVSLGIAG,0
4n4d,A,97,110,13,FRQKTAPLKLAPV,0
4n4d,A,111,130,19,LGTFVAVLLKYFFHFIAGI,0
4n4d,A,148,170,22,AVNGISGILTAIAAFVILIIFV,0
4n4d,A,171,182,11,KFPKLFIHSNY,0
2axt,z,5005,5025,20,QLALAALVILSFVMVIGVPV,0
2axt,z,5026,5038,12,YASPQDWDRSKQ,0
2axt,z,5039,5056,17,IFLGSGLWIALVLVVGV,0
5tcx,A,10,37,27,KYLLFVFNFVFWLAGGVILGVALWLRH,0
5tcx,A,55,61,6,NTFYVG,0
5tcx,A,62,85,23,YILIAVGAVMMFVGFLGCYGAIQ,0
5tcx,A,89,112,23,LLGTFFTCLVILFACEVAAGIWG,0
5tcx,A,113,115,2,VN,0
5tcx,A,116,136,20,DQIAKDVKQFYDQALQQAVV,0
5tcx,A,137,140,3,DDA,0
5tcx,A,141,154,13,NAKAVVKTFHETL,0
5tcx,A,155,203,48,CCGSSTLTALTTSVLKNNLCPSGSNIISNLFKEDCHQKIDDLFSGKLY,0
5tcx,A,204,227,23,IGIAAIVVAVIMIFEMILSMVLS,0
1xji,A,2,5,3,QIT,0
1xji,A,6,9,3,RPE,0
1xji,A,10,32,22,IWLALGTALMGLGTLYFLVKGM,0
1xji,A,42,66,24,YAITTLVPAIAFTMYLSMLLGYGL,0
1xji,A,67,78,11,MVPFGGEQNPI,0
1xji,A,79,99,20,WARYADWLFTTPLLLLDLAL,0
1xji,A,104,127,23,QGTILALVGADGIMIGTGLVGAL,0
1xji,A,128,134,6,KVYSYR,0
1xji,A,135,157,22,VWWAISTAAMLYILYVLFFGFT,0
1xji,A,172,195,23,VLRNVTVVLWSAYPVVWLIGSEG,0
1xji,A,196,201,5,GIVPL,0
1xji,A,202,225,23,IETLLFMVLDVSAKVGFGLILLR,0
1xji,A,231,248,17,EAEAPEPSAGDGAAATS,0
5cbf,E,6,18,12,MFKRFFGAVRTS,0
5cbf,E,19,27,8,RDPSTRGA,0
5cbf,E,28,45,17,LSLAIIVTAATIFYTLA,0
5cbf,E,51,67,16,DSLFYAVSVGLPMGNG,0
5cbf,E,75,96,21,SKIFTLVYAILVVGLFVTVGG,0
5cbf,E,97,103,6,LASAIV,0
5cbf,E,104,106,2,NN,0
5azb,A,24,44,20,WYGLMYLVGFIFAMWLATRR,0
5azb,A,45,57,12,NRPGSGWTKNEV,0
5azb,A,58,79,21,NLLYAGFLGVFLGGRIGYVLF,0
5azb,A,82,87,5,PQFMA,0
5azb,A,101,118,17,FHGGLIGVIVVMIIFAR,0
5azb,A,119,123,4,TKRS,0
5azb,A,124,145,21,FQVSDFIAPLIPFGLGAGRLG,0
5azb,A,202,219,17,LLLEGVVLFIILNLYIR,0
5azb,A,220,224,4,PRPM,0
5azb,A,225,241,16,AVSGLFLIGYGAFRII,0
5azb,A,255,262,7,WVQYISM,0
5azb,A,263,283,20,QILSIPMIVAGVIMMVWAYR,0
5azb,A,284,286,2,SP,0
4pe5,D,27,31,4,SQKS,0
4pe5,D,440,451,11,ISENKTDEEPG,0
4pe5,D,541,549,8,NGTVSPSA,0
4pe5,D,557,567,10,VWVMMFVMLL,0
4pe5,D,568,601,33,VSAVAVFVFEYFSPVGYNRSLADGREPGGPSFT,0
4pe5,D,602,604,2,GK,0
4pe5,D,605,614,9,IWLLWGLVF,0
4pe5,D,615,629,14,NSVPVQNPKGTTSK,0
4pe5,D,631,644,13,VSVWAFFAVIFLA,0
4pe5,D,803,806,3,EKN,0
4pe5,D,822,837,15,YMLGAAMALSLITFI,0
4pe5,D,839,852,13,HLFYWQFRHSFMG,0
2c66,A,1,2,1,S,0
2c66,A,3,108,105,KCDVVVVGGGISGMAAAKLLHDSGLNVVVLEARDRVGGRTYTLRNQKVKYVDLGGSYVGPTQNRILRLAKELGLETYKVNEVERLIHHVKGKSYPFRGPFPPVWN,0
2c66,A,109,126,17,ITYLDHNNFWRTMDDMG,0
2c66,A,127,485,358,EIPSDAPWKAPLAEEWDNMTMKELLDKLCWTESAKQLATLFVNLCVTAETHEVSALWFLWYVKQCGGTTRIISTTNGGQERKFVGGSGQVSERIMDLLGDRVKLERPVIYIDQTRENVLVETLNHEMYEAKYVISAIPPTLGMKIHFNPPLPMMRNQMITRVPLGSVIKCIVYYKEPFWRKKDYCGTMIIDGEEAPVAYTLDDTKPEGNYAAIMGFILAHKARKLARLTKEERLKKLCELYAKVLGSLEALEPVHYEEKNWCEEQYSGGCYTTYFPPGILTQYGRVLRQPVDRIYFAGTETATHWSGYMEGAVEAGERAAREILHAMGKIPEDEIWQSEPESVDVPAQPITTTFLERH,0
2c66,A,486,501,15,PSVPGLLRLIGLTTI,0
2c66,A,502,520,18,SATALGFLAHKRGLLVRV,0
4yl3,C,7,15,8,MSSPALPA,0
4yl3,C,16,32,16,LLCSTLLVIKMYVVAI,0
4yl3,C,72,90,18,RNDMETIYPFLFLGFVYS,0
4yl3,C,91,98,7,LGPNPFV,0
4yl3,C,99,115,16,WMHFLVFLVGRVAHTV,0
4yl3,C,127,146,19,VTYTLAQLPCASMALQILW,0
4yl3,C,147,152,5,AARHL,0
4uxz,C,33,48,15,EGVAVLLCVVIAAWL,0
4uxz,C,53,69,16,TRVLLISSVMLVMIVE,0
4uxz,C,70,99,29,LNSAIEAVVDRIGSEYHELSGRAKDLGSA,0
4uxz,C,100,117,17,VLIAIIDAVITWAILLW,0
4ymv,C,4,44,40,FLSMVKYTPLFISGLIMTLKLTFLAVTIGVLMGLFIALMK,0
4ymv,C,45,48,3,SSI,0
4ymv,C,49,78,29,PIKLVASSYIEVIRGTPLLVQLLLIYNGL,0
4ymv,C,86,107,21,AFTAGVSALAINSSAYVAEII,0
4ymv,C,108,146,38,AGIQAVDPGQNEAARSLGMTHAMAMRYVIIPQAIKNIL,0
4ymv,C,147,168,21,ALGNEFIVMLKESAIVSVIGF,0
4ymv,C,186,207,21,EPYIIIAAIYFVMTLTFSKLL,0
4ymv,C,208,214,6,LFERRL,0
2c72,A,1,2,1,S,0
2c72,A,3,108,105,KCDVVVVGGGISGMAAAKLLHDSGLNVVVLEARDRVGGRTYTLRNQKVKYVDLGGSYVGPTQNRILRLAKELGLETYKVNEVERLIHHVKGKSYPFRGPFPPVWN,0
2c72,A,109,126,17,ITYLDHNNFWRTMDDMG,0
2c72,A,127,485,358,EIPSDAPWKAPLAEEWDNMTMKELLDKLCWTESAKQLATLFVNLCVTAETHEVSALWFLWYVKQCGGTTRIISTTNGGQERKFVGGSGQVSERIMDLLGDRVKLERPVIYIDQTRENVLVETLNHEMYEAKYVISAIPPTLGMKIHFNPPLPMMRNQMITRVPLGSVIKCIVYYKEPFWRKKDYCGTMIIDGEEAPVAYTLDDTKPEGNYAAIMGFILAHKARKLARLTKEERLKKLCELYAKVLGSLEALEPVHYEEKNWCEEQYSGGCYTTYFPPGILTQYGRVLRQPVDRIYFAGTETATHWSGHMEGAVEAGERAAREILHAMGKIPEDEIWQSEPESVDVPAQPITTTFLERH,0
2c72,A,486,498,12,PSVPGLLRLIGL,0
2c72,A,502,520,18,SATALGFLAHKRGLLVRV,0
5ayn,A,7,13,6,RIETQL,0
5ayn,A,14,35,21,LGRLLTRSGDQAWDFVVPFAL,0
5ayn,A,47,65,18,FYYLIVKIGTFLLTPSSG,0
5ayn,A,66,76,10,WIDTHPRIQV,0
5ayn,A,77,98,21,KWGVWLQFFAILAGMVFFGML,0
5ayn,A,114,138,24,LFIALALSGVMASLGSQITDISVG,0
5ayn,A,139,155,16,DLAPSLVAPEKLTHFN,0
5ayn,A,156,177,21,WLRRIDLATEVGAPILAGALF,0
5ayn,A,187,206,19,GLFLIGLWNLVSFVPEYFL,0
5ayn,A,207,224,17,RNVIQRSGLKIKVLTEA,0
5ayn,A,233,244,11,NLRGSFSDPIF,0
5ayn,A,245,266,21,LILSYALLWLSVLSPHGVLLA,0
5ayn,A,281,301,20,LFRGLGAVFGLISTVSFPYL,0
5ayn,A,302,310,8,RRLGLISS,0
5ayn,A,311,331,20,RWHLGFQGVTLGIAVTAFAM,0
5ayn,A,337,359,22,YVFLGCILLSRVGLYGFSNGEF,0
5ayn,A,360,375,15,LRQRLIPEGRRGELN,0
5ayn,A,376,396,20,LSSLTTTSATLILFSAGSLL,0
5ayn,A,403,422,19,YLVYVSLAAVLLANVVFIK,0
5ayn,A,423,426,3,SSR,0
2xtu,A,93,110,17,GPVTWVMMIACVVVFIA,0
2xtu,A,111,115,4,QILG,0
2xtu,A,116,123,7,QEVMLWL,0
2xtu,A,124,136,12,WPFDPTLKFEFW,0
2xtu,A,137,143,6,YFTHAL,0
2xtu,A,144,147,3,HFS,0
2xtu,A,148,166,18,MHILFNLLWWWYLGGAVE,0
2xtu,A,172,189,17,KLIVITLISALLSGYVQ,0
2xtu,A,190,198,8,KFSGPWFG,0
2xtu,A,199,214,15,LTGVVYALMGYVWLR,0
2xtu,A,225,245,20,QRGLIIFALIWIVAGWFDLF,0
2xtu,A,246,248,2,MS,0
2xtu,A,249,268,19,ANGAHIAGLAVGLAMAFVD,0
2x72,C,43,63,20,MFLLIMLGFPINFLTLYVTV,0
2x72,C,64,73,9,HKKLRTPLN,0
2x72,C,74,92,18,ILLNLAVADLFMVFGGFT,0
2x72,C,114,133,19,FFATLGGEIALWSLVVLAI,0
2x72,C,134,153,19,RYVVVCKPMSNFRFGENHA,0
2x72,C,154,170,16,MGVAFTWVMALACAAP,0
2x72,C,203,222,19,VIYMFVVHFIIPLIVIFFC,0
2x72,C,223,254,31,GQLVFTVKEAAAQQQESATTQKAEKEVTRMV,0
2x72,C,255,274,19,IMVIAFLICWLPYAGVAFY,0
2x72,C,291,309,18,AFFAKTSAVYNPVIYIMM,0
2x72,C,310,326,16,KQFRNCMVTTLCCGKN,0
2x72,C,327,348,21,LGDDEASTTVSKTETSQVAPA,0
3ehb,B,-28,0,28,MAIATKRRGVAAVMSLGVATMTAVPALA,0
3ehb,B,1,33,32,DVLGDLPVIGKPVNGGMNFQPASSPLAHDQQW,0
3ehb,B,34,54,20,DHFVLYIITAVTIFVCLLLL,0
3ehb,B,82,98,16,LVPVLILVAIGAFSLP,0
3ehb,B,99,252,153,LFRSQEMPNDPDLVIKAIGHQWYWSYEYPNDGVAFDALMLEKEALADAGYSEDEYLLATDNPVVVPVGKKVLVQVTATDVIHAWTIPAFAVKQDAVPGRIAQLWFSVDQEGVYFGQCSELCGINHAYMPIVVKAVSQEKYEAWLAGAKEEFAA,0
3ehb,B,253,269,16,ASDYLPASPVKLASAE,0
4gpo,B,31,35,4,GAEL,0
4gpo,B,36,39,3,SQQ,0
4gpo,B,40,64,24,EAGMSLLMALVVLLIVAGNVLVIA,0
4gpo,B,79,103,24,ITSLACADLVVGLLVVPFGATLVV,0
4gpo,B,104,112,8,GTWLWGSF,0
4gpo,B,113,137,24,CELWTSLDVLCVTASIETLCVIAI,0
4gpo,B,159,182,23,VIICTVWAISALVSFLPIMMHWW,0
4gpo,B,183,186,3,DED,0
4gpo,B,187,194,7,QALKCYQ,0
4gpo,B,195,206,11,PGCCDFVTNRA,0
4gpo,B,207,229,22,AIASSIISFYIPLLIMIFVALR,0
4gpo,B,239,249,10,KIDRASKRKR,0
4gpo,B,292,315,23,GIIMGVFTLCWLPFFLVNIVNVF,0
4gpo,B,316,323,7,RDLVPDW,0
4gpo,B,324,344,20,FVAFNWLGYANSAMNPIIYC,0
4gpo,B,347,354,7,DFRKAFK,0
4gpo,B,357,373,16,AFPRKADRRLHHHHHH,0
4boi,E,-16,0,16,VLTLLLIICLALEVRS,0
4boi,E,165,171,6,VVEWIH,0
4boi,E,221,243,22,IINIIAPCVLISSLVVLVYFLP,0
4boi,E,244,250,6,QAGGQK,0
4boi,E,251,273,22,TLSISVLLAQTIFLFLIAQKVP,0
4boi,E,284,308,24,YLIFVMFVSLVIVTNCVIVLNVSL,0
4boi,E,309,314,5,TPNTH,0
4boi,E,315,413,98,LSEKIKHLFLEFLPKYLGMHLEPSEETPEKPQPRRRSSFGIMIKAEEYILKKPRSELMFEEQKDRHGLKRVNKMTSDIDIGTTVDLYKDLANFAPEIK,0
4boi,E,414,448,34,CVEACNFIAKSTKEQNDSGSENENWVLIGKVIDK,0
4boi,E,449,473,24,CFWIALLLFSLGTLAIFLTGHLNQ,0
4boi,E,477,488,11,PFPGDPRKYVP,0
3prc,H,16,32,16,WYAQWLVIWTVVLLYL,0
3prc,H,33,258,225,REDRREGYPLVEPLGLVKLAPEDGQVYELPYPKTFVLPHGGTVTVPRRRPETRELKLAQTDGFEGAPLQPTGNPLVDAVGPASYAERAEVVDATVDGKAKIVPLRVATDFSIAEGDVDPRGLPVVAADGVEAGTVTDLWVDRSEHYFRYLELSVAGSARTALIPLGFCDVKKDKIVVTSILSEQFANVPRLQSRDQITLREEDKVSAYYAGGLLYATPERAESLL,0
5h1q,H,8,22,14,NSVNALISRVFVQP,0
5h1q,H,23,27,4,GDLA,0
5h1q,H,28,46,18,RLNSRVTVVILAVSSALL,0
5h1q,H,110,128,18,VFALQAFLFYIPRFIWKA,0
5h1q,H,129,194,65,IAYSGYDLAAAVKYVDRFWSENRDKDDKFKTRLAAFEGRPSVYIWDGIRLARKKRSRNMALFYTL,0
5h1q,H,195,212,17,TVWQAVNAWIQFYILTQ,0
5h1q,H,276,296,20,FIFLWFWLVFVAVVSTVNCF,0
5h1q,H,297,369,72,WIYYLCNKTKAQKTIKNYLSTAPIKSTISDDQFFSALGEDGLFIMDQMALNLGDIPASYLTISMRNICQDFI,0
3eh4,C,2,7,5,EKPKG,0
3eh4,C,8,22,14,LAVILVLTLTILVF,0
2drd,C,2,7,5,NFFID,0
2drd,C,11,27,16,AWVIAIIIMLAGGLAI,0
2drd,C,28,340,312,KLPVAQYPTIAPPAVTISASYPGADAKTVQDTVTQVIEQNMNGIDNLMYMSSNSDSTGTVQITLTFESGTDADIAQVQVQNKLQLAMPLLPQEVQQQGVSVEKSSSSFLMVVGVINTDGTMTQEDISDYVAANMKDAISRTSGVGDVQLFGSQYAMRIWMNPNELNKFQLTPVDVITAIKAQNAQVAAGQLGGTPPVKGQQLNASIIAQTRLTSTEEFGKILLKVNQDGSRVLLRDVAKIELGGENYDIIAEFNGQPASGLGIKLATGANALDTAAAIRAELAKMEPFFPSGLKIVYPYDTTPFVKISIHEV,0
2drd,C,341,357,16,KTLVEAIILVFLVMYL,0
2drd,C,366,386,20,IPTIAVPVVLLGTFAVLAAF,0
2drd,C,387,394,7,FSINTLT,0
2drd,C,395,410,15,FGMVLAIGLLVDDAI,0
2drd,C,443,458,15,GIAMVLSAVFVPMAF,0
2drd,C,459,470,11,GGSTGAIYRQF,0
2drd,C,471,489,18,ITIVSAMALSVLVALILT,0
2drd,C,499,512,13,IAKGDHGEGKKGF,0
2drd,C,519,533,14,FEKSTHHYTDSVGG,0
2drd,C,543,557,14,LYLIIVVGMAYLFV,0
2drd,C,558,873,315,LPSSFLPDEDQGVFMTMVQLPAGATQERTQKVLNEVTHYYLTKEKNNVESVFAVNGFGFAGRGQNTGIAFVSLKDWADRPGEENKVEAITMRATRAFSQIKDAMVFAFNLPAIVELGTATGFDFELIDQAGLGHEKLTQARNQLLAEAAKHPDMLTSVRPNGLEDTPQFKIDIDQEKAQALGVSINDINTTLGAAWGGSYVNDFIDRGRVKKVYVMSEAKYRMLPDDIGDWYVRAADGQMVPFSAFSSSRWEYGSPRLERYNGLPSMEILGQAAPGKSTGEAMELMEQLASKLPTGVGYDWTGMSYQERLSGNQA,0
2drd,C,874,890,16,SLYAISLIVVFLCLAA,0
2drd,C,902,919,17,LVVPLGVIGALLAATFR,0
2drd,C,920,926,6,LTNDVY,0
2drd,C,927,943,16,QVGLLTTIGLSAKNAI,0
2drd,C,976,991,15,MTSLAFILGVMPLVI,0
2drd,C,992,1003,11,TGAGSGAQNAV,0
2drd,C,1004,1019,15,TGVMGGMVTATVLAI,0
2drd,C,1022,1033,11,PVFFVVVRRRF,0
2drd,C,1037,1053,16,EDIEHSHTVDHHHHHH,0
3b8c,A,1,11,10,SSLEDIKNET,0
3b8c,A,57,83,26,LLKFLGFMWNPLSWVMEMAAIMAIAL,0
3b8c,A,84,94,10,NGDGRPPDWQ,0
3b8c,A,95,113,18,FVGIICLLVINSTISFIE,0
3b8c,A,242,262,20,IGNFCICSIAIGMVIEIIVM,0
3b8c,A,263,274,11,PIQRRKYRDGI,0
3b8c,A,275,292,17,NLLVLLIGGIPIAMPTV,0
3b8c,A,645,665,20,TIYAVSITIRIVFGFMLIAL,0
3b8c,A,666,670,4,WEFD,0
3b8c,A,671,690,19,SAFMVLIIAILNDGTIMTI,0
3b8c,A,706,726,20,KEIFATGVVLGGYQAIMTVI,0
3b8c,A,727,753,26,FWAAHKTDFFSDTFGVRSIRDNNHEL,0
3b8c,A,754,771,17,GAVYLQVSIISQALIFV,0
3b8c,A,784,803,19,ALLMIAFLIAQLIATLIAV,0
3b8c,A,804,820,16,ANWEFAKIRGIGWGWA,0
3b8c,A,821,841,20,VIWLYSIVTYFPLDVFKFAI,0
3b8c,A,845,885,40,SGKAWLNLFENKTAFTMKKDYGKEEREAQWMRGSHHHHHH,0
5h2j,C,4,11,7,TGRPEWI,0
5h2j,C,12,28,16,LALGTALMGLGTLYFL,0
5h2j,C,47,61,14,LVPAIAFTMYLSML,0
5h2j,C,62,79,17,GYGLTMVPFGGEQNPIY,0
5h2j,C,80,94,14,ARYADWLFTTPLLL,0
5h2j,C,111,126,15,VGADGIMIGTGLVGA,0
5h2j,C,127,134,7,TKVYSYR,0
5h2j,C,135,150,15,VWWAISTAAMLYILY,0
5h2j,C,178,192,14,VVLWSAYPVVWLIG,0
5h2j,C,193,203,10,EGAGIVPLNI,0
5h2j,C,204,220,16,TLLFMVLDVSAKVGFG,0
1hzx,C,1,36,35,GTEGPNFYVPFSNKTGVVRSPFEAPQYYLAEPWQF,0
1hzx,C,37,64,27,MLAAYMFLLIMLGFPINFLTLYVTVQH,0
1hzx,C,73,99,26,ILLNLAVADLFMVFGGFTTTLYTSLH,0
1hzx,C,100,108,8,YFVFGPTG,0
1hzx,C,109,133,24,NLEGFFATLGGEIALWSLVVLAIE,0
1hzx,C,154,176,22,GVAFTWVMALACAAPPLVGWSR,0
1hzx,C,177,198,21,IPEGMQCSCGIDYYTPHEETN,0
1hzx,C,199,224,25,ESFVIYMFVVHFIIPLIVIFFCYGQ,0
1hzx,C,236,240,4,QESA,0
1hzx,C,254,278,24,IMVIAFLICWLPYAGVAFYIFTHQ,0
1hzx,C,279,286,7,SDFGPIF,0
1hzx,C,287,309,22,TIPAFFAKTSAVYNPVIYIMMN,0
1hzx,C,311,321,10,FRNCMVTTLC,0
1hzx,C,331,333,2,AS,0
3k07,C,-7,4,11,GHHHHHHMIEW,0
3k07,C,6,11,5,RRSVA,0
3k07,C,12,15,3,RFL,0
3k07,C,16,33,17,LMGALFLSIWGTWTIIN,0
3k07,C,339,356,17,GKLLEEFIVVAVVCALF,0
3k07,C,357,363,6,WHVRSA,0
3k07,C,364,384,20,VAIISLPLGLCIAFIVMHFQ,0
3k07,C,393,409,16,GGIAIAVGAMVDAAIV,0
3k07,C,410,449,39,IENAHKRLEEWQHQHPDATLDNKTRWQVITDASVEVGPA,0
3k07,C,450,466,16,FISLLIITLSFIPIFT,0
3k07,C,478,497,19,AFTKTYAMAGAALLAIVVI,0
3k07,C,498,504,6,ILMGYW,0
3k07,C,505,515,10,RGKIPPESSN,0
3k07,C,517,534,17,NRFLIRVYHPLLLKVLH,0
3k07,C,535,538,3,PKT,0
3k07,C,539,555,16,LLVAALSVLTVLWPLN,0
3k07,C,873,890,17,LMVPMTLMIIFVLLYLA,0
3k07,C,891,894,3,RRV,0
3k07,C,895,918,23,EALLIISSVPFALVGGIWLLWWM,0
3k07,C,927,943,16,TGFIALAGVAAEFGVV,0
3k07,C,944,984,40,LMYLRHAIEAVPSLNNPQTFSEQKLDEALYHGAVLRVRPK,0
3k07,C,985,1001,16,MTVAVIIAGLLPILWG,0
3k07,C,1010,1030,20,RIAAPMIGGMITAPLLSLFI,0
3k07,C,1031,1039,8,PAAYKLMW,0
3k07,C,1041,1047,6,RHRVRK,0
5tvn,A,54,76,22,HWAALLILMVIIPTIGGNTLVI,0
5tvn,A,77,92,15,AVSLEKKLQYATNYF,0
5tvn,A,93,117,24,MSLAVADLLVGLFVMPIALLTIMF,0
5tvn,A,122,151,29,LPLVLCPAWLFLDVLFSTASIWHLCAISV,0
5tvn,A,152,174,22,RYIAIKKPIQANQYNSRATAFI,0
5tvn,A,175,195,20,ITVVWLISIGIAIPVPIKGI,0
5tvn,A,214,239,25,GDFMLFGSLAAFFTPLAIMIVTYFL,0
5tvn,A,240,1049,809,IHALQKKAADLEDNWETLNDNLKVIEKADNAAQVKDALTKMRAAALDAQKATPPKLE,0
5tvn,A,1056,325,-731,EMKDFRHGFDILVGQIDDALKLANEGKVKEAQAAAEQLKTTRNAYIQKYLVQTISNEQRASKV,0
5tvn,A,326,350,24,GIVFFLFLLMWCPFFITNITLVLC,0
5tvn,A,359,381,22,MLLEIFVWIGYVSSGVNPLVYT,0
5tvn,A,382,384,2,FN,0
5tvn,A,385,394,9,TFRDAFGRY,0
5tvn,A,395,400,5,TCNYR,0
3l75,W,5,12,7,LRQAYSA,0
3l75,W,19,36,17,FALTVVLGAVLFERAFD,0
3l75,W,37,62,25,GADAIFEHLNEGKLWKHIKHKYEAS,0
3l75,W,63,64,1,E,0
3ei0,E,0,6,6,QDMVSP,0
3ei0,E,198,217,19,NIILPMLFILFISWTAFWS,0
3ei0,E,218,220,2,SY,0
3ei0,E,221,240,19,ANVTLVVSTLIAHIAFNIL,0
3ei0,E,255,274,19,AIIFMIYLFYFVAVIEVTV,0
3ei0,E,275,293,18,HYLKVESQPARAASITRA,0
3ei0,E,294,312,18,RIAFPVVFLLANIILAFL,0
2he6,_,1,68,67,DLELDEYYNKTLATENNTAATRNSDFPVWDDYKSSVDDLQYFLIGLYTFVSLLGFMGNLLILMALMK,0
2he6,_,69,98,29,RNQKTTVNFLIGNLAFSDILVVLFCSPFT,0
2he6,_,104,128,24,DQWMFGKVMCHIMPFLQCVSVLVS,0
2he6,_,129,143,14,LILISIAIVRYHMI,0
2he6,_,144,167,23,HPISNNLTANHGYFLIATVWTLG,0
2he6,_,186,207,21,FGSALLSSRYLCVESWPSDSY,0
2he6,_,208,244,36,IAFTISLLLVQYILPLVCLTVSHTSVCRSISCGLSN,0
2he6,_,245,266,21,ENRLEENEMINLTLHPSKKSG,0
2he6,_,301,321,20,RPSQENHSRILPENFGSVRS,0
2he6,_,322,351,29,LSSSSKFIPGVPTCFEIKPEENSDVHELR,0
2he6,_,352,375,23,KRSVTRIKKRSRSVFYRLTILIL,0
2he6,_,378,384,6,VSWMPL,0
3ir7,H,5,26,21,MFFFDIYPYIAGAVFLIGSWL,0
3ir7,H,27,50,23,YDYGQYTWRAASSQMLDRKGMNL,0
3ir7,H,51,73,22,SNLFHIGILGIFVGHFFGMLTP,0
3ir7,H,87,110,23,KMAMFAGGASGVLCLIGGVLLLK,0
3ir7,H,111,125,14,RLFSPRVRATTTGA,0
3ir7,H,126,145,19,ILILSLLVIQCALGLLTIP,0
3ir7,H,183,204,21,FRLHLVLGMTLFLLFPFSRLI,0
3ir7,H,205,225,20,IWSVPVEYLTRKYQLVRARH,0
5hku,D,137,147,10,PSSPSLLRAI,0
5hku,D,148,153,5,GIAWI,0
5hku,D,154,170,16,LLLLVIFYVFAVMGTK,0
5hku,D,184,200,16,ASMYTLFQVMTLESWS,0
5hku,D,214,233,19,WIYFVSFILVSSFTVLNLF,0
5hku,D,234,285,51,GIIIESMQSAHWEAEDAKRIEQEQRAHDERLEMLQLIRDLSSKVDRLERRS,0
5hku,D,286,288,2,KR,0
2abm,D,6,23,17,AECFGTFWLVFGGCGSA,0
2abm,D,24,37,13,LAAGFPELGIGFA,0
2abm,D,38,53,15,VALAFGLTVLTMAFA,0
2abm,D,61,70,9,FNPAVTIGL,0
2abm,D,82,99,17,GYVIAQVVGGIVAAALL,0
2abm,D,100,134,34,LIASGKTGFDAAASGFASNGYGEHSPGGYSMLSA,0
2abm,D,135,149,14,VVELVLSAGFLLVI,0
2abm,D,163,178,15,IAIGLALTLIHLISI,0
2abm,D,179,182,3,VTN,0
2abm,D,183,195,12,SVNPARSTAVAI,0
2abm,D,196,205,9,QGGWALEQL,0
2abm,D,206,223,17,FFWVVPIVGGIIGGLIY,0
2abm,D,228,231,3,KRD,0
5a45,C,10,31,21,IWLALGTALMGLGTLYFLVKG,0
5a45,C,32,43,11,GVSDPDAKKFY,0
5a45,C,44,62,18,ITTLVPAIAFTMYLSMLL,0
5a45,C,80,97,17,ARYADWLFTTPLLLLDL,0
5a45,C,98,108,10,LLVDADQGTI,0
5a45,C,109,127,18,ALVGADGIMIGTGLVGAL,0
5a45,C,134,153,19,FVWWAISTAAMLYILYVLF,0
5a45,C,154,155,1,G,0
5a45,C,165,173,8,EVASTFKV,0
5a45,C,174,192,18,RNVTVVLWSAYPVVWLIG,0
5a45,C,203,223,20,ETLLFMVLDVSAKVGFGLIL,0
5a45,C,224,231,7,RSRAIFG,0
3bcc,U,1,3,2,AP,0
3bcc,U,5,13,8,TARLYSLL,0
3bcc,U,14,19,5,RRTST,0
3bcc,U,20,43,23,ALTIVVGALLFERAFDQGADAIY,0
4uc1,B,5,26,21,ALFLTFLAACGAPATTGALLK,0
4uc1,B,27,37,10,DEWYDNLNKP,0
4uc1,B,38,65,27,WNPPRWVFPLAWTSLYFLMSLAAMRVA,0
4uc1,B,72,91,19,ALAFYAAQLAFNTLWTPVF,0
4uc1,B,92,97,5,GMKRM,0
4uc1,B,98,119,21,TALAVVMVMWLFVAATMWAFF,0
4uc1,B,125,145,20,GVLFVPYLIWATATTGLNFE,0
4uc1,B,146,157,11,MRLNWNRPEAR,0
2hh1,H,1,7,6,VGVTAF,0
2hh1,H,8,12,4,NFDL,0
2hh1,H,13,32,19,SLAIYSFWIFLAGLIYYLQ,0
2hh1,H,252,260,8,AAMLAEYA,0
5fgn,A,8,11,3,KLG,0
5fgn,A,12,29,17,SALIAFLSLYSSLVLNY,0
5fgn,A,52,72,20,MPVVLFFLSNFVFHVIALPF,0
5fgn,A,74,90,16,KVLIPLILVISAAVSY,0
5fgn,A,101,109,8,SMLNNVLQ,0
5fgn,A,122,141,19,YVLWIVCLGVLPALAYIAV,0
5fgn,A,142,153,11,VKYRVWYKEFL,0
5fgn,A,154,172,18,RLVLAAVSFLCALGIAML,0
5fgn,A,174,183,9,QDYASFFRN,0
5fgn,A,198,212,14,AGVSKYKDWKRSNI,0
1s7b,D,1,3,2,NP,0
1s7b,D,6,24,18,LGGAILAEVIGTTLMKFS,0
1s7b,D,25,33,8,GFTRLWPS,0
1s7b,D,34,50,16,GTIICYCASFWLLAQT,0
3b5d,B,1,3,2,NP,0
3b5d,B,4,6,2,IY,0
3b5d,B,7,22,15,GGAILAEVIGTTLMK,0
3b5d,B,34,48,14,GTIICYCASFWLLA,0
3b5d,B,49,58,9,TLAYIPTGI,0
3b5d,B,59,75,16,YAIWSGVGIVLISLLS,0
3b5d,B,85,101,16,PAIIGMMLICAGVLII,0
3b5d,B,103,110,7,LSRSTPH,0
2hit,H,1,8,7,VGVTAFG,0
2hit,H,9,12,3,FDL,0
2hit,H,13,31,18,SLAIYSFWIFLAGLIYYL,0
2hit,H,252,260,8,AAMLAEYA,0
5va3,D,1,2,1,P,0
5va3,D,3,131,128,RRGHVAPQNTFLDTIIRKFEGQSRKFIIANARVENCAVIYCNDGFCELCGYSRAEVMQRPCTCDFLHGPRTQRRAAAQIAQALLGAEERKVEIAFYRKDGSCFLCLVDVVPVKNEDGAVIMFILNFEV,0
5va3,D,132,157,25,MEKDMVGSGADVLPEYKLQAPRIHR,0
5va3,D,398,409,11,TILHYSPFKAV,0
5va3,D,410,430,20,DWLILLLVIYTAVFTPYSAA,0
5va3,D,434,450,16,ETEEGPPATECGYACQ,0
5va3,D,452,470,18,AVVDLIVDIMFIVDILIN,0
5va3,D,471,497,26,RTTYVNANEEVVSHPGRIAVHYFKGW,0
5va3,D,498,510,12,LIDMVAAIPFDL,0
5va3,D,511,519,8,IFGSGSEE,0
5va3,D,522,539,17,LLKTARLLRLVRVARKL,0
5va3,D,540,547,7,RYSEYGA,0
5va3,D,548,568,20,VLFLLMCTFALIAHWLACIW,0
5va3,D,578,582,4,MDSR,0
5va3,D,598,602,4,SSGL,0
5va3,D,615,627,12,YFTFSSLTSVGF,0
5va3,D,639,663,24,FSICVMLIGSLMYASIFGNVSAII,0
5va3,D,664,863,199,RLYSGTARYHTQMLRVREFIRFHQIPNPLRQRLEEYFQHAWSYTNGIDMNAVLKGFPECLQADICLHLNRSLLQHCKPFRGATKGCLRALAMKFKTTHAPPGDTLVHAGDLLTALYFISRGSIEILRGDVVVAILGKNDIFGEPLNLYARPGKSNGDVRALTYCDLHKIHRDDLLEVLDMYPEFSDHFWSSLEITFNLR,0
5va3,D,864,1035,171,TNMIPGGRQYQELPRCPAPTPSLLNIPLSSPGRRPRGDVESRLDALQRQLNRLETRLSADMATVLQLLQRQMTLVPPAYSAVTTPGPGPTSTSPLLPVSPLPTLTLDSLSQVSQFMACEELPPGAPELPQEGPTRRLSLPGQLGALTSQPLHRHGSDPGSEASNSLEVLFQ,0
3b5w,B,1,9,8,HNDKDLST,0
3b5w,B,27,45,18,IVAGVALILNAASDTFML,0
3b5w,B,46,69,23,LLKPLLDDGFGKTDRSVLVWMPL,0
3b5w,B,70,85,15,VIGLMILRGITSYVS,0
3b5w,B,145,161,16,VVREGASIIGLFIMMF,0
3b5w,B,162,169,7,YSWQLSI,0
3b5w,B,170,186,16,LIVLAPIVSIAIRVVS,0
3b5w,B,249,263,14,ISDPIIQLIASLAL,0
3b5w,B,264,287,23,FVLYAASFPSVMDSLTAGTITVV,0
3b5w,B,288,301,13,SSMIALMRPLKSL,0
1orq,F,21,52,31,MEHPLVELGVSYAALLSVIVVVVECTMQLSG,0
1orq,F,53,56,3,YLV,0
1orq,F,57,80,23,LYLVDLILVIILWADYAYRAYKS,0
1orq,F,81,95,14,DPAGYVKKTLYEIP,0
1orq,F,96,111,15,LVPAGLLALIEGHLA,0
1orq,F,112,150,38,LGLFRLVRLLRFLRILLIISRGSKFLSAIADAADKIRF,0
1orq,F,151,171,20,HLFGAVMLTVLYGAFAIYIV,0
1orq,F,184,200,16,DALWWAVVTATTVGYG,0
1orq,F,209,236,27,KVIGIAVMLTGISALTLLIGTVSNMFQ,0
1orq,F,237,240,3,ILV,0
5jr0,A,7,29,22,FCSYIIISFLIVVNMYIAIILE,0
5jr0,A,30,34,4,FKKK,0
1opn,A,1,30,29,DYQVSSPIYDINYYTSEPCQKINVKQIAA,0
1opn,A,31,54,23,LLPPLYSLVFIFGFVGNMLVILI,0
1opn,A,70,91,21,NLAISDLFFLLTVPFWAHYAA,0
1opn,A,92,98,6,QWDFGN,0
1opn,A,99,124,25,MCQLLTGLYFIGFFSGIFFIILLTI,0
1opn,A,151,169,18,TWVVAVFASLPGIIFTRS,0
1opn,A,170,192,22,KEGLHYTCSSHFPYSQYQFWKN,0
1opn,A,193,218,25,QTLKIVILGLVLPLLVMVICYSGIL,0
1opn,A,240,262,22,MIVYFLFWAPYNIVLLLNTFQE,0
1opn,A,263,275,12,FGLNNCSSSNRL,0
1opn,A,276,300,24,QAMQVTETLGMTHCCINPIIYAFV,0
1xp5,A,49,74,25,WELVIEQFEDLLVRILLLAACISFV,0
1xp5,A,75,88,13,AWFEEGEETITAF,0
1xp5,A,89,108,19,EPFVILLILIANAIVGVWQ,0
1xp5,A,254,275,21,EFGEQLSKVISLICVAVWLIN,0
1xp5,A,276,295,19,GHFNDPVHGGSWIRGAIYY,0
1xp5,A,296,318,22,KIAVALAVAAIPEGLPAVITTC,0
1xp5,A,336,341,5,PSVET,0
1xp5,A,760,781,21,IRYLISSNVGEVVCIFLTAAL,0
1xp5,A,782,785,3,LPE,0
1xp5,A,786,808,22,LIPVQLLWVNLVTDGLPATALG,0
1xp5,A,833,851,18,FFRYMAIGGYVGAATVGA,0
1xp5,A,852,897,45,AWWFMYAEDGPGVTYHQLTHFMQCTEDHPHFEGLDCEIFEAPEPM,0
1xp5,A,898,917,19,MALSVLVTIEMCNALNSLS,0
1xp5,A,926,950,24,PWVNIWLLGSICLSMSLHFLILYV,0
1xp5,A,951,957,6,PLPMIF,0
1xp5,A,958,965,7,LKALDLT,0
1xp5,A,966,987,21,WLMVLKISLPVIGLDEILKFI,0
4bbj,A,1,72,71,KHDHHQGHTHSGKGHACHHEHNSPKTQQASSKMEGPIVYTCPMHPEIRQSAPGHCPLCGMALEPETVTVSE,0
4bbj,A,73,83,10,VSPEYLDMRR,0
4bbj,A,84,102,18,FWIALMLTIPVVILEMGG,0
4bbj,A,112,135,23,GSSWIQLLLATPVVLWGGWPFFK,0
4bbj,A,136,143,7,GWQSLKT,0
4bbj,A,144,146,2,QL,0
4bbj,A,147,170,23,MFTLIAMGIGVAWIYSMVAVLWP,0
4bbj,A,185,201,16,VYFEAAAVITTLVLLG,0
4bbj,A,202,338,136,VLELKAREQTGSAIRALLKLVPESAHRIKEDGSEEEVSLDNVAVGDLLRVRPGEKIPVDGEVQEGRSFVDESMVTGEPIPVAKEASAKVIGATINQTGSFVMKALHVGSDTMLARIVQMVSDAQRSRAPIQRLADT,0
4bbj,A,339,359,20,SGWFVPAVILVAVLSFIVWA,0
4bbj,A,368,389,21,YGLIAAVSVLIIACPCALGLA,0
4bbj,A,390,679,289,PMSIMVGVGKGAQSGVLIKNAEALERMEKVNTLVVDKTGTLTEGHPKLTRIVTDDFVEDNALALAAALEHQSEHPLANAIVHAAKEKGLSLGSVEAFEAPTGKGVVGQVDGHHVAIGNARLMQEHGGDNAPLFEKADELRGKGASVMFMAVDGKTVALLVVEDPIKSSTPETILELQQSGIEIVMLTGDSKRTAEAVAGTLGIKKVVAEIMPEDKSRIVSELKDKGLIVAMAGDGVNDAPALAKADIGIAMGTGTDVAIESAGVTLLHGDLRGIAKARRLSESTMSNIR,0
4bbj,A,680,700,20,NLFFAFIYNVLGVPLAAGVL,0
4bbj,A,707,729,22,LSPMIAAAAMALSSVSVIINAL,0
4bbj,A,730,736,6,LKRVTL,0
4lmj,D,-1,6,7,SQDMVSP,0
4lmj,D,198,214,16,NIILPMLFILFISWTA,0
4lmj,D,215,224,9,WSTSYEANV,0
4lmj,D,225,241,16,LVVSTLIAHIAFNILV,0
4lmj,D,255,271,16,AIIFMIYLFYFVAVIE,0
4lmj,D,272,294,22,TVQHYLKVESQPARAASITRAS,0
4lmj,D,295,312,17,IAFPVVFLLANIILAFL,0
2o9f,A,5,27,22,AAESFGTFWLVFGGSGSAVLAA,0
2o9f,A,28,34,6,FPELGI,0
2o9f,A,35,55,20,FAGVALAFGLTVLTMAFAVG,0
2o9f,A,59,73,14,GHFNPAVTIGLWAG,0
2o9f,A,81,103,22,VGYVIAQVVGGIVAAALLYLIA,0
2o9f,A,104,131,27,GKTGFDAAASGFASNGYGEHSPGGYSM,0
2o9f,A,132,152,20,SALVVELVLSAGFLLVIHGA,0
2o9f,A,162,181,19,PIAIGLACTLIHLISIPVT,0
2o9f,A,183,196,13,SVNPARSTAVAIF,0
2o9f,A,197,201,4,GGWA,0
2o9f,A,202,223,21,EQLWFFWVVPIVGGIIGGLIY,0
5jrf,A,3,30,27,ELGNANFENFIGATEGFSEIAYQFTSH,0
5jrf,A,31,53,22,LTLGYAVMLAGLLYFILTIKNV,0
5jrf,A,58,79,21,MSNILSAVVMVSAFLLLYAQA,0
5jrf,A,80,105,25,NWTSSFTFNEEVGRYFLDPSGDLFN,0
5jrf,A,106,127,21,GYRYLNWLIDVPMLLFQILFV,0
5jrf,A,137,160,23,VRNQFWFSGAMMIITGYIGQFYE,0
5jrf,A,161,164,3,SNL,0
5jrf,A,165,189,24,AFLVWGAISSAFFFHILWVMKKVI,0
5jrf,A,203,228,25,LSNIWILFLISWTLYPGAYLMPYLT,0
5jrf,A,229,241,12,VDGFLYSEDGVM,0
5jrf,A,242,266,24,RQLVYTIADVSSKVIYGVLLGNLA,0
4kkl,B,16,17,1,R,0
4kkl,B,37,60,23,MAAVVGTLVGLAAVAFDKGVAWL,0
4kkl,B,61,83,22,NQRMGALVHTADNYPLLLTVAF,0
4kkl,B,84,97,13,CSAVLAMFGYFLV,0
4kkl,B,128,142,14,PVKFFGGLGTLGGG,0
4kkl,B,144,159,15,LGRAGPTVQIGGNIG,0
4kkl,B,180,203,23,GAAAGLAAAFNAPLAGILFIIEE,0
4kkl,B,216,232,16,AVFIGVIMSTIMYRIF,0
4kkl,B,233,252,19,HEVALIDVGKLSDAPLNTL,0
4kkl,B,253,277,24,LYLILGIIFGIFGPIFNKWVLGMQ,0
4kkl,B,290,305,15,WVLMGGAIGGLCGLL,0
4kkl,B,306,337,31,FVAPATSGGGFNLIPIATAGNFSMGMLVFIF,0
4kkl,B,338,351,13,ARVITTLLCFSSG,0
4kkl,B,353,368,15,GGIFAPMLALGTVLG,0
4kkl,B,369,392,23,AFGMVAVELFPQYHLEAGTFAIA,0
4kkl,B,393,415,22,MGALLAASIRAPLTGIILVLEM,0
4kkl,B,416,422,6,DNYQLI,0
4kkl,B,423,439,16,PMIITGLGATLLAQFT,0
4kkl,B,459,461,2,QK,0
4u4w,B,12,39,27,AVITDWRPEDPAFWQQRGQRIASRNLW,0
4u4w,B,40,58,18,SVPCLLLAFCVWMLFSAV,0
4u4w,B,76,96,20,LTALPSVSGALLRVPYSFMV,0
4u4w,B,97,102,5,IFGGR,0
4u4w,B,103,119,16,WTAFSTGILIIPCVWL,0
4u4w,B,135,151,16,ISLLCGFAGANFASSM,0
4u4w,B,152,169,17,NISFFFPKQKQGGALGL,0
4u4w,B,170,188,18,GGLGNMGVSVMQLVAPLV,0
4u4w,B,215,233,18,SWIWVPFLAIFTIAAWFG,0
4u4w,B,234,238,4,NDLA,0
4u4w,B,253,257,4,GHLW,0
4u4w,B,258,278,20,MSLLYLATFGSFIGFSAGFA,0
4u4w,B,291,308,17,QYAFFGPFIGALARSAG,0
4u4w,B,309,320,11,ALSDRLGGTRV,0
4u4w,B,321,338,17,LVNFILMAIFSGLLFLT,0
4u4w,B,350,370,20,FFAVFLALFLTAGLGSGSTF,0
4u4w,B,371,407,36,MISVIFRKLTMDRVKAEGGSDERAMREAATDTAAAL,0
4u4w,B,408,425,17,FISAIGAIGGFFIPKAF,0
4u4w,B,437,455,18,AMKVFLIFYIACVVITWA,0
4u4w,B,456,458,2,YG,0
2acz,L,1,2,1,V,0
2acz,L,16,39,23,ILVRATAIVLTLYIIYMVGFFAT,0
2acz,L,40,54,14,GELTYEVWIGFFAS,0
2acz,L,55,80,25,FTKVFTLLALFSILIHAWIGMWQVL,0
2acz,L,89,113,24,RLMLQLVIVVALVVYVIYGFVVVW,0
2acz,L,114,115,1,V,0
4ntj,A,-8,15,23,YKDDDDGAPQAVDNLTSAPGNTS,0
4ntj,A,28,53,25,PLLYTVLFFVGLITNGLAMRIFFQI,0
4ntj,A,54,58,4,SKSN,0
4ntj,A,59,81,22,IIFLKNTVISDLLMILTFPFKI,0
4ntj,A,88,91,3,TGP,0
4ntj,A,97,122,25,QVTSVIFYFTMYISISFLGLITIDR,0
4ntj,A,123,132,9,QKTTRPFKT,0
4ntj,A,133,135,2,NP,0
4ntj,A,136,139,3,NLL,0
4ntj,A,140,162,22,AKILSVVIWAFMFLLSLPNMIL,0
4ntj,A,163,178,15,NRQPRDKNVKKCSFL,0
4ntj,A,186,210,24,HEIVNYICQVIFWINFLIVIVCYT,0
4ntj,A,211,1049,838,ITKELYRSYVRTADLEDNWETLNDNLKVIEKADNAAQVKDALTKMRAAALDAQKATPPKLE,0
4ntj,A,1050,1059,9,KSPDSPEMK,0
4ntj,A,1060,229,-831,FRHGFDILVGQIDDALKLANEGKVKEAQAAAEQLKTTRNAYIQKYLRGVGKV,0
4ntj,A,231,236,5,KKVNV,0
4ntj,A,237,262,25,VFIIIAVFFICFVPFHFARIPYTLS,0
4ntj,A,279,302,23,KESTLWLTSLNACLNPFIYFFLC,0
4ntj,A,303,311,8,SFRNSLIS,0
4ntj,A,313,351,38,KCPNSATSLSQDNRKKEQDGGDPNEETPMGRPLEVLFQ,0
4lou,B,37,61,24,MAAVVGTLVGLAAVAFDKGVAWLQ,0
4lou,B,62,83,21,QRMGALVHTADNYPLLLTVAF,0
4lou,B,84,97,13,CSAVLAMFGYFLV,0
4lou,B,129,142,13,VKFFGGLGTLGGG,0
4lou,B,144,156,12,LGRQGPTVQIGG,0
4lou,B,181,203,22,AAAGLAAAFNAPLAGILFIIEE,0
4lou,B,216,232,16,AVFIGVIMSTIMYRIF,0
4lou,B,233,252,19,HEVALIDVGKLSDAPLNTL,0
4lou,B,253,277,24,LYLILGIIFGIFGPIFNKWVLGMQ,0
4lou,B,290,305,15,WVLMGGAIGGLCGLL,0
4lou,B,306,337,31,FVAPATSGGGFNLIPIATAGNFSMGMLVFIF,0
4lou,B,338,351,13,ARVITTLLCFSSG,0
4lou,B,353,368,15,GGIFAPMLALGTVLG,0
4lou,B,369,392,23,AFGMVAVELFPQYHLEAGTFAIA,0
4lou,B,393,415,22,MGALLAASIRAPLTGIILVLEM,0
4lou,B,416,422,6,DNYQLI,0
4lou,B,423,439,16,PMIITGLGATLLAQFT,0
4lou,B,459,461,2,QK,0
4ytp,D,35,41,6,SKAASL,0
4ytp,D,42,61,19,WTGERVVSVLLLGLLPAAY,0
4ytp,D,68,92,24,DYSLAAALTLHGHWGIGQVVTDYV,0
4ytp,D,93,96,3,GDA,0
4ytp,D,97,117,20,QKVAKAGLLALSAFTFAGLC,0
4ytp,D,126,135,9,CKAVAMLWK,0
2fkw,S,19,37,18,RVFLGLALVAHFLAFSAT,0
2fkw,S,38,41,3,WLH,0
3ejy,B,1,18,17,KTDTPSLETPQAARLRR,0
3ejy,B,37,61,24,MAAVVGTLVGLAAVAFDKGVAWLQ,0
3ejy,B,62,83,21,QRMGALVHTADNYPLLLTVAF,0
3ejy,B,84,97,13,CSAVLAMFGYFLV,0
3ejy,B,129,142,13,VKFFGGLGTLGGG,0
3ejy,B,144,156,12,LGREGPTVQIGG,0
3ejy,B,181,203,22,AAAGLAAAFNAPLAGILFIIEH,0
3ejy,B,216,232,16,AVFIGVIMSTIMYRIF,0
3ejy,B,233,252,19,HEVALIDVGKLSDAPLNTL,0
3ejy,B,253,273,20,LYLILGIIFGIFGPIFNKWV,0
3ejy,B,274,284,10,GMQDLLHRVH,0
3ejy,B,290,305,15,WVLMGGAIGGLCGLL,0
3ejy,B,306,337,31,FVAPATSGGGFNLIPIATAGNFSMGMLVFIF,0
3ejy,B,338,351,13,ARVITTLLCFSSG,0
3ejy,B,353,368,15,GGIFAPMLALGTVLG,0
3ejy,B,369,391,22,AFGMVAVELFPQYHLEAGTFAI,0
3ejy,B,392,415,23,GMGALLAASIRAPLTGIILVLEM,0
3ejy,B,416,422,6,DNYQLI,0
3ejy,B,423,439,16,PMIITGLGATLLAQFT,0
3ejy,B,459,473,14,QLARSKAASASENT,0
4lbe,F,-5,21,26,HHHHHHPPMLSGLLARLVKLLLGRHG,0
4lbe,F,22,24,2,AL,0
4lbe,F,25,50,25,WRAAGAATVLLVIVLLAGSYLAVLA,0
4lbe,F,63,79,16,RALWWSVETATTVGYG,0
4lbe,F,87,114,27,GRLVAVVVMVAGITSFGLVTAALATWF,0
4lbe,F,115,124,9,GREQERAGH,0
3wta,A,20,43,23,DAQWVVFAVMALAAIVFSIAVQF,0
3wta,A,44,49,5,PLPLR,0
3wta,A,50,72,22,TYYVNIAICTIAATAYYAMAVN,0
3wta,A,90,110,20,YARYIDWVFTTPLLLLDLVL,0
3wta,A,111,116,5,TNMPA,0
3wta,A,117,139,22,MIAWIMGADIAMIAFGIIGAFT,0
3wta,A,144,164,20,WFYFVVGCIMLAVLAWGMIN,0
3wta,A,165,180,15,IFKEELQKHKEYTGA,0
3wta,A,181,205,24,TTLLIYLIVLWVIYPIVWGLGAGG,0
3wta,A,212,235,23,EIIAMGILDLLAKPLYAIGVLIT,0
3wta,A,236,244,8,EVVYGKLG,0
2zz9,D,23,29,6,VAFKGV,0
2zz9,D,30,37,7,TQAFWKA,0
2zz9,D,38,55,17,TAEFLAMLIFVLLSVGS,0
2zz9,D,72,89,17,ISLCFGLSIATMVQCFG,0
2zz9,D,90,93,3,ISG,0
2zz9,D,94,106,12,HINPAVTVAMVC,0
2zz9,D,107,115,8,RKISIAKS,0
2zz9,D,116,133,17,FYITAQCLGAIIGAGIL,0
2zz9,D,158,177,19,GLLVELIITFQLVFTIFAS,0
2zz9,D,178,187,9,DDKRTDVTG,0
2zz9,D,188,205,17,VALAIGFSVAIGHLFAI,0
2zz9,D,209,222,13,ASMNPARSFGPAV,0
2zz9,D,231,248,17,IYWVGPIIGAVLAGALY,0
2zz9,D,249,253,4,YVFC,0
2zz9,D,254,323,69,DVELKRRLKEAFSKAAQQTKGSYMEVEDNRSQVETEDLILKPGVVHVIDIDRGDEKKGKDSSGEVLSSV,0
1ja5,A,1,16,15,EPSSKKLTGRLMLAV,0
1ja5,A,17,35,18,GAVLGSLQFGYNTGVINA,0
1ja5,A,66,82,16,LSVAIFSVGGMIGSFS,0
1ja5,A,83,96,13,GLFVNRFGRRNSM,0
1ja5,A,97,113,16,MMNLLAFVSAVLMGFS,0
1ja5,A,123,139,16,LGRFIIGVYCGLTTGF,0
1ja5,A,140,159,19,PMYVGEVSPTAFRGALGTL,0
1ja5,A,160,178,18,QLGIVVGILIAQVFGLDS,0
1ja5,A,189,206,17,LSIIFIPALLQCIVLPF,0
1ja5,A,207,277,70,PESPRFLLINRNEENRAKSVLKKLRGTADVTHDLQEMKEESRQMMREKKVTILELFRSPAYRQPILIAVV,0
1ja5,A,278,294,16,QLSQQLSGINAVFYYS,0
1ja5,A,309,326,17,TIGSGIVNTAFTVVSLF,0
1ja5,A,327,344,17,VERAGRRTLHLIGLAGM,0
1ja5,A,345,360,15,GCAILMTIALALLEQ,0
1ja5,A,363,378,15,MSYLSIVAIFGFVAF,0
1ja5,A,379,403,24,EVGPGPIPWFIVAELFSQGPRPAA,0
1ja5,A,404,420,16,AVAGFSNWTSNFIVGM,0
1ja5,A,423,438,15,YVEQLCGPYVFIIFT,0
1ja5,A,439,492,53,LLVLFFIFTYFKVPETKGRTFDEIASGFRQGGASQSDKTPEELFHPLGADSQV,0
2h2p,B,1,17,16,KTDTPSLETPQAARLR,0
2h2p,B,18,36,18,RQLIRQLLERDKTPLAIL,0
2h2p,B,37,61,24,MAAVVGTLVGLAAVAFDKGVAWLQ,0
2h2p,B,84,97,13,CSAVLAMFGYFLV,0
2h2p,B,98,128,30,KYAPEAGGSGIPEIEGALEDQRPVRWWRVL,0
2h2p,B,129,142,13,VKFFGGLGTLGGG,0
2h2p,B,144,156,12,LGREGPTVQIGG,0
2h2p,B,157,180,23,IGRMVLDIFRLKGDEARHTLLAT,0
2h2p,B,181,203,22,AAAGLAAAFNAPLAGILFIIEE,0
2h2p,B,204,215,11,RPQFRYTLISI,0
2h2p,B,216,232,16,AVFIGVIMSTIMYRIF,0
2h2p,B,253,277,24,LYLILGIIFGIFGPIFNKWVLGMQ,0
2h2p,B,278,284,6,LLHRVH,0
2h2p,B,285,289,4,GNIT,0
2h2p,B,290,304,14,WVLMGGAIGGLCGL,0
2h2p,B,317,325,8,NLIPIATA,0
2h2p,B,338,351,13,ARVITTLLCFSSG,0
2h2p,B,353,368,15,GGIFAPMLALGTVLG,0
2h2p,B,393,415,22,MGALLAASIRAPLTGIILVLEM,0
2h2p,B,423,439,16,PMIITGLGATLLAQFT,0
2h2p,B,440,458,18,GKPLYSAILARTLAKQEA,0
2h2p,B,459,465,6,QLARSK,0
2dr6,C,2,7,5,NFFID,0
2dr6,C,11,27,16,AWVIAIIIMLAGGLAI,0
2dr6,C,28,340,312,KLPVAQYPTIAPPAVTISASYPGADAKTVQDTVTQVIEQNMNGIDNLMYMSSNSDSTGTVQITLTFESGTDADIAQVQVQNKLQLAMPLLPQEVQQQGVSVEKSSSSFLMVVGVINTDGTMTQEDISDYVAANMKDAISRTSGVGDVQLFGSQYAMRIWMNPNELNKFQLTPVDVITAIKAQNAQVAAGQLGGTPPVKGQQLNASIIAQTRLTSTEEFGKILLKVNQDGSRVLLRDVAKIELGGENYDIIAEFNGQPASGLGIKLATGANALDTAAAIRAELAKMEPFFPSGLKIVYPYDTTPFVKISIHEV,0
2dr6,C,341,357,16,KTLVEAIILVFLVMYL,0
2dr6,C,366,386,20,IPTIAVPVVLLGTFAVLAAF,0
2dr6,C,387,394,7,FSINTLT,0
2dr6,C,395,411,16,FGMVLAIGLLVDDAIV,0
2dr6,C,428,436,8,EATRKSMG,0
2dr6,C,442,458,16,VGIAMVLSAVFVPMAF,0
2dr6,C,459,470,11,GGSTGAIYRQF,0
2dr6,C,471,489,18,ITIVSAMALSVLVALILT,0
2dr6,C,499,512,13,IAKGDHGEGKKGF,0
2dr6,C,517,530,13,RMFEKSTHHYTDS,0
2dr6,C,541,558,17,LVLYLIIVVGMAYLFVR,0
2dr6,C,559,873,314,PSSFLPDEDQGVFMTMVQLPAGATQERTQKVLNEVTHYYLTKEKNNVESVFAVNGFGFAGRGQNTGIAFVSLKDWADRPGEENKVEAITMRATRAFSQIKDAMVFAFNLPAIVELGTATGFDFELIDQAGLGHEKLTQARNQLLAEAAKHPDMLTSVRPNGLEDTPQFKIDIDQEKAQALGVSINDINTTLGAAWGGSYVNDFIDRGRVKKVYVMSEAKYRMLPDDIGDWYVRAADGQMVPFSAFSSSRWEYGSPRLERYNGLPSMEILGQAAPGKSTGEAMELMEQLASKLPTGVGYDWTGMSYQERLSGNQA,0
2dr6,C,874,891,17,SLYAISLIVVFLCLAAL,0
2dr6,C,899,919,20,SVMLVVPLGVIGALLAATFR,0
2dr6,C,920,926,6,LTNDVY,0
2dr6,C,927,943,16,QVGLLTTIGLSAKNAI,0
2dr6,C,975,992,17,LMTSLAFILGVMPLVIS,0
2dr6,C,993,1000,7,GAGSGAQ,0
2dr6,C,1001,1019,18,AVGTGVMGGMVTATVLAI,0
2dr6,C,1020,1031,11,FVPVFFVVVRR,0
2dr6,C,1037,1053,16,EDIEHSHTVDHHHHHH,0
4yxd,D,35,41,6,SKAASL,0
4yxd,D,42,61,19,WTGERVVSVLLLGLLPAAY,0
4yxd,D,68,92,24,DYSLAAALTLHGHWGIGQVVTDYV,0
4yxd,D,93,97,4,GDAL,0
4yxd,D,98,118,20,KVAKAGLLALSAFTFAGLCY,0
4yxd,D,126,134,8,CKAVAMLW,0
5xan,B,34,49,15,ALLLLLTLLGSLLYI,0
5xan,B,50,301,251,RPWEHKNDPWSLWNDQYQFMTLGLDLKGGLRIELAPESGTATRDELDRVKTVIENRINALGVAEPTVTVSGGKRVVVEIPGATPAVQDRARSCIQQTARLEFRIVNSDAKPDPAVREKNPRSSGYTLAQLGPVVATGETIADATSGTDQRSGQWVVNFKTTDAGAKTFGDFTGKNVNRLMAVVLDDQIQSVATINQRLFRDIQISGNFTPEEASQLACVLKSGALPIKIVTAAERSIGPSLGADAIRSGAI,0
5xan,B,302,315,13,ALVGIGLVFVMLF,0
5xan,B,324,341,17,VGALGLLFSSIIILGIL,0
5xan,B,342,354,12,GFGATLTLPGIA,0
5xan,B,355,367,12,LVLTIGAAVDGN,0
5xan,B,400,413,13,DVNASHLLSALAL,0
5xan,B,414,424,10,NYSTGAVKGF,0
5xan,B,425,443,18,VTLIIGVIASTFSNLVFA,0
5xan,B,478,493,15,TLSVLLALAGAALVA,0
5xan,B,494,602,108,RGLNYGVDFAPGTTLTARVDRQVTTEQLRNSVIGAGVSKVTGQSATIQRDTTPGQQGQNFTVKVPELNDAEVKQIGAAIGKLPQGQVLASETVGPAVGKELTQKTIYA,0
5xan,B,603,617,14,LLGLGLILVYVGFR,0
5xan,B,624,641,17,GSIIAAIHDVAIAMGLF,0
5xan,B,642,653,11,LLGLEFTVASV,0
5xan,B,654,668,14,ALLTLIGYSLNDSI,0
5xan,B,703,718,15,TSVSTMLPLISLLIF,0
5xan,B,719,726,7,GPVLRDF,0
5xan,B,727,741,14,LILLVGILVGTYSS,0
3l71,W,5,12,7,LRQAYSA,0
3l71,W,13,18,5,FRRTS,0
3l71,W,19,36,17,FALTVVLGAVLFERAFD,0
3l71,W,63,64,1,E,0
5o66,O,2,26,24,ELLKSLVFAVIMVPVVMAIILGLI,0
5o66,O,27,36,9,GLGEVFNIF,0
3k03,E,18,22,4,AKDK,0
3k03,E,26,45,19,LFVLTILTLISGTIFYSTV,0
3k03,E,46,50,4,GLRP,0
3k03,E,51,70,19,DALYFSVVTLTTVGDTPPP,0
3k03,E,71,73,2,TD,0
3k03,E,74,95,21,GKIFTILYIFIGIGLVFGFIH,0
3k03,E,102,110,8,LPSILSNL,0
1dop,D,1,105,104,TIAVGKFTKDEKDLFDSMDDWLRRDRFVFVGWSGLLLFPCAYFALGGWFTGTTFVTSWYTHGLASSYLEGCNFLTAAVSTPANSLAHSLLLLWGPEAQGDFTRW,0
1dop,D,114,134,20,VALHGAFALIGFMLRQFELA,0
1dop,D,135,140,5,SVQLR,0
1dop,D,141,160,19,YNAIAFSGPIAVFVSVFLI,0
1dop,D,176,188,12,AAIFRFILFFQG,0
1dop,D,197,218,21,HMMGVAGVLGAALLCAIHGAT,0
1dop,D,219,224,5,ENTLF,0
1dop,D,225,262,37,DGDGANTFRAFNPTQAEETYSMVTANRFWSQIFGVAF,0
1dop,D,263,267,4,NKRW,0
1dop,D,268,289,21,HFFMLFVPVTGLWMSALGVVG,0
1dop,D,295,353,58,AYDFVSQEIRAAEDPEFETFYTKNILLNEGIRAWMAAQDQPHENLIFPEEVLPRGNAL,0
3um7,B,1,26,25,TTAPQEPPARPLQAGSGAGPAPGRA,0
3um7,B,30,51,21,TLLALLALVLLYLVSGALVFR,0
3um7,B,52,104,52,LEQPHEQQAQRELGEVREKFLRAHPCVSDQELGLLIKEVADALGGGADPETQ,0
3um7,B,105,111,6,TSQSSH,0
3um7,B,112,116,4,AWDL,0
3um7,B,117,133,16,SAFFFSGTIITTIGYG,0
3um7,B,134,141,7,VALRTDA,0
3um7,B,142,169,27,RLFCIFYALVGIPLFGILLAGVGDRLG,0
3um7,B,171,176,5,LRHGI,0
3um7,B,180,192,12,AIFLKWHVPPEL,0
3um7,B,199,220,21,LFLLIGCLLFVLTPTFVFCYM,0
3um7,B,221,224,3,DWS,0
3um7,B,225,242,17,LEAIYFVIVTLTTVGFG,0
3um7,B,243,255,12,YVAGADPRQDSP,0
3um7,B,256,280,24,YQPLVWFWILLGLAYFASVLTTIG,0
3um7,B,291,309,18,AEMGGLTAQSNSLEVLFQ,0
5xa8,A,54,76,22,EQFEDLLVRILLLAACISFVLA,0
5xa8,A,77,87,10,FEEGEETITA,0
5xa8,A,88,105,17,VEPFVILLILIANAIVG,0
5xa8,A,254,273,19,EFGEQLSKVISLICVAVWL,0
5xa8,A,274,296,22,NIGHFNDPVHGGSWIRGAIYYF,0
5xa8,A,297,314,17,IAVALAVAAIPEGLPAV,0
5xa8,A,759,777,18,FIRYLISSNVGEVVCIFL,0
5xa8,A,778,787,9,AALGLPEAL,0
5xa8,A,788,807,19,PVQLLWVNLVTDGLPATAL,0
5xa8,A,830,851,21,GWLFFRYMAIGGYVGAATVGA,0
5xa8,A,852,898,46,AWWFMYAEDGPGVTYHQLTHFMQCTEDHPHFEGLDCEIFEAPEPMT,0
5xa8,A,899,916,17,ALSVLVTIEMCNALNSL,0
5xa8,A,932,954,22,LLGSICLSMSLHFLILYVDPLP,0
5xa8,A,955,961,6,IFKLKA,0
5xa8,A,962,988,26,DLTQWLMVLKISLPVIGLDEILKFIA,0
5h2n,C,4,11,7,TGRPEWI,0
5h2n,C,12,28,16,LALGTALMGLGTLYFL,0
5h2n,C,47,61,14,LVPAIAFTMYLSML,0
5h2n,C,62,79,17,GYGLTMVPFGGEQNPIY,0
5h2n,C,80,94,14,ARYADWLFTTPLLL,0
5h2n,C,111,126,15,VGADGIMIGTGLVGA,0
5h2n,C,127,134,7,TKVYSYR,0
5h2n,C,135,150,15,VWWAISTAAMLYILY,0
5h2n,C,178,192,14,VVLWSAYPVVWLIG,0
5h2n,C,193,203,10,EGAGIVPLNI,0
5h2n,C,204,220,16,TLLFMVLDVSAKVGFG,0
4iky,A,1,2,1,A,0
4iky,A,27,48,21,LFFTEFWERFSYYGMRAILVY,0
4iky,A,49,65,16,MYYEVSKGGLGLDEHL,0
4iky,A,66,88,22,LAIMSIYGALVYMSGIIGGWLA,0
4iky,A,95,114,19,RAVFYGGLLIMAGHIALAI,0
4iky,A,115,119,4,GGVA,0
4iky,A,120,140,20,LFVSMALIVLGTGLLKPNVS,0
4iky,A,161,180,19,YMGINLGAFLAPLVVGTAG,0
4iky,A,181,185,4,KYNF,0
4iky,A,186,207,21,LGFGLAAVGMFLGLVVFVATR,0
4iky,A,229,249,20,AAAIMAVGAVVIAVLLAILI,0
4iky,A,250,252,2,NG,0
4iky,A,253,277,24,FTVETFISLVGILGIIIPIIYFVV,0
4iky,A,296,320,24,PLFVASAMFWAIQQQGSTILANYA,0
4iky,A,321,333,12,KRTQLDVAGIHL,0
4iky,A,334,353,19,PAWFQSLNPLFIIILAPVF,0
4iky,A,369,388,19,KFALGLLFAGLSFIVILVP,0
4iky,A,389,398,9,HLSGGGLVH,0
4iky,A,399,420,21,IWLVLSYFIVVLGELCLSPVG,0
4iky,A,438,458,20,LWFLSNAAAQAINAQLVRFY,0
4iky,A,459,463,4,PENE,0
4iky,A,464,485,21,AYFGTIGGAALVLGLILLAIA,0
4iky,A,495,507,12,RLESSGENLYFQ,0
3p03,C,30,56,26,ENPTNLEGKLADAAAAIILEGEDTQA,0
3p03,C,57,62,5,LNWSV,0
3p03,C,63,75,12,VPALVIVLATVV,0
3p03,C,85,98,13,NFASSALSAVVDN,0
3p03,C,99,115,16,GWAFILFGTVFVFFIV,0
3p03,C,116,143,27,IAASKFGTIRLGRIDEAPEFRTVSWIS,0
3p03,C,144,158,14,MFAAGMGIDLMFYG,0
3p03,C,183,200,17,TTMFHWTLHPWAIYAIV,0
3p03,C,201,237,36,LAIAYSTFRVGRKQLLSSAFVPLIGEKGAEGWLGKL,0
3p03,C,238,258,20,DILAIIATVFGTACSLGLGA,0
3p03,C,272,275,3,DPS,0
3p03,C,284,298,14,VLTLAFIFSAISGV,0
3p03,C,299,303,4,KGIQ,0
3p03,C,304,322,18,LSNANMVLAALLAIFVFV,0
3p03,C,326,343,17,VSILNLLPGSIGNYLSN,0
3p03,C,368,382,14,FYWAWWISWSPFVG,0
3p03,C,383,401,18,FLARISRGRSIREFILGV,0
3p03,C,402,416,14,LVPAGVSTVWFSIF,0
3p03,C,436,445,9,EEQLFGLLH,0
3p03,C,457,477,20,MILLGTFFITSADSASTVMG,0
3p03,C,478,490,12,MSQHGQLEANKW,0
3p03,C,491,505,14,TAAWGVATAAIGLT,0
3p03,C,522,537,15,IVAATPFLFVVIGLM,0
3p03,C,538,568,30,ALVKDLSNDVIYLEYREQQRFNARLARERR,0
3p03,C,569,595,26,HNEHRKRELAAKRRRERKASGAGKRR,0
1fbb,C,1,3,2,AQ,0
1fbb,C,4,9,5,TGRPE,0
1fbb,C,10,28,18,IWLALGTALMGLGTLYFL,0
1fbb,C,48,62,14,VPAIAFTMYLSMLL,0
1fbb,C,63,78,15,YGLTMVPFGGEQNPI,0
1fbb,C,79,94,15,WARYADWLFTTPLLL,0
1fbb,C,112,128,16,GADGIMIGTGLVGALT,0
1fbb,C,129,133,4,VYSY,0
1fbb,C,134,150,16,FVWWAISTAAMLYILY,0
1fbb,C,178,196,18,VVLWSAYPVVWLIGSEGA,0
1fbb,C,197,203,6,IVPLNI,0
1fbb,C,204,220,16,TLLFMVLDVSAKVGFG,0
1fbb,C,228,248,20,IFGEAEAPEPSAGDGAAATS,0
4pd5,C,-5,2,7,PAVPRMS,0
4pd5,C,4,19,15,MSCCGMAVLLGIAVL,0
4pd5,C,20,32,12,SSNRKAINLRTV,0
4pd5,C,33,49,16,GAFAIQFSLGAFILYV,0
4pd5,C,50,78,28,WGQELLRGFSDAVSNVINYGNDGTSFLF,0
4pd5,C,103,118,15,TLIFFSALISVLYYL,0
4pd5,C,120,136,16,MQWVIRILGGGLQKAL,0
4pd5,C,137,178,41,TSRAESMSAAANIFVGQTEAPLVVRPFVPKMTQSELFAVMC,0
4pd5,C,179,191,12,GLASIAGGVLAG,0
4pd5,C,202,217,15,VAASFMAAPGGLLFA,0
4pd5,C,218,229,11,LMMPETEKPQD,0
4pd5,C,230,240,10,EDITLDGGDD,0
4pd5,C,241,242,1,P,0
4pd5,C,243,267,24,NVIDAAAGGASAGLQLALNVGAML,0
4pd5,C,268,288,20,AFIGLIALINGMLGGIGGWF,0
4pd5,C,295,309,14,EMLLGWLFAPLAFL,0
4pd5,C,359,375,16,SFALCGFANLSSIAIL,0
4pd5,C,376,395,19,GGLGSLAPKRRGDIARMGV,0
4pd5,C,396,415,19,AVIAGTLSNLMAATIAGFF,0
4pd5,C,417,418,1,F,0
3kp9,A,1,15,14,ASYLKLKAQEETWL,0
3kp9,A,22,40,18,LAILAGLGSLLTAYLTYT,0
3kp9,A,41,52,11,LTEQPAAFCTG,0
3kp9,A,53,55,2,GG,0
3kp9,A,56,64,8,DLVLSSRW,0
3kp9,A,65,89,24,EFLGIPTAAVGLLGFLGVLALAVL,0
3kp9,A,91,92,1,G,0
3kp9,A,104,124,20,FGLVSAMTAFEMYMLYLMVA,0
3kp9,A,125,129,4,LRQF,0
3kp9,A,130,148,18,MYCTTAIILVAGLGLVTV,0
3kp9,A,161,181,20,SYILVAFLTLVTTIGVYANQ,0
3kp9,A,182,279,97,PPPSPLAVGLAAHLRQIGGTMYGAYWCPHCQDQKELFGAAFDQVPYVECSPNGPGTPQAQECTEAGITSYPTWIINGRTYTGVRSLEALAVASGYPL,0
3kp9,A,280,291,11,EGRLEHHHHHH,0
2c76,A,1,2,1,S,0
2c76,A,3,490,487,KCDVVVVGGGISGMAAAKLLHDSGLNVVVLEARDRVGGRTYTLRNQKVKYVDLGGSYVGPTQNRILRLAKELGLETYKVNEVERLIHHVKGKSYPFRGPFPPVWNPITYLDHNNFWRTMDDMGREIPSDAPWKAPLAEEWDNMTMKELLDKLCWTESAKQLATLFVNLCVTAETHEVSALWFLWYVKQCGGTTRIISTTNGGQERKFVGGSGQVSERIMDLLGDRVKLERPVIYIDQTRENVLVETLNHEMYEAKYVISAIPPTLGMKIHFNPPLPMMRNQMITRVPLGSVIKCIVYYKEPFWRKKDYCGTMIIDGEEAPVAYTLDDTKPEGNYAAIMGFILAHKARKLARLTKEERLKKLCELYAKVLGSLEALEPVHYEEKNWCEEQYSGGCYTTYFPPGILTQYGRVLRQPVDRIYFAGTETATHWSGWMEGAVEAGERAAREILHAMGKIPEDEIWQSEPESVDVPAQPITTTFLERHLPSVP,0
2c76,A,491,501,10,LLRLIGLTTI,0
2c76,A,502,520,18,SATALGFLAHKRGLLVRV,0
4pi2,C,1,15,14,SSTTSAAAGAAAEV,0
4pi2,C,28,41,13,VLLNVFYLIVRIY,0
4pi2,C,42,63,21,QVFGWRAGLDSFAPEFQTYWM,0
4pi2,C,64,77,13,ILWTEIPLELVSG,0
4pi2,C,114,128,14,GIAIYWGASFFTEQ,0
4pi2,C,129,145,16,GTWHMTVIRDTDFTPS,0
4pi2,C,146,160,14,IIEFYMSYPIYSVI,0
4pi2,C,188,200,12,GPFMIIPNVGLN,0
4pi2,C,201,210,9,WGHTFWFME,0
4pi2,C,211,223,12,LFVAPLHWGFVF,0
2avl,A,93,110,17,GRVAMIGFAASLLGEAL,0
2avl,A,111,127,16,GKGILAQLNLETGIPI,0
2avl,A,128,149,21,EAEPLLLFFILFTLLGAIGAL,0
2avl,A,194,217,23,LFVGRLAQLGIAFSLIGEIITGK,0
2avl,A,218,230,12,ALAQLNIETGIP,0
2avl,A,231,249,18,QDIEPLVLLNVAFFFFAA,0
4n4w,A,-2,83,85,GTADLEDNWETLNDNLKVIEKADNAAQVKDALTKMRAAALDAQKATPPKLEDKSPDSPEMKDFRHGFDILVGQIDDALKLANEGK,0
4n4w,A,84,91,7,KEAQAAA,0
4n4w,A,92,230,138,QLKTTRNAYIQKYLSGQCEVPLVRTDNPKSWYEDVEGCGIQCQNPLFTEAEHQDM,0
4n4w,A,231,254,23,SYIAAFGAVTGLCTLFTLATFVA,0
4n4w,A,264,287,23,VILFYVNACFFVGSIGWLAQFMD,0
4n4w,A,289,294,5,RREIV,0
4n4w,A,295,312,17,RADGTMRLGEPTSNETL,0
4n4w,A,313,340,27,CVIIFVIVYYALMAGVVWFVVLTYAWH,0
4n4w,A,357,378,21,SYFHLLTWSLPFVLTVAILAV,0
4n4w,A,379,399,20,QVDGDSVSGICFVGYKNYRY,0
4n4w,A,400,424,24,AGFVLAPIGLVLIVGGYFLIRGVM,0
4n4w,A,440,442,2,AA,0
4n4w,A,452,474,22,GIFGFLAFGFVLITFSCHFYDF,0
4n4w,A,475,492,17,NQAEWERSFRDYVLCQA,0
4n4w,A,493,505,12,VTIGLPTKQPIP,0
4n4w,A,506,516,10,CEIKNRPSLL,0
4n4w,A,517,538,21,EKINLFAMFGTGIAMSTWVWT,0
4n4w,A,539,550,11,ATLLIWRRTWC,0
4n4w,A,554,555,1,Q,0
4n7l,M,1,54,53,EYQNIFSQVQVRGPADLGMTEDVNLANRSGVGPFSTLLGWFGNAQLGPIYLGS,0
4n7l,M,55,72,17,GVLSLFSGLMWFFTIGI,0
4n7l,M,82,87,5,AVFLR,0
4n7l,M,117,133,16,ASFFMFVAVWSWWGRT,0
4n7l,M,134,146,12,LRAQALGMGKHT,0
4n7l,M,147,164,17,WAFLSAIWLWMVLGFIR,0
4n7l,M,179,192,13,FSHLDWTNNFSLV,0
4n7l,M,200,221,21,FHGLSIAFLYGSAHLFAMHGA,0
4n7l,M,222,268,46,ILAVSRFGGERELEQIADRGTAAERAALFWRWTMGFNATMEGIHRW,0
4n7l,M,269,286,17,IWMAVLVTLTGGIGILL,0
4n7l,M,294,299,5,YVWGQ,0
5dhg,A,47,50,3,LGL,0
5dhg,A,51,74,23,VTIVGLYLAVCVGGLLGNCLVMY,0
5dhg,A,90,112,22,FNLALADTLVLLTLPFQGTDIL,0
5dhg,A,113,118,5,GFWPF,0
5dhg,A,119,143,24,NALCKTVIAIDYYNMFTSTFTLTA,0
5dhg,A,171,191,20,VAIWALASVVGVPVAIMGSA,0
5dhg,A,192,208,16,VEDEEIECLVEIPTPQ,0
5dhg,A,209,233,24,YWGPVFAICIFLFSFIVPVLVISV,0
5dhg,A,267,291,24,VVAVFVGCWTPVQVFVLAQGLGVQ,0
5dhg,A,292,296,4,SSET,0
5dhg,A,297,321,24,VAILRFCTALGYVNSCLNPILYAF,0
5dhg,A,324,330,6,NFKACF,0
2j1i,D,30,50,20,QIGGLVIAGILFILGILIVL,0
2j1i,D,51,53,2,RR,0
4n6h,A,996,1001,5,GTTMA,0
4n6h,A,1002,47,-955,LEDNWETLNDNLKVIEKADNAAQVKDALTKMRAAALDAQKATPPKLEDKSPDSPEMKDFRHGFDILVGQIDDALKLANEGKVKEAQAAAEQLKTTRNAYIQKYLGSPGARSASSLA,0
4n6h,A,48,73,25,AIAITALYSAVCAVGLLGNVLVMFG,0
4n6h,A,88,110,22,FNLALADALATSTLPFQSAKYL,0
4n6h,A,111,114,3,ETW,0
4n6h,A,115,143,28,FGELLCKAVLSIDYYNMFTSIFTLTMMS,0
4n6h,A,168,189,21,NICIWVLASGVGVPIMVMAVT,0
4n6h,A,190,198,8,PRDGAVVC,0
4n6h,A,199,231,32,LQFPSPSWYWDTVTKICVFLFAFVVPILIITV,0
4n6h,A,264,289,25,VVVGAFVVCWAPIHIFVIVWTLVDI,0
4n6h,A,290,295,5,RRDPL,0
4n6h,A,296,320,24,VAALHLCIALGYANSSLNPVLYAF,0
4n6h,A,323,334,11,NFKRCFRQLCR,0
5jgp,B,1,10,9,IVKRPVSAS,0
5jgp,B,11,34,23,ARAFFYIVLLSILSTGIALLTLA,0
5jgp,B,149,171,22,VVAISLAGGIGIFTLVFFTLRR,0
5jgp,B,172,226,54,RHQVVAPLNQLVTASQRIEHGQFDSPPLDTNLPNELGLLAKTFNQMSSELHKLY,0
1x0i,1,1,7,6,AQITGR,0
1x0i,1,8,11,3,EWI,0
1x0i,1,12,32,20,LALGTALMGLGTLYFLVKGM,0
1x0i,1,41,61,20,FYAITTLVPAIAFTMYLSML,0
1x0i,1,62,65,3,GYG,0
1x0i,1,66,76,10,TMVPFGGEQN,0
1x0i,1,77,80,3,IYW,0
1x0i,1,81,99,18,RYADWLFTTPLLLLDLAL,0
1x0i,1,104,123,19,QGTILALVGADGIMIGTGL,0
1x0i,1,124,136,12,GALTKVYSYRFV,0
1x0i,1,137,157,20,WAISTAAMLYILYVLFFGFT,0
1x0i,1,172,190,18,VLRNVTVVLWSAYPVVWL,0
1x0i,1,191,203,12,GSEGAGIVPLNI,0
1x0i,1,204,225,21,TLLFMVLDVSAKVGFGLILLR,0
1x0i,1,234,248,14,APEPSAGDGAAATS,0
1dv3,H,1,10,9,VGVTAFQNF,0
1dv3,H,15,32,17,AIYSFWIFLAGLIYYLQ,0
1dv3,H,33,256,223,ENMREGYPLENEDGTPAANQGPFPLPKPKTFILPHGRGTLTVPGPESEDRPIALARTAVSEGFPHAPTGDPMKDGVGPASWVARRDLPELDGHGHNKIKPMKAAAGFHVSAGKNPIGLPVRGCDLEIAGKVVDIWVDIPEQMARFLEVELKDGSTRLLPMQMVKVQSNRVHVNALSSDLFAGIPTIKSPTEVTLLEEDKICGYVAGGLMYAAPKRKSVVAAML,0
1dv3,H,257,260,3,EYA,0
5avr,G,4,22,18,GPDNDERFTYDYYRLRVV,0
5avr,G,23,39,16,LIVAAVLCVIGIIILL,0
2m7x,A,125,126,1,F,0
2m7x,A,127,142,15,QINFLGSLLIAGCIT,0
5aw7,G,4,21,17,GPDNDERFTYDYYRLRV,0
5aw7,G,22,38,16,GLIVAAVLCVIGIIIL,0
4ycn,A,1,54,53,EAAHSKSTEECLAYFGVSETTGLTPDQVKRHLEKYGHNELPAEEGKSLWELVI,0
4ycn,A,55,73,18,QFEDLLVRILLLAACISF,0
4ycn,A,89,107,18,EPFVILLILIANAIVGVW,0
4ycn,A,108,253,145,ERNAENAIEALKEYEPEMGKVYRADRKSVQRIKARDIVPGDIVEVAVGDKVPADIRILSIKSTTLRVDQSILTGESVSVIKHTEPVPDPRAVNQDKKNMLFSGTNIAAGKALGIVATTGVSTEIGKIRDQMAATEQDKTPLQQKL,0
4ycn,A,254,276,22,EFGEQLSKVISLICVAVWLINI,0
4ycn,A,296,318,22,KIAVALAVAAIPEGLPAVITTC,0
4ycn,A,319,759,440,ALGTRRMAKKNAIVRSLPSVETLGCTSVICSDKTGTLTTNQMSVCKMFIIDKVDGDFCSLNEFSITGSTYAPEGEVLKNDKPIRSGQFDGLVELATICALCNDSSLDFNETKGVYEKVGEATETALTTLVEKMNVFNTEVRNLSKVERANACNSVIRQLMKKEFTLEFSRDRKSMSVYCSPAKSSRAAVGNKMFVKGAPEGVIDRCNYVRVGTTRVPMTGPVKEKILSVIKEWGTGRDTLRCLALATRDTPPKREEMVLDDSSRFMEYETDLTFVGVVGMLDPPRKEVMGSIQLCRDAGIRVIMITGDNKGTAIAICRRIGIFGENEEVADRAYTGREFDDLPLAEQREACRRACCFARVEPSHKSKIVEYLQSYDEITAMTGDGVNDAPALKKAEIGIAMGSGTAVAKTASEMVLADDNFSTIVAAVEEGRAIYNNMKQ,0
4ycn,A,760,781,21,IRYLISSNVGEVVCIFLTAAL,0
4ycn,A,787,807,20,IPVQLLWVNLVTDGLPATAL,0
4ycn,A,808,831,23,FNPPDLDIMDRPPRSPKEPLISG,0
4ycn,A,832,852,20,LFFRYMAIGGYVGAATVGAA,0
4ycn,A,867,872,5,HQLTH,0
4ycn,A,898,916,18,MALSVLVTIEMCNALNSL,0
4ycn,A,917,926,9,ENQSLMRMP,0
4ycn,A,927,950,23,WVNIWLLGSICLSMSLHFLILYV,0
4ycn,A,967,987,20,LMVLKISLPVIGLDEILKFI,0
4ycn,A,988,994,6,RNYLEG,0
2npc,C,15,31,16,CTALVLFMTIPGIALF,0
2npc,C,32,47,15,GGLIRGKNVLSMLTQ,0
2npc,C,48,64,16,TVTFALVCILWVVYGY,0
2npc,C,102,117,15,FQGSFACITVGLIVG,0
2npc,C,118,128,10,LAERIRFSAV,0
2npc,C,129,147,18,IFVVVWLTLSYIPIAHMV,0
2npc,C,161,178,17,AGGTVVAINAAIAGLVG,0
2npc,C,179,181,2,YL,0
2npc,C,182,194,12,GKRVGFGKEAFK,0
2npc,C,195,202,7,HNLPMVF,0
2npc,C,203,219,16,GTAILYIGWFGFNAGS,0
2npc,C,231,248,17,VNTVVATAAAILGWIFG,0
2npc,C,249,261,12,WALRGKPSLLGA,0
2npc,C,262,276,14,SGAIAGLVGVTPAC,0
2npc,C,282,298,16,GALIIGVVAGLAGLWG,0
2npc,C,299,301,2,TM,0
2npc,C,302,310,8,KRLLRVDD,0
2npc,C,311,314,3,CDV,0
2npc,C,315,332,17,GVHGVCGIVGCIMTGIF,0
2npc,C,353,377,24,VQLESIAITIVWSGVVAFIGYKLA,0
2npc,C,378,386,8,LTVGLRVP,0
2npc,C,387,424,37,EQEREGLDVNSHGENAYNADQAQQPAQADLEHHHHHH,0
5u2h,D,21,33,12,SSTNYGTIKWIF,0
5u2h,D,36,49,13,VFSYISFALISDK,0
5u2h,D,50,207,157,YQKKEPLISSVHTKVKGIAEVKAEILENGMKKMVSGVFDTADYTFPLQGNSFFVMTNFIKTEGQQQGLCPDFPTARTICSSDRGCKKGRMDPQSKGIQTGRCVVYKERLKTCEVSAWCPIEEVKDAPRPALLNSAENFTVLIKNNIDFPGHNYTTRN,0
5u2h,D,208,213,5,LPGVN,0
5u2h,D,214,283,69,TCTFHKTQNPQCPIFRLGDIFQETGDSFSDVAIQGGIMGIEIYWDCNLDGWFHHCRPKYSFRRLDDKTT,0
5u2h,D,284,287,3,ESL,0
5u2h,D,288,329,41,PGYNFRYAKYYKENNVEKRTLIKVFGIRFDILVFGTGGKFN,0
5u2h,D,330,344,14,IQLAVYIGSVISYF,0
5u2h,D,351,362,11,DILINTYSASS,0
1iij,A,7,31,24,TFIIATVVGVLLFLILVVVVGILI,0
1iij,A,32,35,3,RRR,0
3aee,D,35,38,3,SKA,0
3aee,D,39,60,21,SLHWTGERVVSVLLLGLLPAA,0
3aee,D,69,92,23,YSLAAALTLHGHWGIGQVVTDYV,0
3aee,D,93,97,4,GDAL,0
3aee,D,98,117,19,KAAKAGLLALSAFTFAGLC,0
3aee,D,126,134,8,CKAVAMLW,0
3mra,A,282,298,16,IFVISSIIITVVVINT,0
3mra,A,299,301,2,HR,0
5kmd,D,1002,1009,7,LRITNIV,0
5kmd,D,1017,1033,16,IIYLIVLNGITMGLET,0
5kmd,D,1035,1042,7,TFMQSFG,0
5kmd,D,1043,1061,18,YTTLFNQIVITIFTIEII,0
5kmd,D,1079,1094,15,DFFVVAISLVPTSSG,0
5kmd,D,1096,1112,16,ILRVLRVLRLFRLVTA,0
5kmd,D,1114,1124,10,QMRKIVSALI,0
5kmd,D,1134,1151,17,ALMTLFFYIFAIMATQL,0
5kmd,D,1152,1162,10,GERFPEWFGT,0
5kmd,D,1163,1180,17,GESFYTLFQVMTLDDWS,0
5kmd,D,1181,1190,9,GIVRPLMEV,0
5kmd,D,1191,1193,2,PY,0
5kmd,D,1194,1213,19,YVFFIPFIFVVTFVMINLV,0
4fby,l,7,23,16,ALAALVILSFVMVIGV,0
4fby,l,24,39,15,VAYASPQDWDRSKQL,0
4fby,l,40,54,14,FLGSGLWIALVLVV,0
5e79,z,8,25,17,LAALVILSFVMVIGVPV,0
5e79,z,26,39,13,YASPQDWDRSKQL,0
5e79,z,40,55,15,FLGSGLWIALVLVVG,0
4a01,B,2,13,11,AAILPDLGTEI,0
4a01,B,14,29,15,IPVCAVIGIAFALFQ,0
4a01,B,42,66,24,DASPNAAAKNGYNDYLIEEEEGIN,0
4a01,B,93,109,16,KYVGIFMVAFAILIFL,0
4a01,B,110,142,32,LGSVEGFSTSPQACSYDKTKTCKPALATAIFS,0
4a01,B,143,160,17,VSFLLGGVTSLVSGFLG,0
4a01,B,191,209,18,VMGFLLAANGLLVLYIAI,0
4a01,B,210,227,17,LFKIYYGDDWGGLFEAI,0
4a01,B,228,244,16,GYGLGGSSMALFGRVG,0
4a01,B,289,306,17,GMGSDLFGSYAESSCAA,0
4a01,B,307,327,20,VVASISSFGLNHELTAMLYP,0
4a01,B,328,345,17,IVSSVGILVCLLTTLFA,0
4a01,B,362,379,17,KQLVISTVLMTIGVAVV,0
4a01,B,380,405,25,FVALPTSFTIFNFGVQKDVKSWQLF,0
4a01,B,406,425,19,CVAVGLWAGLIIGFVTEYY,0
4a01,B,456,473,17,KSVIIPIFAIAISIFVS,0
4a01,B,474,482,8,TFAAMYGI,0
4a01,B,483,501,18,VAALGMLSTIATGLAIDA,0
4a01,B,537,556,19,AIGKGFAIGSAALVSLALF,0
4a01,B,557,576,19,AFVSRASITTVDVLTPKVF,0
4a01,B,577,593,16,GLIVGAMLPYWFSAMT,0
4a01,B,641,660,19,MIPPGALVMLTPLVVGILF,0
4a01,B,661,664,3,VET,0
4a01,B,665,685,20,SGVLAGSLVSGVQIAISASN,0
4a01,B,733,751,18,GPSLNILIKLMAVESLVF,0
4a01,B,752,758,6,PFFATH,0
4a01,B,759,766,7,GLLFKIF,0
3ae3,D,35,41,6,SKAASL,0
3ae3,D,42,62,20,WTGERVVSVLLLGLLPAAYL,0
3ae3,D,68,89,21,DYSLAAALTLHGHWGIGQVVT,0
3ae3,D,90,97,7,YVRGDAL,0
3ae3,D,98,120,22,KAAKAGLLALSAFTFAGLCYFN,0
3ae3,D,125,134,9,ICKAVAMLW,0
5l1f,D,10,524,514,SIQIGGLFPRGADQEYSAFRVGMVQFSTSEFRLTPHIDNLEVANSFAVTNAFCSQFSRGVYAIFGFYDKKSVNTITSFCGTLHVSFITPSFPTDGTHPFVIQMRPDLKGALLSLIEYYQWDKFAYLYDSDRGLSTLQAVLDSAAEKKWQVTAINVGNINNDKKDETYRSLFQDLELKKERRVILDCERDKVNDIVDQVITIGKHVKGYHYIIANLGFTDGDLLKIQFGGAEVSGFQIVDYDDSLVSKFIERWSTLEEKEYPGAHTATIKYTSALTYDAVQVMTEAFRNLRKQRIEISRRGNAGDCLANPAVPWGQGVEIERALKQVQVEGLSGNIKFDQNGKRINYTINIMELKTNGPRKIGYWSEVDKMVLTEDDTSGLEQKTVVVTTILESPYVMMKKNHEMLEGNERYEGYCVDLAAEIAKHCGFKYKLTIVGDGKYGARDADTKIWNGMVGELVYGKADIAIAPLTITLVREEVIDFSKPFMSLGISIMIKKPQKSKPGVFSFLDPLAYE,0
5l1f,D,525,543,18,WMCIVFAYIGVSVVLFLV,0
5l1f,D,545,553,8,TDSTNEFG,0
5l1f,D,578,588,10,FSLGAFMQQG,0
5l1f,D,589,590,1,D,0
5l1f,D,597,614,17,GRIVGGVWWFFTLIIIS,0
5l1f,D,615,792,177,YTANLAAFLTVERMVSPIESAEDLSKQTEIAYGTLDSGSTKEFFRRSKIAVFDKMWTYMRSAEPSVFVRTTAEGVARVRKSKGKYAYLLESTMNEYIEQRKPCDTMKVGGNLDSKGYGIATPKGSSLGTPVNLAVLKLSEQGVLDKLKNKWWYDKGECGAKDSGSKEKTSALSLSNV,0
5l1f,D,793,809,16,GVFYILVGGLGLAMLV,0
5l1f,D,817,831,14,SRAEAKRMKGLVPR,0
5e9s,C,19,33,14,WGLVLGAVFGLIAG,0
5e9s,C,34,37,3,FGY,0
5e9s,C,38,61,23,GAVKTYIKPFGDLFVRLLKMLVM,0
5e9s,C,89,109,20,YYLATSAMAVFFGLIVGRLF,0
5e9s,C,110,130,20,VGANVNLGSGTGKAIEAQPP,0
5e9s,C,131,144,13,LVQTLLNIVPTNP,0
5e9s,C,207,223,16,PIGVFALIAYVMAEQG,0
5e9s,C,224,231,7,RVVGPLA,0
5e9s,C,232,249,17,VVGAVYTGLFLQIVITY,0
5e9s,C,260,267,7,IKFIRKA,0
5e9s,C,271,284,13,ITAFVTRSSSGTL,0
5e9s,C,308,324,16,GATINMDGTALYQGVT,0
5e9s,C,325,341,16,LFVANAIGHPLTLGQQ,0
5e9s,C,342,367,25,VVVLTAVLASIGTAGVPGAGAIMLA,0
5e9s,C,361,370,9,GAIMLAMVL,0
5e9s,C,371,393,22,SVGLDLTPGSPVALAYAMILGI,0
5e9s,C,394,409,15,AILDMGRTMVNVTGD,0
2l2t,B,43,52,9,TLPQHARTP,0
2l2t,B,53,78,25,IAAGVIGGLFILVIVGLTFAVYVRR,0
4tqq,M,1,54,53,EYQNIFSQVQVRGPADLGMTEDVNLANRSGVGPFSTLLGWFGNAQLGPIYLGS,0
4tqq,M,55,71,16,GVLSLFSGLMWFFTIG,0
4tqq,M,82,87,5,AVFLR,0
4tqq,M,118,134,16,SFFMFVAVWSWWGRTY,0
4tqq,M,135,145,10,RAQALGMGKH,0
4tqq,M,146,163,17,AWAFLSAIWLWMVLGFI,0
4tqq,M,179,192,13,FSHLDWTNNFSLV,0
4tqq,M,201,221,20,HGLSIAFLYGSALLFAMHGA,0
4tqq,M,222,267,45,ILAVSRFGGERELEQIADRGTAAERAALFWRWTMGFNATMEGIHR,0
4tqq,M,268,283,15,AIWMAVLVTLTGGIG,0
4tqq,M,294,299,5,YVWGQ,0
3has,A,1,5,4,AQIT,0
3has,A,6,9,3,RPE,0
3has,A,10,32,22,IWLALGTALMGLGTLYFLVKGM,0
3has,A,42,66,24,YAITTLVPAIAFTMYLSMLLGYGL,0
3has,A,67,78,11,MVPFGGEQNPI,0
3has,A,79,100,21,WARYADWLFTTPLLLLDLALL,0
3has,A,104,127,23,QGTILALVGADGIMIGTGLVGAL,0
3has,A,128,134,6,KVYSYR,0
3has,A,135,157,22,VWWAISTAAMLYILYVAFFGFT,0
3has,A,171,195,24,KVLRNVTVVLWSAYPVVWLIGSEG,0
3has,A,196,201,5,GIVPL,0
3has,A,202,225,23,IETLLFMVLDVSAKVGFGLILLR,0
3has,A,232,249,17,AEAPEPSAGDGAAATSD,0
4qo2,A,92,110,18,AGPVTWVMMIACVVVFIA,0
4qo2,A,111,139,28,QILGDQEVMLWLAWPFDPTLKFEFWRYF,0
4qo2,A,140,166,26,HALMHFSLMHILFNLLWWWYLGGAVE,0
4qo2,A,172,189,17,KLIVITLISALLSGYVQ,0
4qo2,A,190,198,8,KFSGPWFG,0
4qo2,A,199,214,15,LSGVVYALMGYVWLR,0
4qo2,A,226,242,16,RGLIIFALIWIVAGWF,0
4qo2,A,243,249,6,LFGMSM,0
4qo2,A,250,267,17,NGAHIAGLAVGLAMAFV,0
4tsy,B,4,6,2,AG,0
4tsy,B,7,28,21,VIDGAGLGFDVLKTVLEALGN,0
4tsy,B,130,138,8,RMYEELYY,0
4xdj,B,77,95,18,VAIFVVVVVYLVTGGLVF,0
4xdj,B,96,148,52,ALEQPFESSQKNTIALEKAEFLRDHVCVSPQELETLIQHALDADNAGVSPIG,0
4xdj,B,155,162,7,HWDLGSA,0
4xdj,B,163,175,12,FFAGTVITTIGY,0
4xdj,B,176,185,9,NIAPSTEGG,0
4xdj,B,186,208,22,IFCILYAIFGIPLFGFLLAGIG,0
4xdj,B,242,260,18,LFILAGCIVFVTIPAVIF,0
4xdj,B,261,271,10,YIEGWTALES,0
4xdj,B,272,284,12,YFVVVTLTTVGF,0
4xdj,B,285,291,6,DFVAGG,0
4xdj,B,298,300,2,EW,0
4xdj,B,301,321,20,KPLVWFWILVGLAYFAAVLS,0
5uk6,C,1,5,4,NLES,0
5uk6,C,6,26,20,LHWIYVAGMTIGALHFWSLS,0
5uk6,C,36,57,21,YLVAMFIPIWSGLAYMAMAID,0
5uk6,C,58,68,10,GKVEAAGQIA,0
5uk6,C,69,89,20,YARYIDWMVTTPLLLLSLSW,0
5uk6,C,101,122,21,IGFLMSTQIVVITSGLIADLS,0
5uk6,C,123,127,4,RDWV,0
5uk6,C,128,149,21,YLWYICGVCAFLIILWGIWNP,0
5uk6,C,166,187,21,KLVTYFTVLWIGYPIVWIIGP,0
5uk6,C,188,197,9,GFGWINQTI,0
3c1h,C,1,2,1,P,0
3c1h,C,15,31,16,CTALVLFMTIPGIALF,0
3c1h,C,32,46,14,GGLIRGKNVLSMLT,0
3c1h,C,47,64,17,VTVTFALVCILWVVYGY,0
3c1h,C,102,118,16,FQGSAACITVGLIVGA,0
3c1h,C,119,126,7,AERIRFS,0
3c1h,C,127,147,20,VLIFVVVWLTLSYIPIAHMV,0
3c1h,C,161,178,17,AGGTVVHINAAIAGLVG,0
3c1h,C,179,181,2,YL,0
3c1h,C,182,194,12,GKRVGFGKEAFK,0
3c1h,C,195,202,7,HNLPMVF,0
3c1h,C,203,219,16,GTAILYIGWFGFNAGS,0
3c1h,C,231,248,17,VNTVVATAAAILGWIFG,0
3c1h,C,249,260,11,WALRGKPSLLG,0
3c1h,C,261,276,15,CSGAIAGLVGVTPAC,0
3c1h,C,282,299,17,GALIIGVVAGLAGLWGV,0
3c1h,C,300,301,1,M,0
3c1h,C,302,309,7,KRLLRVD,0
3c1h,C,310,313,3,PCD,0
3c1h,C,314,332,18,FGVHGVCGIVGCIMTGIF,0
3c1h,C,353,377,24,VQLESIAITIVWSGVVAFIGYKLA,0
3c1h,C,378,386,8,LTVGLRVP,0
3c1h,C,387,424,37,EQEREGLDVNSHGENAYNADQAQQPAQADLEHHHHHH,0
4zjc,A,26,43,17,YEDEFLRYLWRDYLYPK,0
4zjc,A,44,69,25,YEWVLIAAYVAVFVVALVGNTLVCL,0
4zjc,A,85,108,23,VNLSLADVLVTAICLPASLLVDI,0
4zjc,A,109,117,8,ESWLFGHA,0
4zjc,A,118,141,23,CKVIPYLQAVSVSVAVLTLSFIA,0
4zjc,A,163,183,20,SILGIWAVSLAIMVPQAAVM,0
4zjc,A,184,210,26,CSSVLPELANRTRLFSVCDERWADDL,0
4zjc,A,211,234,23,PKIYHSCFFIVTYLAPLGLMAMA,0
4zjc,A,302,324,22,VLLVFALCYLPISVLNILKRVF,0
4zjc,A,325,335,10,MFRQASDREA,0
4zjc,A,336,358,22,YACFTFSHWLVYANSAANPIIY,0
4zjc,A,363,371,8,KFREQFKA,0
3mkt,A,19,36,17,TPVLIASVAQTGMGFVD,0
3mkt,A,37,57,20,IMAGGVSAIDMAAVSIAASI,0
3mkt,A,58,75,17,LPSILFGVGLLMALVPV,0
3mkt,A,94,111,17,GLILALLVSVPIIAVLF,0
3mkt,A,112,133,21,TQFIIRFMDVEEAMATKTVGY,0
3mkt,A,134,153,19,HAVIFAVPAYLLFQALRSF,0
3mkt,A,161,177,16,PAMVIGFIGLLLNIPL,0
3mkt,A,178,198,20,WIFVYGKFGAPELGGVGCGV,0
3mkt,A,199,216,17,TAIVYWIMLLLLLFYIV,0
3mkt,A,239,263,24,RLFRLGFPVAAALFFEVTLFAVVA,0
3mkt,A,264,279,15,LVAPLGSTVVAAHQV,0
3mkt,A,280,297,17,LNFSSLVFMFPMSIGAA,0
3mkt,A,325,344,19,LATACITALLTVLFREQIA,0
3mkt,A,345,358,13,LYTENQVVVALAM,0
3mkt,A,359,380,21,LLLFAAIYQCMDAVQVVAAGS,0
3mkt,A,389,412,23,IFHRTFISYWVLGLPTGYILGMT,0
3mkt,A,413,423,10,WLTEQPLGAK,0
3mkt,A,424,440,16,FWLGFIIGLSAAALML,0
4xp9,C,35,57,22,FLLSVIGFAVDLANVWRFPYLC,0
4xp9,C,58,62,4,KNGG,0
4xp9,C,63,82,19,AFLVPYGIMLAVGGIPLFY,0
4xp9,C,112,133,21,VVLIAFYVDFYYNVIIAWSLR,0
4xp9,C,134,194,60,FFASFTNSLPWTSCNNIWNTPNCRPFEGHVEGFQSAASEYFNRYILELNRSEGIHDLGAI,0
4xp9,C,195,214,19,WDMALCLLIVYLICYFSLW,0
4xp9,C,220,240,20,GKVVWFTALFPYAVLLILLI,0
4xp9,C,241,247,6,GLTLPG,0
4xp9,C,248,256,8,FLGIQYYL,0
4xp9,C,257,263,6,PNFSAI,0
4xp9,C,264,287,23,KAEVWVDAATQVFFSLGPGFGVL,0
4xp9,C,304,321,17,LLTSFINSATSFIAGFV,0
4xp9,C,322,350,28,FSVLGYMAHTLGVRIEDVATEGPGLVFV,0
4xp9,C,351,357,6,YPAAIA,0
4xp9,C,358,367,9,MPASTFWAL,0
4xp9,C,368,389,21,FFMMLATLGLDSSFGGSEAII,0
4xp9,C,407,423,16,AGLFSLYFVVGLASCT,0
4xp9,C,424,426,2,GG,0
4xp9,C,427,451,24,YFFHLLDRYAAGYSILVAVFFEAI,0
4xp9,C,481,504,23,WRFVAPIFLLFITVYGLIGYEPL,0
4xp9,C,505,513,8,YADYVYPS,0
4xp9,C,514,532,18,ANALGWCIAGSSVVMIPA,0
4mjn,N,16,28,12,VGLASIGPGVGQ,0
4mjn,N,29,56,27,TAAGQAVEGIARQPEAEGKIRGTLLLS,0
4mjn,N,57,70,13,AFMEALTIYGLVV,0
4mjn,N,76,81,5,ANPFV,0
3j9j,D,55,74,19,FNFFVYCLYMIIFTAAAYY,0
3j9j,D,75,92,17,PVEGLPPYKLKNTVGDY,0
3j9j,D,93,117,24,RVTGEILSVSGGVYFFFRGIQYFL,0
3j9j,D,132,152,20,EILFFVQSLFMLVSVVLYFS,0
3j9j,D,153,156,3,RKE,0
3j9j,D,157,176,19,VASMVFSLAMGWTNMLYYT,0
3j9j,D,182,192,10,GIYAVMIEKM,0
3j9j,D,193,218,25,LRDLCRFMFVYLVFLFGFSTAVVTL,0
3j9j,D,219,227,8,EDGKYNSL,0
3j9j,D,228,245,17,STCLELFKFTIGMGDLE,0
3j9j,D,246,252,6,TENYDF,0
3j9j,D,253,277,24,AVFIILLLAYVILTYILLLQMLIA,0
3j9j,D,288,308,20,ESKNIWKLQRAITILDTEKS,0
2yks,E,1,10,9,PADNAADAR,0
2yks,E,11,209,198,VDVSVSIFINKIYGVNTLEQTYKVDGYIVAQWTGKPRKTPGDKPLIVENTQIERWINNGLWVPALEFINVVGSPDTGNKRLMLFPDGRVIYNARFLGSFSNDMDFRLFPFDRQQFVLELEPFSYNNQQLRFSDIQVYTENIDNEEIDEWWIRKASTHISDIRYDHLSSVQPNQNEFSRITVRIDAVRNPSYYLWSFIL,0
2yks,E,210,224,14,LGLIIAASWSVFWL,0
2yks,E,229,244,15,RLQTSFTLMLTVVAY,0
2yks,E,245,264,19,AYTSNILPRLPYTTVIDQM,0
2yks,E,265,281,16,IAGYGSIFAAILLIIF,0
2yks,E,297,313,16,RCRLAFPLGFLAIGCV,0
2yks,E,314,316,2,VI,0
2yks,E,317,321,4,GITL,0
5ktf,A,403,426,23,SKIEPVVLPLLWFEQSGAMGGKP,0
5ktf,A,427,434,7,STFYTQL,0
5ktf,A,435,443,8,LMPQVLHY,0
5ktf,A,444,465,21,QYVLLGLGGLLLLVPIICQLR,0
4d6t,W,2,4,2,PT,0
4d6t,W,5,13,8,TARLYSLL,0
4d6t,W,14,18,4,RRTS,0
4d6t,W,19,39,20,FALTIVVGALFFERAFDQGA,0
5ng5,J,1,10,9,PNFFIDRPI,0
5ng5,J,11,26,15,AWVIAIIIMLAGGLA,0
5ng5,J,341,357,16,KTLVEAIILVFLVMYL,0
5ng5,J,358,365,7,LQNFRAT,0
5ng5,J,366,383,17,IPTIAVPVVLLGTFAVL,0
5ng5,J,397,411,14,MVLAIGLLVDDAIV,0
5ng5,J,412,441,29,VENVERVMAEEGLPPKEATRKSMGQIQGA,0
5ng5,J,442,457,15,VGIAMVLSAVFVPMA,0
5ng5,J,471,489,18,ITIVSAMALSVLVALILT,0
5ng5,J,490,511,21,ALCATMLKPIAKGDHGEGKKG,0
5ng5,J,512,526,14,FGWFNRMFEKSTHH,0
5ng5,J,528,535,7,DSVGGIL,0
5ng5,J,536,541,5,STGRY,0
5ng5,J,542,556,14,VLYLIIVVGMAYLF,0
5ng5,J,875,891,16,LYAISLIVVFLCLAAL,0
5ng5,J,892,895,3,ESW,0
5ng5,J,896,918,22,IPFSVMLVVPLGVIGALLAATF,0
5ng5,J,928,943,15,VGLLTTIGLSAKNAI,0
5ng5,J,944,974,30,IVEFAKDLMDKEGKGLIEATLDAVRMRLRP,0
5ng5,J,975,991,16,LMTSLAFILGVMPLVI,0
5ng5,J,1001,1019,18,AVGTGVMGGMVTATVLAI,0
5ng5,J,1020,1033,13,FVPVFFVVVRRRF,0
2wit,C,30,56,26,ENPTNLEGKLADAAAAIILEGEDTQA,0
2wit,C,57,60,3,LNW,0
2wit,C,61,76,15,VIVPALVIVLATVVW,0
2wit,C,82,90,8,SFTNFASS,0
2wit,C,93,98,5,AVVDN,0
2wit,C,99,116,17,GWAFILFGTVFVFFIVV,0
2wit,C,117,142,25,AASKFGTIRLGRIDEAPEFRTVSWI,0
2wit,C,143,158,15,MMFAAGMGIGLMFYG,0
2wit,C,183,201,18,TTMFHWTLHPWAIYAIVG,0
2wit,C,202,236,34,AIAYSTFRVGRKQLLSSAFVPLIGEKGAEGWLGK,0
2wit,C,237,258,21,IDILAIIATVFGTACSLGLGA,0
2wit,C,273,274,1,P,0
2wit,C,284,299,15,VLTLAFIFSAISGVG,0
2wit,C,301,322,21,IQYLSNANMVLAALLAIFVFV,0
2wit,C,326,343,17,VSILNLLPGSIGNYLSN,0
2wit,C,368,385,17,FYWAWWISWSPFVGMFL,0
2wit,C,386,398,12,RISRGRSIREFI,0
2wit,C,399,416,17,GVLLVPAGVSTVWFSIF,0
2wit,C,437,445,8,EQLFGLLH,0
2wit,C,456,477,21,AMILLGTFFITSADSASTVMG,0
2wit,C,478,489,11,MSQHGQLEANK,0
2wit,C,490,506,16,VTAAWGVATAAIGLTL,0
2wit,C,519,538,19,NVTIVAATPFLFVVIGLMF,0
2wit,C,539,568,29,LVKDLSNDVIYLEYREQQRFNARLARERR,0
2wit,C,569,595,26,HNEHRKRELAAKRRRERKASGAGKRR,0
3ze3,C,-8,31,39,HHHHHHELANNTTGFTRIIKAAGYSWKGLRAAWINEAAF,0
3ze3,C,36,48,12,AVLLCVVIAAWL,0
3ze3,C,49,52,3,VDA,0
3ze3,C,53,65,12,TRVLLISSVMLV,0
3ze3,C,104,117,13,IIDAVITWAILLW,0
3ze3,C,118,121,3,HFG,0
3vra,D,1,27,26,LSAVRRAIPLSARILRTSLIQRCAGA,0
3vra,D,58,79,21,FKIERYFAAAMVPLIPAAYFI,0
3vra,D,80,84,4,GREM,0
3vra,D,85,109,24,LCLALALTLHVHWGVWGVVNDYGR,0
3vra,D,116,138,22,LAAAVRVGAYIFTACLLAGLLY,0
3vra,D,139,145,6,NEHDVG,0
3vra,D,146,153,7,TRAFEMV,0
3vra,D,154,156,2,EL,0
4qtn,C,4,12,8,AWWKRELF,0
4qtn,C,23,35,12,LMFLGIQAVVFV,0
4qtn,C,36,42,6,NPDSWL,0
4qtn,C,43,57,14,SVAAVTGILCVVFV,0
4qtn,C,64,76,12,YLFGLISVSLYA,0
4qtn,C,77,84,7,VSYTFKL,0
4qtn,C,85,90,5,GEMML,0
4qtn,C,91,104,13,LLVYVPVQFVGFA,0
4qtn,C,132,145,13,LVVAASVVGTSVY,0
4qtn,C,146,161,15,EWLHHLGSALPTLDG,0
4qtn,C,162,175,13,TVVVSIVAQVLMI,0
4qtn,C,182,194,12,ALWIVVNILTIS,0
4qtn,C,195,208,13,WAVAWFKNGETSL,0
4qtn,C,209,222,13,LLLMYVMYLCNSV,0
2bs4,F,29,50,21,QSATGLFLGLFMIGHMFFVST,0
2bs4,F,51,54,3,LLG,0
2bs4,F,55,65,10,NVMLWVTKKF,0
2bs4,F,66,76,10,LDFIFEGGKP,0
2bs4,F,77,99,22,VVSFLAAFVFAVFIAHAFLAMR,0
2bs4,F,105,118,13,RQYLTFKTHKDLM,0
2bs4,F,125,151,26,WWIQAMTGFAMFFLGSVHLYIMMTQP,0
2bs4,F,152,155,3,TIG,0
2bs4,F,156,165,9,VSSSFRMVS,0
2bs4,F,167,192,25,MWPLYLVLLFAVILHGSVGLYRLAV,0
2bs4,F,206,232,26,ANLKKLKTLMSAFLIVLGLLTFGAYV,0
2bs4,F,233,254,21,KGLEQTDPNIDYKYFDYKRTH,0
2bs4,F,255,256,1,R,0
3dl8,E,1,7,6,YYALLT,0
3dl8,E,9,25,16,VIIAVVLIISTLLQKG,0
3dl8,E,55,69,14,YWLGALFLVLALLL,0
3dl8,E,70,72,2,VI,0
3dl8,E,73,107,34,KEKGSVVEKSVQTEQSEGKGTTQESGKGHHHHHH,0
2y02,A,31,32,1,G,0
2y02,A,42,63,21,GMSLLMALVVLLIVAGNVLVI,0
2y02,A,64,82,18,AIGSTQRLQTLTNLFITS,0
2y02,A,83,103,20,ACADLVVGLLVVPFGATLVV,0
2y02,A,108,133,25,WGSFLCELWTSLDVLCVTASIETLC,0
2y02,A,134,163,29,IAIDRYLAITSPFRYQSLMTRARAKVIIC,0
2y02,A,164,183,19,VWAISALVSFLPIMMHWWR,0
2y02,A,187,194,7,QALKCYQ,0
2y02,A,200,225,25,FVTNRAYAIASSIISFYIPLLIMIF,0
2y02,A,226,237,11,ALRVYREAKEQ,0
2y02,A,238,249,11,RKIDRASKRKT,0
2y02,A,278,293,15,RVMLMREHKALKTLG,0
2y02,A,294,315,21,IMGVFTLCWLPFFLVNIVNVF,0
2y02,A,324,344,20,FVAFNWLGYANSAMNPIIYC,0
2y02,A,345,346,1,S,0
2y02,A,347,357,10,DFRKAFKRLL,0
2y02,A,359,373,14,PRKADRRLHHHHHH,0
2kyh,A,5,29,24,RGLSDLGGRVRNIGDVMEHPLVEL,0
2kyh,A,30,48,18,VSYAALLSVIVVVVEYTM,0
2kyh,A,55,74,19,VRLYLVDLILVIILWADYA,0
2kyh,A,75,83,8,RAYKSGDP,0
2kyh,A,84,110,26,GYVKKTLYEIPALVPAGLLALIEGHL,0
2kyh,A,118,142,24,VRLLRFLRILLIISRGSKFLSAIA,0
2kyh,A,143,151,8,AADKLVPR,0
2n2a,B,101,108,7,EQRASPL,0
2n2a,B,109,130,21,SIISAVVGILLVVVLGVVFGI,0
2n2a,B,142,154,12,TMRRLLQETELV,0
1ppj,W,5,13,8,TARLYSLL,0
1ppj,W,19,43,24,FALTIVVGALFFERAFDQGADAIY,0
1ppj,W,44,60,16,HINEGKLWKHIKHKYE,0
3jaf,E,25,239,214,PSEFLDKLMGKVSGYDARIRPNFKGPPVNVTCNIFINSFGSIAETTMDYRVNIFLRQQWNDPRLAYSEYPDDSLDLDPSMLDSIWKPDLFFANEKGANFHEVTTDNKLLRISKNGNVLYSIRITLVLACPMDLKNFPMDVQTCIMQLESFGYTMNDLIFEWDEKGAVQVADGLTLPQFILKEEKDLRYCTKHYNTGKFTCIEARFHLERQMGYY,0
3jaf,E,240,262,22,IQMYIPSLLIVILSWVSFWINM,0
3jaf,E,265,286,21,PARVGLGITTVLTMTTQSSGS,0
3jaf,E,287,298,11,ASLPKVSYVKA,0
3jaf,E,299,322,23,DIWMAVCLLFVFSALLEYAAVNF,0
3jaf,E,339,363,24,TVSRVAFPLVFLIFNIFYWITYKL,0
3jaf,E,364,366,2,PR,0
3cir,P,13,38,25,WGLFGAGGMWSAIIAPVMILLVGIL,0
3cir,P,39,61,22,PLGLFPGDALSYERVLAFAQSF,0
3cir,P,62,86,24,GRVFLFLMIVLPLWCGLHRMHHAM,0
3cir,P,94,116,22,AGKWVFYGLAAILTVVTLIGVV,0
3cir,P,117,118,1,I,0
4hyj,A,1,2,1,E,0
4hyj,A,3,10,7,VNLLVLA,0
4hyj,A,11,33,22,QYMFWVGFVGMAAGTLYFLVER,0
4hyj,A,43,64,21,ATVAALVTFVAAIHYYFMKDA,0
4hyj,A,65,77,12,GTSGLLSEIDGF,0
4hyj,A,78,100,22,TEIRYIDWLVTTPLLLVKFPLL,0
4hyj,A,103,105,2,KG,0
4hyj,A,109,131,22,PLLTKLVIADVIMIVGGYIGES,0
4hyj,A,132,142,10,INIAGGFTQL,0
4hyj,A,143,166,23,LWSYLIGCFAWIYIIYLLFTNVT,0
4hyj,A,179,201,22,LLKMRLFILIGWAIYPIGYAVT,0
4hyj,A,202,211,9,FAPGVEIQL,0
4hyj,A,212,234,22,RELIYNFADLTNKVGFGLIAFF,0
4hyj,A,242,258,16,SSSKGKTLTSHHHHHH,0
4md2,B,10,32,22,IWLALGTALMGLGTLYFLVKGM,0
4md2,B,33,42,9,VSDPDAKKF,0
4md2,B,43,62,19,AITTLVPAIAFTMYLSMLL,0
4md2,B,80,98,18,ARYADWLFTTPLLLLDLA,0
4md2,B,99,106,7,LVDADQG,0
4md2,B,107,127,20,ILALVGADGIMIGTGLVGAL,0
4md2,B,134,154,20,FVWWAISTAAMLYILYVLFF,0
4md2,B,155,156,1,F,0
4md2,B,163,173,10,RPEVASTFKV,0
4md2,B,174,192,18,RNVTVVLWSAYPVVWLIG,0
4md2,B,203,224,21,ETLLFMVLDVSAKVGFGLILL,0
4md2,B,225,234,9,SRAIFGEAE,0
1kgb,C,1,4,3,AQI,0
1kgb,C,5,9,4,GRPE,0
1kgb,C,10,28,18,IWLALGTALMGLGTLYFL,0
1kgb,C,47,62,15,LVPAIAFTMYLSMLL,0
1kgb,C,63,79,16,YGLTMVPFGGEQNPIY,0
1kgb,C,80,94,14,ARYADWLFTTPLLL,0
1kgb,C,111,127,16,VGADGIMIGTGLVGAL,0
1kgb,C,128,133,5,KVYSY,0
1kgb,C,134,150,16,FVWWAISTAAMLYILY,0
1kgb,C,157,161,4,SKAE,0
1kgb,C,178,192,14,VVLWSAYPVVWLIG,0
1kgb,C,193,202,9,EGAGIVPLN,0
1kgb,C,203,220,17,ETLLFMVLDVSAKVGFG,0
3d9s,D,1,14,13,KKEVCSVAFLKAV,0
3d9s,D,15,31,16,AEFLATLIFVFFGLGS,0
3d9s,D,44,61,17,IALAFGLAIGTLAQALG,0
3d9s,D,62,64,2,VS,0
3d9s,D,65,78,13,GHINPAITLALLV,0
3d9s,D,79,87,8,NQISLLRA,0
3d9s,D,88,105,17,FYVAAQLVGAIAGAGIL,0
3d9s,D,130,149,19,AMVVELILTFQLALCIFAS,0
3d9s,D,150,159,9,DSRRTSPVG,0
3d9s,D,160,177,17,PALSIGLSVTLGHLVGI,0
3d9s,D,183,195,12,MNPARSFGPAVV,0
3d9s,D,204,221,17,VFWVGPIVGAVLAAILY,0
3d9s,D,222,245,23,YLLFPNSLSLSERVAIIKGTYEP,0
3d9s,D,246,265,19,EDWEEQREERKKTMELTTR,0
4doj,C,30,56,26,ENPTNLEGKLADAEEEIILEGEDTQA,0
4doj,C,61,76,15,VIVPALVIVLATVVW,0
4doj,C,77,90,13,IGFKDSFTNFASS,0
4doj,C,91,98,7,LSAVVDN,0
4doj,C,99,116,17,GWAFILFGTVFVFFIVV,0
4doj,C,143,158,15,MMFAAGMGIDLMFYG,0
4doj,C,159,182,23,TEPLTFYRNGVPGHDEHNVGVAM,0
4doj,C,183,201,18,TTMFHWTLHPWAIYAIVG,0
4doj,C,237,258,21,IDILAIIATVFGTACSLGLGA,0
4doj,C,259,270,11,QIGAGLSAANI,0
4doj,C,271,272,1,E,0
4doj,C,273,282,9,PSDWTIVGI,0
4doj,C,283,296,13,SVLTLAFIFSAIS,0
4doj,C,297,299,2,VG,0
4doj,C,301,322,21,IQYLSNANMVLAALLAIFVFV,0
4doj,C,323,325,2,GP,0
4doj,C,326,343,17,VSILNLLPGSIGNYLSN,0
4doj,C,344,367,23,FQMAGRTAMSADGTAGEWLGSWT,0
4doj,C,368,385,17,FYWAWWISWSPFVGMFL,0
4doj,C,399,416,17,GVLLVPAGVSTVWFSIF,0
4doj,C,417,435,18,GTAIVFEQNGESIWGDGA,0
4doj,C,436,445,9,EEQLFGLLH,0
4doj,C,446,455,9,LPGGQIMGI,0
4doj,C,456,477,21,AMILLGTFFITSADSASTVMG,0
4doj,C,490,506,16,VTAAWGVATAAIGLTL,0
4doj,C,507,518,11,LSGGDNALSNL,0
4doj,C,519,538,19,NVTIVAATPFLFVVIGLMF,0
4doj,C,569,595,26,HNEHRKRELAAKRRRERKASGAGKRR,0
4m2t,A,1,29,28,ELEEDLKGRADKNFSKMGKKSKKEKKEK,0
4m2t,A,45,69,24,DRLYMLVGTLAAIIHGVALPLMML,0
4m2t,A,70,114,44,FGDMTDSFASVGQVSKQSTQMSEADKRAMFAKLEEEMTTYAYYY,0
4m2t,A,115,135,20,GIGAGVLIVAYIQVSFWCLA,0
4m2t,A,182,204,22,GDKIGMFFQAMATFFGGFIIGF,0
4m2t,A,205,210,5,RGWKL,0
4m2t,A,211,232,21,LVILAISPVLGLSAGIWAKIL,0
4m2t,A,287,309,22,AITANISMGAAFLLIYASYALA,0
4m2t,A,310,329,19,WYGTSLVISKEYSIGQVLT,0
4m2t,A,330,351,21,FFSVLIGAFSVGQASPNIEAF,0
4m2t,A,627,680,53,GNEIELGNEACKSKDEIDNLDMSSKDSGSSLIRRRSTRKSICGPHDQDRKLST,0
4m2t,A,704,728,24,PYFVVGIFCAIINGGLQPAFSVIF,0
4m2t,A,729,753,24,KVVGVFTNGGPPETQRQNSNLFSL,0
4m2t,A,754,776,22,FLILGIISFITFFLQGFTFGKA,0
4m2t,A,824,847,23,TGSRLAVIFQNIANLGTGIIISL,0
4m2t,A,848,854,6,YGWQLT,0
4m2t,A,855,875,20,LLLAIVPIIAIAGVVEMKML,0
4m2t,A,929,952,23,KAHVFGITFSFTQAMMYFSYAAC,0
4m2t,A,953,973,20,RFGAYLVTQQLMTFENVLLV,0
4m2t,A,974,994,20,SAIVFGAMAVGQVSSFAPDY,0
4m2t,A,1272,1282,10,AKRSHHHHHH,0
2y03,A,31,32,1,G,0
2y03,A,42,63,21,GMSLLMALVVLLIVAGNVLVI,0
2y03,A,64,81,17,AIGSTQRLQTLTNLFIT,0
2y03,A,82,103,21,LACADLVVGLLVVPFGATLVV,0
2y03,A,108,134,26,WGSFLCELWTSLDVLCVTASIETLCV,0
2y03,A,135,162,27,AIDRYLAITSPFRYQSLMTRARAKVII,0
2y03,A,163,183,20,TVWAISALVSFLPIMMHWWR,0
2y03,A,187,194,7,QALKCYQ,0
2y03,A,200,225,25,FVTNRAYAIASSIISFYIPLLIMIF,0
2y03,A,226,239,13,ALRVYREAKEQIR,0
2y03,A,240,249,9,IDRASKRKT,0
2y03,A,278,293,15,RVMLMREHKALKTLG,0
2y03,A,294,315,21,IMGVFTLCWLPFFLVNIVNVF,0
2y03,A,323,343,20,LFVAFNWLGYANSAMNPIIY,0
2y03,A,344,346,2,RS,0
2y03,A,347,357,10,DFRKAFKRLL,0
2y03,A,359,373,14,PRKADRRLHHHHHH,0
2wjn,M,1,51,50,DYQTIYTQIQARGPHITVSGEWGDNDRVGKPFYSYWLGKIGDAQIGPIYL,0
2wjn,M,52,70,18,ASGIAAFAFGSTAILIIL,0
2wjn,M,81,87,6,LQFFRQ,0
2wjn,M,116,133,17,GLFMTLSLGSWWIRVYS,0
2wjn,M,134,143,9,ARALGLGTH,0
2wjn,M,144,161,17,AWNFAAAIFFVLCIGCI,0
2wjn,M,177,190,13,WPHIDWLTAFSIR,0
2wjn,M,199,219,20,HGFSIGFAYGCGLLFAAHGA,0
2wjn,M,220,265,45,ILAVARFGGDREIEQITDRGTAVERAALFWRWTIGFNATIESVHR,0
2wjn,M,266,283,17,GWFFSLMVMVSASVGIL,0
2wjn,M,292,298,6,YLWCVK,0
1prc,H,16,33,17,WYAQWLVIWTVVLLYLR,0
1prc,H,34,258,224,EDRREGYPLVEPLGLVKLAPEDGQVYELPYPKTFVLPHGGTVTVPRRRPETRELKLAQTDGFEGAPLQPTGNPLVDAVGPASYAERAEVVDATVDGKAKIVPLRVATDFSIAEGDVDPRGLPVVAADGVEAGTVTDLWVDRSEHYFRYLELSVAGSARTALIPLGFCDVKKDKIVVTSILSEQFANVPRLQSRDQITLREEDKVSAYYAGGLLYATPERAESLL,0
1l9h,A,39,64,25,AAYMFLLIMLGFPINFLTLYVTVQH,0
1l9h,A,65,72,7,KLRTPLN,0
1l9h,A,73,98,25,ILLNLAVADLFMVFGGFTTTLYTSL,0
1l9h,A,109,133,24,NLEGFFATLGGEIALWSLVVLAIE,0
1l9h,A,134,153,19,YVVVCKPMSNFRFGENHAI,0
1l9h,A,154,176,22,GVAFTWVMALACAAPPLVGWSR,0
1l9h,A,200,224,24,SFVIYMFVVHFIIPLIVIFFCYGQ,0
1l9h,A,225,235,10,VFTVKEAAAQ,0
1l9h,A,236,240,4,QESA,0
1l9h,A,241,252,11,TQKAEKEVTRM,0
1l9h,A,253,277,24,IIMVIAFLICWLPYAGVAFYIFTH,0
1l9h,A,287,309,22,TIPAFFAKTSAVYNPVIYIMMN,0
1l9h,A,311,321,10,FRNCMVTTLC,0
1l9h,A,322,330,8,GKNPLGDD,0
1l9h,A,331,333,2,AS,0
1l9h,A,334,348,14,TVSKTETSQVAPA,0
4d6u,W,2,4,2,PT,0
4d6u,W,5,13,8,TARLYSLL,0
4d6u,W,14,17,3,RRT,0
4d6u,W,18,32,14,TFALTIVVGALFFE,0
5lse,H,12,29,17,ASLAIYSFWIFLAGLIY,0
1bct,A,203,225,22,ETLLFMVLDVSAKVGFGLILLR,0
1bct,A,226,231,5,RAIFG,0
3tdo,E,-2,-1,1,G,0
3tdo,E,0,1,1,A,0
3tdo,E,2,22,20,KETLDKLTNAAINKINLLNT,0
3tdo,E,23,27,4,KVKY,0
3tdo,E,28,46,18,VSSAFAGLYVGIGILLIF,0
3tdo,E,63,79,16,MGLSFAIALSLVIMTG,0
3tdo,E,81,91,10,LFTGNNMVMS,0
3tdo,E,92,104,12,GMLNKGVSIKDT,0
3tdo,E,105,129,24,KIWAYSWVGNLIGALVLGIIFVGT,0
3tdo,E,136,150,14,VAEFFANTAASKAS,0
3tdo,E,154,174,20,ALFFRGILCNILVCVSVLCS,0
3tdo,E,175,179,4,RTNS,0
3tdo,E,180,197,17,TAKIIMIFLCLFAFITS,0
3tdo,E,199,211,12,EHSVANMTIYSV,0
3tdo,E,227,249,22,YNLVAVTLGNIVGGALFMGLGT,0
3tdo,E,250,256,6,ILGKEK,0
3tdo,E,257,265,8,NAAAENLY,0
2wdr,H,15,36,21,FILVRATAIVLTLYIIYMVGF,0
2wdr,H,37,56,19,ATSGELTYEVWIGFFASAF,0
2wdr,H,57,80,23,KVFTLLALFSILIHAWIGMWQVL,0
2wdr,H,89,110,21,RLMLQLVIVVALVVYVIYGFV,0
2wdr,H,111,115,4,VWGV,0
1u77,C,1,2,1,P,0
1u77,C,3,14,11,VADKADNAFMM,0
1u77,C,15,33,18,CTALVLFMTIPGIALFYG,0
1u77,C,45,64,19,TQVTVTFALVCILWVVYGY,0
1u77,C,65,102,37,LASGEGNNFFGNINWLMLKNIELTAVMGSIYQYIHVA,0
1u77,C,103,120,17,QGSFACITVGLIVGALA,0
1u77,C,126,147,21,AVLIFVVVWLTLSYIPIAHMV,0
1u77,C,148,160,12,GGGLLASHGALD,0
1u77,C,161,180,19,AGGTVVHINAAIAGLVGAY,0
1u77,C,200,218,18,VFTGTAILYIGWFGFNAG,0
1u77,C,219,230,11,AGTANEIAALA,0
1u77,C,231,251,20,VNTVVATAAAILGWIFGEWA,0
1u77,C,259,276,17,GACSGAIAGLVGVTPAC,0
1u77,C,277,280,3,YIG,0
1u77,C,283,302,19,ALIIGVVAGLAGLWGVTML,0
1u77,C,312,332,20,DVFGVHGVCGIVGCIMTGIF,0
1u77,C,333,352,19,ASSLGGVGFAEGVTMGHQL,0
1u77,C,353,380,27,VQLESIAITIVWSGVVAFIGYKLADLT,0
3mku,A,19,41,22,TPVLIASVAQTGMGFVDTIMAG,0
3mku,A,42,53,11,VSAIDMAAVSI,0
3mku,A,54,75,21,ASIWLPSILFGVGLLMALVPV,0
3mku,A,93,114,21,QGLILALLVSVPIIAVLFQTQ,0
3mku,A,115,129,14,IIRFMDVEEAMATK,0
3mku,A,130,153,23,VGYMHAVIFAVPAYLLFQALRSF,0
3mku,A,161,182,21,PAMVIGFIGLLLNIPLNWIFV,0
3mku,A,183,193,10,GKFGAPELGG,0
3mku,A,194,217,23,GCGVATAIVYWIMLLLLLFYIVT,0
3mku,A,239,267,28,RLFRLGFPVAAALFFEVTLFAVVALLVA,0
3mku,A,268,272,4,LGST,0
3mku,A,273,297,24,VAAHQVALNFSSLVFMFPMSIGAA,0
3mku,A,325,348,23,LATACITALLTVLFREQIALLYT,0
3mku,A,349,353,4,NQVV,0
3mku,A,354,380,26,ALAMQLLLFAAIYQCMDAVQVVAAGS,0
3mku,A,389,413,24,IFHRTFISYWVLGLPTGYILGMTN,0
3mku,A,415,440,25,TEQPLGAKGFWLGFIIGLSAAALML,0
5nj3,B,374,390,16,HQLRWVSKRSFKNLLG,0
5nj3,B,393,414,21,ASIAQIIVTVVLGLVIGAIYF,0
5nj3,B,415,427,12,LKNDSTGIQNRA,0
5nj3,B,428,448,20,VLFFLTTNQCFSSVSAVELF,0
5nj3,B,452,460,8,KLFIHEYI,0
5nj3,B,471,497,26,GKLLSDLLPMRMLPSIIFTCIVYFML,0
5nj3,B,498,503,5,LKPKA,0
5nj3,B,504,529,25,AFFVMMFTLMMVAYSASSMALAIAA,0
5nj3,B,535,556,21,VATLLMTICFVFMMIFSGLLV,0
5nj3,B,557,561,4,LTTI,0
5nj3,B,562,582,20,SWLSWLQYFSIPRYGFTALQ,0
5nj3,B,583,626,43,NEFLGQNFCPGLNATGNNPCNYATCTGEEYLVKQGIDLSPWGL,0
5nj3,B,627,648,21,KNHVALACMIVIFLTIAYLKL,0
1bcc,U,1,3,2,AP,0
1bcc,U,5,13,8,TARLYSLL,0
1bcc,U,14,19,5,RRTST,0
1bcc,U,20,36,16,ALTIVVGALLFERAFD,0
3c1i,C,15,32,17,CTALVLFMTIPGIALFY,0
3c1i,C,33,45,12,GLIRGKNVLSML,0
3c1i,C,46,64,18,QVTVTFALVCILWVVYGY,0
3c1i,C,102,118,16,FQGSFACITVGLIVGA,0
3c1i,C,119,126,7,AERIRFS,0
3c1i,C,127,147,20,VLIFVVVWLTLSYIPIAHMV,0
3c1i,C,161,178,17,AGGTVVHINAAIAGLVG,0
3c1i,C,179,182,3,YLI,0
3c1i,C,183,194,11,KRVGFGKEAFK,0
3c1i,C,195,201,6,HNLPMV,0
3c1i,C,202,218,16,TGTAILYIGWFGANAG,0
3c1i,C,231,248,17,VNTVVATAAAILGWIFG,0
3c1i,C,249,260,11,WALRGKPSLLG,0
3c1i,C,261,276,15,CSGAIAGLVGVTPAC,0
3c1i,C,282,299,17,GALIIGVVAGLAGLWGV,0
3c1i,C,300,301,1,M,0
3c1i,C,302,308,6,KRLLRV,0
3c1i,C,309,313,4,DPCD,0
3c1i,C,314,332,18,FGVHGVCGIVGCIMTGIF,0
3c1i,C,353,377,24,VQLESIAITIVWSGVVAFIGYKLA,0
3c1i,C,378,386,8,LTVGLRVP,0
3c1i,C,387,424,37,EQEREGLDVNSHGENAYNADQAQQPAQADLEHHHHHH,0
4hwa,G,-19,24,43,GSSHHHHHHSSGLVPRGSHMEDLNVVDSINGAGSWLVANQALL,0
4hwa,G,35,59,24,AIIIVGLIIARMISNAVNRLMISR,0
4hwa,G,60,66,6,IDATVA,0
4hwa,G,67,87,20,FLSALVRYGIIAFTLIAALG,0
4hwa,G,92,108,16,TASVIAVLGAAGLAVG,0
4hwa,G,109,112,3,ALQ,0
4hwa,G,113,123,10,SLSNLAAGVL,0
4hwa,G,124,280,156,VMFRPFRAGEYVDLGGVAGTVLSVQIFSTTMRTADGKIIVIPNGKIIAGNIINFSREPVRRNEFIIGVAYDSDIDQVKQILTNIIQSEDRILKDREMTVRLNELGASSINFVVRVWSNSGDLQNVYWDVLERIKREFDAAGISFPYPQMDVNFKRV,0
4hwa,G,281,286,5,EDKAA,0
3tdx,E,-2,0,2,GR,0
3tdx,E,2,22,20,KETLDKLTNAAINKINLLNT,0
3tdx,E,25,47,22,KYLVSSAFAGLYVGIGILLIFT,0
3tdx,E,48,62,14,GGLLTDAGSPMTKI,0
3tdx,E,63,79,16,MGLSFAIALSLVIMTG,0
3tdx,E,81,92,11,VFTGNNMVMSA,0
3tdx,E,105,129,24,KIWAYSWVGNLIGALVLGIIFVGT,0
3tdx,E,130,135,5,LVDKG,0
3tdx,E,136,149,13,VAEFFANTAASKA,0
3tdx,E,150,153,3,MPF,0
3tdx,E,154,175,21,ALFFRGILCNILVCVSVLCSF,0
3tdx,E,180,197,17,TAKIIMIFLCLFAFITS,0
3tdx,E,199,211,12,EHSVANMTIYSV,0
3tdx,E,212,226,14,LFSPTISTVTIGGA,0
3tdx,E,227,249,22,YNLVAVTLGNIVGGALFMGLGT,0
3tdx,E,257,265,8,NAAAENLY,0
3ogc,F,-6,21,27,MHHHHHHPPMLSGLLARLVKLLLGRHG,0
3ogc,F,25,50,25,WRAAGAATVLLVIVLLAGSYLAVLA,0
3ogc,F,51,62,11,RGAPGAQLITY,0
3ogc,F,63,78,15,RALWWSVATATTVGY,0
3ogc,F,79,85,6,DLYPVT,0
3ogc,F,86,112,26,WGRLVAVVVMVAGITSFGLVTAALAT,0
5en0,A,1,39,38,CGTEGPNFYVPFSNKTGVVRSPFEAPQYYLAEPWQFSM,0
5en0,A,40,63,23,AAYMFLLIMLGFPINFLTLYVTV,0
5en0,A,75,95,20,LLNLAVADLFMVFGGFTTIL,0
5en0,A,96,112,16,TSLHGYFVFGPTGCNL,0
5en0,A,113,133,20,GFFATLGGEIALWSLVVLAI,0
5en0,A,154,172,18,MGVAFTWVMALACAAPPL,0
5en0,A,173,201,28,GWSRYIPEGMQCSCGIDYYTPHEETNNE,0
5en0,A,202,221,19,FVIYMFVVHFIIPLIVIFF,0
5en0,A,255,277,22,IMVIAFLICWLPYAGVAFYIFT,0
5en0,A,278,288,10,QGSCFGPIFM,0
5en0,A,289,309,20,IPAFFAKTSAVYNPVIYIMM,0
5en0,A,311,322,11,QFRNCMVTTLC,0
5kaf,r,6,20,14,VVLLPVLLAAGWAV,0
5kaf,r,21,35,14,NILPYAVKQVQKLL,0
4ain,C,41,54,13,DAEEEIILEGEDT,0
4ain,C,55,61,6,ASLNWS,0
4ain,C,62,77,15,IVPALVIVLATVVWG,0
4ain,C,85,98,13,NFASSALSAVVDN,0
4ain,C,99,116,17,GWAFILFGTVFVFFIVV,0
4ain,C,117,142,25,AASKFGTIRLGRIDEAPEFRTVSWI,0
4ain,C,143,158,15,MMFAAGMGIGLMFYG,0
4ain,C,183,200,17,TTMFHWTLHPWAIYAIV,0
4ain,C,201,237,36,LAIAYSTFRVGRKQLLSSAFVPLIGEKGAEGWLGKL,0
4ain,C,238,258,20,DILAIIATVFGTACSLGLGA,0
4ain,C,282,296,14,VSVLTLAFIFSAIS,0
4ain,C,297,300,3,VGK,0
4ain,C,301,322,21,IQYLSNANMVLAALLAIFVFV,0
4ain,C,326,342,16,VSILNLLPGSIGNYLS,0
4ain,C,367,382,15,IFYWAWWISWSPFVG,0
4ain,C,383,399,16,FLARISRGRSIREFIL,0
4ain,C,400,416,16,VLLVPAGVSTVWFSIF,0
4ain,C,436,445,9,EEQLFGLLH,0
4ain,C,456,477,21,AMILLGTFFITSADSASTVMG,0
4ain,C,478,490,12,MSQHGQLEANKW,0
4ain,C,491,506,15,TAAWGVATAAIGLTL,0
4ain,C,519,537,18,NVTIVAATPFLFVVIGLM,0
4ain,C,538,553,15,ALVKDLSNDVIYLEY,0
4ain,C,554,579,25,EQQRFNARLARERRVHNEHRKRELA,0
2l0j,D,19,21,2,,0
2l0j,D,25,47,22,LVVAASIIGILHLILWILDRLF,0
2l0j,D,48,60,12,KSIYRFFEHGLK,0
2l0j,D,61,62,1,G,0
3har,A,1,5,4,AQIT,0
3har,A,6,9,3,RPE,0
3har,A,10,33,23,IWLALGTALMGLGTLYFLVKGMG,0
3har,A,42,66,24,YAITTLVPAIAFTMYLSMLLGYGL,0
3har,A,67,78,11,MVPFGGEQNPI,0
3har,A,79,99,20,WARYADWLFTTPLLLLDLAL,0
3har,A,106,128,22,TILALVGADGIMIGTGLVGALT,0
3har,A,129,133,4,VYSY,0
3har,A,134,157,23,FVWWAISTAAMLYVLYVLFFGFT,0
3har,A,171,195,24,KVLRNVTVVLWSAYPVVWLIGSEG,0
3har,A,196,201,5,GIVPL,0
3har,A,202,225,23,IETLLFMVLDVSAKVGFGLILLR,0
3har,A,232,249,17,AEAPEPSAGDGAAATSD,0
1y5d,A,1,36,35,ETPNTTEDYDTTTEFDYGDATPCQKVNERAFGAQL,0
1y5d,A,41,56,15,SLVFVIGLVGNILVV,0
1y5d,A,57,61,4,VLVQ,0
1y5d,A,62,68,6,KRLKNM,0
1y5d,A,69,73,4,SIYL,0
1y5d,A,74,89,15,NLAISDLLFLFTLPF,0
1y5d,A,94,107,13,LKDDWVFGDAMCK,0
1y5d,A,113,127,14,YTGLYSEIFFIILL,0
1y5d,A,128,130,2,ID,0
1y5d,A,131,146,15,YLAIVHAVFALRART,0
1y5d,A,147,152,5,TFGVI,0
1y5d,A,153,166,13,SIIIWALAILASM,0
1y5d,A,170,195,25,FSKTQWEFTHHTCSLHFPHESLREW,0
1y5d,A,201,219,18,KLNLFGLVLPLLVMIICY,0
1y5d,A,221,235,14,IIKILLRRPNEKKS,0
1y5d,A,236,240,4,AVRL,0
1y5d,A,241,256,15,FVIMIIFFLFWTPYN,0
1y5d,A,262,279,17,VFQDFLFTHECEQSRHL,0
1y5d,A,286,300,14,EVIAYTHCCVNPVI,0
1y5d,A,301,302,1,A,0
1y5d,A,303,355,52,VGERFRKYLRQLFHRRVAVHLVKWLPFLSVDRLERVSSTSPSTGEHELSAGF,0
2bk3,A,1,2,1,S,0
2bk3,A,3,108,105,KCDVVVVGGGISGMAAAKLLHDSGLNVVVLEARDRVGGRTYTLRNQKVKYVDLGGSYVGPTQNRILRLAKELGLETYKVNEVERLIHHVKGKSYPFRGPFPPVWN,0
2bk3,A,109,126,17,ITYLDHNNFWRTMDDMG,0
2bk3,A,127,485,358,EIPSDAPWKAPLAEEWDNMTMKELLDKLCWTESAKQLATLFVNLCVTAETHEVSALWFLWYVKQCGGTTRIISTTNGGQERKFVGGSGQVSERIMDLLGDRVKLERPVIYIDQTRENVLVETLNHEMYEAKYVISAIPPTLGMKIHFNPPLPMMRNQMITRVPLGSVIKCIVYYKEPFWRKKDYCGTMIIDGEEAPVAYTLDDTKPEGNYAAIMGFILAHKARKLARLTKEERLKKLCELYAKVLGSLEALEPVHYEEKNWCEEQYSGGCYTTYFPPGILTQYGRVLRQPVDRIYFAGTETATHWSGYMEGAVEAGERAAREILHAMGKIPEDEIWQSEPESVDVPAQPITTTFLERH,0
2bk3,A,486,498,12,PSVPGLLRLIGL,0
2bk3,A,502,520,18,SATALGFLAHKRGLLVRV,0
5l1g,D,525,543,18,WMCIVFAYIGVSVVLFLV,0
5l1g,D,545,553,8,TDSTNEFG,0
5l1g,D,573,577,4,FNSL,0
5l1g,D,578,588,10,FSLGAFMQQG,0
5l1g,D,589,590,1,D,0
5l1g,D,591,596,5,SPRSL,0
5l1g,D,597,614,17,GRIVGGVWWFFTLIIIS,0
5l1g,D,793,810,17,GVFYILVGGLGLAMLVA,0
5l1g,D,811,816,5,IEFCY,0
5l1g,D,817,831,14,SRAEAKRMKGLVPR,0
3v3y,M,53,72,19,SLGVLSLFSGLMWFFTIGI,0
3v3y,M,73,81,8,FWYQAGWN,0
3v3y,M,82,87,5,AVFLR,0
3v3y,M,88,116,28,LFFFSLEPPAPEYGLSFAAPLKEGGLWL,0
3v3y,M,117,135,18,ASFFMFVAVWSWWGRTYL,0
3v3y,M,145,164,19,TAWAFLSAIWLWMVLGFIR,0
3v3y,M,165,178,13,ILMGSWSEAVPYG,0
3v3y,M,179,192,13,FSHLDWTNNFSLV,0
3v3y,M,193,200,7,GNLFYNP,0
3v3y,M,201,221,20,HGLSIAFLYGSALLFAMHGA,0
3v3y,M,268,286,18,AIWMAVLVTLTGGIGILL,0
3v3y,M,287,293,6,GTVVDN,0
3v3y,M,294,300,6,YVWGQN,0
3v3y,M,301,302,1,G,0
5ite,C,18,37,19,WLALGTIGMLLGMLYFIAD,0
5ite,C,38,50,12,LDVQDPRQKEFY,0
5ite,C,51,69,18,ITILIPAIAAASYLSMFF,0
5ite,C,88,104,16,ARYADWLFTTPLLLLD,0
5ite,C,105,117,12,GLLAGASQRDIG,0
5ite,C,118,136,18,LVGIDAFMIVTGLVATLT,0
5ite,C,142,160,18,YAFWTISTISMVFLLYYL,0
5ite,C,161,182,21,AVFGEAVSDADEDTRSTFNAL,0
5ite,C,183,200,17,NIILVTWAIYPVAWLVG,0
5ite,C,212,230,18,TLLFMVLDLVAKVGFGFI,0
5ite,C,231,238,7,LRSRAIM,0
3ae2,D,35,38,3,SKA,0
3ae2,D,39,61,22,SLHWTGERVVSVLLLGLLPAAY,0
3ae2,D,69,89,20,YSLAAALTLHGHWGIGQVVT,0
3ae2,D,90,98,8,YVRGDALQ,0
3ae2,D,99,118,19,AAKAGLLALSAFTFAGLCY,0
3ae2,D,125,134,9,ICKAVAMLW,0
5iua,A,-1,5,6,APPIMG,0
5iua,A,6,26,20,SVYITVELAIAVLAILGNVL,0
5iua,A,47,67,20,LAAADILVGVLAIPFAITIS,0
5iua,A,68,75,7,GFCAACH,0
5iua,A,76,96,20,CLFIACFVLVLAQSSIFSLL,0
5iua,A,124,144,20,IAICWVLSFAIGLTPMLGWN,0
5iua,A,145,171,26,CGQPKEGKAHSQGCGEGQVACLFEDV,0
5iua,A,172,194,22,PMNYMVYFNFFACVLVPLLLML,0
5iua,A,239,259,20,GLFALCWLPLHIINCFTFFC,0
5iua,A,260,264,4,DCSH,0
5iua,A,265,286,21,PLWLMYLAIVLAHTNSVVNPF,0
5iua,A,293,304,11,EFRQTFRKIIR,0
4a2n,B,1,4,3,NEN,0
4a2n,B,5,22,17,WKICFIVMFIIWVFVRK,0
4a2n,B,45,66,21,VFLNFIGMVFLPLTAVFSSYL,0
4a2n,B,67,76,9,SFNINLPDS,0
4a2n,B,77,93,16,RLFALIVTFLNIGLFT,0
4a2n,B,129,145,16,AHLWLWVITQGIILSN,0
4a2n,B,147,162,15,VLIFGIVAWAILYFI,0
4a2n,B,193,194,1,V,0
3qbk,D,1,17,16,TETLPPVTESAVALQA,0
3qbk,D,18,20,2,VT,0
3qbk,D,21,28,7,RELFEFV,0
3qbk,D,29,36,7,NDPLLAS,0
3qbk,D,37,57,20,LYINIALAGLSILLFVFMTR,0
3qbk,D,66,86,20,IAVSTILVPVVSIASYTGLA,0
3qbk,D,87,120,33,GLTISVLEMPAGHFAEGSSVMLGGEEVDGVVTM,0
3qbk,D,121,141,20,GRYLTWALSTPMILLALGLL,0
3qbk,D,147,168,21,KLFTAITFDIAMCVTGLAAAL,0
3qbk,D,169,174,5,TSSHL,0
3qbk,D,175,199,24,RWFWYAISCACFIVVLYILLVEWA,0
3qbk,D,211,232,21,STLKLLTVVMWLGYPIVWALG,0
3qbk,D,233,243,10,EGVAVLPVGY,0
3qbk,D,244,268,24,SWAYSALDIVAKYIFAFLLLNYLT,0
3qbk,D,277,291,14,ILDVPSASGAPADD,0
3qap,A,1,4,3,VGL,0
3qap,A,5,27,22,TLFWLGAIGMLVGTLAFAWAGR,0
3qap,A,36,60,24,YVTLVGISGIAAVAYVVMALGVGW,0
3qap,A,61,68,7,PVAERTV,0
3qap,A,69,89,20,APRYIDWILTTPLIVYFLGL,0
3qap,A,97,118,21,FGIVITLNTVVMLAGFAGAMV,0
3qap,A,119,122,3,GIE,0
3qap,A,123,146,23,YALFGMGAVAFLGLVYYLVGPMT,0
3qap,A,160,184,24,VRLRNLTVILWAIYPFIWLLGPPG,0
3qap,A,185,191,6,ALLTPT,0
3qap,A,192,215,23,DVALIVYLDLVTKVGFGFIALDA,0
3qap,A,220,239,19,AEHGESLAGVDTDAPAVAD,0
4age,G,1,24,23,EDLNVVDSINGAGSWLVANQALL,0
4age,G,29,59,30,NIVAALAIIIVGLIIARMISNAVNRLMISR,0
4age,G,60,66,6,IDATVA,0
4age,G,67,89,22,FLSALVRYGIIAFTLIAALGRV,0
4age,G,91,108,17,QTASVIAVLGAAGLAVG,0
4age,G,109,280,171,ALQGSLSNLAAGVLLVMFRPFRAGEYVDLGGVAGTVLSVQIFSTTMRTADGKIIVIPNGKIIAGNIINFSREPVRRNEFIIGVAYDSDIDQVKQILTNIIQSEDRILKDREMTVRLNELGASSINFVVRVWSNSGDLQNVYWDVLERIKREFDAAGISFPYPQMDVNFKRV,0
4age,G,281,286,5,EDKAA,0
5klv,K,2,21,19,TRFLGPRYRQLARNWVPTA,0
5klv,K,22,38,16,LWGAVGAVGLVWATDW,0
3aed,D,35,41,6,SKAASL,0
3aed,D,42,62,20,WTGERVVSVLLLGLLPAAYL,0
3aed,D,68,89,21,DYSLAAALTLHGHWGIGQVVT,0
3aed,D,90,97,7,YVRGDAL,0
3aed,D,98,118,20,KAAKAGLLALSAFTFAGLCY,0
3aed,D,126,134,8,CKAVAMLW,0
3zpr,A,42,61,19,GMSLLMALVVLLIVAGNVL,0
3zpr,A,62,82,20,IAAIGSTQRLQTLTNLFITS,0
3zpr,A,83,103,20,ACADLVVGLLVVPFGATLVV,0
3zpr,A,108,133,25,WGSFLCELWTSLDVLCVTASIETLC,0
3zpr,A,134,163,29,IAIDRYLAITSPFRYQSLMTRARAKVIIC,0
3zpr,A,164,183,19,VWAISALVSFLPIMMHWWR,0
3zpr,A,187,194,7,QALKCYQ,0
3zpr,A,200,225,25,FVTNRAYAIASSIISFYIPLLIMIF,0
3zpr,A,226,237,11,ALRVYREAKEQ,0
3zpr,A,238,252,14,RKIDRASKRKTSRV,0
3zpr,A,281,293,12,LMREHKALKTLG,0
3zpr,A,294,315,21,IMGVFTLCWLPFFLVNIVNVF,0
3zpr,A,324,342,18,FVAFNWLGYANSAMNPII,0
3zpr,A,343,346,3,CRS,0
3zpr,A,347,356,9,DFRKAFKRL,0
3zpr,A,358,373,15,FPRKADRRLHHHHHH,0
1ijp,A,1,12,11,ENLNMDLLYMA,0
1ijp,A,13,36,23,AVMMGLPAIGAAIGIGILGGKFL,0
1ijp,A,48,71,23,LRTQFFIVMGLVDAIAMIAVGLG,0
1ijp,A,72,79,7,YVMFAVA,0
1kpk,B,1,11,10,KTDTPSLETP,0
1kpk,B,12,39,27,AARLRRRQLIRQLLERDKTPLAILFMA,0
1kpk,B,40,60,20,VVGTLVGLAAVAFDKGVAWL,0
1kpk,B,84,97,13,CSAVLAMFGYFLV,0
1kpk,B,98,128,30,KYAPEAGGSGIPEIEGALEDQRPVRWWRVL,0
1kpk,B,129,142,13,VKFFGGLGTLGGG,0
1kpk,B,144,155,11,LGREGPTVQIG,0
1kpk,B,156,180,24,NIGRMVLDIFRLKGDEARHTLLAT,0
1kpk,B,181,202,21,AAAGLAAAFNAPLAGILFIIE,0
1kpk,B,203,216,13,MRPQFRYTLISIK,0
1kpk,B,217,232,15,VFIGVIMSTIMYRIF,0
1kpk,B,253,273,20,LYLILGIIFGIFGPIFNKWV,0
1kpk,B,274,289,15,GMQDLLHRVHGGNIT,0
1kpk,B,290,305,15,WVLMGGAIGGLCGLL,0
1kpk,B,337,351,14,VARVITTLLCFSSG,0
1kpk,B,353,368,15,GGIFAPMLALGTVLG,0
1kpk,B,392,415,23,GMGALLAASIRAPLTGIILVLEM,0
1kpk,B,423,436,13,PMIITGLGATLLA,0
1kpk,B,437,461,24,FTGGKPLYSAILARTLAKQEAEQL,0
1kpk,B,462,473,11,RSKAASASENT,0
5iu7,A,-3,3,6,DGAPPI,0
5iu7,A,4,26,22,GSSVYITVELAIAVLAILGNVL,0
5iu7,A,47,68,21,LAAADILVGVLAIPFAITIST,0
5iu7,A,69,75,6,FCAACH,0
5iu7,A,76,97,21,CLFIACFVLVLAQSSIFSLLA,0
5iu7,A,124,144,20,IAICWVLSFAIGLTPMLGWN,0
5iu7,A,145,171,26,CGQPKEGKAHSQGCGEGQVACLFEDV,0
5iu7,A,172,195,23,PMNYMVYFNFFACVLVPLLLMLG,0
5iu7,A,238,259,21,AGLFALCWLPLHIINCFTFFC,0
5iu7,A,260,264,4,DCSH,0
5iu7,A,265,286,21,PLWLMYLAIVLAHTNSVVNPF,0
5iu7,A,293,306,13,EFRQTFRKIIRSH,0
2rcr,H,16,33,17,IYSFWIFLAGLIYYLQT,0
2rcr,H,34,255,221,NMREGYPLENEDGTPAANQGPFPLPKPKTFILPHGRGTLTVPGPESEDRPIALARTAVSEGFPHAPTGDPMKDGVGPASWVARRDLPELDGHGHNKIKPMKAAAGFHVSAGKNPIGLPVRGCDLEIAGKVVDIWVDIPEQMARFLEVELKDGSTRLLPMQMVKVQSNRVHVNALSSDLFAGIPTIKSPTEVTLLEEDKICGYVAGGLMYAAPKRKSVVAAM,0
2rcr,H,256,260,4,AEYA,0
3syc,D,50,54,4,AKRK,0
3syc,D,70,75,5,NVRET,0
3syc,D,90,117,27,WRFNLLIFVMVYTVTWLFFGMIWWLIA,0
3syc,D,118,121,3,IRG,0
3syc,D,122,133,11,MDHIEDPSWTP,0
3syc,D,134,141,7,VTNLNGF,0
3syc,D,142,157,15,SAFLFSIETETTIGY,0
3syc,D,158,167,9,YRVITDKCP,0
3syc,D,168,195,27,GIILLLIQSVLGSIVNAFMVGCMFVKI,0
3syc,D,383,389,6,LEVLFQ,0
4lxj,A,1,5,4,SATK,0
4lxj,A,7,23,16,VGEALEYVNIGLSHFL,0
4lxj,A,31,51,20,SLIIIIPFIYNIVWQLLYSL,0
4lxj,A,52,76,24,KDRPPLVFYWIPWVGSAVVYGMKP,0
4lxj,A,77,87,10,EFFEECQKKY,0
4lxj,A,88,535,447,DIFSFVLLGRVMTVYLGPKGHEFVFNAKLADVSAEAAYAHLTTPVFGKGVIYDCPNSRLMEQKKFVKGALTKEAFKSYVPLIAEEVYKYFRDSKNFRLNERTTGTIDVMVTQPEMTIFTASRSLLGKEMRAKLDTDFAYLYSDLDKGFTPINFVFPNLPLEHYRKRDHAQKAISGTYMSLIKERRKNNDIQDRDLIDSLMKNSTYKDGVKMTDQEIANLLIGVLMGGQHTSAATSAWILLHLAERPDVQQELYEEQMRVLDGGKKELTYDLLQEMPLLNQTIKETLRMHHPLHSLFRKVMKDMHVPNTSYVIPAGYHVLVSPGYTHLRDEYFPNAHQFNIHRWNNDSASSYSVGEEVDYGFGAISKGVSSPYLPFGGGRHRCIGEHFAYCQLGVLMSIFIRTLKWHYPEGKTVPPPDFTSMVTLPTGPAKIIWEKRNPEQKIGGRHH,0
5aw6,G,4,21,17,GPDNDERFTYDYYRLRV,0
5aw6,G,22,39,17,GLIVAAVLCVIGIIILL,0
5aww,G,1,10,9,DLLYTLVIL,0
5aww,G,11,24,13,YLGVAGLLVYLVL,0
5aww,G,55,67,12,TVILGVVFAALA,0
5aww,G,68,75,7,VIGLWPR,0
2mc7,A,1,9,8,NRSPDKII,0
2mc7,A,10,26,16,LIFLLISLLVLCLALW,0
5avs,G,4,24,20,GPDNDERFTYDYYRLRVVGL,0
5avs,G,25,40,15,VAAVLCVIGIIILLA,0
4bvn,A,31,35,4,GAEL,0
4bvn,A,40,64,24,EAGMSLLMALVVLLIVAGNVLVIA,0
4bvn,A,65,79,14,IGSTQRLQTLTNLF,0
4bvn,A,80,103,23,TSLACADLVVGLLVVPFGATLVV,0
4bvn,A,110,136,26,SFLCELWTSLDVLCVTASVETLCVIA,0
4bvn,A,137,160,23,DRYLAITSPFRYQSLMTRARAKV,0
4bvn,A,161,183,22,ICTVWAISALVSFLPIMMHWWR,0
4bvn,A,187,194,7,QALKCYQ,0
4bvn,A,200,228,28,FVTNRAYAIASSIISFYIPLLIMIFVAL,0
4bvn,A,229,240,11,VYREAKEQIRK,0
4bvn,A,241,246,5,DRASK,0
4bvn,A,275,292,17,KTSRVMLMREHKALKTL,0
4bvn,A,293,315,22,IIMGVFTLCWLPFFLVNIVNVF,0
4bvn,A,324,344,20,FVAFNWLGYANSAMNPIILC,0
4bvn,A,345,346,1,S,0
4bvn,A,347,356,9,DFRKAFKRL,0
4bvn,A,357,358,1,A,0
4bvn,A,359,373,14,PRKADRRLHHHHHH,0
2j1h,A,15,37,22,FIIATVEGVLLFLILVVVVGIL,0
2j1h,A,38,42,4,KRRR,0
3gia,A,1,2,1,E,0
3gia,A,15,33,18,MAVGVMIGASIFSIFGVG,0
3gia,A,34,41,7,KIAGRNL,0
3gia,A,42,56,14,ETFILSGIYALLVA,0
3gia,A,72,80,8,IAFIHKAI,0
3gia,A,84,91,7,ITGALSI,0
3gia,A,92,113,21,LWMSYVISIALFAKGFAGYFL,0
3gia,A,114,125,11,LINAPINTFNI,0
3gia,A,126,140,14,ITEIGIVAFFTALN,0
3gia,A,144,150,6,KAVGRA,0
3gia,A,151,170,19,FFIVLVKLLILGLFIFAGL,0
3gia,A,171,190,19,TIHPSYVIPDLAPSAVSGM,0
3gia,A,191,206,15,FASAIFFLSYMGFGV,0
3gia,A,226,242,16,ISILIVMFVYVGVAIS,0
3gia,A,243,259,16,IGNLPIDELIKASENA,0
3gia,A,260,268,8,AVAAKPFL,0
3gia,A,269,274,5,NLGFL,0
3gia,A,275,293,18,ISIGALFSISSAMNATIY,0
3gia,A,296,305,9,NVAYSLAKD,0
3gia,A,324,340,16,YITSALGVLFALLFNM,0
3gia,A,342,357,15,VASITSAVFMVIYLF,0
3gia,A,375,395,20,VIFSFIVVLGVFLLLLYYQW,0
3gia,A,396,399,3,TNR,0
3gia,A,400,415,15,VFYGIIATFIGVLIF,0
3gia,A,436,444,8,ESSGLVPR,0
2c88,A,49,56,7,WELVIEQ,0
2c88,A,61,79,18,VRILLLAACISFVLAWFE,0
2c88,A,80,84,4,GEET,0
2c88,A,85,100,15,TAFVEPFVILLILIA,0
2c88,A,260,277,17,SKVISLICVAVWLINIG,0
2c88,A,278,291,13,FNDPVHGGSWIRG,0
2c88,A,292,311,19,IYYFKIAVALAVAAIPEGL,0
2c88,A,763,783,20,LISSNVGEVVCIFLTAALGL,0
2c88,A,785,804,19,ALIPVQLLWVNLVTDGLPA,0
2c88,A,833,852,19,FFRYMAIGGYVGAATVGAA,0
2c88,A,853,896,43,WWFMYAEDGPGVTYHQLTHFMQCTEDHPHFEGLDCEIFEAPEP,0
2c88,A,897,916,19,TMALSVLVTIEMCNALNSL,0
2c88,A,932,951,19,LLGSICLSMSLHFLILYVD,0
2c88,A,952,966,14,LPMIFKLKALDLTQ,0
2c88,A,967,987,20,LMVLKISLPVIGLDEILKFI,0
2xut,A,1,12,11,NSPVDAPKWPR,0
2xut,A,13,18,5,IPYII,0
2xut,A,19,39,20,SEACERFSFYGMRNILTPFL,0
2xut,A,55,74,19,AKDVFHSFVIGVYFFPLLG,0
2xut,A,75,86,11,WIADRFFGKYN,0
2xut,A,87,106,19,ILWLSLIYCVGHAFLAIFE,0
2xut,A,111,128,17,FYTGLFLIALGSGGIKP,0
2xut,A,129,153,24,VSSFMGDQFDQSNKSLAQKAFDMF,0
2xut,A,154,172,18,FTINFGSFFASLSMPLLL,0
2xut,A,179,197,18,AFGIPGVLMFVATVFFWL,0
2xut,A,198,206,8,RKRYIHMP,0
2xut,A,207,226,19,EPKDPHGFLPVIRSALLTK,0
2xut,A,227,239,12,EGKGNIGLVLAL,0
2xut,A,240,255,15,GGVSAAYALVNIPTL,0
2xut,A,257,273,16,VAGLCCAMVLVMGFVG,0
2xut,A,274,305,31,GASLQLERARKSHPDAAVDGVRSVLRILVLF,0
2xut,A,306,326,20,LVTPFWSLFDQKASTWILQA,0
2xut,A,335,352,17,EPAMMQALNPLLVMLLI,0
2xut,A,353,358,5,FNNFV,0
2xut,A,359,370,11,YPAIERMGVKL,0
2xut,A,371,376,5,ALRKM,0
2xut,A,377,394,17,AGIAITGLSWIVVGTIQ,0
2xut,A,404,423,19,IFWQILPYALLTFGEVLVS,0
2xut,A,424,444,20,TGLEFAYSQAPKAMKGTIMS,0
2xut,A,445,464,19,WTLSVTVGNLWVLLANVSV,0
2xut,A,468,477,9,VTEQIVQTG,0
2xut,A,483,499,16,QMFFFAGFAILAAIVF,0
2xut,A,501,524,23,YARSYQMQDHYRQATGSENLYFQ,0
3bz2,Z,11,24,13,LVILSFVMVIGVP,0
3bz2,Z,25,38,13,AYASPQDWDRSKQ,0
3bz2,Z,39,53,14,IFLGSGLWIALVLV,0
4kpp,A,6,25,19,KFQLLAISSLTLPWLISLA,0
4kpp,A,26,36,10,NYHHPALTQT,0
4kpp,A,37,58,21,LSGLAVVSASFLISWAAETAE,0
4kpp,A,65,84,19,SLAIVALLAVLPEYAVDGY,0
4kpp,A,85,100,15,AWKAGSVGGEYVHYA,0
4kpp,A,101,122,21,ANMTGANRLLIGIGWSLVAFI,0
4kpp,A,139,157,18,LEIFFLFLATLYAFTLPL,0
4kpp,A,158,161,3,GHI,0
4kpp,A,162,181,19,PFDALVFVSLYAIYIYLST,0
4kpp,A,193,199,6,PAYLCS,0
4kpp,A,204,224,20,RRLSVVVLFLFAGFTILMSV,0
4kpp,A,225,237,12,AFSEGLLETARI,0
4kpp,A,238,244,6,GIDEFL,0
4kpp,A,245,264,19,VQWIAPLASESPELIVAIY,0
4kpp,A,275,296,21,NALISSKVNQWTLLIGTIAII,0
4kpp,A,297,314,17,SISAFKLQSLPLDARQS,0
4kpp,A,315,332,17,EVLLTAAQSLFAVAILL,0
4kpp,A,337,355,18,WKEASALFLLFIVQLLFP,0
4kpp,A,356,358,2,VE,0
4kpp,A,359,379,20,RYIISAIYIILSLPILFAKR,0
4kpp,A,380,393,13,EIVESFRTVKRLI,0
4kpp,A,397,405,8,SGENLYFQ,0
1oja,A,1,2,1,S,0
1oja,A,3,108,105,KCDVVVVGGGISGMAAAKLLHDSGLNVVVLEARDRVGGRTYTLRNQKVKYVDLGGSYVGPTQNRILRLAKELGLETYKVNEVERLIHHVKGKSYPFRGPFPPVWN,0
1oja,A,109,126,17,ITYLDHNNFWRTMDDMG,0
1oja,A,127,485,358,EIPSDAPWKAPLAEEWDNMTMKELLDKLCWTESAKQLATLFVNLCVTAETHEVSALWFLWYVKQCGGTTRIISTTNGGQERKFVGGSGQVSERIMDLLGDRVKLERPVIYIDQTRENVLVETLNHEMYEAKYVISAIPPTLGMKIHFNPPLPMMRNQMITRVPLGSVIKCIVYYKEPFWRKKDYCGTMIIDGEEAPVAYTLDDTKPEGNYAAIMGFILAHKARKLARLTKEERLKKLCELYAKVLGSLEALEPVHYEEKNWCEEQYSGGCYTTYFPPGILTQYGRVLRQPVDRIYFAGTETATHWSGYMEGAVEAGERAAREILHAMGKIPEDEIWQSEPESVDVPAQPITTTFLERH,0
1oja,A,486,498,12,PSVPGLLRLIGL,0
1oja,A,502,520,18,SATALGFLAHKRGLLVRV,0
4yms,C,4,44,40,FLSMVKYTPLFISGLIMTLKLTFLAVTIGVLMGLFIALMK,0
4yms,C,45,48,3,SSI,0
4yms,C,49,78,29,PIKLVASSYIEVIRGTPLLVQLLLIYNGL,0
4yms,C,86,107,21,AFTAGVSALAINSSAYVAEII,0
4yms,C,108,146,38,AGIQAVDPGQNEAARSLGMTHAMAMRYVIIPQAIKNIL,0
4yms,C,147,168,21,ALGNEFIVMLKESAIVSVIGF,0
4yms,C,186,207,21,EPYIIIAAIYFVMTLTFSKLL,0
4yms,C,208,214,6,LFERRL,0
5mmt,A,11,19,8,PLGLSTLF,0
5mmt,A,20,37,17,TEMWERFSYYGMRAILL,0
5mmt,A,58,74,16,IMAIYASMVYLSGTIG,0
5mmt,A,75,87,12,FVADRIIGARPA,0
5mmt,A,88,104,16,FWGGVLIMLGHIVLAL,0
5mmt,A,110,127,17,LFGSIILIIIGTGFLKP,0
5mmt,A,128,152,24,VSTLVGTLYDEHDRRRDAGFSIFV,0
5mmt,A,153,169,16,GINLGAFIAPLIVGAA,0
5mmt,A,177,193,16,AFSLAAIGMFIGLLVY,0
5mmt,A,194,211,17,FGGKKTLDPHYLRPTDP,0
5mmt,A,215,221,6,EVKPLL,0
5mmt,A,222,240,18,KVSLAVAGFIAIIVVMNL,0
5mmt,A,249,264,15,INLLTIVAIAIPVFY,0
5mmt,A,275,286,11,STEHLRVVSYI,0
5mmt,A,287,307,20,LFIAAVLFWAIEEQGSVVLA,0
5mmt,A,323,339,16,FQSLNPLFIMLYTPFF,0
5mmt,A,340,344,4,WLWT,0
5mmt,A,352,354,2,SP,0
5mmt,A,355,372,17,KFAVGLMFAGLSFLLMA,0
5mmt,A,387,403,16,WLVGSWALVILGEMLI,0
5mmt,A,421,425,4,QMMS,0
5mmt,A,426,442,16,WFLSSSVGSALNAQLV,0
5mmt,A,455,472,17,YFGLGSVVLGIVLVFLS,0
3ij4,C,2,45,43,DLKVDEEEVDSGQPVSIQAFASSSTLHGISHIFSYERLSLKRV,0
3ij4,C,46,50,4,WALC,0
3ij4,C,51,75,24,MGSLALLALVCTNRIQYYFLYPHV,0
3ij4,C,423,445,22,AYEVAGLLGDIGGQMGLFIGAS,0
3ij4,C,446,451,5,LTVLE,0
3ij4,C,452,466,14,FDYAYEVIKHRLCR,0
4ikx,A,26,47,21,TLFFTEFWERFSYYGMRAILV,0
4ikx,A,48,67,19,YMYYEVSKGGLGLDEHLAL,0
4ikx,A,68,88,20,IMSIYGALVYMSGIIGGWLA,0
4ikx,A,95,114,19,RAVFYGGLLIMAGHIALAI,0
4ikx,A,115,119,4,GGVA,0
4ikx,A,120,140,20,LFVSMALIVLGTGLLKPNVS,0
4ikx,A,160,180,20,FYMGINLGAFLAPLVVGTAG,0
4ikx,A,181,187,6,KYNFHL,0
4ikx,A,188,207,19,FGLAAVGMFLGLVVFVATR,0
4ikx,A,230,249,19,AAIMAVGAVVIAVLLAILI,0
4ikx,A,250,253,3,NGW,0
4ikx,A,254,277,23,TVETFISLVGILGIIIPIIYFVV,0
4ikx,A,294,317,23,YIPLFVASAMFWAIQQQGSTILA,0
4ikx,A,318,328,10,YADKRTQLDV,0
4ikx,A,329,330,1,G,0
4ikx,A,331,335,4,HLSP,0
4ikx,A,336,357,21,WFQSLNPLFIIILAPVFAWMW,0
4ikx,A,368,387,19,QKFALGLLFAGLSFIVILV,0
4ikx,A,388,391,3,GHL,0
4ikx,A,392,393,1,G,0
4ikx,A,394,399,5,GLVHP,0
4ikx,A,400,421,21,WLVLSYFIVVLGELCLSPVGL,0
4ikx,A,438,455,17,LWFLSNAAAQAINAQLV,0
4ikx,A,456,466,10,FYTPENETAY,0
4ikx,A,467,485,18,GTIGGAALVLGLILLAIA,0
4ikx,A,494,507,13,IRLESSGENLYFQ,0
3wu2,z,8,25,17,LAALVILSFVMVIGVPV,0
3wu2,z,26,39,13,YASPQDWDRSKQL,0
3wu2,z,40,56,16,FLGSGLWIALVLVVGV,0
5h2o,C,4,11,7,TGRPEWI,0
5h2o,C,12,28,16,LALGTALMGLGTLYFL,0
5h2o,C,47,61,14,LVPAIAFTMYLSML,0
5h2o,C,62,79,17,GYGLTMVPFGGEQNPIY,0
5h2o,C,80,94,14,ARYADWLFTTPLLL,0
5h2o,C,111,126,15,VGADGIMIGTGLVGA,0
5h2o,C,127,134,7,TKVYSYR,0
5h2o,C,135,150,15,VWWAISTAAMLYILY,0
5h2o,C,178,192,14,VVLWSAYPVVWLIG,0
5h2o,C,193,203,10,EGAGIVPLNI,0
5h2o,C,204,220,16,TLLFMVLDVSAKVGFG,0
5xa9,A,51,57,6,LVIEQF,0
5xa9,A,58,74,16,DLLVRILLLAACISFV,0
5xa9,A,75,88,13,AWFEEGEETITAF,0
5xa9,A,89,103,14,EPFVILLILIANAI,0
5xa9,A,257,273,16,EQLSKVISLICVAVWL,0
5xa9,A,274,296,22,NIGHFNDPVHGGSWIRGAIYYF,0
5xa9,A,297,311,14,IAVALAVAAIPEGL,0
5xa9,A,764,780,16,ISSNVGEVVCIFLTAA,0
5xa9,A,781,786,5,GLPEA,0
5xa9,A,787,803,16,IPVQLLWVNLVTDGLP,0
5xa9,A,835,851,16,RYMAIGGYVGAATVGA,0
5xa9,A,852,898,46,AWWFMYAEDGPGVTYHQLTHFMQCTEDHPHFEGLDCEIFEAPEPMT,0
5xa9,A,899,914,15,ALSVLVTIEMCNALN,0
5xa9,A,935,950,15,SICLSMSLHFLILYV,0
5xa9,A,951,957,6,PLPMIF,0
5xa9,A,958,967,9,LKALDLTQW,0
5xa9,A,968,984,16,MVLKISLPVIGLDEIL,0
3prq,Z,7,23,16,ALAALVILSFVMVIGV,0
3prq,Z,24,39,15,VAYASPQDWDRSKQL,0
3prq,Z,40,54,14,FLGSGLWIALVLVV,0
3l70,W,5,12,7,LRQAYSA,0
3l70,W,13,18,5,FRRTS,0
3l70,W,19,36,17,FALTVVLGAVLFERAFD,0
3l70,W,63,64,1,E,0
3b9b,A,1,60,59,EAAHSKSTEECLAYFGVSETTGLTPDQVKRHLEKYGHNELPAEEGKSLWELVIEQFEDL,0
3b9b,A,61,78,17,VRILLLAACISFVLAWF,0
3b9b,A,86,101,15,AFVEPFVILLILIAN,0
3b9b,A,102,257,155,IVGVWQERNAENAIEALKEYEPEMGKVYRADRKSVQRIKARDIVPGDIVEVAVGDKVPADIRILSIKSTTLRVDQSILTGESVSVIKHTEPVPDPRAVNQDKKNMLFSGTNIAAGKALGIVATTGVSTEIGKIRDQMAATEQDKTPLQQKLDEFG,0
3b9b,A,258,274,16,QLSKVISLICVAVWLI,0
3b9b,A,296,314,18,KIAVALAVAAIPEGLPAV,0
3b9b,A,315,760,445,TTCLALGTRRMAKKNAIVRSLPSVETLGCTSVICSDKTGTLTTNQMSVCKMFIIDKVDGDFCSLNEFSITGSTYAPEGEVLKNDKPIRSGQFDGLVELATICALCNDSSLDFNETKGVYEKVGEATETALTTLVEKMNVFNTEVRNLSKVERANACNSVIRQLMKKEFTLEFSRDRKSMSVYCSPAKSSRAAVGNKMFVKGAPEGVIDRCNYVRVGTTRVPMTGPVKEKILSVIKEWGTGRDTLRCLALATRDTPPKREEMVLDDSSRFMEYETDLTFVGVVGMLDPPRKEVMGSIQLCRDAGIRVIMITGDNKGTAIAICRRIGIFGENEEVADRAYTGREFDDLPLAEQREACRRACCFARVEPSHKSKIVEYLQSYDEITAMTGDGVNDAPALKKAEIGIAMGSGTAVAKTASEMVLADDNFSTIVAAVEEGRAIYNNMKQF,0
3b9b,A,761,777,16,RYLISSNVGEVVCIFL,0
3b9b,A,787,806,19,IPVQLLWVNLVTDGLPATA,0
3b9b,A,807,831,24,GFNPPDLDIMDRPPRSPKEPLISG,0
3b9b,A,832,851,19,LFFRYMAIGGYVGAATVGA,0
3b9b,A,899,915,16,ALSVLVTIEMCNALNS,0
3b9b,A,916,933,17,SENQSLMRMPPWVNIWL,0
3b9b,A,934,951,17,GSICLSMSLHFLILYVD,0
3b9b,A,968,987,19,MVLKISLPVIGLDEILKFI,0
3b9b,A,988,994,6,RNYLEG,0
5a8e,A,42,64,22,GMSLLMALVVLLIVAGNVLVIA,0
5a8e,A,65,79,14,IGSTQRLQTLTNLF,0
5a8e,A,80,103,23,TSLACADLVVGLLVVPFGATLVV,0
5a8e,A,108,137,29,WGSFLCELWTSLDVLCVTASVWTLCVIAI,0
5a8e,A,138,160,22,RYLAITSPFRYQSLMTRARAKV,0
5a8e,A,161,183,22,ICTVWAISALVSFLPIMMHWWR,0
5a8e,A,187,194,7,QALKCYQ,0
5a8e,A,200,232,32,FVTNRAYAIASSIISFYIPLLIMIFVALRVYR,0
5a8e,A,233,240,7,AKEQIRK,0
5a8e,A,275,290,15,KTSRVMLMREHKALK,0
5a8e,A,291,314,23,LGIIMGVFTLCWLPFFLVNIVNV,0
5a8e,A,325,346,21,VAFNWLGYANSAMNPIILCRS,0
5a8e,A,347,353,6,DFRKAF,0
3k0d,E,18,22,4,AKDK,0
3k0d,E,26,45,19,LFVLTILTLISGTIFYSTV,0
3k0d,E,46,50,4,GLRP,0
3k0d,E,51,70,19,DALYFSVVTLTTVGETPPP,0
3k0d,E,71,73,2,TD,0
3k0d,E,74,95,21,GKIFTILYIFIGIGLVFGFIH,0
3k0d,E,102,110,8,LPSILSNL,0
2o7l,A,96,113,17,TWVMMIACVVVFIAMQI,0
2o7l,A,114,115,1,G,0
2o7l,A,116,123,7,QEVMLWL,0
2o7l,A,124,147,23,WPFDPTLKFEFWRYFTHALMHFS,0
2o7l,A,148,163,15,MHILFNLLWWWYLGG,0
2o7l,A,173,190,17,LIVITLISALLSGYVQQ,0
2o7l,A,191,197,6,FSGPWF,0
2o7l,A,198,213,15,GLSGVVYALMGYVWL,0
2o7l,A,229,244,15,IIFALIWIVAGWFDL,0
2o7l,A,245,249,4,GMSM,0
2o7l,A,251,267,16,GAHIAGLAVGLAMAFV,0
4ww3,A,9,36,27,TWWYNPSIVVHPHWREFDQVPDAVYYS,0
4ww3,A,37,57,20,GIFIGICGIIGCGGNGIVIY,0
4ww3,A,73,94,21,INLAFSDFTFSLVNGFPLMTI,0
4ww3,A,95,107,12,CFLKKWIFGFAA,0
4ww3,A,108,130,22,KVYGFIGGIFGFMSIMTMAMIS,0
4ww3,A,155,172,17,IIFVWLWSVLWAIGPIF,0
4ww3,A,173,199,26,WGAYTLEGVLCNCSFDYISRDSTTRS,0
4ww3,A,200,221,21,ILCMFILGFFGPILIIFFCYF,0
4ww3,A,263,282,19,IVIVSQFLLSWSPYAVVAL,0
4ww3,A,283,299,16,AQFGPLEWVTPYAAQL,0
4ww3,A,300,317,17,VMFAKASAIHNPMIYSV,0
4ww3,A,320,329,9,KFREAISQT,0
2occ,Z,16,34,18,IGLSVTFLSFLLPAGWVL,0
2occ,Z,35,43,8,HLDNYKKS,0
2occ,Z,44,46,2,AA,0
2mv6,A,19,41,22,LSLILVVILVLLTVLALLSHRR,0
2mv6,A,42,49,7,LKQKIWP,0
4yt0,D,28,53,25,SAAVTGAAPPQFDPIAAEKGFKPLH,0
4yt0,D,54,78,24,HGTLFKIERYFAAAMVPLIPAAYF,0
4yt0,D,85,108,23,LCLALALTLHVHWGVWGVVNDYG,0
4yt0,D,109,116,7,PFVLGDT,0
4yt0,D,117,139,22,AAAVRVGAYIFTACLLAGLLYF,0
4yt0,D,146,154,8,TRAFEMVW,0
2v50,C,1,12,11,SKFFIDRPIFA,0
2v50,C,13,25,12,VIALVIMLAGGL,0
2v50,C,344,357,13,GEAILLVFLVMYL,0
2v50,C,358,366,8,LQNFRATL,0
2v50,C,367,382,15,PTIAVPVVLLGTFGV,0
2v50,C,398,409,11,VLAIGLLVDDA,0
2v50,C,410,442,32,VVVENVERVMAEEGLSPREAARKSMGQIQGAL,0
2v50,C,443,455,12,GIAMVLSAVFLP,0
2v50,C,472,485,13,TIVSAMALSVIVA,0
2v50,C,486,511,25,ILTPALCATMLKPIEKGDHGEHKGG,0
2v50,C,512,536,24,FGWFNRMFLSTTHGYERGVASILK,0
2v50,C,537,541,4,RAPY,0
2v50,C,542,555,13,LIYVVIVAGMIWM,0
2v50,C,877,890,13,LSLLVVFLCLAAL,0
2v50,C,891,897,6,ESWSIP,0
2v50,C,898,914,16,SVMLVVPLGVIGALLA,0
2v50,C,930,942,12,LTTIGLSAKNAI,0
2v50,C,943,973,30,IVEFAKELHEQGKGIVEAAIEACRMRLRPI,0
2v50,C,974,988,14,MTSLAFILGVVPLA,0
2v50,C,1003,1016,13,GVIGGMVTATVLA,0
2v50,C,1017,1028,11,FWVPLFYVAVS,0
2v50,C,1029,1030,1,L,0
2v50,C,1031,1052,21,KDEASKQQASVEKGQHHHHHH,0
4nv5,A,1,16,15,ASYLKLKAQEETWLQ,0
4nv5,A,17,20,3,HSR,0
4nv5,A,21,38,17,ILAILAGLGSLLTAYLT,0
4nv5,A,49,53,4,ATGD,0
4nv5,A,56,61,5,DLVLS,0
4nv5,A,71,90,19,TAAVGLLGFLGVLALAVLP,0
4nv5,A,93,102,9,PLVKRWRWP,0
4nv5,A,103,124,21,LFGLVSAMTAFEMYMLYLMVA,0
4nv5,A,130,148,18,MYCTTAIILVAGLGLVTV,0
4nv5,A,149,154,5,GHRWL,0
4nv5,A,156,160,4,GKLA,0
4nv5,A,161,180,19,SYILVAFLTLVTTIGVYAN,0
4nv5,A,283,291,8,LEHHHHHH,0
2o9g,D,-2,4,6,SHMFRK,0
2o9g,D,5,22,17,AAESFGTFWLVFGGSGS,0
2o9g,D,38,55,17,VALAFGLTVLTMAFAVG,0
2o9g,D,56,58,2,IS,0
2o9g,D,59,73,14,GHFNPAVTIGLWAG,0
2o9g,D,74,81,7,RFPAKEV,0
2o9g,D,82,99,17,GYVIAQVVGGIVAAALL,0
2o9g,D,135,152,17,VVELVLSAGFLLVIHGA,0
2o9g,D,153,161,8,DKFAPAGF,0
2o9g,D,162,178,16,PIAIGLACTLIHLISI,0
2o9g,D,182,195,13,TSVNPARSTAVAI,0
2o9g,D,206,223,17,FFWVVPIVGGIIGGLIY,0
2o9g,D,224,230,6,TLLEKR,0
1xqf,C,1,2,1,P,0
1xqf,C,15,32,17,CTALVLFMTIPGIALFY,0
1xqf,C,33,45,12,GLIRGKNVLSML,0
1xqf,C,46,64,18,QVTVTFALVCILWVVYGY,0
1xqf,C,102,118,16,FQGSFACITVGLIVGA,0
1xqf,C,119,126,7,AERIRFS,0
1xqf,C,127,147,20,VLIFVVVWLTLSYIPIAHMV,0
1xqf,C,161,178,17,AGGTVVHINAAIAGLVG,0
1xqf,C,179,181,2,YL,0
1xqf,C,182,194,12,GKRVGFGKEAFK,0
1xqf,C,195,201,6,HNLPMV,0
1xqf,C,202,219,17,TGTAILYIGWFGFNAGS,0
1xqf,C,231,248,17,VNTVVATAAAILGWIFG,0
1xqf,C,249,260,11,WALRGKPSLLG,0
1xqf,C,261,276,15,CSGAIAGLVGVTPAC,0
1xqf,C,282,299,17,GALIIGVVAGLAGLWGV,0
1xqf,C,300,301,1,M,0
1xqf,C,302,310,8,KRLLRVDD,0
1xqf,C,311,313,2,CD,0
1xqf,C,314,332,18,FGVHGVCGIVGCIMTGIF,0
1xqf,C,353,377,24,VQLESIAITIVWSGVVAFIGYKLA,0
1xqf,C,378,386,8,LTVGLRVP,0
1xqf,C,387,418,31,EQEREGLDVNSHGENAYNADQAQQPAQADLE,0
4lmk,D,-1,6,7,SQDMVSP,0
4lmk,D,197,214,17,PNIILPMLFILFISWTA,0
4lmk,D,215,224,9,WSTSYEANV,0
4lmk,D,225,241,16,LVVSTLIAHIAFNILV,0
4lmk,D,254,271,17,GAIIFMIYLFYFVAVIE,0
4lmk,D,272,294,22,TVQHYLKVESQPARAASITRAS,0
4lmk,D,295,312,17,IAFPVVFLLANIILAFL,0
5hi9,D,74,395,321,FDRDRLFSVVSRGVPEELTGLLEYLRWNSKYLTDSAYTEGSTGKTCLMKAVLNLQDGVNACIMPLLQIDKDSGNPKPLVNAQCTDEFYQGHSALHIAIEKRSLQCVKLLVENGADVHLRACGRFFQKHQGTCFYFGELPLSLAACTKQWDVVTYLLENPHQPASLEATDSLGNTVLHALVMIADNSPENSALVIHMYDGLLQMGARLCPTVQLEEISNHQGLTPLKLAAKEGKIEIFRHILQREFSGPYQPLSRKFTEWCYGPVRVSLYDLSSVDSWEKNSVLEIIAFHCKSPNRHRMVVLEPLNKLLQEKWDRLVSRFFF,0
5hi9,D,396,411,15,FACYLVYMFIFTVVA,0
5hi9,D,437,453,16,HILILLGGIYLLLGQL,0
5hi9,D,454,474,20,YFWRRRLFIWISFMDSYFEI,0
5hi9,D,475,489,14,FLLQALLTVLSQVL,0
5hi9,D,500,515,15,LVLSLVLGWLNLLYY,0
5hi9,D,516,522,6,RGFQHT,0
5hi9,D,523,537,14,IYSVMIQKVILRDL,0
5hi9,D,538,555,17,RFLLVYLVFLFGFAVAL,0
5hi9,D,598,610,12,ELFKFTIGMGEL,0
5hi9,D,621,640,19,VLLLLLAYVLLTYVLLLNM,0
5hi9,D,641,715,74,IALMSETVNHVADNSWSIWKLQKAISVLEMENGYWWCRRKKHREGRLLKVGTRGDGTPDERWCFRVEEVNWAAW,0
3llq,A,-27,0,27,DYKDDDDKHHHHHHHHHHENLYFQSYV,0
3llq,A,1,3,2,GR,0
3llq,A,4,22,18,LLAEFFGTFWLVFGGCGS,0
3llq,A,39,58,19,ALAFGLTVLTMAYAVGGIS,0
3llq,A,60,70,10,HFNPAVSVGL,0
3llq,A,71,81,10,VAGRFPASSL,0
3llq,A,82,99,17,PYVIAQVAGAIVAAAAL,0
3llq,A,130,151,21,SALLIEIILTAFFLIVILGST,0
3llq,A,152,158,6,GRVPAG,0
3llq,A,159,176,17,APIAIGLALTLIHLISI,0
3llq,A,180,194,14,TSVNPARSTGQALF,0
3llq,A,201,221,20,QLWLFWLAPIVGGAAGAVIW,0
3llq,A,222,228,6,LFGEKD,0
5hk1,A,12,33,21,ALLLAVAAVLTQVVWLWLGTQ,0
5hk1,A,34,195,161,FVFQREEIAQLARQYAGLDHELAFSRLIVELRRLHPGHVLPDEELQWVFVNAGGWMGAMCLLHASLSEYVLLFGTALGSRGHSGRYWAEISDTIISGTFHQWREGTTKSEVFYPGETVVHGPGEATAVEWGPNTWMVEYGRGVIPSTLAFALADTVFSTQD,0
5hk1,A,196,218,22,LTLFYTLRSYARGLRLELTTYL,0
3b4r,A,1,2,1,N,0
3b4r,A,18,32,14,ITFILFLVVIIGLS,0
3b4r,A,33,40,7,MNNSIFW,0
3b4r,A,41,57,16,VLFILLFVSVVLHELG,0
3b4r,A,97,113,16,GPLVSFIIGIVLLIVS,0
3b4r,A,114,125,11,FFDININGYPL,0
3b4r,A,126,147,21,YTLSLLNLMLGGFNLIPAFPM,0
3b4r,A,170,186,16,ANIGKSLALIMLLFGL,0
3b4r,A,187,190,3,SMN,0
3b4r,A,191,205,14,ILILVSLFVYFGAE,0
3b4r,A,221,224,3,AKD,0
3kj6,A,0,34,34,FGQPGNGSAFLLAPNRSHAPDHDVTQQRDEVWVV,0
3kj6,A,35,38,3,MGI,0
3kj6,A,39,59,20,MSLIVLAIVFGNVLVITAIA,0
3kj6,A,70,88,18,FITSLACADLVMGLAVVP,0
3kj6,A,89,91,2,GA,0
3kj6,A,92,107,15,HILMKMWTFGNFWCE,0
3kj6,A,108,111,3,WTS,0
3kj6,A,112,130,18,DVLCVTASIETLCVIAVD,0
3kj6,A,150,164,14,RVIILMVWIVSGLT,0
3kj6,A,165,202,37,FLPIQMHWYRATHQEAINCYAEETCCDFFTNQAYAIA,0
3kj6,A,204,221,17,IVSFYVPLVIMVFVYSR,0
3kj6,A,243,262,19,NLSQVEQDGRTGHGLRRSS,0
3kj6,A,275,291,16,GIIMGTFTLCWLPFFI,0
3kj6,A,292,306,14,NIVHVIQDNLIRKE,0
3kj6,A,307,310,3,YIL,0
3kj6,A,311,327,16,NWIGYVNSGFNPLIYC,0
3kj6,A,332,338,6,RIAFQE,0
3kj6,A,347,365,18,KAYGNGYSSNGNTGEQSG,0
4res,G,17,27,10,PFYYDYETVR,0
4res,G,28,44,16,GGLIFAALAFIVGLII,0
2qfi,A,1,4,3,NQS,0
2qfi,A,18,36,18,MASLLLLIKIFAWWYTGS,0
2qfi,A,37,41,4,SILA,0
2qfi,A,42,57,15,LVDSLVDIGASLTNL,0
2qfi,A,83,102,19,LAQSMFISGSALFLFLTGI,0
2qfi,A,103,121,18,HLISPTPMTDPGVGVIVT,0
2qfi,A,122,139,17,VALICTIILVSFQRWVV,0
2qfi,A,147,165,18,RADMLHYQSDVMMNGAIL,0
2qfi,A,166,177,11,ALGLSWYGWHR,0
2qfi,A,178,199,21,DALFALGIGIYILYSALRMGY,0
2qfi,A,291,300,9,REGKRSMLS,0
4kk9,B,16,17,1,R,0
4kk9,B,37,61,24,MAAVVGTLVGLAAVAFDKGVAWLQ,0
4kk9,B,62,83,21,QRMGALVHTADNYPLLLTVAF,0
4kk9,B,84,97,13,CSAVLAMFGYFLV,0
4kk9,B,128,142,14,PVKFFGGLGTLGGG,0
4kk9,B,144,156,12,LGRAGPTVQIGG,0
4kk9,B,180,204,24,GAAAGLAAAFNAPLAGILFIIEEM,0
4kk9,B,216,232,16,AVFIGVIMSTIMYRIF,0
4kk9,B,233,252,19,HEVALIDVGKLSDAPLNTL,0
4kk9,B,253,277,24,LYLILGIIFGIFGPIFNKWVLGMQ,0
4kk9,B,290,305,15,WVLMGGAIGGLCGLL,0
4kk9,B,306,337,31,FVAPATSGGGFNLIPIATAGNFSMGMLVFIF,0
4kk9,B,338,351,13,ARVITTLLCFSSG,0
4kk9,B,353,368,15,GGIFAPMLALGTVLG,0
4kk9,B,369,392,23,AFGMVAVELFPQYHLEAGTFAIA,0
4kk9,B,393,415,22,MGALLAASIRAPLTGIILVLEM,0
4kk9,B,416,422,6,DNYQLI,0
4kk9,B,423,439,16,PMIITGLGATLLAQFT,0
4kk9,B,459,461,2,QK,0
5vb8,D,1000,1009,9,MYLRITNIV,0
5vb8,D,1015,1032,17,KFIIYLIVLNGITMGLE,0
5vb8,D,1033,1034,1,S,0
5vb8,D,1035,1041,6,TFMQSF,0
5vb8,D,1042,1044,2,VY,0
5vb8,D,1045,1064,19,TLFNQIVITIFTIEIILRI,0
5vb8,D,1076,1089,13,SLFDFFVVAISLV,0
5vb8,D,1096,1097,1,I,0
5vb8,D,1098,1113,15,RVLRVLRLFRLVTAV,0
5vb8,D,1114,1130,16,QMRKIVSALISVIPGM,0
5vb8,D,1131,1148,17,SVIALMTLFFYIFAIMA,0
5vb8,D,1149,1166,17,QLFGERFPEWFGTLGES,0
5vb8,D,1167,1177,10,YTLFQVMTLE,0
5vb8,D,1178,1195,17,WSMGIVRPLMEVYPYAW,0
5vb8,D,1196,1214,18,FFIPFIFVVTFVMINLVV,0
1zhd,A,-3,-1,2,PA,0
1zhd,A,0,20,20,VGLGITTVLTLTTQSSGSRA,0
1zhd,A,27,50,23,VKAIDIWLAVCLLFVFSALLEYA,0
1zhd,A,51,57,6,VNFVSR,0
1zhd,A,58,72,14,KKKHRLLEHHHHHH,0
4r1i,B,11,23,12,FLRTVEWLGNML,0
4r1i,B,24,40,16,HPVTLFIIFIVLLLIA,0
4r1i,B,90,109,19,TGFAPLGTVLVSLLGVGIA,0
4r1i,B,110,113,3,KSG,0
4r1i,B,114,125,11,ISALMRLLLTK,0
4r1i,B,126,182,56,PRKLTTFMVVFTGILSNTASELGYVVLIPLSAVIFHSLGRHPLAGLAAAFAGVSGG,0
4r1i,B,183,203,20,SANLFLGTIDPLLAGITQQA,0
4r1i,B,214,231,17,PEANWFFMAASTFVIAL,0
4r1i,B,232,276,44,GYFVTEKIVEPQLGPYQSDLSQEEKDIRHSNEITPLEYKGLIWA,0
4r1i,B,277,289,12,VVFIALSALLAW,0
4r1i,B,315,329,14,VVFIFLLFALPGIV,0
4r1i,B,330,341,11,GRITRSLRGER,0
4r1i,B,342,350,8,VVNAMAES,0
4r1i,B,351,368,17,STLGLYLVIIFFAAQFV,0
4r1i,B,376,388,12,GQYIAVKGAVFL,0
4r1i,B,397,412,15,LFIGFILICAFINLM,0
4r1i,B,414,428,14,SASAQWAVTAPIFV,0
4r1i,B,440,452,12,IQAAYRIGDSVT,0
4r1i,B,453,492,39,IITPMMSYFGLIMATVMKYKKDAGVGTLISMMLPYSAFF,0
4r1i,B,493,504,11,IAWIALFCIWV,0
5v5z,A,26,44,18,LGVPFVYNLVWQYLYSLR,0
5v5z,A,45,67,22,DRAPLVFYWIPWFGSAASYGQQ,0
5v5z,A,68,79,11,YEFFESCRQKY,0
5v5z,A,80,429,349,DVFSFMLLGKIMTVYLGPKGHEFVFNAKLSDVSAEDAYKHLTTPVFGKGVIYDCPNSRLMEQKKFAKFALTTDSFKRYVPKIREEILNYFVTDESFKLKEKTHGVANVMKTQPEITIFTASRSLFGDEMRRIFDRSFAQLYSDLDKGFTPINFVFPNLPLPHYWRRDAAQKKISATYMKEIKSRRERGDIDPNRDLIDSLLIHSTYKDGVKMTDQEIANLLIGILMGGQHTSASTSAWFLLHLGEKPHLQDVIYQEVVELLKEKGGDLNDLTYEDLQKLPSVNNTIKETLRMHMPLHSIFRKVTNPLRIPETNYIVPKGHYVLVSPGYAHTSERYFDNPEDFDPTRWDT,0
5v5z,A,442,524,82,DEVDYGFGKVSKGVSSPYLPFGGGRHRCIGEQFAYVQLGTILTTFVYNLRWTIDGYKVPDPDYSSMVVLPTEPAEIIWEKRE,0
4u4t,A,14,38,24,ITDWRPEDPAFWQQRGQRIASRNL,0
4u4t,A,39,61,22,ISVPCLLLAFCVWMLFSAVAVN,0
4u4t,A,73,96,23,LFMLTALPSVSGALLRVPYSFMV,0
4u4t,A,97,101,4,IFGG,0
4u4t,A,102,123,21,RWTAFSTGILIIPCVWLGFAV,0
4u4t,A,131,152,21,VFIIISLLCGFAGANFASSMA,0
4u4t,A,153,167,14,ISFFFPKQKQGGAL,0
4u4t,A,168,191,23,LNGGLGNMGVSVMQLVAPLVVSL,0
4u4t,A,212,234,22,ANASWIWVPFLAIFTIAAWFGM,0
4u4t,A,235,239,4,DLAT,0
4u4t,A,247,254,7,LPVLKRG,0
4u4t,A,255,282,27,LWIMSLLYLATFGSFIGFSAGFAMLSK,0
4u4t,A,290,312,22,LQYAFFGPFIGALARSAGGALS,0
4u4t,A,313,317,4,RLGG,0
4u4t,A,318,339,21,RVTLVNFILMAIFSGLLFLTL,0
4u4t,A,348,373,25,MAFFAVFLALFLTAGLGSGSTFQMI,0
4u4t,A,374,407,33,VIFRKLTMDRVKAEGGSDERAMREAATDTAAAL,0
4u4t,A,408,429,21,FISAIGAIGGFFIPKAFGSSL,0
4u4t,A,436,457,21,GAMKVFLIFYIACVVITWAVY,0
4u4t,A,458,464,6,RHSKKL,0
3wxv,A,121,129,8,RACFKSIF,0
3wxv,A,138,158,20,WTHLLGFVLFLFLGILTMLR,0
3wxv,A,161,170,9,YFMAPLQEK,0
3wxv,A,171,190,19,VFGMFFLGAVLCLSFSWLF,0
3wxv,A,204,223,19,SKLDYSGIALLIMGSFVPW,0
3wxv,A,224,238,14,YYSFYCSPQPRLIY,0
3wxv,A,239,259,20,SIVCVLGISAIIVAQWDRFA,0
3wxv,A,264,280,16,QTRAGVFLGLGLSGVV,0
3wxv,A,281,297,16,TMHFTIAEGFVKATTV,0
3wxv,A,301,321,20,WFFLMAVMYITGAGLYAARI,0
3wxv,A,337,356,19,QIFHVLVVAAAFVHFYGVS,0
3wxv,A,357,373,16,LQEFRYGLEGGCTDDT,0
2o9e,D,-1,1,2,AM,0
2o9e,D,2,27,25,RKLAAESFGTFWLVFGGSGSAVLAA,0
2o9e,D,35,58,23,FAGVALAFGLTVLTMAFAVGHIS,0
2o9e,D,60,76,16,HFNPAVTIGLWAGGRF,0
2o9e,D,78,103,25,KEVVGYVIAQVVGGIVAAALLYLIA,0
2o9e,D,132,154,22,SALVVELVLSAGFLLVIHGATD,0
2o9e,D,155,160,5,FAPAG,0
2o9e,D,161,181,20,APIAIGLALTLIHLISIPVT,0
2o9e,D,183,196,13,SVNPARSTAVAIF,0
2o9e,D,202,228,26,EQLWFFWVVPIVGGIIGGLIYRTLLE,0
2o9e,D,229,230,1,R,0
2hg9,H,1,10,9,VGVTAFGNF,0
2hg9,H,11,15,4,LASL,0
2hg9,H,16,32,16,IYSFWIFLAGLIYYLQ,0
2hg9,H,252,260,8,AAMLAEYA,0
5tta,A,62,165,103,ENIPLFINNSKIQYDDTPYHWPSNVISLTNSSEKAIMDYEITCLAYDKNGKPLELYWDAQNVAADGEVGSVGFSPAGVDYGIVTGISPVSPKSYSHTYRKMQQ,0
5tta,A,166,178,12,PPQDIISMFEKQ,0
5tta,A,185,200,15,NWLKEWKQMEKEYAK,0
5tta,A,201,274,73,NAIAPGKNQNDAFLLFDKWKQSTGEHGVKYIISCVKQVTFNDGSVWKNSAYENWLKSFQGKEVSNSVLENYYK,0
5xam,A,35,52,17,LLLLLTLLGSLLYIWRP,0
5xam,A,53,226,173,EHKNDPWSLWNDQYQFMTLGLDLKGGLRIELAPESGTATRDELDRVKTVIENRINALGVAEPTVTVSGGKRVVVEIPGATPAVQDRARSIIQQTARLEFRIVNSDAKPDPAVREKNPRSSGYTLAQLGPVVATGETIADATSGTDQRSGQWVVNFKTTDAGAKTFGDFTGKNV,0
5xam,A,229,299,70,MAVVLDDQIQSVATINQRLFRDIQISGNFTPEEASQLALVLKSGALPIKIVTAAERSIGPSLGADAIRSG,0
5xam,A,300,317,17,IAALVGIGLVFVMLFAY,0
5xam,A,324,344,20,VGALGLLFSSIIILGILGGF,0
5xam,A,345,351,6,ATLTLP,0
5xam,A,352,368,16,IAGLVLTIGAAVDGNV,0
5xam,A,400,416,16,DVNASHLLSALALYNY,0
5xam,A,417,421,4,TGAV,0
5xam,A,422,443,21,GFAVTLIIGVIASTFSNLVFA,0
5xam,A,477,495,18,TTLSVLLALAGAALVATR,0
5xam,A,496,541,45,LNYGVDFAPGTTLTARVDRQVTTEQLRNSVIGAGVSKVTGQSATI,0
5xam,A,543,599,56,DTTPGQQGQNFTVKVPELNDAEVKQIGAAIGKLPQGQVLASETVGPAVGKELTQKT,0
5xam,A,600,617,17,YAVLLGLGLILVYVGFR,0
5xam,A,624,644,20,GSIIAAIHDVAIAMGLFSLL,0
5xam,A,645,652,7,LEFTVAS,0
5xam,A,653,669,16,AALLTLIGYSLNDSII,0
5xam,A,702,718,16,MTSVSTMLPLISLLIF,0
5xam,A,719,723,4,GPVL,0
5xam,A,724,744,20,DFSLILLVGILVGTYSSIYI,0
4ekw,F,983,1000,17,DYKDDDDKGSLVPRGSH,0
4ekw,F,1001,1003,2,YL,0
4ekw,F,1004,1009,5,ITNIV,0
4ekw,F,1010,1017,7,SSFFTKF,0
4ekw,F,1018,1034,16,IYLIVLNGITMGLETS,0
4ekw,F,1042,1061,19,VYTTLFNQIVITIFTIEII,0
4ekw,F,1062,1078,16,RIYVHRISFFKDPWSL,0
4ekw,F,1079,1094,15,DFFVVAISLVPTSSG,0
4ekw,F,1096,1111,15,ILRVLRVLRLFRLVT,0
4ekw,F,1112,1113,1,V,0
4ekw,F,1114,1124,10,QMRKIVSALI,0
4ekw,F,1125,1133,8,VIPGMLSV,0
4ekw,F,1134,1151,17,ALMTLFFYIFAIMATQL,0
4ekw,F,1163,1180,17,GESFYTLFQVMTLESWS,0
4ekw,F,1194,1213,19,WVFFIPFIFVVTFVMINLV,0
4ekw,F,1214,1219,5,AIIVD,0
4ekw,F,1220,1267,47,MAILNQKEEQHIIDEVQSHEDNINNEIIKLREEIVELKELIKTSLKN,0
2h2s,B,1,17,16,KTDTPSLETPQAARLR,0
2h2s,B,18,39,21,RQLIRQLLERDKTPLAILFMA,0
2h2s,B,40,61,21,VVGTLVGLAAVAFDKGVAWLQ,0
2h2s,B,81,96,15,AFLCSAVLAMFGYFL,0
2h2s,B,97,128,31,RKYAPEAGGSGIPEIEGALEDQRPVRWWRVL,0
2h2s,B,129,142,13,VKFFGGLGTLGGG,0
2h2s,B,144,155,11,LGRAGPTVQIG,0
2h2s,B,156,180,24,NIGRMVLDIFRLKGDEARHTLLAT,0
2h2s,B,181,200,19,AAAGLAAAFNAPLAGILFI,0
2h2s,B,201,216,15,EEMRPQFRYTLISIK,0
2h2s,B,217,232,15,VFIGVIMSTIMYRIF,0
2h2s,B,253,273,20,LYLILGIIFGIFGPIFNKWV,0
2h2s,B,274,284,10,GMQDLLHRVH,0
2h2s,B,285,291,6,GNITKW,0
2h2s,B,292,306,14,LMGGAIGGLCGLLG,0
2h2s,B,335,351,16,IFVARVITTLLCFSSG,0
2h2s,B,353,368,15,GGIFAPMLALGTVLG,0
2h2s,B,392,415,23,GMGALLAASIRAPLTGIILVLEM,0
2h2s,B,422,436,14,LPMIITGLGATLLA,0
2h2s,B,437,458,21,FTGGKPLYSAILARTLAKQEA,0
2h2s,B,459,465,6,QLARSK,0
4ri3,B,17,36,19,KVEDGLFGTSGGIGFTKEN,0
4ri3,B,37,56,19,LFVGRVAMIGFAASLLGEG,0
4ri3,B,79,97,18,LLLFFILFTLLGAIGALG,0
4ri3,B,98,106,8,RGRFVDEP,0
4ri3,B,135,140,5,FTKSN,0
4ri3,B,141,158,17,LFVGRLAQLGFAFSLIG,0
4ri3,B,166,174,8,LAQLNIET,0
4ri3,B,182,198,16,PLVLLNVVFFFIAAIN,0
4ri3,B,199,206,7,GTGKFIT,0
1s8j,A,1,3,2,AQ,0
1s8j,A,4,10,6,TGRPEW,0
1s8j,A,11,31,20,WLALGTALMGLGTLYFLVKG,0
1s8j,A,42,62,20,YAITTLVPAIAFTMYLSMLL,0
1s8j,A,63,64,1,Y,0
1s8j,A,65,77,12,LTMVPFGGEQNP,0
1s8j,A,78,79,1,Y,0
1s8j,A,80,99,19,ARYASWLFTTPLLLLDLAL,0
1s8j,A,104,125,21,QGTILALVGADGIMIGTGLVG,0
1s8j,A,126,136,10,LTKVYSYRFV,0
1s8j,A,137,157,20,WAISTAAMLYILYVLFFGFT,0
1s8j,A,171,191,20,KVLRNVTVVLWSAYPVVWLI,0
1s8j,A,192,203,11,SEGAGIVPLNI,0
1s8j,A,204,225,21,TLLFMVLDVSAKVGFGLILLR,0
1s8j,A,233,249,16,EAPEPSAGDGAAATSD,0
4bon,E,-16,0,16,VLTLLLIICLALEVRS,0
4bon,E,165,171,6,VVEWIH,0
4bon,E,221,243,22,IINIIAPCVLISSLVVLVYFLP,0
4bon,E,244,250,6,QAGGQK,0
4bon,E,251,273,22,TLSISVLLAQTIFLFLIAQKVP,0
4bon,E,284,309,25,YLIFVMFVSLVIVTNCVIVLNVSLR,0
4bon,E,310,314,4,PNTH,0
4bon,E,315,413,98,LSEKIKHLFLEFLPKYLGMHLEPSEETPEKPQPRRRSSFGIMIKAEEYILKKPRSELMFEEQKDRHGLKRVNKMTSDIDIGTTVDLYKDLANFAPEIK,0
4bon,E,414,446,32,CVEACNFIAKSTKEQNDSGSENENWVLIGKVI,0
4bon,E,447,473,26,KACFWIALLLFSLGTLAIFLTGHLNQ,0
4bon,E,477,488,11,PFPGDPRKYVP,0
3ejz,B,1,17,16,KTDTPSLETPQAARLR,0
3ejz,B,18,36,18,RQLIRQLLERDKTPLAIL,0
3ejz,B,37,61,24,MAAVVGTLVGLAAVAFDKGVAWLQ,0
3ejz,B,84,97,13,CSAVLAMFGYFLV,0
3ejz,B,98,128,30,KYAPEAGGSGIPEIEGALEDQRPVRWWRVL,0
3ejz,B,129,142,13,VKFFGGLGTLGGG,0
3ejz,B,144,156,12,LGREGPTVQIGG,0
3ejz,B,157,180,23,IGRMVLDIFRLKGDEARHTLLAT,0
3ejz,B,181,203,22,AAAGLAAAFNAPLAGILFIIEV,0
3ejz,B,204,215,11,RPQFRYTLISI,0
3ejz,B,216,232,16,AVFIGVIMSTIMYRIF,0
3ejz,B,253,277,24,LYLILGIIFGIFGPIFNKWVLGMQ,0
3ejz,B,278,284,6,LLHRVH,0
3ejz,B,285,289,4,GNIT,0
3ejz,B,290,305,15,WVLMGGAIGGLCGLL,0
3ejz,B,317,324,7,NLIPIAT,0
3ejz,B,338,351,13,ARVITTLLCFSSG,0
3ejz,B,353,368,15,GGIFAPMLALGTVLG,0
3ejz,B,392,415,23,GMGALLAASIRAPLTGIILVLEM,0
3ejz,B,423,439,16,PMIITGLGATLLAQFT,0
3ejz,B,440,458,18,GKPLYSAILARTLAKQEA,0
3ejz,B,459,473,14,QLARSKAASASENT,0
3b9w,C,1,7,6,AVAPAE,0
3b9w,C,19,36,17,SINILAMLLVGFGFLMV,0
3b9w,C,37,44,7,VRRYGFS,0
3b9w,C,45,63,18,TTGTYLVVATGLPLYILL,0
3b9w,C,82,99,17,YAEFAVATGLIAMGAVL,0
3b9w,C,100,104,4,RLRV,0
3b9w,C,105,122,17,QYALLALFIVPVYLLNE,0
3b9w,C,141,159,18,SIAIHAFGAYFGLGVSIA,0
3b9w,C,160,178,18,TTAAQRAQPIESDATSDR,0
3b9w,C,179,195,16,SMLGSMVLWLFWPSFA,0
3b9w,C,209,228,19,NTLLALCGATLATYFLSAL,0
3b9w,C,229,236,7,HKGKASI,0
3b9w,C,237,254,17,DMANAALAGGVAIGSVC,0
3b9w,C,260,277,17,GAFVIGLLGGAISVVGF,0
3b9w,C,278,292,14,FIQPMLESKAKTID,0
3b9w,C,293,313,20,CGVHNLHGLPGLLGGFSAIL,0
3b9w,C,323,347,24,TGIGITLALALIGGVIAGALIKLT,0
3b9w,C,348,369,21,TTKQAYEDSHEFIHLAGPEDE,0
3b9w,C,370,407,37,KAERLVLEAKTEIQGLKNRIDAAVLSAKSEGHHHHHH,0
3eh3,C,5,27,22,KGALAVILVLTLTILVFWLGVY,0
3eh3,C,28,34,6,VFFARG,0
4lcu,F,-6,21,27,MHHHHHHPPMLSGLLARLVKLLLGRHG,0
4lcu,F,31,50,19,ATVLLVIVLLAGSYLAVLA,0
4lcu,F,51,62,11,RGAPGAQLITY,0
4lcu,F,63,79,16,RALWWSVETATTVGYG,0
4lcu,F,80,86,6,LYPVTL,0
4lcu,F,87,107,20,GRLVAVVVMVAGITSFGLVT,0
5h2m,C,4,11,7,TGRPEWI,0
5h2m,C,12,28,16,LALGTALMGLGTLYFL,0
5h2m,C,47,61,14,LVPAIAFTMYLSML,0
5h2m,C,62,79,17,GYGLTMVPFGGEQNPIY,0
5h2m,C,80,94,14,ARYADWLFTTPLLL,0
5h2m,C,111,126,15,VGADGIMIGTGLVGA,0
5h2m,C,127,134,7,TKVYSYR,0
5h2m,C,135,150,15,VWWAISTAAMLYILY,0
5h2m,C,178,192,14,VVLWSAYPVVWLIG,0
5h2m,C,193,203,10,EGAGIVPLNI,0
5h2m,C,204,220,16,TLLFMVLDVSAKVGFG,0
5dqq,B,30,57,27,FQKAAALVDLAEDGIGLPVEILDQSSF,0
5dqq,B,60,73,13,ARYYFIFTRLDLI,0
5dqq,B,74,90,16,SLNYFALLFLNFFEQP,0
5dqq,B,122,137,15,YEVITLAILLVHTFF,0
5dqq,B,138,153,15,ISYEGSRIFWTSRLN,0
5dqq,B,154,169,15,VKVACVVILFVDVLV,0
5dqq,B,185,203,18,IAPYVRVIIFILSIRELR,0
5dqq,B,204,216,12,TLVLLSGMLGTY,0
5dqq,B,217,237,20,NILALWMLFLLFASWIAFVM,0
5dqq,B,255,265,10,YQMFILFTTS,0
5dqq,B,272,277,5,PAYKS,0
5dqq,B,281,304,23,SVFFVLYVLIGVYFVTNLILAVV,0
5dqq,B,305,407,102,DSFKEQLAKQVSGMDQMKRRMLEKAFGLIDSDKNGEIDKNQCIKLFEQLTNYRTLPKISKEEFGLIFDELDDTRDFKINKDEFADLCQAIALRFQKEEVPSL,0
5dqq,B,413,417,4,IYHS,0
5dqq,B,418,427,9,LSQQLRAFV,0
5dqq,B,428,433,5,SPNFG,0
5dqq,B,434,449,15,AISFILIINFIAVVV,0
5dqq,B,467,484,17,EFVFGWIYVLEMALKIY,0
5dqq,B,485,487,2,YG,0
5dqq,B,488,493,5,ENYWR,0
5dqq,B,494,495,1,G,0
5dqq,B,496,513,17,NRFDFLVTWVIVIGETA,0
5dqq,B,531,545,14,YLLLARMLRLIRLL,0
5dqq,B,546,551,5,NVQRY,0
5dqq,B,552,561,9,AFIATFITL,0
5dqq,B,562,582,20,PSLMPYLGTIFCVLCIYCSI,0
5dqq,B,650,672,22,YFVSFYVITILLLLNLVVAFVL,0
5dqq,B,673,703,30,AFFTELDLEEEEKCQGQDSQEKRNRRRSAG,0
2zzl,C,-12,4,16,LELLPTAVEGVSQAQI,0
2zzl,C,5,10,5,GRPEW,0
2zzl,C,11,29,18,WLALGTALMGLGTLYFLV,0
2zzl,C,45,62,17,TTLVPAIAFTMYLSMLL,0
2zzl,C,63,79,16,YGLTMVPFGGEQNPIY,0
2zzl,C,80,95,15,ARYADWLFTTPLLLL,0
2zzl,C,110,127,17,LVGADGIMIGTGLVGAL,0
2zzl,C,128,133,5,KVYSY,0
2zzl,C,134,152,18,FVWWAISTAAMLYILYVL,0
2zzl,C,175,192,17,NVTVVLWSAYPVVWLIG,0
2zzl,C,193,203,10,EGAGIVPLNI,0
2zzl,C,204,222,18,TLLFMVLDVSAKVGFGLI,0
2zzl,C,233,249,16,EAPEPSAGDGAAATSD,0
3l72,W,5,12,7,LRQAYSA,0
3l72,W,13,19,6,FRRTST,0
3l72,W,20,36,16,ALTVVLGAVLFERAFD,0
3l72,W,63,64,1,E,0
4pd6,C,-5,4,9,PAVPRMSLF,0
4pd6,C,6,19,13,CCGMAVLLGIAVL,0
4pd6,C,20,32,12,SSNRKAINLRTV,0
4pd6,C,33,46,13,GAFAIQFSLGAFI,0
4pd6,C,50,78,28,WGQELLRGFSDAVSNVINYGNDGTSFLF,0
4pd6,C,103,118,15,TLIFFSALISVLYYL,0
4pd6,C,120,136,16,MQWVIRILGGGLQKAL,0
4pd6,C,137,177,40,TSRAESMSAAANIFVGQTEAPLVVRPFVPKMTQSELFAVM,0
4pd6,C,178,191,13,GGLASIAGGVLAG,0
4pd6,C,203,217,14,AASFMAAPGGLLFA,0
4pd6,C,218,229,11,LMMPETEKPQD,0
4pd6,C,230,240,10,EDITLDGGDD,0
4pd6,C,241,242,1,P,0
4pd6,C,243,274,31,NVIDAAAGGASAGLQLALNVGAMLIAFIGLI,0
4pd6,C,275,286,11,LINGMLGGIGG,0
4pd6,C,295,303,8,EMLLGWLF,0
4pd6,C,362,375,13,LCGFANLSSIAIL,0
4pd6,C,376,395,19,GGLGSLAPKRRGDIARMGV,0
4pd6,C,396,412,16,AVIAGTLSNLMAATIA,0
4pd6,C,417,418,1,F,0
1dxz,A,243,264,21,TLSISVLLSLTVFLLVIVELI,0
1dxz,A,265,267,2,ST,0
5c6n,A,20,43,23,SLSIPAMIGMFVMALYNVVNTIF,0
5c6n,A,44,56,12,SYAVGIEGVAGV,0
5c6n,A,57,78,21,IAFPIMMIMMSMAGALGIGGA,0
5c6n,A,101,123,22,TVILVLSVIGFISAFTLLGPAL,0
5c6n,A,124,136,12,LFGATSVTQGYA,0
5c6n,A,137,162,25,DYLFPILLGSIFFFFAFAANNIIRS,0
5c6n,A,166,188,22,TFAMVTMIVPAVLNILLDVLFI,0
5c6n,A,189,195,6,GLNMGV,0
5c6n,A,196,216,20,GASIATVIAQASVTGLVLRY,0
5c6n,A,242,263,21,LVGLPAFVQQSSASLMMIAIN,0
5c6n,A,264,278,14,MLLRFGSDFYVGVF,0
5c6n,A,279,300,21,LVQRIMMFVMMPMMGIMQAMQ,0
5c6n,A,323,345,22,KVATIFSIGIFALLMLFPEALL,0
5c6n,A,346,359,13,VFTADREVIQAGV,0
5c6n,A,360,384,24,AMHILFCVTFLIGAQIVAGGLYQS,0
5c6n,A,389,410,21,QALILSLSRQIIFLIPLVLIL,0
5c6n,A,411,417,6,HIFGLS,0
5c6n,A,418,438,20,VWWAFPIADVLSFILTVVLL,0
1f6n,H,1,10,9,VGVTAFGNF,0
1f6n,H,12,31,19,ASLAIYSFWIFLAGLIYYL,0
1f6n,H,32,250,218,TENMREGYPLENEDGTPAANQGPFPLPKPKTFILPHGRGTLTVPGPESEDRPIALARTAVSEGFPHAPTGDPMKDGVGPASWVARRDLPELDGHGHNKIKPMKAAAGFHVSAGKNPIGLPVRGCDLEIAGKVVDIWVDIPEQMARFLEVELKDGSTRLLPMQMVKVQSNRVHVNALSSDLFAGIPTIKSPTEVTLLEEDKICGYVAGGLMYAAPKRKS,0
1f6n,H,251,260,9,VAAMLAEYA,0
4ikz,A,1,2,1,A,0
4ikz,A,27,46,19,LFFTEFWERFSYYGMRAIL,0
4ikz,A,47,68,21,YYMYYEVSKGGLGLDEHLALA,0
4ikz,A,69,88,19,MSIYGALVYMSGIIGGWLA,0
4ikz,A,95,112,17,RAVFYGGLLIMAGHIAL,0
4ikz,A,113,122,9,IPGGVAALF,0
4ikz,A,123,140,17,SMALIVLGTGLLKPNVS,0
4ikz,A,161,177,16,YMGINLGAFLAPLVVG,0
4ikz,A,178,188,10,AGMKYNFHLG,0
4ikz,A,189,207,18,GLAAVGMFLGLVVFVATR,0
4ikz,A,229,245,16,AAAIMAVGAVVIAVLL,0
4ikz,A,247,253,6,LIPNGW,0
4ikz,A,254,258,4,TVET,0
4ikz,A,259,277,18,ISLVGILGIIIPIIYFVV,0
4ikz,A,296,317,21,PLFVASAMFWAIQQQGSTILA,0
4ikz,A,318,336,18,YADKRTQLDVAGIHLSPA,0
4ikz,A,337,353,16,FQSLNPLFIIILAPVF,0
4ikz,A,369,386,17,KFALGLLFAGLSFIVIL,0
4ikz,A,387,400,13,PGHLSGGGLVHPI,0
4ikz,A,401,418,17,LVLSYFIVVLGELCLSP,0
4ikz,A,438,454,16,LWFLSNAAAQAINAQL,0
4ikz,A,455,466,11,RFYTPENETAY,0
4ikz,A,467,484,17,GTIGGAALVLGLILLAI,0
4ikz,A,495,507,12,RLESSGENLYFQ,0
1dze,C,1,5,4,AQIT,0
1dze,C,6,11,5,RPEWI,0
1dze,C,12,28,16,LALGTALMGLGTLYFL,0
1dze,C,47,61,14,LVPAIAFTMYLSML,0
1dze,C,62,79,17,GYGLTMVPFGGEQNPIY,0
1dze,C,80,94,14,ARYADWLFTTPLLL,0
1dze,C,112,126,14,GADGIMIGTGLVGA,0
1dze,C,127,134,7,TKVYSYR,0
1dze,C,135,149,14,VWWAISTAAMLYIL,0
1dze,C,178,192,14,VVLWSAYPVVWLIG,0
1dze,C,193,203,10,EGAGIVPLNI,0
1dze,C,204,220,16,TLLFMVLDVSAKVGFG,0
1dze,C,231,248,17,EAEAPEPSAGDGAAATS,0
5m8j,A,31,37,6,WKTLLA,0
5m8j,A,41,55,14,GALVAVGYMDPGNW,0
5m8j,A,56,69,13,TSITGGQNFQYLL,0
5m8j,A,70,85,15,SIIVISSLLAMLLQN,0
5m8j,A,98,104,6,AQAIRA,0
5m8j,A,113,137,24,FWILTELAIMATDIAEVIGAAIAL,0
5m8j,A,138,146,8,LLFKIPIF,0
5m8j,A,147,162,15,AVVITVLDVFLLLLL,0
5m8j,A,170,187,17,EALVVCLIFVILFVFLY,0
5m8j,A,188,195,7,IILSQPA,0
5m8j,A,196,202,6,HQVAKG,0
5m8j,A,203,222,19,IPSWASVQTSPKIGGQTPL,0
5m8j,A,223,241,18,ASLGIIGATIMPANLFLH,0
5m8j,A,268,284,16,SNIQLSLAMVVNALLL,0
5m8j,A,285,331,46,MGVAVFKSGAVQDPSFFGLYQALSNPDMVSNPVLAEAARSGVLSTL,0
5m8j,A,332,351,19,AVALLASGQNSTITGTITG,0
5m8j,A,366,382,16,LRRLVTRLIAIIPVVV,0
5m8j,A,383,402,19,VAITSHQGSLDEHQALNNL,0
5m8j,A,403,419,16,NNSQVFLALALPFSIV,0
5m8j,A,444,465,21,GWLTVIILTLLNLISISSQIA,0
5m8j,A,466,479,13,FFGDNPSSQDLLL,0
5m8j,A,480,497,17,QVISIGIILAMIGLLIW,0
1afo,B,62,73,11,QLAHHFSEPEI,0
1afo,B,74,99,25,LIIFGVMAGVIGTILLISYGIRRLI,0
2c75,A,1,2,1,S,0
2c75,A,3,108,105,KCDVVVVGGGISGMAAAKLLHDSGLNVVVLEARDRVGGRTYTLRNQKVKYVDLGGSYVGPTQNRILRLAKELGLETYKVNEVERLIHHVKGKSYPFRGPFPPVWN,0
2c75,A,109,127,18,ITYLDHNNFWRTMDDMGR,0
2c75,A,128,485,357,IPSDAPWKAPLAEEWDNMTMKELLDKLCWTESAKQLATLFVNLCVTAETHEVSALWFLWYVKQCGGTTRIISTTNGGQERKFVGGSGQVSERIMDLLGDRVKLERPVIYIDQTRENVLVETLNHEMYEAKYVISAIPPTLGMKIHFNPPLPMMRNQMITRVPLGSVIKCIVYYKEPFWRKKDYCGTMIIDGEEAPVAYTLDDTKPEGNYAAIMGFILAHKARKLARLTKEERLKKLCELYAKVLGSLEALEPVHYEEKNWCEEQYSGGCYTTYFPPGILTQYGRVLRQPVDRIYFAGTETATHWSGLMEGAVEAGERAAREILHAMGKIPEDEIWQSEPESVDVPAQPITTTFLERH,0
2c75,A,486,498,12,PSVPGLLRLIGL,0
2c75,A,502,520,18,SATALGFLAHKRGLLVRV,0
1ojc,A,1,2,1,S,0
1ojc,A,3,108,105,KCDVVVVGGGISGMAAAKLLHDSGLNVVVLEARDRVGGRTYTLRNQKVKYVDLGGSYVGPTQNRILRLAKELGLETYKVNEVERLIHHVKGKSYPFRGPFPPVWN,0
1ojc,A,109,126,17,ITYLDHNNFWRTMDDMG,0
1ojc,A,127,490,363,EIPSDAPWKAPLAEEWDNMTMKELLDKLCWTESAKQLATLFVNLCVTAETHEVSALWFLWYVKQCGGTTRIISTTNGGQERKFVGGSGQVSERIMDLLGDRVKLERPVIYIDQTRENVLVETLNHEMYEAKYVISAIPPTLGMKIHFNPPLPMMRNQMITRVPLGSVIKCIVYYKEPFWRKKDYCGTMIIDGEEAPVAYTLDDTKPEGNYAAIMGFILAHKARKLARLTKEERLKKLCELYAKVLGSLEALEPVHYEEKNWCEEQYSGGCYTTYFPPGILTQYGRVLRQPVDRIYFAGTETATHWSGYMEGAVEAGERAAREILHAMGKIPEDEIWQSEPESVDVPAQPITTTFLERHLPSVP,0
1ojc,A,491,501,10,LLRLIGLTTI,0
1ojc,A,502,520,18,SATALGFLAHKRGLLVRV,0
5jdh,A,4,21,17,GVGYFLLGLILLYYGSD,0
5jdh,A,22,42,20,FVLGSERIARHFNVSNFVIG,0
5jdh,A,43,58,15,TVMAIGTSLPEILTS,0
5jdh,A,74,91,17,IGSCICNIGLVLGLSAI,0
5jdh,A,92,103,11,SPIIVDKNLQK,0
5jdh,A,104,118,14,ILVYLLFVIFAAVI,0
5jdh,A,128,142,14,VVLLILFIIYLRWT,0
5jdh,A,143,151,8,KNGSAEIE,0
5jdh,A,156,168,12,NNPSVVFSLVLL,0
5jdh,A,169,186,17,IGLIGVLVGAELFVDGA,0
5jdh,A,205,219,14,AFGTSLPELMVSLA,0
5jdh,A,220,229,9,AKRNLGGMV,0
5jdh,A,230,247,17,GNVIGSNIADIGGALAV,0
5jdh,A,261,275,14,AVLVIMSLLLYLFA,0
5jdh,A,276,282,6,YSKIGR,0
5jdh,A,283,297,14,QGILFLALYIIAIA,0
5aw4,G,4,24,20,GPDNDERFTYDYYRLRVVGL,0
5aw4,G,25,42,17,VAAVLCVIGIIILLAGK,0
4ycm,A,1,54,53,EAAHSKSTEECLAYFGVSETTGLTPDQVKRHLEKYGHNELPAEEGKSLWELVI,0
4ycm,A,55,73,18,QFEDLLVRILLLAACISF,0
4ycm,A,89,107,18,EPFVILLILIANAIVGVW,0
4ycm,A,108,253,145,ERNAENAIEALKEYEPEMGKVYRADRKSVQRIKARDIVPGDIVEVAVGDKVPADIRILSIKSTTLRVDQSILTGESVSVIKHTEPVPDPRAVNQDKKNMLFSGTNIAAGKALGIVATTGVSTEIGKIRDQMAATEQDKTPLQQKL,0
4ycm,A,254,276,22,EFGEQLSKVISLICVAVWLINI,0
4ycm,A,296,318,22,KIAVALAVAAIPEGLPAVITTC,0
4ycm,A,319,759,440,ALGTRRMAKKNAIVRSLPSVETLGCTSVICSDKTGTLTTNQMSVCKMFIIDKVDGDFCSLNEFSITGSTYAPEGEVLKNDKPIRSGQFDGLVELATICALCNDSSLDFNETKGVYEKVGEATETALTTLVEKMNVFNTEVRNLSKVERANACNSVIRQLMKKEFTLEFSRDRKSMSVYCSPAKSSRAAVGNKMFVKGAPEGVIDRCNYVRVGTTRVPMTGPVKEKILSVIKEWGTGRDTLRCLALATRDTPPKREEMVLDDSSRFMEYETDLTFVGVVGMLDPPRKEVMGSIQLCRDAGIRVIMITGDNKGTAIAICRRIGIFGENEEVADRAYTGREFDDLPLAEQREACRRACCFARVEPSHKSKIVEYLQSYDEITAMTGDGVNDAPALKKAEIGIAMGSGTAVAKTASEMVLADDNFSTIVAAVEEGRAIYNNMKQ,0
4ycm,A,760,781,21,IRYLISSNVGEVVCIFLTAAL,0
4ycm,A,787,808,21,IPVQLLWVNLVTDGLPATALG,0
4ycm,A,809,832,23,NPPDLDIMDRPPRSPKEPLISGW,0
4ycm,A,833,852,19,FFRYMAIGGYVGAATVGAA,0
4ycm,A,898,916,18,MALSVLVTIEMCNALNSL,0
4ycm,A,917,926,9,ENQSLMRMP,0
4ycm,A,927,950,23,WVNIWLLGSICLSMSLHFLILYV,0
4ycm,A,951,957,6,PLPMIF,0
4ycm,A,967,987,20,LMVLKISLPVIGLDEILKFI,0
4ycm,A,988,994,6,RNYLEG,0
4uwe,D,1,8,7,GDGGEGE,0
4uwe,D,128,129,1,D,0
4uwe,D,692,705,13,SPYPGGGEGWGGN,0
4uwe,D,799,850,51,FKFLPPPGYAPCHEAVLPRERLRLEPIKEYRREGPRGPHLVGPSRCLSHTD,0
4uwe,D,1009,1014,5,VQDIP,0
4uwe,D,1054,1072,18,PPDQEPSQVENQSRWDRV,0
4uwe,D,1210,1419,209,LRFFAICGLQEGFEPFAINMQRPVTTWFSKSLPQFEPVPPEHPHYEVARMDGTVDTPPCLRLAHRTWGSQNSLVEMLFLRLSLPVQFHQHFRCTAGATPLAPPGLQPPAEDEARAAEPDPDYENLRRSAGGWGEAEGGKEGTAKEGTPGGTPQPGVEAQPVRAENEKDATTEKNKKRGFLFKAKKAAMMTQPPATPALPRLPHDVVPAD,0
4uwe,D,1479,1490,11,QGNVHSSLKCS,0
4uwe,D,1498,1508,10,DFVSPGQQGR,0
4uwe,D,2831,2854,23,ERTEKKKTRKISQTAQTYDPREG,0
2qpd,C,2,5,3,EKP,0
2qpd,C,6,23,17,GALAVILVLTLTILVFW,0
5avq,G,4,22,18,GPDNDERFTYDYYRLRVV,0
5avq,G,23,39,16,LIVAAVLCVIGIIILL,0
2c8l,A,49,56,7,WELVIEQ,0
2c8l,A,60,76,16,LVRILLLAACISFVLA,0
2c8l,A,77,87,10,FEEGEETITA,0
2c8l,A,88,103,15,VEPFVILLILIANAI,0
2c8l,A,258,276,18,QLSKVISLICVAVWLINI,0
2c8l,A,277,295,18,HFNDPVHGGSWIRGAIYY,0
2c8l,A,296,314,18,KIAVALAVAAIPEGLPAV,0
2c8l,A,761,780,19,RYLISSNVGEVVCIFLTAA,0
2c8l,A,781,785,4,GLPE,0
2c8l,A,786,807,21,LIPVQLLWVNLVTDGLPATAL,0
2c8l,A,834,851,17,FRYMAIGGYVGAATVGA,0
2c8l,A,852,899,47,AWWFMYAEDGPGVTYHQLTHFMQCTEDHPHFEGLDCEIFEAPEPMTM,0
2c8l,A,900,916,16,LSVLVTIEMCNALNSL,0
2c8l,A,931,948,17,WLLGSICLSMSLHFLIL,0
2c8l,A,949,970,21,VDPLPMIFKLKALDLTQWLMV,0
2c8l,A,971,987,16,KISLPVIGLDEILKFI,0
4lz6,A,21,41,20,LSIPAMIGMFVMALYNVVDT,0
4lz6,A,42,56,14,FISYAVGIEGVAGV,0
4lz6,A,57,78,21,IAFPIMMIMMSMAGALGIGGA,0
4lz6,A,98,119,21,NILTVILVLSVIGFISAFTLL,0
4lz6,A,120,139,19,PALQLFGATSVTQGYATDY,0
4lz6,A,140,162,22,FPILLGSIFFFFAFAANNIIRS,0
4lz6,A,166,187,21,TFAMVTMIVPAVLNILLDVLF,0
4lz6,A,188,197,9,FGLNMGVLG,0
4lz6,A,198,217,19,SIATVIAQASVTGLVLRYF,0
4lz6,A,242,262,20,LVGLPAFVQQSSASLMMIAI,0
4lz6,A,263,278,15,SMLLRFGSDFYVGVF,0
4lz6,A,279,300,21,LVQRIMMFVMMPMMGIMQAMQ,0
4lz6,A,323,344,21,KVATIFSIGIFALLMLFPEAL,0
4lz6,A,345,360,15,RVFTADREVIQAGVS,0
4lz6,A,361,383,22,MHILFCVTFLIGAQIVAGGLYQ,0
4lz6,A,389,410,21,QALILSLSRQIIFLIPLVLIL,0
4lz6,A,411,417,6,HIFGLS,0
4lz6,A,418,438,20,VWWAFPIADVLSFILTVVLL,0
4n7x,A,-4,4,8,AHHHMLVK,0
4n7x,A,5,21,16,TRLFPVWALLLSVAAY,0
4n7x,A,30,47,17,GPYVGPLLMLIMFAMGV,0
4n7x,A,48,50,2,LR,0
4n7x,A,51,59,8,DDFKRVLS,0
4n7x,A,60,61,1,P,0
4n7x,A,62,82,20,PVAAATFLHYLIMPLTAWIL,0
4n7x,A,97,115,18,LVGSVASGTASNVMIYLA,0
4n7x,A,116,119,3,GDV,0
4n7x,A,120,140,20,LSVTISAVSTLVGVFATPLL,0
4n7x,A,152,171,19,VVGMLKSILQIVVIPITAG,0
4n7x,A,172,178,6,VIHHTF,0
4n7x,A,179,185,6,KTVKRI,0
4n7x,A,186,188,2,PY,0
4n7x,A,189,205,16,PAMSMVCILAIISAVV,0
4n7x,A,221,241,20,AVILHNGIGLLSGYWGGKLF,0
4n7x,A,242,248,6,FDESTC,0
4n7x,A,249,264,15,TLAIAVGMQNSGLAA,0
4n7x,A,279,296,17,ALFSVWHNLSGSLLAGY,0
4n7x,A,297,301,4,SGKP,0
4n7x,A,302,307,5,KKDQE,0
3utw,A,1,4,3,AQI,0
3utw,A,5,9,4,GRPE,0
3utw,A,10,33,23,IWLALGTALMGLGTLYFLVKGMG,0
3utw,A,41,62,21,FYAITTLVAAIAFTMFLSMLL,0
3utw,A,63,79,16,YGLTMVPFGGEQNPIY,0
3utw,A,80,99,19,ARYADWLFTTPLLLLDLAL,0
3utw,A,104,126,22,QGTILALVGADGIMIGTGLVGA,0
3utw,A,127,134,7,TKVYSYR,0
3utw,A,135,157,22,VWWAISTAAMLYILYVLFFGFT,0
3utw,A,172,192,20,VLRNVTVVLWSAYPVVWLIG,0
3utw,A,193,201,8,EGAGIVPL,0
3utw,A,202,225,23,IETLLFMVLDVSAKVGFGLILLR,0
3utw,A,232,249,17,AEAPEPSAGDGAAATSD,0
3aef,D,35,40,5,SKAAS,0
3aef,D,41,60,19,HWTGERVVSVLLLGLLPAA,0
3aef,D,69,89,20,YSLAAALTLHGHWGIGQVVT,0
3aef,D,90,98,8,YVRGDALQ,0
3aef,D,99,118,19,AAKAGLLALSAFTFAGLCY,0
3aef,D,126,134,8,CKAVAMLW,0
5iwk,D,327,349,22,FCVLGAIYVLYIICFTMCCVYR,0
5iwk,D,350,382,32,LKPRITNRTNPRDNTLLQQKLLQEAYVTPKDD,0
5iwk,D,383,408,25,RLVGELVSIVGAVIILLVEIPDIFR,0
5iwk,D,422,444,22,PFHVIIVTYAFMVLVTMVMRLT,0
5iwk,D,445,448,3,SDG,0
5iwk,D,449,470,21,VVPMSFALVLGWCNVMYFARG,0
5iwk,D,487,511,24,DLMRFCWQMAVVILGFASAFYIIF,0
5iwk,D,512,524,12,TEDPDELGHFYD,0
5iwk,D,525,544,19,PMALFSTFELFLTIIDGPA,0
5iwk,D,545,551,6,YDVDLP,0
5iwk,D,552,576,24,MYSITYAAFAIIATLLMLNLLIAM,0
5iwk,D,585,606,21,HERDELWRAQVVATTVMLERK,0
2eau,A,49,54,5,ELVIE,0
2eau,A,55,73,18,FEDLLVRILLLAACISFV,0
2eau,A,74,89,15,AWFEEGEETITAFVE,0
2eau,A,90,108,18,FVILLILIANAIVGVWQE,0
2eau,A,254,276,22,FGEQLSKVISLICVAVWLINIG,0
2eau,A,277,295,18,FNDPVHGGSWIRGAIYYF,0
2eau,A,296,318,22,IAVALAVAAIPEGLPAVITTCL,0
2eau,A,760,781,21,RYLISSNVGEVVCIFLTAALG,0
2eau,A,782,785,3,PEA,0
2eau,A,786,808,22,IPVQLLWVNLVTDGLPATALGF,0
2eau,A,830,852,22,WLFFRYMAIGGYVGAATVGAAA,0
2eau,A,853,897,44,WFMYAEDGPGVTYHQLTHFMQCTEDHPHFEGLDCEIFEAPEPMT,0
2eau,A,898,916,18,ALSVLVTIEMCNALNSLS,0
2eau,A,927,948,21,VNIWLLGSICLSMSLHFLILY,0
2eau,A,949,950,1,D,0
2eau,A,951,956,5,LPMIF,0
2eau,A,957,966,9,LKALDLTQW,0
2eau,A,967,987,20,MVLKISLPVIGLDEILKFIA,0
3sya,D,50,54,4,AKRK,0
3sya,D,82,88,6,FTTLVD,0
3sya,D,90,116,26,WRFNLLIFVMVYTVTWLFFGMIWWLI,0
3sya,D,117,144,27,YIRGDMDHIEDPSWTPCVTNLNGFVSA,0
3sya,D,145,157,12,LFSIETETTIGY,0
3sya,D,158,167,9,YRVITDKCP,0
3sya,D,168,195,27,GIILLLIQSVLGSIVNAFMVGCMFVKI,0
3sya,D,198,204,6,KKRAET,0
3sya,D,383,389,6,LEVLFQ,0
4fa7,C,1,3,2,EE,0
4fa7,C,4,6,2,PK,0
4fa7,C,7,24,17,ALAVILVLTLTILVFWL,0
5b34,A,7,9,2,PE,0
5b34,A,10,31,21,IWLALGTALMGLGTLYFLVKG,0
5b34,A,43,66,23,AITTLVPAIAFTMYLSMLLGYGL,0
5b34,A,67,78,11,MVPFGGEQNPI,0
5b34,A,79,99,20,WARYADWLFTTPLLLLDLAL,0
5b34,A,104,127,23,QGTILALVGADGIMIGTGLVGAL,0
5b34,A,128,135,7,KVYSYRF,0
5b34,A,136,158,22,WWAISTAAMLYILYVLFFGFTS,0
5b34,A,171,192,21,KVLRNVTVVLWSAYPVVWLIG,0
5b34,A,193,202,9,EGAGIVPLN,0
5b34,A,203,225,22,ETLLFMVLDVSAKVGFGLILLR,0
2r4s,A,24,36,12,TQQRDEVWVVGM,0
2r4s,A,37,43,6,IVMSLI,0
2r4s,A,44,59,15,LAIVFGNVLVITAIA,0
2r4s,A,70,83,13,FITSLACADLVMG,0
2r4s,A,84,90,6,AVVPFG,0
2r4s,A,91,107,16,AHILMKMWTFGNFWCE,0
2r4s,A,108,116,8,WTSIDVLC,0
2r4s,A,117,130,13,TASIETLCVIAVD,0
2r4s,A,150,161,11,RVIILMVWIVS,0
2r4s,A,162,164,2,LT,0
2r4s,A,165,202,37,FLPIQMHWYRATHQEAINCYANETCCDFFTNQAYAIA,0
2r4s,A,203,206,3,SIV,0
2r4s,A,207,221,14,FYVPLVIMVFVYSR,0
2r4s,A,243,263,20,NLSQVEQDGRTGHGLRRSSK,0
2r4s,A,274,286,12,LGIIMGTFTLCW,0
2r4s,A,287,291,4,PFFI,0
2r4s,A,292,310,18,NIVHVIQDNLIRKEVYIL,0
2r4s,A,311,317,6,NWIGYV,0
2r4s,A,318,328,10,SGFNPLIYCR,0
2r4s,A,332,337,5,RIAFQ,0
2r4s,A,349,365,16,YGNGYSSNGNTGEQSG,0
3qbi,D,1,17,16,TETLPPVTESAVALQA,0
3qbi,D,18,20,2,VT,0
3qbi,D,21,28,7,RELFEFV,0
3qbi,D,29,36,7,NDPLLAS,0
3qbi,D,37,57,20,LYINIALAGLSILLFVFMTR,0
3qbi,D,66,87,21,IAVSTILVPVVSIASYTGLAS,0
3qbi,D,88,120,32,LTISVLEMPAGHFAEGSSVMLGGEEVDGVVTM,0
3qbi,D,121,142,21,GRYLTWALSTPMILLALGLLA,0
3qbi,D,147,168,21,KLFTAITFDIAMCVTGLAAAL,0
3qbi,D,169,174,5,TSSHL,0
3qbi,D,175,199,24,RWFWYAISCACFIVVLYILLVEWA,0
3qbi,D,211,232,21,STLKLLTVVMWLGYPIVWALG,0
3qbi,D,233,243,10,EGVAVLPVGY,0
3qbi,D,244,268,24,SWAYSALDIVAKYIFAFLLLNYLT,0
3qbi,D,278,291,13,LDVPSASGAPADD,0
4zr0,A,117,199,82,DSTTFVKELPAEEKLSIATDYSNDYKKHKFLDLNRPLLMQILRSDFKKDFYVDQIHRPRHYGKGSAPLFGNFLEPLTKTAWW,0
4zr0,A,200,215,15,VPVAWLPVVVYHMGV,0
4zr0,A,227,247,20,LFCVGVFVWTLIEYGLHRFL,0
4zr0,A,248,257,9,HFDDWLPES,0
4zr0,A,258,267,9,IAFATHFLL,0
4zr0,A,268,283,15,GCHHYLPMDKYRLVM,0
4zr0,A,284,302,18,PTLFVILCAPFYKLVFAL,0
4zr0,A,309,325,16,AGFAGGLFGYVCYDEC,0
4zr0,A,326,357,31,FFLHHSKLPPFMRKLKKYHLEHHYKNYQLGF,0
4zr0,A,358,371,13,VTSWFWDEVFGTY,0
4zr0,A,372,380,8,GPDAPLSK,0
2lkh,A,19,39,20,FDKICKIGTESVEAGRLIEL,0
2lkh,A,40,45,5,QEGGG,0
2lkh,A,46,67,21,GGPLYFVVNVIEPCKKFSELT,0
2lkh,A,81,102,21,TESKSVLKSLTEKLKKIVELI,0
2lkh,A,103,108,5,STSSA,0
2lkh,A,109,129,20,PLIGKYMLFTKEFVESSIKI,0
4faa,C,1,3,2,EE,0
4faa,C,7,28,21,ALAVILVLTLTILVFWLGVYA,0
4faa,C,29,34,5,FFARG,0
4fbz,C,1,9,8,AATVGPES,0
4fbz,C,10,28,18,WLWIGTIGMTLGTLYFVG,0
4fbz,C,45,61,16,TFITTIAAAMYFAMAT,0
4fbz,C,62,77,15,FGVTEVVVGDEALTI,0
4fbz,C,78,93,15,WARYADWLFTTPLLL,0
4fbz,C,110,127,17,IGLDVFMIGTGMIAAFA,0
4fbz,C,128,132,4,TPGT,0
4fbz,C,133,149,16,IAWWGISTGALLALLY,0
4fbz,C,175,191,16,LVIVLWLLYPVVWILG,0
4fbz,C,192,203,11,EGTFGILPLYW,0
4fbz,C,204,221,17,TAAFMVLDLSAKVGFGV,0
4fbz,C,239,241,2,PT,0
5ec5,I,55,65,10,ATHSIGSTIS,0
5ec5,I,74,75,1,V,0
5ec5,I,76,86,10,VSYSHSHQKS,0
4tq3,A,1,14,13,DSSLANINQIDVP,0
4tq3,A,16,39,23,YLRLLRPVAWLCFLLPYAVGFGF,0
4tq3,A,52,70,18,GLLSFAFWMAFSFTINAL,0
4tq3,A,71,81,10,DRDVDRLHDG,0
4tq3,A,82,85,3,VKD,0
4tq3,A,86,98,12,NLSMQPLVTGEI,0
4tq3,A,99,119,20,VREAWLYCIAFLALSLATAA,0
4tq3,A,125,143,18,FLAMLGANIIGYVYSAPP,0
4tq3,A,144,151,7,FKAWPVM,0
4tq3,A,152,168,16,VICNALAAVLAFYAGL,0
4tq3,A,176,191,15,IAIYPAAFFLAATFY,0
4tq3,A,192,225,33,PTAVSDYEFDKKAGLKNTPVFFGPERALKSLYP,0
4tq3,A,226,241,15,SAITVILWAYVFLMA,0
4tq3,A,246,261,15,KVISPLIIAYTLIYT,0
4tq3,A,262,278,16,IINSRWDGEKLNVSPN,0
4tq3,A,279,294,15,ILTPFGIISALFIAY,0
4tq3,A,302,303,1,G,0
3hap,A,1,5,4,AQIT,0
3hap,A,6,9,3,RPE,0
3hap,A,10,32,22,IWLALGTALMGLGTLYFLVKGM,0
3hap,A,42,66,24,YAITTLVPAIAFTMYLSMLLGYGL,0
3hap,A,67,78,11,MVPFGGEQNPI,0
3hap,A,79,99,20,WARYADWLFTTPLLLLDLAL,0
3hap,A,104,127,23,QGTILAAVGADGIMIGTGLVGAL,0
3hap,A,128,134,6,KVYSYR,0
3hap,A,135,157,22,VWWAISTAAMLYILYVLFFGFT,0
3hap,A,172,195,23,VLRNVTVVLWSAYPVVWLIGSEG,0
3hap,A,196,201,5,GIVPL,0
3hap,A,202,225,23,IETLLFMVLDVSAKVGFGLILLR,0
3hap,A,232,249,17,AEAPEPSAGDGAAATSD,0
3x3c,B,5,27,22,GNANFENFIGATEGFSEIAYQF,0
3x3c,B,28,52,24,SHILTLGYAVMLAGLLYFILTIKN,0
3x3c,B,59,80,21,SNILSAVVMVSAFLLLYAQAQ,0
3x3c,B,81,105,24,WTSSFTFNEEVGRYFLDPSGDLFN,0
3x3c,B,106,127,21,GYRYLNWLIDVPMLLFQILFV,0
3x3c,B,137,160,23,VRNQFWFSGAMMIITGYIGQFYE,0
3x3c,B,161,165,4,SNLT,0
3x3c,B,166,189,23,FLVWGAISSAFFFHILWVMKKVI,0
3x3c,B,204,228,24,SNIWILFLISWTLYPGAYLMPYLT,0
3x3c,B,229,239,10,VDGFLYSEDG,0
3x3c,B,240,265,25,MARQLVYTIADVSSKVIYGVLLGNL,0
5l1e,D,10,524,514,SIQIGGLFPRGADQEYSAFRVGMVQFSTSEFRLTPHIDNLEVANSFAVTNAFCSQFSRGVYAIFGFYDKKSVNTITSFCGTLHVSFITPSFPTDGTHPFVIQMRPDLKGALLSLIEYYQWDKFAYLYDSDRGLSTLQAVLDSAAEKKWQVTAINVGNINNDKKDETYRSLFQDLELKKERRVILDCERDKVNDIVDQVITIGKHVKGYHYIIANLGFTDGDLLKIQFGGAEVSGFQIVDYDDSLVSKFIERWSTLEEKEYPGAHTATIKYTSALTYDAVQVMTEAFRNLRKQRIEISRRGNAGDCLANPAVPWGQGVEIERALKQVQVEGLSGNIKFDQNGKRINYTINIMELKTNGPRKIGYWSEVDKMVLTEDDTSGLEQKTVVVTTILESPYVMMKKNHEMLEGNERYEGYCVDLAAEIAKHCGFKYKLTIVGDGKYGARDADTKIWNGMVGELVYGKADIAIAPLTITLVREEVIDFSKPFMSLGISIMIKKPQKSKPGVFSFLDPLAYE,0
5l1e,D,525,543,18,WMCIVFAYIGVSVVLFLV,0
5l1e,D,545,553,8,TDSTNEFG,0
5l1e,D,577,588,11,WFSLGAFMQQG,0
5l1e,D,589,590,1,D,0
5l1e,D,597,614,17,GRIVGGVWWFFTLIIIS,0
5l1e,D,615,792,177,YTANLAAFLTVERMVSPIESAEDLSKQTEIAYGTLDSGSTKEFFRRSKIAVFDKMWTYMRSAEPSVFVRTTAEGVARVRKSKGKYAYLLESTMNEYIEQRKPCDTMKVGGNLDSKGYGIATPKGSSLGTPVNLAVLKLSEQGVLDKLKNKWWYDKGECGAKDSGSKEKTSALSLSNV,0
5l1e,D,793,810,17,GVFYILVGGLGLAMLVA,0
5l1e,D,817,831,14,SRAEAKRMKGLVPR,0
3jyc,D,36,42,6,ARRKCR,0
3jyc,D,43,60,17,RFVKKNGQCNVEFTNMD,0
3jyc,D,61,69,8,KPQRYIAD,0
3jyc,D,70,77,7,FTTCVDI,0
3jyc,D,78,104,26,WRYMLLLFSLAFLVSWLLFGLIFWLI,0
3jyc,D,131,147,16,AAFLFSIETQTTIGYG,0
3jyc,D,156,181,25,LAVFMVVVQSIVGCIIDSFMIGAIM,0
3jyc,D,182,372,190,KMARPKKRAQTLLFSHNAVVAMRDGKLCLMWRVGNLRKSHIVEAHVRAQLIKPRITEEGEYIPLDQIDIDVGFDKGLDRIFLVSPITILHEINEDSPLFGISRQDLETDDFEIVVILEGMVEATAMTTQARSSYLASEILWGHRFEPVLFEEKNQYKVDYSHFHKTYEVPSTPRCSAKDLVENKFLLSNS,0
3jyc,D,373,378,5,EVLFQ,0
2kb7,P,5,18,13,QYLTRSAIRRAST,0
2kb7,P,27,50,23,NLQNLFINFALILIFLLLIAIIV,0
2kb7,P,51,53,2,LL,0
2kbv,A,447,448,1,D,0
2kbv,A,449,470,21,FIIAYGGLRGAIAFSLGYLLD,0
5gth,z,1,7,6,TILFQL,0
5gth,z,8,25,17,LAALVILSFVMVIGVPV,0
5gth,z,40,55,15,FLGSGLWIALVLVVG,0
5gth,z,56,62,6,LNFFVV,0
4qnc,B,1,4,3,ENL,0
4qnc,B,5,25,20,GYVAAFLTTVSFLPQVLRVV,0
4qnc,B,34,52,18,RNMYIMFFLGVVLWFVYG,0
4qnc,B,53,59,6,LRSDLP,0
4qnc,B,60,80,20,ILANVVTLFFVTIILYYKLT,0
5nik,K,1,226,225,TPLLELKDIRRSYPAGDEQVEVLKGISLDIYAGEMVAIVGASGSGKSTLMNILGCLDKATSGTYRVAGQDVATLDADALAQLRREHFGFIFQRYHLLSHLTAEQNVEVPAVYAGLERKQRLLRAQELLQRLGLEDRTEYYPAQLSGGQQQRVSIARALMNGGQVILADEPTGALDSHSGEEVMAILHQLRDRGHTVIIVTHDPQVAAQAERVIEIRDGEIVRNPP,0
5nik,K,246,247,1,W,0
5nik,K,248,267,19,QFVSGFNEALTMAWRALAA,0
5nik,K,268,269,1,K,0
5nik,K,270,294,24,RTLLTMLGIIIGIASVVSIVVVGD,0
5nik,K,523,545,22,FLTLVAVISLVVGGIGVMNIML,0
5nik,K,546,572,26,SVTERTREIGIRMAVGARASDVLQQF,0
5nik,K,573,601,28,IEAVLVCLVGGALGITLSLLIAFTLQLF,0
5nik,K,608,632,24,FSPLALLLAFLCSTVTGILFGWLP,0
5nik,K,633,648,15,RNAARLDPVDALARE,0
3or6,F,26,50,24,RAAGAATVLLVIVLLAGSYLAVLA,0
3or6,F,51,62,11,RGAPGAQLITY,0
3or6,F,63,78,15,RALWWSVQTATTVGY,0
3or6,F,79,86,7,DLYPVTL,0
3or6,F,87,111,24,GRCVAVVVMVAGITSFGLVTAALA,0
4cdi,F,2,25,23,ELLKSLVFAVIMVPVVMAIILGL,0
4cdi,F,26,35,9,YGLGEVFNI,0
4cdi,F,36,46,10,SGVGKKDQPG,0
4cdi,F,47,49,2,NH,0
2exw,B,1,17,16,KTDTPSLETPQAARLR,0
2exw,B,37,61,24,MAAVVGTLVGLAAVAFDKGVAWLQ,0
2exw,B,62,83,21,QRMGALVHTADNYPLLLTVAF,0
2exw,B,84,97,13,CSAVLAMFGYFLV,0
2exw,B,128,142,14,PVKFFGGLGTLGGG,0
2exw,B,144,159,15,LGREGPTVQIGGNIG,0
2exw,B,180,204,24,GAAAGLAAAFNAPLAGILFIIEEM,0
2exw,B,216,232,16,AVFIGVIMSTIMYRIF,0
2exw,B,233,252,19,HEVALIDVGKLSDAPLNTL,0
2exw,B,253,277,24,LYLILGIIFGIFGPIFNKWVLGMQ,0
2exw,B,278,284,6,LLHRVH,0
2exw,B,290,305,15,WVLMGGAIGGLCGLL,0
2exw,B,306,317,11,FVAPATSGGGF,0
2exw,B,318,324,6,LIPIAT,0
2exw,B,325,336,11,GNFSMGMLVFI,0
2exw,B,337,351,14,VARVITTLLCFSSG,0
2exw,B,353,368,15,GGIFAPMLALGTVLG,0
2exw,B,369,391,22,AFGMVAVELFPQYHLEAGTFAI,0
2exw,B,392,415,23,GMGALLAASIRAPLTGIILVLEM,0
2exw,B,416,421,5,DNYQL,0
2exw,B,422,439,17,LPMIITGLGATLLAQFT,0
2exw,B,459,473,14,QLARSKAASASENT,0
5njg,B,374,390,16,HQLRWVSKRSFKNLLG,0
5njg,B,393,414,21,ASIAQIIVTVVLGLVIGAIYF,0
5njg,B,415,427,12,LKNDSTGIQNRA,0
5njg,B,428,448,20,VLFFLTTNQCFSSVSAVELF,0
5njg,B,452,460,8,KLFIHEYI,0
5njg,B,471,497,26,GKLLSDLLPMRMLPSIIFTCIVYFML,0
5njg,B,498,503,5,LKPKA,0
5njg,B,504,529,25,AFFVMMFTLMMVAYSASSMALAIAA,0
5njg,B,535,556,21,VATLLMTICFVFMMIFSGLLV,0
5njg,B,557,561,4,LTTI,0
5njg,B,562,582,20,SWLSWLQYFSIPRYGFTALQ,0
5njg,B,583,626,43,NEFLGQNFCPGLNATGNNPCNYATCTGEEYLVKQGIDLSPWGL,0
5njg,B,627,648,21,KNHVALACMIVIFLTIAYLKL,0
5kte,A,17,42,25,HHHHHHHHATLRGTAGPRGVRRILP,0
5kte,A,44,63,19,GPAVIASIAYMDPGNFATN,0
5kte,A,64,75,11,EGGARYGYSLL,0
5kte,A,76,92,16,VILAANLMAMVIQNLS,0
5kte,A,113,142,29,PLVWFYWIQAELVAMATDLAEFLGAALAI,0
5kte,A,143,150,7,LLTGLPM,0
5kte,A,151,165,14,WGAVVTGVVTFWLL,0
5kte,A,166,175,9,LHHRGTRPL,0
5kte,A,177,192,15,AVGAFVLMIGVAYLV,0
5kte,A,193,221,28,VVLARPDLAAVGAGFVPRLQGPGSAYLA,0
5kte,A,222,236,14,GIIGATVMPHVIYL,0
5kte,A,237,258,21,SALTQGRIQTDTTYYYRRLVR,0
5kte,A,262,278,16,DVIAAMGLAGLINMSM,0
5kte,A,279,304,25,AVAAATFHGKNVENAGDLTTAYQTL,0
5kte,A,305,309,4,PLLG,0
5kte,A,310,314,4,AASV,0
5kte,A,315,339,24,FAVALLASGLSSSAVGTMAGDVIM,0
5kte,A,342,352,10,MGFHIPLWLR,0
5kte,A,354,363,9,ITMLPAFIV,0
5kte,A,364,374,10,LLGMDPSSVL,0
5kte,A,375,394,19,LSQVILCFGVPFALVPLLL,0
5kte,A,406,421,15,TRRSFTVIGWVIAVI,0
5kte,A,422,428,6,IALNGY,0
5kte,A,429,436,7,LWELLGG,0
1u7c,C,1,2,1,P,0
1u7c,C,3,14,11,VADKADNAFMM,0
1u7c,C,15,33,18,CTALVLFMTIPGIALFYG,0
1u7c,C,45,64,19,TQVTVTFALVCILWVVYGY,0
1u7c,C,65,102,37,LASGEGNNFFGNINWLMLKNIELTAVMGSIYQYIHVA,0
1u7c,C,103,120,17,QGSFACITVGLIVGALA,0
1u7c,C,126,147,21,AVLIFVVVWLTLSYIPIAHMV,0
1u7c,C,148,160,12,GGGLLASHGALD,0
1u7c,C,161,180,19,AGGTVVHINAAIAGLVGAY,0
1u7c,C,200,218,18,VFTGTAILYIGWFGFNAG,0
1u7c,C,219,230,11,AGTANEIAALA,0
1u7c,C,231,251,20,VNTVVATAAAILGWIFGEWA,0
1u7c,C,259,276,17,GACSGAIAGLVGVTPAC,0
1u7c,C,277,281,4,YIGV,0
1u7c,C,282,302,20,GALIIGVVAGLAGLWGVTML,0
1u7c,C,312,332,20,DVFGVHGVCGIVGCIMTGIF,0
1u7c,C,333,352,19,ASSLGGVGFAEGVTMGHQL,0
1u7c,C,353,380,27,VQLESIAITIVWSGVVAFIGYKLADLT,0
2y01,A,31,32,1,G,0
2y01,A,42,63,21,GMSLLMALVVLLIVAGNVLVI,0
2y01,A,64,81,17,AIGSTQRLQTLTNLFIT,0
2y01,A,82,103,21,LACADLVVGLLVVPFGATLVV,0
2y01,A,108,133,25,WGSFLCELWTSLDVLCVTASIETLC,0
2y01,A,134,163,29,IAIDRYLAITSPFRYQSLMTRARAKVIIC,0
2y01,A,164,183,19,VWAISALVSFLPIMMHWWR,0
2y01,A,187,193,6,QALKCY,0
2y01,A,200,225,25,FVTNRAYAIASSIISFYIPLLIMIF,0
2y01,A,226,237,11,ALRVYREAKEQ,0
2y01,A,238,249,11,RKIDRASKRKT,0
2y01,A,278,293,15,RVMLMREHKALKTLG,0
2y01,A,294,315,21,IMGVFTLCWLPFFLVNIVNVF,0
2y01,A,324,343,19,FVAFNWLGYANSAMNPIIY,0
2y01,A,344,346,2,RS,0
2y01,A,347,356,9,DFRKAFKRL,0
2y01,A,357,358,1,A,0
2y01,A,359,373,14,PRKADRRLHHHHHH,0
3vrb,D,1,27,26,LSAVRRAIPLSARILRTSLIQRCAGA,0
3vrb,D,56,79,23,TLFKIERYFAAAMVPLIPAAYFI,0
3vrb,D,80,84,4,GREM,0
3vrb,D,85,109,24,LCLALALTLHVHWGVWGVVNDYGR,0
3vrb,D,117,139,22,AAAVRVGAYIFTACLLAGLLYF,0
3vrb,D,140,145,5,EHDVG,0
3vrb,D,146,154,8,TRAFEMVW,0
3vrb,D,155,156,1,L,0
4m1m,A,1,29,28,ELEEDLKGRADKNFSKMGKKSKKEKKEK,0
4m1m,A,35,68,33,LTMFRYAGWLDRLYMLVGTLAAIIHGVALPLMM,0
4m1m,A,69,115,46,IFGDMTDSFASVGQVSKQSTQMSEADKRAMFAKLEEEMTTYAYYYT,0
4m1m,A,116,139,23,IGAGVLIVAYIQVSFWCLAAGRQ,0
4m1m,A,180,204,24,GIGDKIGMFFQAMATFFGGFIIGF,0
4m1m,A,205,211,6,RGWKLT,0
4m1m,A,212,232,20,VILAISPVLGLSAGIWAKIL,0
4m1m,A,289,309,20,TANISMGAAFLLIYASYALA,0
4m1m,A,310,330,20,WYGTSLVISKEYSIGQVLTV,0
4m1m,A,331,352,21,FSVLIGAFSVGQASPNIEAFA,0
4m1m,A,627,680,53,GNEIELGNEACKSKDEIDNLDMSSKDSGSSLIRRRSTRKSICGPHDQDRKLST,0
4m1m,A,705,728,23,YFVVGIFCAIINGGLQPAFSVIF,0
4m1m,A,729,752,23,KVVGVFTNGGPPETQRQNSNLFS,0
4m1m,A,753,774,21,LFLILGIISFITFFLQGFTFG,0
4m1m,A,824,847,23,TGSRLAVIFQNIANLGTGIIISL,0
4m1m,A,848,854,6,YGWQLT,0
4m1m,A,855,879,24,LLLAIVPIIAIAGVVEMKMLSGQA,0
4m1m,A,926,952,26,AMKKAHVFGITFSFTQAMMYFSYAAA,0
4m1m,A,953,972,19,RFGAYLVTQQLMTFENVLL,0
4m1m,A,973,995,22,FSAIVFGAMAVGQVSSFAPDYA,0
4m1m,A,1272,1282,10,AKRSHHHHHH,0
3ar9,A,48,73,25,WELVIEQFEDLLVRILLLAACISFV,0
3ar9,A,74,89,15,AWFEEGEETITAFVE,0
3ar9,A,90,110,20,FVILLILIANAIVGVWQERN,0
3ar9,A,253,274,21,EFGEQLSKVISLICVAVWLIN,0
3ar9,A,275,296,21,GHFNDPVHGGSWIRGAIYYFK,0
3ar9,A,297,318,21,AVALAVAAIPEGLPAVITTCL,0
3ar9,A,760,781,21,RYLISSNVGEVVCIFLTAALG,0
3ar9,A,782,785,3,PEA,0
3ar9,A,786,808,22,IPVQLLWVNLVTDGLPATALGF,0
3ar9,A,830,852,22,WLFFRYMAIGGYVGAATVGAAA,0
3ar9,A,853,897,44,WFMYAEDGPGVTYHQLTHFMQCTEDHPHFEGLDCEIFEAPEPMT,0
3ar9,A,898,916,18,ALSVLVTIEMCNALNSLS,0
3ar9,A,931,950,19,LLGSICLSMSLHFLILYVD,0
3ar9,A,951,964,13,LPMIFKLKALDLT,0
3ar9,A,965,987,22,WLMVLKISLPVIGLDEILKFIA,0
1rhz,C,1,20,19,SKREETGLATSAGLIRYMD,0
1rhz,C,21,30,9,TFSKIRVKP,0
1rhz,C,31,49,18,HVIGVTVAFVIIEAILTY,0
2wjl,C,1,4,3,AQI,0
2wjl,C,5,10,5,GRPEW,0
2wjl,C,11,33,22,WLALGTALMGLGTLYFLVKGMG,0
2wjl,C,41,62,21,FYAITTLVPAIAFTMYLSMLL,0
2wjl,C,63,79,16,YGLTMVPFGGEQNPIY,0
2wjl,C,80,100,20,ARYADWLFTTPLLLLDLALL,0
2wjl,C,106,127,21,TILALVGADGIMIGTGLVGAL,0
2wjl,C,128,133,5,KVYSY,0
2wjl,C,134,156,22,FVWWAISTAAMLYILYVLFFGF,0
2wjl,C,157,161,4,SKAE,0
2wjl,C,171,192,21,KVLRNVTVVLWSAYPVVWLIG,0
2wjl,C,193,203,10,DGAGIVPLNI,0
2wjl,C,204,225,21,TLLFMVLDVSAKVGFGLILLR,0
2wjl,C,232,249,17,AEAPEPSAGDGAAATSD,0
1bl8,D,25,50,25,WRAAGAATVLLVIVLLAGSYLAVLA,0
1bl8,D,51,62,11,RGAPGAQLITY,0
1bl8,D,63,78,15,RALWWSVETATTVGY,0
1bl8,D,79,86,7,DLYPVTL,0
1bl8,D,87,112,25,GRCVAVVVMVAGITSFGLVTAALAT,0
4ck0,C,17,27,10,WKGLRAAWIN,0
4ck0,C,28,32,4,AAFR,0
4ck0,C,33,48,15,EGVAVLLAVVIACWL,0
4ck0,C,53,67,14,TRVLLISSVMLVMI,0
4ck0,C,68,102,34,ELLNSAIEAVVDRIGSEYHELSGRAKDLGSAAVL,0
4ck0,C,103,117,14,AIIDAVITWCILLW,0
5bps,J,13,26,13,ISTIGLLGAGIGI,0
5bps,J,27,56,29,IVFAALINGVSRNPSIKDTVFPMAILGFA,0
5bps,J,57,71,14,SEATGLFCLMVSFL,0
3jae,E,25,239,214,PSEFLDKLMGKVSGYDARIRPNFKGPPVNVTCNIFINSFGSIAETTMDYRVNIFLRQQWNDPRLAYSEYPDDSLDLDPSMLDSIWKPDLFFANEKGANFHEVTTDNKLLRISKNGNVLYSIRITLVLACPMDLKNFPMDVQTCIMQLESFGYTMNDLIFEWDEKGAVQVADGLTLPQFILKEEKDLRYCTKHYNTGKFTCIEARFHLERQMGYY,0
3jae,E,240,260,20,IQMYIPSLLIVILSWVSFWI,0
3jae,E,266,287,21,ARVGLGITTVLTMTTQSSGSR,0
3jae,E,288,298,10,SLPKVSYVKA,0
3jae,E,299,319,20,DIWMAVCLLFVFSALLEYAA,0
3jae,E,340,363,23,VSRVAFPLVFLIFNIFYWITYKL,0
3tij,C,-5,1,6,PAVPRM,0
3tij,C,3,20,17,FMSLIGMAVLLGIAVLL,0
3tij,C,21,31,10,SNRKAINLRT,0
3tij,C,32,47,15,GGAFAIQFSLGAFIL,0
3tij,C,50,78,28,WGQELLRGFSDAVSNVINYGNDGTSFLF,0
3tij,C,103,118,15,TLIFFSALISVLYYL,0
3tij,C,120,136,16,MQWVIRILGGGLQKAL,0
3tij,C,137,175,38,TSRAESMSAAANIFVGQTEAPLVVRPFVPKMTQSELFA,0
3tij,C,176,192,16,MCGGLASIAGGVLAGY,0
3tij,C,201,217,16,LVAASFMAAPGGLLFA,0
3tij,C,218,229,11,LMMPETEKPQD,0
3tij,C,230,240,10,EDITLDGGDD,0
3tij,C,242,252,10,ANVIDAAAGG,0
3tij,C,254,274,20,AGLQLALNVGAMLIAFIGLI,0
3tij,C,359,375,16,SFALCGFANLSSIAIL,0
3tij,C,376,394,18,GGLGSLAPKRRGDIARMG,0
3tij,C,395,415,20,KAVIAGTLSNLMAATIAGFF,0
3tij,C,417,418,1,F,0
5bq6,J,13,33,20,ISTIGLLGAGIGIAIVFAAL,0
5bq6,J,34,48,14,NGVSRNPSIKDTVF,0
5bq6,J,49,71,22,MAILGFALSEATGLFCLMVSFL,0
2brd,C,1,6,5,QITGR,0
2brd,C,7,9,2,EW,0
2brd,C,10,28,18,WLALGTALMGLGTLYFLV,0
2brd,C,47,64,17,VPAIAFTMYLSMLLGYG,0
2brd,C,65,77,12,TMVPFGGEQNPI,0
2brd,C,78,94,16,WARYADWLFTTPLLLL,0
2brd,C,112,128,16,ADGIMIGTGLVGALTK,0
2brd,C,129,133,4,YSYR,0
2brd,C,134,150,16,VWWAISTAAMLYILYV,0
2brd,C,177,196,19,VVLWSAYPVVWLIGSEGAG,0
2brd,C,197,202,5,VPLNI,0
2brd,C,203,220,17,TLLFMVLDVSAKVGFGL,0
2brd,C,228,248,20,FGEAEAPEPSAGDGAAATS,0
5ndz,A,1126,1134,8,DEAAVNLA,0
5ndz,A,63,68,5,FSASV,0
5ndz,A,73,97,24,TTVFLPIVYTIVFVVALPSNGMAL,0
5ndz,A,98,115,17,VFLFRTKKKAPAVIYMA,0
5ndz,A,116,136,20,LALADLLSVIWFPLKIAYHI,0
5ndz,A,144,167,23,EALCNVLIGFFYANMYCSILFLT,0
5ndz,A,168,194,26,LSVQRAWEIVNPMGHSRKKANIAIGI,0
5ndz,A,195,214,19,LAIWLLILLVTIPLYVVKQ,0
5ndz,A,236,259,23,GDMFNYFLSLAIGVFLFPAFLTA,0
5ndz,A,260,290,30,AYVLMIRALADLEDNWETLNDNLKVIEKADNAAQVKDALTKMRAAALDAQKATPPKLEDKSPDSPEMKDFRHGFDILVGQIDDALKLANEGKVKEAQAAAEQLKTTRNAYIQKYLENSEKKRKRAIKLAV,0
5ndz,A,291,313,22,VAAMYLICFTPSNLLLVVHYFL,0
5ndz,A,323,343,20,ALYIVALCLSTLNSCIDPFV,0
5ndz,A,344,348,4,YFVS,0
5ndz,A,349,358,9,DFRDHAKNA,0
3jad,E,238,260,22,YLIQMYIPSLLIVILSWVSFWI,0
3jad,E,261,265,4,MDAA,0
3jad,E,266,288,22,ARVGLGITTVLTMTTQSSGSRA,0
3jad,E,299,321,22,DIWMAVCLLFVFSALLEYAAVN,0
3jad,E,322,325,3,IAR,0
3jad,E,329,338,9,LFISRAKRI,0
3jad,E,339,362,23,TVSRVAFPLVFLIFNIFYWITYK,0
4md1,B,10,32,22,IWLALGTALMGLGTLYFLVKGM,0
4md1,B,33,42,9,VSDPDAKKF,0
4md1,B,43,62,19,AITTLVPAIAFTMYLSMLL,0
4md1,B,80,98,18,ARYADWLFTTPLLLLDLA,0
4md1,B,99,106,7,LVDADQG,0
4md1,B,107,127,20,ILALVGADGIMIGTGLVGAL,0
4md1,B,134,154,20,FVWWAISTAAMLYILYVLFF,0
4md1,B,155,156,1,F,0
4md1,B,163,173,10,RPEVASTFKV,0
4md1,B,174,192,18,RNVTVVLWSAYPVVWLIG,0
4md1,B,203,224,21,ETLLFMVLDVSAKVGFGLILL,0
4md1,B,225,234,9,SRAIFGEAE,0
3j7t,A,51,71,20,LVIEQFEDLLVRILLLAACI,0
3j7t,A,72,90,18,FVLAWFEEGEETITAFVE,0
3j7t,A,91,110,19,FVILLILIANAIVGVWQER,0
3j7t,A,257,275,18,EQLSKVISLICVAVWLIN,0
3j7t,A,276,293,17,GHFNDPVHGGSWIRGAI,0
3j7t,A,294,314,20,YFKIAVALAVAAIPEGLPAV,0
3j7t,A,760,781,21,IRYLISSNVGEVVCIFLTAAL,0
3j7t,A,782,785,3,LPE,0
3j7t,A,786,807,21,LIPVQLLWVNLVTDGLPATAL,0
3j7t,A,832,852,20,LFFRYMAIGGYVGAATVGAA,0
3j7t,A,853,897,44,WWFMYAEDGPGVTYHQLTHFMQCTEDHPHFEGLDCEIFEAPEPM,0
3j7t,A,898,916,18,MALSVLVTIEMCNALNSL,0
3j7t,A,926,950,24,PWVNIWLLGSICLSMSLHFLILYV,0
3j7t,A,951,957,6,PLPMIF,0
3j7t,A,958,964,6,LKALDL,0
3j7t,A,965,987,22,QWLMVLKISLPVIGLDEILKFI,0
4hz3,B,11,17,6,LPRVLK,0
4hz3,B,24,41,17,LLVLAVIIYGTAGFHFI,0
4hz3,B,42,46,4,GESW,0
4hz3,B,47,63,16,VSLYWTFVTIATVGYG,0
4hz3,B,64,70,6,YSPHTP,0
4hz3,B,71,92,21,GMYFTCTLIVLGIGTFAVAVE,0
4hz3,B,93,98,5,LLEFL,0
4hz3,B,100,101,1,R,0
1pss,H,13,30,17,SLAIYSFWIFLAGLIYY,0
2wjm,M,1,51,50,DYQTIYTQIQARGPHITVSGEWGDNDRVGKPFYSYWLGKIGDAQIGPIYL,0
2wjm,M,52,70,18,ASGIAAFAFGSTAILIIL,0
2wjm,M,81,87,6,LQFFRQ,0
2wjm,M,116,133,17,GLFMTLSLGSWWIRVYS,0
2wjm,M,134,142,8,ARALGLGT,0
2wjm,M,143,161,18,IAWNFAAAIFFVLCIGCI,0
2wjm,M,177,190,13,WPHIDWLTAFSIR,0
2wjm,M,198,218,20,WHGFSIGFAYGCGLLFAAHG,0
2wjm,M,219,265,46,TILAVARFGGDREIEQITDRGTAVERAALFWRWTIGFNATIESVHR,0
2wjm,M,266,284,18,GWFFSLMVMVSASVGILL,0
2wjm,M,292,298,6,YLWCVK,0
5kzo,A,1713,1720,7,GHHHHHH,0
5kzo,A,1730,1754,24,PAQLHFMYVAAAAFVLLFFVGCGV,0
5kzo,A,1755,1771,16,LSRKRRRQHGQLWFPE,0
5bqa,J,13,26,13,ISTIGLLGAGIGI,0
5bqa,J,27,56,29,IVFAALINGVSRNPSIKDTVFPMAILGFA,0
5bqa,J,57,71,14,SEATGLFCLMVSFL,0
2y00,A,31,32,1,G,0
2y00,A,42,63,21,GMSLLMALVVLLIVAGNVLVI,0
2y00,A,64,81,17,AIGSTQRLQTLTNLFIT,0
2y00,A,82,103,21,LACADLVVGLLVVPFGATLVV,0
2y00,A,108,133,25,WGSFLCELWTSLDVLCVTASIETLC,0
2y00,A,134,163,29,IAIDRYLAITSPFRYQSLMTRARAKVIIC,0
2y00,A,164,183,19,VWAISALVSFLPIMMHWWR,0
2y00,A,187,194,7,QALKCYQ,0
2y00,A,200,225,25,FVTNRAYAIASSIISFYIPLLIMIF,0
2y00,A,226,237,11,ALRVYREAKEQ,0
2y00,A,238,249,11,RKIDRASKRKT,0
2y00,A,278,293,15,RVMLMREHKALKTLG,0
2y00,A,294,315,21,IMGVFTLCWLPFFLVNIVNVF,0
2y00,A,324,343,19,FVAFNWLGYANSAMNPIIY,0
2y00,A,344,346,2,RS,0
2y00,A,347,357,10,DFRKAFKRLL,0
2y00,A,359,373,14,PRKADRRLHHHHHH,0
4j4q,A,1,39,38,NGTEGPNFYVPFSNKTGVVRSPFEAPQYYLAEPWQFSM,0
4j4q,A,40,65,25,AAYMFLLIMLGFPINFLTLYVTVQH,0
4j4q,A,69,96,27,TPLNYILLNLAVADLFMVFGGFTTTLY,0
4j4q,A,97,112,15,SLHGYFVFGPTGCNL,0
4j4q,A,113,137,24,GFFATLGGEIALWSLVVLAIERYV,0
4j4q,A,151,173,22,HAIMGVAFTWVMALACAAPPLV,0
4j4q,A,174,202,28,WSRYIPEGMQCSCGIDYYTPHEETNNES,0
4j4q,A,203,228,25,VIYMFVVHFIIPLIVIFFCYGQLVF,0
4j4q,A,250,274,24,TRMVIIMVIAFLICWLPYAGVAFY,0
4j4q,A,275,289,14,FTHQGSDFGPIFMT,0
4j4q,A,290,314,24,PAFFAKTSAVYNPVIYIMMNKQFR,0
4j4q,A,315,321,6,CMVTTL,0
4j4q,A,327,348,21,LGDDEASTTVSKTETSQVAPA,0
3ar8,A,55,73,18,FEDLLVRILLLAACISFV,0
3ar8,A,74,89,15,AWFEEGEETITAFVE,0
3ar8,A,90,111,21,FVILLILIANAIVGVWQERNA,0
3ar8,A,251,274,23,LDEFGEQLSKVISLICVAVWLIN,0
3ar8,A,275,295,20,GHFNDPVHGGSWIRGAIYYF,0
3ar8,A,296,321,25,IAVALAVAAIPEGLPAVITTCLALG,0
3ar8,A,758,781,23,FIRYLISSNVGEVVCIFLTAALG,0
3ar8,A,782,786,4,PEAL,0
3ar8,A,787,809,22,PVQLLWVNLVTDGLPATALGFN,0
3ar8,A,829,852,23,GWLFFRYMAIGGYVGAATVGAAA,0
3ar8,A,853,866,13,WFMYAEDGPGVTY,0
3ar8,A,867,872,5,QLTHF,0
3ar8,A,873,897,24,QCTEDHPHFEGLDCEIFEAPEPMT,0
3ar8,A,898,918,20,ALSVLVTIEMCNALNSLSEN,0
3ar8,A,927,949,22,VNIWLLGSICLSMSLHFLILYV,0
3ar8,A,951,957,6,LPMIFK,0
3ar8,A,958,964,6,KALDLT,0
3ar8,A,965,987,22,WLMVLKISLPVIGLDEILKFIA,0
1rg5,H,1,9,8,VGVTAFGN,0
1rg5,H,10,14,4,DLAS,0
1rg5,H,15,31,16,AIYSFWIFLAGLIYYL,0
1rg5,H,251,260,9,VAAMLAEYA,0
3or7,F,22,24,2,AL,0
3or7,F,25,50,25,WRAAGAATVLLVIVLLAGSYLAVLA,0
3or7,F,63,79,16,RALWWSVITATTVGYG,0
3or7,F,87,113,26,GRCVAVVVMVAGITSFGLVTAALATW,0
3or7,F,114,124,10,VGREQERRGH,0
4fy0,B,1,4,3,EVK,0
4fy0,B,14,35,21,ILAMAGNAVGLGNFLRFPVQA,0
4fy0,B,36,41,5,ENGGG,0
4fy0,B,42,63,21,FMIPYIIAFLLVGIPLMWIEW,0
4fy0,B,89,124,35,AKILGVFGLWIPLVVAIYYVYIESWTLGFAIKFLV,0
4fy0,B,125,131,6,LVPEPP,0
4fy0,B,132,134,2,,0
4fy0,B,135,166,31,DPDSILRPFKEFLYSYIGVPKGDEPILKPSL,0
4fy0,B,167,185,18,AYIVFLITMFINVSILIR,0
4fy0,B,191,214,23,ERFAKIAMPTLFILAVFLVIRVF,0
4fy0,B,215,222,7,LETPNGT,0
4fy0,B,223,231,8,ADGLNFLW,0
4fy0,B,232,241,9,PDFEKLKDP,0
4fy0,B,242,265,23,VWIAAVGQIFATLSLGFGAIITY,0
4fy0,B,278,298,20,GLTAATLNEKAEVILGGSIS,0
4fy0,B,299,307,8,PAAVAFFG,0
4fy0,B,308,317,9,ANAVAIAKA,0
4fy0,B,318,325,7,AFNLGFI,0
4fy0,B,326,332,6,LPAIFS,0
4fy0,B,333,339,6,TAGGTF,0
4fy0,B,340,367,27,GFLWFFLLFFAGLTSSIAIMQPMIAFL,0
4fy0,B,377,396,19,AVLWTAAIVFFSAHLVMFL,0
4fy0,B,397,399,2,KS,0
4fy0,B,400,425,25,DEMDFWAGTIGVVFFGLTELIIFFW,0
4fy0,B,429,437,8,DKAWEEIN,0
4fy0,B,445,472,27,RIYYYVMRYITPAFLAVLLVVWAREYI,0
4fy0,B,473,483,10,KIMEETHWTV,0
4fy0,B,484,502,18,ITRFYIIGLFLFLTFLVF,0
4fy0,B,604,606,2,SA,0
1r3l,L,1,21,20,APMLSGLLARLVKLLLGRHG,0
1r3l,L,22,25,3,ALH,0
1r3l,L,26,50,24,RAAGAATVLLVIVLLAGSYLAVLA,0
1r3l,L,63,79,16,RALWWSVETATTVGYG,0
1r3l,L,87,112,25,GRCVAVVVMVAGITSFGLVTAALAT,0
1r3l,L,113,124,11,FVGREQERRGH,0
3c1j,C,1,2,1,P,0
3c1j,C,18,32,14,LVLFMTIPGIALFY,0
3c1j,C,33,45,12,GLIRGKNVLSML,0
3c1j,C,46,61,15,QVTVTFALVCILWVV,0
3c1j,C,63,68,5,YSLAF,0
3c1j,C,106,118,12,AACITVGLIVGA,0
3c1j,C,119,126,7,AERIRFS,0
3c1j,C,127,143,16,VLIFVVVWLTLSYIPI,0
3c1j,C,164,178,14,TVVHINAAIAGLVG,0
3c1j,C,179,182,3,YLI,0
3c1j,C,183,194,11,KRVGFGKEAFK,0
3c1j,C,195,201,6,HNLPMV,0
3c1j,C,202,215,13,TGTAILYIGWFGA,0
3c1j,C,235,248,13,VATAAAILGWIFG,0
3c1j,C,249,260,11,WALRGKPSLLG,0
3c1j,C,261,274,13,CSGAIAGLVGVTP,0
3c1j,C,285,299,14,IIGVVAGLAGLWGV,0
3c1j,C,300,301,1,M,0
3c1j,C,302,309,7,KRLLRVD,0
3c1j,C,310,313,3,PCD,0
3c1j,C,314,328,14,FGVHGVCGIVGCIM,0
3c1j,C,357,377,20,SIAITIVWSGVVAFIGYKLA,0
3c1j,C,378,386,8,LTVGLRVP,0
3c1j,C,387,424,37,EQEREGLDVNSHGENAYNADQAQQPAQADLEHHHHHH,0
2wdq,L,1,10,9,VSNASALGR,0
2wdq,L,16,35,19,ILVRATAIVLTLYIIYMVG,0
2wdq,L,36,56,20,FATSGELTYEVWIGFFASAF,0
2wdq,L,57,80,23,KVFTLLALFSILIHAWIGMWQVL,0
2wdq,L,89,110,21,RLMLQLVIVVALVVYVIYGFV,0
2wdq,L,111,115,4,VWGV,0
4f8h,E,1,4,3,QDM,0
4f8h,E,5,198,193,SPPPPIADEPLTVNTGIYLIECYSLDDKAETFKVNAFLSLSWKDRRLAFDPVRSGVRVKTYEPEAIWIPEIRFVNVENARDADVVDISVSPDGTVQYLERFSARVLSPLDFRRYPFDSQTLHIYLIVRSVDTRNIVLAVDLEKVGKNDDVFLTGWDIESFTAVVKPANFALEDRLESKLDYQLRISRQYFSYI,0
4f8h,E,199,218,19,NIILPMLFILFISWTAFWS,0
4f8h,E,222,240,18,ANVTLVVSTLIAHIAFNI,0
4f8h,E,241,255,14,VETNLPKTPYMTYT,0
4f8h,E,256,275,19,AIIFMIYLFYFVAVIEVTV,0
4f8h,E,293,313,20,ASRIAFPVVFLLANIILAFL,0
4f8h,E,314,315,1,F,0
4f8h,E,316,317,1,F,0
5gti,z,1,7,6,TILFQL,0
5gti,z,8,25,17,LAALVILSFVMVIGVPV,0
5gti,z,40,55,15,FLGSGLWIALVLVVG,0
5gti,z,56,62,6,LNFFVV,0
2wsx,C,1,7,6,KNEKRK,0
2wsx,C,15,27,12,FPPLIIVGILCW,0
2wsx,C,28,32,4,TVRD,0
2wsx,C,33,50,17,DAANVVINAVFSYVTNV,0
2wsx,C,51,64,13,GWAFEWYMVVMLF,0
2wsx,C,96,108,12,ASCTSAAVLFWG,0
2wsx,C,109,135,26,IEIYYYISTPPFGLEPNSTGAKELGL,0
2wsx,C,136,150,14,YSLFHWGPLPWATY,0
2wsx,C,192,212,20,DNFYLVALIFAMGTSLGLAT,0
2wsx,C,213,235,22,LVTECMQWLFGIPHTLQLDAII,0
2wsx,C,236,249,13,TCWIILNAICVAC,0
2wsx,C,255,275,20,RIASDVRSYLSFLMLGWVFI,0
2wsx,C,276,278,2,SG,0
2wsx,C,279,296,17,SFIMNYFTDSVGMLLMY,0
2wsx,C,297,316,19,PRMLFYTDPIAKGGFPQGW,0
2wsx,C,317,331,14,VFYWAWWVIYAIQM,0
2wsx,C,353,366,13,GLTASTWILWTVL,0
2wsx,C,367,389,22,SNTLLLIDKNILNIPNLIEQYG,0
2wsx,C,390,399,9,ARAIIETWA,0
2wsx,C,400,409,9,LPLSTATMW,0
2wsx,C,410,431,21,FFILCFIATVTLVNACSYTLA,0
2wsx,C,447,460,13,VRIGWSILVGIIG,0
2wsx,C,461,472,11,VLLALGGLKPI,0
2wsx,C,473,488,15,TAIIAGGCPLFFVNI,0
3x2q,Z,17,37,20,GLSVTFLSFLLPAGWVLYHL,0
3x2q,Z,38,43,5,NYKKS,0
2rmz,A,685,691,6,ESPKGP,0
2rmz,A,692,714,22,ILVVLLSVMGAILLIGLAALLI,0
3x3b,B,5,27,22,GNANFENFIGATEGFSEIAYQF,0
3x3b,B,28,52,24,SHILTLGYAVMLAGLLYFILTIKN,0
3x3b,B,59,80,21,SNILSAVVMVSAFLLLYAQAQ,0
3x3b,B,81,105,24,WTSSFTFNEEVGRYFLDPSGDLFN,0
3x3b,B,106,127,21,GYRYLNWLIDVPMLLFQILFV,0
3x3b,B,137,160,23,VRNQFWFSGAMMIITGYIGQFYE,0
3x3b,B,161,164,3,SNL,0
3x3b,B,165,189,24,AFLVWGAISSAFFFHILWVMKKVI,0
3x3b,B,204,228,24,SNIWILFLISWTLYPGAYLMPYLT,0
3x3b,B,229,239,10,VDGFLYSEDG,0
3x3b,B,240,265,25,MARQLVYTIADVSSKVIYGVLLGNL,0
3vhz,C,-12,4,16,LELLPTAVEGVSQAQI,0
3vhz,C,5,9,4,GRPE,0
3vhz,C,10,29,19,IWLALGTALMGLGTLYFLV,0
3vhz,C,46,62,16,TLVPAIAFTMYLSMLL,0
3vhz,C,63,78,15,YGLTMVPFGGEQNPI,0
3vhz,C,79,94,15,WARYADWLFTTPLAL,0
3vhz,C,111,128,17,VGADGIMIGTGLVGALT,0
3vhz,C,129,133,4,VYSY,0
3vhz,C,134,150,16,FVWWAISTAAMLYILY,0
3vhz,C,177,192,15,TVVLWSAYPVVWLIG,0
3vhz,C,193,202,9,EGAGIVPLN,0
3vhz,C,203,221,18,ETLLFMVLDVSAKVGFGL,0
3vhz,C,233,249,16,EAPEPSAGDGAAATSD,0
4qo0,B,90,92,2,ER,0
4qo0,B,93,112,19,GPVTWVMMIACVVVFIAMQ,0
4qo0,B,132,147,15,FEFWRYFTHALMHFS,0
4qo0,B,149,166,17,HILFNLLWWWYLGGAVE,0
4qo0,B,167,171,4,RLGS,0
4qo0,B,172,191,19,KLIVITLISALLSGYVQQK,0
4qo0,B,198,216,18,GLSGVVYALMGYVWLRGE,0
4qo0,B,217,224,7,DPQSGIY,0
4qo0,B,225,242,17,QRGLIIFALIWIVAGWF,0
4qo0,B,250,268,18,NGAHIAGLAVGLAMAFVD,0
4qo0,B,269,271,2,LN,0
3haq,A,1,5,4,AQIT,0
3haq,A,6,9,3,RPE,0
3haq,A,10,33,23,IWLALGTALMGLGTLYFLVKGMG,0
3haq,A,41,62,21,FYAITTLVPAIAFTMYLSMLL,0
3haq,A,63,79,16,YGLTMVPFGGEQNPIY,0
3haq,A,80,99,19,ARYADWLFTTPLLLLDLAL,0
3haq,A,104,126,22,QGTILALVGADGIMIGTGLVGA,0
3haq,A,127,134,7,TKVYSYR,0
3haq,A,135,157,22,VWWAISTAAMLYALYVLFFGFT,0
3haq,A,171,192,21,KVLRNVTVVLWSAYPVVWLIG,0
3haq,A,193,201,8,EGAGIVPL,0
3haq,A,202,225,23,IETLLFMVLDVSAKVGFGLILLR,0
3haq,A,232,249,17,AEAPEPSAGDGAAATSD,0
4zr1,A,117,200,83,DSTTFVKELPAEEKLSIATDYSNDYKKHKFLDLNRPLLMQILRSDFKKDFYVDQIHRPRHYGKGSAPLFGNFLEPLTKTAWWV,0
4zr1,A,201,216,15,PVAWLPVVVYHMGVA,0
4zr1,A,227,248,21,LFCVGVFVWTLIEYGLHRFLF,0
4zr1,A,249,257,8,FDDWLPES,0
4zr1,A,258,267,9,IAFATHFLL,0
4zr1,A,268,285,17,GCHHYLPMDKYRLVMPP,0
4zr1,A,286,302,16,LFVILCAPFYKLVFAL,0
4zr1,A,309,325,16,AGFAGGLFGYVCYDEC,0
4zr1,A,326,335,9,FFLHHSKLP,0
4zr1,A,336,350,14,FMRKLKKYHLEHHY,0
4zr1,A,351,356,5,NYQLG,0
4zr1,A,357,371,14,GVTSWFWDEVFGTY,0
4zr1,A,372,390,18,GPDAPLSKMKYESGLEVL,0
4agf,G,1,24,23,EDLNVVDSINGAGSWLVANQALL,0
4agf,G,25,35,10,SYAVNIVAAL,0
4agf,G,36,59,23,IIIVGLIIARMISNAVNRLMISR,0
4agf,G,67,87,20,FLSALVRYGIIAFTLIAALG,0
4agf,G,88,91,3,VGV,0
4agf,G,92,108,16,TASVIAVLGAAGLAVG,0
4agf,G,281,286,5,EDKAA,0
5iub,A,-1,5,6,APPIMG,0
5iub,A,6,29,23,SVYITVELAIAVLAILGNVLVCW,0
5iub,A,44,67,23,VVSLAAADILVGVLAIPFAITIS,0
5iub,A,68,75,7,GFCAACH,0
5iub,A,76,100,24,CLFIACFVLVLAQSSIFSLLAIAI,0
5iub,A,122,144,22,GIIAICWVLSFAIGLTPMLGWN,0
5iub,A,145,171,26,CGQPKEGKAHSQGCGEGQVACLFEDV,0
5iub,A,172,198,26,PMNYMVYFNFFACVLVPLLLMLGVYL,0
5iub,A,234,259,25,AAIIAGLFALCWLPLHIINCFTFFC,0
5iub,A,260,265,5,DCSHA,0
5iub,A,266,290,24,LWLMYLAIVLAHTNSVVNPFIYAY,0
5iub,A,293,304,11,EFRQTFRKIIR,0
3f7y,F,21,26,5,SALQW,0
3f7y,F,27,29,2,AA,0
3f7y,F,30,50,20,AATVLLVIVLLAGSYLAVLA,0
3f7y,F,63,78,15,RALWWSVETATTVGY,0
3f7y,F,87,108,21,GRCVAVVVMVAGITSFGLVTA,0
3f7y,F,109,114,5,LATWF,0
3f7y,F,115,124,9,GQEQQQQGQ,0
3zry,S,13,34,21,ISTIGLLGAGIGIAIVFAALI,0
3zry,S,35,48,13,GVSRNPSIKDTVF,0
3zry,S,49,71,22,MAILGFALSEATGLFCLMVSFL,0
3zry,S,74,76,2,GV,0
1ijd,S,19,36,17,TRVFLVIAAIAHFLAFT,0
1ijd,S,37,40,3,TPW,0
1ijd,S,41,42,1,H,0
2r4r,A,1,36,35,GQPGNGSAFLLAPNRSHAPDHDVTQQRDEVWVVGM,0
2r4r,A,37,42,5,IVMSL,0
2r4r,A,43,59,16,VLAIVFGNVLVITAIA,0
2r4r,A,65,84,19,TVTNYFITSLACADLVMGL,0
2r4r,A,85,90,5,VVPFG,0
2r4r,A,91,107,16,AHILMKMWTFGNFWCE,0
2r4r,A,108,115,7,WTSIDVL,0
2r4r,A,116,134,18,VTASIETLCVIAVDRYFA,0
2r4r,A,144,162,18,LTKNKARVIILMVWIVSG,0
2r4r,A,163,164,1,T,0
2r4r,A,165,202,37,FLPIQMHWYRATHQEAINCYANETCCDFFTNQAYAIA,0
2r4r,A,203,206,3,SIV,0
2r4r,A,207,225,18,FYVPLVIMVFVYSRVFQE,0
2r4r,A,243,263,20,NLSQVEQDGRTGHGLRRSSK,0
2r4r,A,271,287,16,LKTLGIIMGTFTLCWL,0
2r4r,A,288,291,3,FFI,0
2r4r,A,292,310,18,NIVHVIQDNLIRKEVYIL,0
2r4r,A,311,315,4,NWIG,0
2r4r,A,316,333,17,VNSGFNPLIYCRSPDFR,0
2r4r,A,349,365,16,YGNGYSSNGNTGEQSG,0
5koy,A,35,68,33,LTMFRYAGWLDRLYMLVGTLAAIIHGVALPLMM,0
5koy,A,69,115,46,IFGDMTDSFASVGNVSKNSTNMSEADKRAMFAKLEEEMTTYAYYYT,0
5koy,A,116,139,23,IGAGVLIVAYIQVSFWCLAAGRQ,0
5koy,A,180,204,24,GIGDKIGMFFQAMATFFGGFIIGF,0
5koy,A,205,211,6,RGWKLT,0
5koy,A,212,233,21,VILAISPVLGLSAGIWAKILS,0
5koy,A,288,310,22,ITANISMGAAFLLIYASYALAF,0
5koy,A,311,330,19,YGTSLVISKEYSIGQVLTV,0
5koy,A,331,355,24,FSVLIGAFSVGQASPNIEAFANAR,0
5koy,A,693,699,6,WRILKL,0
5koy,A,705,728,23,YFVVGIFCAIINGGLQPAFSVIF,0
5koy,A,729,752,23,KVVGVFTNGGPPETQRQNSNLFS,0
5koy,A,753,774,21,LFLILGIISFITFFLQGFTFG,0
5koy,A,824,847,23,TGSRLAVIFQNIANLGTGIIISL,0
5koy,A,848,854,6,YGWQLT,0
5koy,A,855,879,24,LLLAIVPIIAIAGVVEMKMLSGQA,0
5koy,A,926,952,26,AMKKAHVFGITFSFTQAMMYFSYAAC,0
5koy,A,953,972,19,RFGAYLVTQQLMTFENVLL,0
5koy,A,973,995,22,FSAIVFGAMAVGQVSSFAPDYA,0
3ae1,D,42,62,20,WTGERVVSVLLLGLLPAAYL,0
3ae1,D,63,67,4,PCSA,0
3ae1,D,68,89,21,DYSLAAALTLHGHWGIGQVVT,0
3ae1,D,100,120,20,AKAGLLALSAFTFAGLCYFN,0
3ae1,D,121,125,4,HDVG,0
3ae1,D,126,134,8,CKAVAMLW,0
3ae1,D,135,136,1,L,0
4q54,z,1,7,6,TILFQL,0
4q54,z,8,22,14,LAALVILSFVMVIG,0
4q54,z,43,55,12,SGLWIALVLVVG,0
4q54,z,56,62,6,LNFFVV,0
3v3z,M,55,72,17,GVLSLFSGLMWFFTIGI,0
3v3z,M,73,81,8,FWYQAGWN,0
3v3z,M,82,87,5,AVFLR,0
3v3z,M,88,116,28,LFFFSLEPPAPEYGLSFAAPLKEGGLWL,0
3v3z,M,117,134,17,ASFFMFVAVWSWWGRTY,0
3v3z,M,146,163,17,AWAFLSAIWLWMVLGFI,0
3v3z,M,164,178,14,PILMGSWSEAVPYG,0
3v3z,M,179,192,13,FSHLDWTNNFSLV,0
3v3z,M,193,200,7,GNLFYNP,0
3v3z,M,201,221,20,HGLSIAFLYGSALLFAMHGA,0
3v3z,M,268,285,17,AIWMAVLVTLTGGIGIL,0
3v3z,M,286,293,7,SGTVVDN,0
3v3z,M,294,300,6,YVWGQN,0
3v3z,M,301,302,1,G,0
2knc,A,955,964,9,AMGSEERAI,0
2knc,A,965,988,23,IWWVLVGVLGGLLLLTILVLAMW,0
5b35,A,6,9,3,RPE,0
5b35,A,10,32,22,IWLALGTALMGLGTLYFLVKGM,0
5b35,A,42,66,24,YAITTLVPAIAFTMYLSMLLGYGL,0
5b35,A,67,78,11,MVPFGGEQNPI,0
5b35,A,79,99,20,WARYADWLFTTPLLLLDLAL,0
5b35,A,104,127,23,QGTILALVGADGIMIGTGLVGAL,0
5b35,A,128,134,6,KVYSYR,0
5b35,A,135,157,22,VWWAISTAAMLYILYVLFFGFT,0
5b35,A,172,195,23,VLRNVTVVLWSAYPVVWLIGSEG,0
5b35,A,196,201,5,GIVPL,0
5b35,A,202,225,23,IETLLFMVLDVSAKVGFGLILLR,0
4hod,B,1,4,3,EVK,0
4hod,B,13,32,19,LILAMAGNAVGLGNFLRFP,0
4hod,B,33,43,10,QAAENGGGAF,0
4hod,B,44,63,19,IPYIIAFLLVGIPLMWIEW,0
4hod,B,89,124,35,AKILGVFGLWIPLVVAIYYVYIESWTLGFAIKFLV,0
4hod,B,125,132,7,LVPEPPP,0
4hod,B,133,134,1,A,0
4hod,B,135,166,31,DPDSILRPFKEFLYSYIGVPKGDEPILKPSL,0
4hod,B,167,185,18,AYIVFLITMFINVSILIR,0
4hod,B,191,212,21,ERFAKIAMPTLFILAVFLVIR,0
4hod,B,213,222,9,FLLETPNGT,0
4hod,B,223,230,7,ADGLNFL,0
4hod,B,231,243,12,TPDFEKLKDPGV,0
4hod,B,244,266,22,IAAVGQIFFTLSLGFGAIITYA,0
4hod,B,277,297,20,SGLTAATLNEKASVILGGSI,0
4hod,B,298,325,27,IPAAVAFFGVANAVAIAKAGAFNLGFI,0
4hod,B,326,331,5,LPAIF,0
4hod,B,332,339,7,QTAGGTF,0
4hod,B,340,367,27,GFLWFFLLFFAGLTSSIAIMQPMIAFL,0
4hod,B,378,396,18,VLWTAAIVFFSAHLVMFL,0
4hod,B,397,399,2,KS,0
4hod,B,400,426,26,DEMDFWAGTIGVVFFGLTELIIFFWI,0
4hod,B,429,437,8,DKAWEEIN,0
4hod,B,445,469,24,RIYYYVMRYITPAFLAVLLVVWAR,0
4hod,B,470,471,1,Y,0
4hod,B,472,477,5,PKIME,0
4hod,B,478,483,5,THWTV,0
4hod,B,484,502,18,ITRFYIIGLFLFLTFLVF,0
5iu4,A,-1,5,6,APPIMG,0
5iu4,A,6,29,23,SVYITVELAIAVLAILGNVLVCW,0
5iu4,A,45,67,22,VSLAAADILVGVLAIPFAITIS,0
5iu4,A,68,74,6,GFCAAC,0
5iu4,A,75,97,22,GCLFIACFVLVLAQSSIFSLLA,0
5iu4,A,125,145,20,AICWVLSFAIGLTPMLGWNN,0
5iu4,A,146,171,25,GQPKEGKAHSQGCGEGQVACLFEDV,0
5iu4,A,172,195,23,PMNYMVYFNFFACVLVPLLLMLG,0
5iu4,A,237,259,22,IAGLFALCWLPLHIINCFTFFC,0
5iu4,A,260,265,5,DCSHA,0
5iu4,A,266,288,22,LWLMYLAIVLAHTNSVVNPFIY,0
5iu4,A,293,304,11,EFRQTFRKIIR,0
3aeg,D,35,38,3,SKA,0
3aeg,D,39,60,21,SLHWTGERVVSVLLLGLLPAA,0
3aeg,D,71,89,18,LAAALTLHGHWGIGQVVT,0
3aeg,D,90,97,7,YVRGDAL,0
3aeg,D,98,117,19,KAAKAGLLALSAFTFAGLC,0
3aeg,D,126,134,8,CKAVAMLW,0
4dxw,D,1,13,12,TPFFSSLKDNRI,0
4dxw,D,16,30,14,TVVSIIILNAVLIG,0
4dxw,D,31,34,3,TTY,0
4dxw,D,35,36,1,L,0
4dxw,D,37,56,19,PLFLETIHLLDYGITIFFV,0
4dxw,D,65,75,10,EKQKADFFKS,0
4dxw,D,81,94,13,TVIVAISLIPIPN,0
4dxw,D,95,97,2,SS,0
4dxw,D,98,116,18,LVLRLLRIFRVLRLISVI,0
4dxw,D,117,133,16,ELKQIIEAILESVRRV,0
4dxw,D,134,154,20,FVSLLLFIILYIYATMGAIL,0
4dxw,D,155,165,10,GNDDPSRWGD,0
4dxw,D,166,192,26,GISLITLFQVLTLSSWETVMLPMQEI,0
4dxw,D,193,194,1,W,0
4dxw,D,195,212,17,SWVYFFSFIIICSITIL,0
4dxw,D,228,229,1,E,0
3zpq,A,42,63,21,GMSLLMALVVLLIVAGNVLVI,0
3zpq,A,64,80,16,AIGSTQRLQTLTNLFI,0
3zpq,A,81,103,22,SLACADLVVGLLVVPFGATLVV,0
3zpq,A,108,134,26,WGSFLCELWTSLDVLCVTASIETLCV,0
3zpq,A,135,162,27,AIDRYLAITSPFRYQSLMTRARAKVII,0
3zpq,A,163,183,20,TVWAISALVSFLPIMMHWWR,0
3zpq,A,187,194,7,QALKCYQ,0
3zpq,A,200,228,28,FVTNRAYAIASSIISFYIPLLIMIFVAL,0
3zpq,A,229,237,8,VYREAKEQ,0
3zpq,A,238,249,11,RKIDRASKRKT,0
3zpq,A,278,293,15,RVMLMREHKALKTLG,0
3zpq,A,294,315,21,IMGVFTLCWLPFFLVNIVNVF,0
3zpq,A,324,343,19,FVAFNWLGYANSAMNPIIY,0
3zpq,A,344,346,2,RS,0
3zpq,A,347,357,10,DFRKAFKRLL,0
3zpq,A,359,373,14,PRKADRRLHHHHHH,0
2eat,A,51,56,5,VIEQF,0
2eat,A,58,73,15,LLVRILLLAACISFV,0
2eat,A,74,89,15,AWFEEGEETITAFVE,0
2eat,A,90,107,17,FVILLILIANAIVGVWQ,0
2eat,A,254,275,21,FGEQLSKVISLICVAVWLINI,0
2eat,A,276,295,19,HFNDPVHGGSWIRGAIYYF,0
2eat,A,296,318,22,IAVALAVAAIPEGLPAVITTCL,0
2eat,A,760,782,22,RYLISSNVGEVVCIFLTAALGL,0
2eat,A,783,786,3,EAL,0
2eat,A,787,808,21,PVQLLWVNLVTDGLPATALGF,0
2eat,A,833,852,19,FRYMAIGGYVGAATVGAAA,0
2eat,A,853,897,44,WFMYAEDGPGVTYHQLTHFMQCTEDHPHFEGLDCEIFEAPEPMT,0
2eat,A,898,916,18,ALSVLVTIEMCNALNSLS,0
2eat,A,927,950,23,VNIWLLGSICLSMSLHFLILYVD,0
2eat,A,951,964,13,LPMIFKLKALDLT,0
2eat,A,965,987,22,WLMVLKISLPVIGLDEILKFIA,0
2kog,A,-2,0,2,SH,0
2kog,A,93,113,20,KMMIILGVICAIILIIIIVY,0
2kog,A,114,116,2,ST,0
2qpe,C,2,5,3,EKP,0
2qpe,C,6,23,17,GALAVILVLTLTILVFW,0
3utv,A,1,4,3,AQI,0
3utv,A,5,6,1,G,0
3utv,A,7,29,22,PEWIWLALGTALMGLGTLYFLV,0
3utv,A,43,67,24,AITTLVPAIAFTMFLSMLLGYGLT,0
3utv,A,68,78,10,VPFGGEQNPI,0
3utv,A,79,99,20,WARYADWLFTTPLLLLDLAL,0
3utv,A,104,127,23,QGTILALVGADGIMIGTGLVGAL,0
3utv,A,128,134,6,KVYSYR,0
3utv,A,135,158,23,VWWAISTAAMLYILYVLFFGFTS,0
3utv,A,172,195,23,VLRNVTVVLWSAYPVVWLIGSEG,0
3utv,A,196,199,3,GIV,0
3utv,A,200,224,24,LNIETLLFMVLDVSAKVGFGLILL,0
3utv,A,232,249,17,AEAPEPSAGDGAAATSD,0
1x0k,1,1,4,3,AQI,0
1x0k,1,5,10,5,GRPEW,0
1x0k,1,11,33,22,WLALGTALMGLGTLYFLVKGMG,0
1x0k,1,41,62,21,FYAITTLVPAIAFTMYLSMLL,0
1x0k,1,63,78,15,YGLTMVPFGGEQNPI,0
1x0k,1,79,100,21,WARYADWLFTTPLLLLDLALL,0
1x0k,1,106,128,22,TILALVGADGIMIGTGLVGALT,0
1x0k,1,129,133,4,VYSY,0
1x0k,1,134,157,23,FVWWAISTAAMLYILYVLFFGFT,0
1x0k,1,171,192,21,KVLRNVTVVLWSAYPVVWLIG,0
1x0k,1,193,203,10,EGAGIVPLNI,0
1x0k,1,204,226,22,TLLFMVLDVSAKVGFGLILLRS,0
1x0k,1,232,248,16,AEAPEPSAGDGAAATS,0
3uu3,E,-3,4,7,SAAAQDM,0
3uu3,E,5,28,23,SPPPPIADEPLTVNTGIYLIESY,0
3uu3,E,29,34,5,LDDCA,0
3uu3,E,35,202,167,TFKVNAFLSLSWKDRRLAFDPVRSGVRVKTYEPEAIWIPEIRFVNVENARDADVVDISVSPDGTVQYLERFSARVLSPLDFRRYPFDSQTLHIYLIVRSVDTRNIVLAVDLEKVGKNDDVFLTGWDIESFTAVVKPANFALEDRLESKLDYQLRISRQYFSYIPNII,0
3uu3,E,203,218,15,PMLFILFISWTAFWS,0
3uu3,E,222,238,16,ANVTLVVSTLIAHIAF,0
3uu3,E,239,258,19,ILVECNLPKTPYMTYTGAI,0
3uu3,E,259,275,16,FMIYLFYFVAVIEVTV,0
3uu3,E,292,310,18,RASRIAFPVVFLLANIIL,0
3uu3,E,311,315,4,FLFF,0
3uu3,E,316,317,1,F,0
4ycl,A,51,58,7,LVIEQFE,0
4ycl,A,61,78,17,VRILLLAACISFVLAWF,0
4ycl,A,79,85,6,EGEETI,0
4ycl,A,86,104,18,AFVEPFVILLILIANAIV,0
4ycl,A,260,280,20,SKVISLICVAVWLINIGHFN,0
4ycl,A,281,291,10,PVHGGSWIRG,0
4ycl,A,292,314,22,IYYFKIAVALAVAAIPEGLPAV,0
4ycl,A,761,784,23,RYLISSNVGEVVCIFLTAALGLP,0
4ycl,A,786,807,21,LIPVQLLWVNLVTDGLPATAL,0
4ycl,A,835,854,19,RYMAIGGYVGAATVGAAAW,0
4ycl,A,855,896,41,FMYAEDGPGVTYHQLTHFMQCTEDHPHFEGLDCEIFEAPEP,0
4ycl,A,897,916,19,TMALSVLVTIEMCNALNSL,0
4ycl,A,926,950,24,PWVNIWLLGSICLSMSLHFLILYV,0
4ycl,A,951,967,16,PLPMIFKLKALDLTQW,0
4ycl,A,968,987,19,MVLKISLPVIGLDEILKFI,0
5aw5,G,4,21,17,GPDNDERFTYDYYRLRV,0
5aw5,G,22,38,16,GLIVAAVLCVIGIIIL,0
2m6i,E,225,248,23,QLYIPSLLIVILSWISFWINLDA,0
2m6i,E,250,267,17,ARVGLGITTVLTLTTQS,0
2m6i,E,283,306,23,DIWLAVCLLFVFSALLEYAAVNF,0
2m6i,E,307,396,89,SRQREFGGGGFIQRAKKID,0
2m6i,E,397,420,23,ISRIGFPLAFLIFNLFYWIIYKI,0
2m6i,E,427,434,7,EHHHHHH,0
2dhl,A,1,5,4,AQDI,0
2dhl,A,6,23,17,STIGDLVKWIIDTVNKF,0
2vv5,G,1,24,23,EDLNVVDSINGAGSWLVANQALL,0
2vv5,G,25,34,9,SYAVNIVAA,0
2vv5,G,35,59,24,AIIIVGLIIARMISNAVNRLMISR,0
2vv5,G,67,87,20,FLSALVRYGIIAFTLIAALG,0
2vv5,G,88,91,3,VGV,0
2vv5,G,92,108,16,TASVIAVLGAAGLVVG,0
2vv5,G,281,286,5,EDKAA,0
4pi0,B,1,8,7,SQSKSGG,0
4pi0,B,35,50,15,FAVLGGYHVHFMLTA,0
4pi0,B,51,67,16,DWDFWVDWKDRRMWPT,0
4pi0,B,68,81,13,VPILGVTFCAASQ,0
4pi0,B,92,108,16,GAVFAALGLLIGEWIN,0
4pi0,B,109,125,16,YVNFWGWTYFPISLVF,0
4pi0,B,126,140,14,SALIVPAIWLDVIL,0
4pi0,B,147,161,14,ITAVVGSLGWGLLF,0
4pi0,B,162,221,59,PNNWPAIAAFHQATEQHGQLMTLADLIGFHFVRTSMPEYIRMVERGTLRTFGKDVVPVA,0
4pi0,B,222,240,18,FFSGFVSMMVYFLWWFMG,0
4phu,A,-12,0,12,DYKDDDDKGSAT,0
4phu,A,7,28,21,SFGLYVAAFALGFPLNVLAIR,0
4phu,A,29,43,14,ATAHARLRLTPSAV,0
4phu,A,44,66,22,ALNLGCSDLLLTVSLPLKAVEA,0
4phu,A,78,102,24,CPVFAVAHFAPLYAGGGFLAALSA,0
4phu,A,103,111,8,RYLGAAFP,0
4phu,A,112,119,7,GYQAFRR,0
4phu,A,120,124,4,CYSW,0
4phu,A,125,146,21,VCAAIWALVLCHLGLVFGLEA,0
4phu,A,179,203,24,GPARFSLSLLLFFLPLAITAFCFV,0
4phu,A,204,2224,2020,CLRALARGSNIFEMLRIDEGLRLKIYKDTEGYYTIGIGHLLTKSPSLNAAKSELDKAIGRNTNGVITKDEAEKLFNQDVDAAVRGILRNAKLKPVYDSLDAVRRAALINMVFQMGETGVAGFTNSLRMLQQKRWDEAAVNLAKSRWYNQTPNRAKRVITTFRTGTWDAYGSLTHRRKLRAAW,0
4phu,A,2225,2249,24,AGGALLTLLLCVGPYNASNVASFL,0
4phu,A,2258,2277,19,KLGLITGAWSVVLNPLVTG,0
4phu,A,2278,2280,2,LG,0
4phu,A,2281,2316,35,GPGLKTVCAARTQGGKSQKAENLYFQGHHHHHHHH,0
3bvd,C,2,6,4,EKPK,0
3bvd,C,7,24,17,ALAVILVLTLTILVFWL,0
1ojb,A,1,2,1,S,0
1ojb,A,3,489,486,KCDVVVVGGGISGMAAAKLLHDSGLNVVVLEARDRVGGRTYTLRNQKVKYVDLGGSYVGPTQNRILRLAKELGLETYKVNEVERLIHHVKGKSYPFRGPFPPVWNPITYLDHNNFWRTMDDMGREIPSDAPWKAPLAEEWDNMTMKELLDKLCWTESAKQLATLFVNLCVTAETHEVSALWFLWYVKQCGGTTRIISTTNGGQERKFVGGSGQVSERIMDLLGDRVKLERPVIYIDQTRENVLVETLNHEMYEAKYVISAIPPTLGMKIHFNPPLPMMRNQMITRVPLGSVIKCIVYYKEPFWRKKDYCGTMIIDGEEAPVAYTLDDTKPEGNYAAIMGFILAHKARKLARLTKEERLKKLCELYAKVLGSLEALEPVHYEEKNWCEEQYSGGCYTTYFPPGILTQYGRVLRQPVDRIYFAGTETATHWSGYMEGAVEAGERAAREILHAMGKIPEDEIWQSEPESVDVPAQPITTTFLERHLPSV,0
1ojb,A,490,501,11,GLLRLIGLTTI,0
1ojb,A,502,520,18,SATALGFLAHKRGLLVRV,0
3ux4,C,2,20,18,GLVLLYVGIVLISNGICG,0
3ux4,C,29,48,19,AVMNFFVGGLSIVCNVVVI,0
3ux4,C,49,58,9,YSALHPTAP,0
3ux4,C,59,73,14,EGAEDIVQVSHHLT,0
3ux4,C,74,76,2,FY,0
3ux4,C,77,95,18,PATGLLFGFTYLYAAINH,0
3ux4,C,102,120,18,PYSWYSLFVAINTVPAAI,0
3ux4,C,121,141,20,SHYSDMLDDHKVLGITEGDW,0
3ux4,C,142,159,17,AIIWLAWGVLWLTAFIE,0
3ux4,C,168,188,20,FTPWLAIIEGILTAWIPAWL,0
3ux4,C,189,195,6,FIQHWV,0
4pda,C,-5,1,6,PAVPRM,0
4pda,C,9,25,16,MAVLLGIAVLLSSNRK,0
4pda,C,27,42,15,NLRTVGGAFAIQFSL,0
4pda,C,50,78,28,WGQELLRGFSDAVSNVINYGNDGTSFLF,0
4pda,C,103,118,15,TLIFFSALISVLYYL,0
4pda,C,120,136,16,MQWVIRILGGGLQKAL,0
4pda,C,137,171,34,TSRAESMSAAANIFVGQTEAPLVVRPFVPKMTQS,0
4pda,C,172,189,17,LFAVMCGGLASIAGGVL,0
4pda,C,206,223,17,FMAAPGGLLFAKLMMPE,0
4pda,C,224,229,5,EKPQD,0
4pda,C,230,240,10,EDITLDGGDD,0
4pda,C,242,270,28,ANVIDAAAGGASAGLQLALNVGAMLIAF,0
4pda,C,363,380,17,CGFANLSSIAILLGGLG,0
4pda,C,381,390,9,LAPKRRGDI,0
4pda,C,391,408,17,RMGVKAVIAGTLSNLMA,0
4pda,C,417,418,1,F,0
5m8k,A,31,37,6,WKTLLA,0
5m8k,A,43,58,15,LVAVGYMDPGNWSTS,0
5m8k,A,59,67,8,TGGQNFQY,0
5m8k,A,68,84,16,LLSIIVISSLLAMLLQ,0
5m8k,A,98,104,6,AQAIRA,0
5m8k,A,113,137,24,FWILTELAIMATDIAQVIGAAIAL,0
5m8k,A,138,146,8,LLFKIPIF,0
5m8k,A,147,162,15,AVVITVLDVFLLLLL,0
5m8k,A,170,190,20,EALVVCLIFVILFVFLYQII,0
5m8k,A,191,199,8,SQPAWHQV,0
5m8k,A,200,210,10,KGLIPSWASV,0
5m8k,A,211,222,11,TSPKIGGQTPL,0
5m8k,A,223,240,17,ASLGIIGATIMPHNLFL,0
5m8k,A,269,285,16,NIQLSLAMVVNALLLI,0
5m8k,A,286,300,14,GVAVFKSGAVQDPS,0
5m8k,A,301,308,7,FGLYQAL,0
5m8k,A,309,331,22,NPDMVSNPVLAEAARSGVLSTL,0
5m8k,A,332,351,19,AVALLASGQNSTITGTITG,0
5m8k,A,366,382,16,LRRLVTRLIAIIPVVV,0
5m8k,A,383,402,19,VAITSHQGSLDEHQALNNL,0
5m8k,A,403,419,16,NNSQVFLALALPFSIV,0
5m8k,A,444,465,21,GWLTVIILTLLNLISISSQIA,0
5m8k,A,466,479,13,FFGDNPSSQDLLL,0
5m8k,A,480,497,17,QVISIGIILAMIGLLIW,0
3bz1,Z,8,26,18,LAALVILSFVMVIGVPVA,0
3bz1,Z,27,36,9,ASPQDWDRS,0
3bz1,Z,37,56,19,QLIFLGSGLWIALVLVVGV,0
1vf5,U,1,2,1,E,0
1vf5,U,3,4,1,D,0
1vf5,U,5,26,21,LGWVALLVVFTWSIAMVVWGR,0
2hqc,C,1,6,5,PNFFI,0
2hqc,C,7,11,4,RPIF,0
2hqc,C,12,25,13,WVIAIIIMLAGGL,0
2hqc,C,342,356,14,TLVEAIILVFLVMY,0
2hqc,C,357,365,8,FLQNFRAT,0
2hqc,C,366,382,16,IPTIAVPVVLLGTFAV,0
2hqc,C,399,410,11,LAIGLLVADAI,0
2hqc,C,411,440,29,VVENVERVMAEEGLPPKEATRKSMGQIQG,0
2hqc,C,441,455,14,LVGIAMVLSAVFVP,0
2hqc,C,472,489,17,TIVSAMALSVLVALILT,0
2hqc,C,490,498,8,ALCATMLK,0
2hqc,C,499,512,13,IAKGDHGEGKKGF,0
2hqc,C,513,527,14,GWFNRMFEKSTHHY,0
2hqc,C,528,535,7,DSVGGIL,0
2hqc,C,536,540,4,STGR,0
2hqc,C,541,556,15,LVLYLIIVVGMAYLF,0
2hqc,C,877,890,13,AISLIVVFLCLAA,0
2hqc,C,891,897,6,YESWSI,0
2hqc,C,898,915,17,FSVMLVVPLGVIGALLA,0
2hqc,C,930,943,13,LLTTIGLSAKNAI,0
2hqc,C,944,975,31,IVEFAKDLMDKEGKGLIEATLDAVRMRLRPI,0
2hqc,C,976,992,16,MTSLAFILGVMPLVIS,0
2hqc,C,1005,1019,14,GVMGGMVTATVLAI,0
2hqc,C,1020,1036,16,FVPVFFVVVRRRFSRK,0
2hqc,C,1037,1053,16,EDIEHSHTVDHHHHHH,0
5azd,D,14,37,23,VFNMLSLTIAGMLAAFVFFLLAR,0
5azd,D,38,44,6,YVAPRY,0
5azd,D,45,67,22,IALYLSALIVFIAGYHYLRIFE,0
5azd,D,90,111,21,YRYADWLLTVPLLLLELILVL,0
5azd,D,112,117,5,LTAAR,0
5azd,D,118,140,22,WNLSIKLVVASVLMLALGYVGE,0
5azd,D,149,172,23,LWGALSSIPFFYILYVLWVELGQ,0
5azd,D,173,185,12,IREAKFGPRVLE,0
5azd,D,186,207,21,LGATRLVLLMSWGFYPIAYAL,0
5azd,D,220,243,23,IQIGYSLADLIAKPIYGLLVFAI,0
5azd,D,244,253,9,RAKSLEEGF,0
5c6o,A,24,44,20,PAMIGMFVMALYNVVDTIFI,0
5c6o,A,45,56,11,YAVGIEGVAGV,0
5c6o,A,57,78,21,IAFPIMMIMMSMAGALGIGGA,0
5c6o,A,100,119,19,LTVILVLSVIGFISAFTLL,0
5c6o,A,120,138,18,PALQLFGATSVTQGYATD,0
5c6o,A,139,161,22,LFPILLGSIFFFFAFAANNIIR,0
5c6o,A,167,191,24,FAMVTMIVPAVLNILLDVLFIFGL,0
5c6o,A,192,195,3,MGV,0
5c6o,A,196,215,19,GASIATVIAQASVTGLVLR,0
5c6o,A,242,263,21,LVGLPAFVQQSSASLMMIAIN,0
5c6o,A,264,278,14,MLLRFGSDFYVGVF,0
5c6o,A,279,298,19,LVQRIMMFVMMPMMGIMQA,0
5c6o,A,323,345,22,KVATIFSIGIFALLMLFPEALL,0
5c6o,A,346,359,13,VFTADREVIQAGV,0
5c6o,A,360,383,23,AMHILFCVTFLIGAQIVAGGLYQ,0
5c6o,A,389,410,21,QALILSLSRQIIFLIPLVLIL,0
5c6o,A,411,418,7,HIFGLSG,0
5c6o,A,419,438,19,WWAFPIADVLSFILTVVLL,0
4pd7,C,-5,1,6,PAVPRM,0
4pd7,C,4,21,17,MSLIGMAVLLGIAVLLS,0
4pd7,C,22,29,7,NRKAINL,0
4pd7,C,30,47,17,TVGGAFAIQFSLGAFIL,0
4pd7,C,50,78,28,WGQELLRGFSDAVSNVINYGNDGTSFLF,0
4pd7,C,103,118,15,TLIFFSALISVLYYL,0
4pd7,C,120,136,16,MQWVIRILGGGLQKAL,0
4pd7,C,137,175,38,TSRAESMSAAANIFVGQTEAPLVVRPFVPKMTQSELFA,0
4pd7,C,176,192,16,MCGGLASIAGGVLAGY,0
4pd7,C,202,220,18,VAASFMAAPGGLLFAKLM,0
4pd7,C,221,229,8,PETEKPQD,0
4pd7,C,230,240,10,EDITLDGGDD,0
4pd7,C,242,274,32,ANVIDAAAGGASAGLQLALNVGAMLIAFIGLI,0
4pd7,C,275,286,11,LINGMLGGIGG,0
4pd7,C,359,379,20,SFALCGFANLSSIAILLGGL,0
4pd7,C,380,394,14,SLAPKRRGDIARMG,0
4pd7,C,395,415,20,KAVIAGTLSNLMAATIAGFF,0
4pd7,C,417,418,1,F,0
4y9h,A,6,9,3,RPE,0
4y9h,A,10,32,22,IWLALGTALMGLGTLYFLVKGM,0
4y9h,A,42,66,24,YAITTLVPAIAFTMYLSMLLGYGL,0
4y9h,A,67,78,11,MVPFGGEQNPI,0
4y9h,A,79,99,20,WARYADWLFTTPLLLLDLAL,0
4y9h,A,104,127,23,QGTILALVGADGIMIGTGLVGAL,0
4y9h,A,128,134,6,KVYSYR,0
4y9h,A,135,157,22,VWWAISTAAMLYILYVLFFGFT,0
4y9h,A,172,195,23,VLRNVTVVLWSAYPVVWLIGSEG,0
4y9h,A,196,201,5,GIVPL,0
4y9h,A,202,224,22,IETLLFMVLDVSAKVGFGLILL,0
5t5n,E,2,32,30,VTYTNRVADARLGTFSQLLLQWKGSIYKLL,0
5t5n,E,33,53,20,SEFLIFISLYFAISLVYRLI,0
5t5n,E,62,82,20,EKLALYCNSYAELAPVSAVL,0
5t5n,E,83,239,156,AYVSLVVSRWWAQYESIPWPDRIMNLVSCNVDGEDEYGRLLRRTLMRYSNLCSVLILRSVSTAVYKRFPSMEHVVRAGLMTPEEHKKFESLNSPHNKFWIPCVWFSNLAVKARNEGRIRDSVLLQGILNELNTLRSQCGRLYGYDWISIPLVYTQV,0
5t5n,E,240,258,18,TVAVYSFFLACLIGRQFL,0
5t5n,E,265,287,22,GHELDLFVPVFTFLQFFFYAGW,0
5t5n,E,288,367,79,KVAEQLINPFGEDDDDFETNWLIDRNLQVSLMAVDEMHQDLPILEKDLYWNEPDPQPPYTAATAEYKRPSFLGSTFDIS,0
4pdv,E,18,20,2,AK,0
4pdv,E,25,45,20,VLFVLTILTLISGTIFYSTV,0
4pdv,E,46,50,4,GLRP,0
4pdv,E,51,67,16,DALYFSVVTLTTVGYG,0
4pdv,E,68,74,6,FSPQTD,0
4pdv,E,75,99,24,GKIFTILYIFIGIGLVFGFIHKLA,0
4pdv,E,103,109,6,LPSILS,0
4uyo,C,32,33,1,Q,0
4uyo,C,34,48,14,GVAVLLCVVIAAWL,0
4uyo,C,53,67,14,TRVLLISSVMLVMI,0
4uyo,C,68,102,34,ELLNSAIEAVVDRIGSEYHELSGRAKDLGSAAVL,0
4uyo,C,103,117,14,AIIDAVITWAILLW,0
3prr,Z,5011,5024,13,LVILSFVMVIGVP,0
3prr,Z,5025,5038,13,AYASPQDWDRSKQ,0
3prr,Z,5039,5052,13,IFLGSGLWIALVL,0
3l73,W,5,12,7,LRQAYSA,0
3l73,W,20,39,19,ALTVVLGAVLFERAFDQGA,0
3l73,W,40,62,22,AIFEHLNEGKLWKHIKHKYEAS,0
3l73,W,63,64,1,E,0
5h2l,C,4,11,7,TGRPEWI,0
5h2l,C,12,28,16,LALGTALMGLGTLYFL,0
5h2l,C,47,61,14,LVPAIAFTMYLSML,0
5h2l,C,62,79,17,GYGLTMVPFGGEQNPIY,0
5h2l,C,80,94,14,ARYADWLFTTPLLL,0
5h2l,C,111,126,15,VGADGIMIGTGLVGA,0
5h2l,C,127,134,7,TKVYSYR,0
5h2l,C,135,150,15,VWWAISTAAMLYILY,0
5h2l,C,178,192,14,VVLWSAYPVVWLIG,0
5h2l,C,193,203,10,EGAGIVPLNI,0
5h2l,C,204,220,16,TLLFMVLDVSAKVGFG,0
3b8e,H,30,48,18,LIFAALAFIVGLIIILSK,0
3b8e,H,49,51,2,LR,0
4ri2,B,17,36,19,KVEDGLFGTSGGIGFTKEN,0
4ri2,B,37,56,19,LFVGRVAMIGFAASLLGEG,0
4ri2,B,78,97,19,PLLLFFILFTLLGAIGALG,0
4ri2,B,98,106,8,RGRFVDEP,0
4ri2,B,134,140,6,GFTKSN,0
4ri2,B,141,158,17,LFVGRLAQLGFAFSLIG,0
4ri2,B,166,174,8,LAQLNIET,0
4ri2,B,182,198,16,PLVLLNVVFFFIAAIN,0
4ri2,B,199,206,7,GTGKFIT,0
2zxe,G,1,3,2,DP,0
2zxe,G,4,22,18,GPDNDERFTYDYYRLRVV,0
2zxe,G,23,38,15,LIVAAVLCVIGIIIL,0
2zxe,G,43,74,31,RCKFNQNKRTRSNSGTATAQHLLQPGEATEC,0
5heo,E,11,210,199,VDVSVSIFINKIYGVNTLEQTYKVDGYIVAQWTGKPRKTPGDKPLIVENTQIERWINNGLWVPALEFINVVGSPDTGNKRLMLFPDGRVIYNARFLGSFSNDMDFRLFPFDRQQFVLELEPFSYNNQQLRFSDIQVYTENIDNEEIDEWWIRGKASTHISDIRYDHLSSVQPNQNEFSRITVRIDAVRNPSYYLWSFIL,0
5heo,E,211,222,11,LGLIIAASWSV,0
5heo,E,233,246,13,TSFTLMLTVVAYA,0
5heo,E,247,265,18,YTSNILGRLPYTTVIDQM,0
5heo,E,266,279,13,IAGYGSIFAAILL,0
5heo,E,303,315,12,FPLGFLAIGCVL,0
5heo,E,316,317,1,I,0
4grv,A,33,51,18,YKDDDDATSTSESDTAGP,0
4grv,A,63,87,24,KVLVTAIYLALFVVGTVGNSVTLF,0
4grv,A,88,92,4,LARK,0
4grv,A,93,96,3,SLQ,0
4grv,A,97,106,9,LQSTVHYHL,0
4grv,A,107,130,23,SLALSDLLILLLAMPVELYNFIW,0
4grv,A,136,164,28,FGDAGCRGYYFLRDACTYATALNVASLS,0
4grv,A,165,190,25,ARYLAICHPFKAKTLMSRSRTKKFI,0
4grv,A,191,210,19,AIWLASALLAIPMLFTMGL,0
4grv,A,226,258,32,PIVDTATVKVVIQVNTFMSFLFPMLVISILNT,0
4grv,A,259,1048,789,IANKLTVMVNIFEMLRIDEGLRLKIYKDTEGYYTIGIGHLLTKSPSLNAAKSELDK,0
4grv,A,1049,1051,2,IG,0
4grv,A,1052,308,-744,NTNGVITKDEAEKLFNQDVDAAVRGILRNAKLKPVYDSLDAVRRAALINMVFQMGETGVAGFTNSLRMLNNKRWDEAAVNLAKSRWYNQTPNRAKRVITTFRTGTWDAYGSGSVQALRHGVL,0
4grv,A,309,335,26,ARAVVIAFVVCWLPYHVRRLMFCYIS,0
4grv,A,347,370,23,HYFYMLTNALAYASSAINPILYN,0
4grv,A,371,379,8,VSANFRQV,0
4grv,A,380,409,29,LSTLACLCPGWRHRRKAHHHHHHHHHHGG,0
3kg2,D,524,543,19,IWMCIVFAYIGVSVVLFLV,0
3kg2,D,545,567,22,FSPYEWHTEEFEDGRETQSSES,0
3kg2,D,568,575,7,NEFGIFN,0
3kg2,D,576,586,10,LWFSLGAFMQ,0
3kg2,D,587,592,5,GADIS,0
3kg2,D,593,596,3,RSL,0
3kg2,D,597,617,20,GRIVGGVWWFFTLIIISSYT,0
3kg2,D,793,813,20,GVFYILVGGLGLAMLVALIE,0
3kg2,D,814,817,3,CYK,0
3kg2,D,818,832,14,RAEAKRMKGLVPRG,0
4boo,E,-16,0,16,VLTLLLIICLALEVRS,0
4boo,E,165,171,6,VVEWIH,0
4boo,E,221,243,22,IINIIAPCVLISSLVVLVYFLP,0
4boo,E,244,250,6,QAGGQK,0
4boo,E,251,273,22,TLSISVLLAQTIFLFLIAQKVP,0
4boo,E,284,308,24,YLIFVMFVSLVIVTNCVIVLNVSL,0
4boo,E,309,314,5,TPNTH,0
4boo,E,315,413,98,LSEKIKHLFLEFLPKYLGMHLEPSEETPEKPQPRRRSSFGIMIKAEEYILKKPRSELMFEEQKDRHGLKRVNKMTSDIDIGTTVDLYKDLANFAPEIK,0
4boo,E,414,448,34,CVEACNFIAKSTKEQNDSGSENENWVLIGKVIDK,0
4boo,E,449,473,24,CFWIALLLFSLGTLAIFLTGHLNQ,0
4boo,E,477,488,11,PFPGDPRKYVP,0
1j7f,L,18,40,22,LAAIGAAIGIGILGGKFLEGAA,0
1j7f,L,41,47,6,QPDLIP,0
1j7f,L,48,68,20,LRTQFFIVMGLVDAIPMIAV,0
2qjk,F,9,12,3,TRR,0
2qjk,F,13,31,18,FLYYATAGAGAVATGAAV,0
3k0g,E,18,22,4,AKDK,0
3k0g,E,26,45,19,LFVLTILTLISGTIFYSTV,0
3k0g,E,46,50,4,GLRP,0
3k0g,E,51,70,19,DALYFSVVTLTTVGETPPP,0
3k0g,E,71,73,2,TD,0
3k0g,E,74,95,21,GKIFTILYIFIGIGLVFGFIH,0
3k0g,E,102,110,8,LPSILSNL,0
3wxw,A,132,140,8,RACFKSIF,0
3wxw,A,146,167,21,GNIWTHLLGCVFFLCLGIFYM,0
3wxw,A,168,169,1,R,0
3wxw,A,172,182,10,SFVAPLQEKV,0
3wxw,A,183,203,20,FGLFFLGAILCLSFSWLFHT,0
3wxw,A,215,235,20,SKLDYSGIALLIMGSFVPWL,0
3wxw,A,236,247,11,YSFYCNPQPCF,0
3wxw,A,248,266,18,YLIVICVLGIAAIIVSQW,0
3wxw,A,275,294,19,GVRAGVFLGLGLSGIIPTL,0
3wxw,A,295,308,13,YVISEGFLKAATI,0
3wxw,A,311,313,2,GW,0
3wxw,A,314,334,20,MLMASLYITGAALYAARIPE,0
3wxw,A,344,365,21,FHSHQLFHIFVVAGAFVHFHG,0
3wxw,A,366,384,18,SNLQEFRFMIGGGCSEED,0
4nv6,A,1,16,15,ASYLKLKAQEETWLQ,0
4nv6,A,17,20,3,HSR,0
4nv6,A,21,42,21,ILAILAGLGSLLTAYLTYTKL,0
4nv6,A,65,89,24,EFLGIPTAAVGLLGFLGVLALAVL,0
4nv6,A,90,91,1,D,0
4nv6,A,93,102,9,PLVKRWRWP,0
4nv6,A,103,124,21,LFGLVSAMTAFEMYMLYLMVA,0
4nv6,A,130,149,19,MYCTTAIILVAGLGLVTVL,0
4nv6,A,150,154,4,HRWL,0
4nv6,A,156,159,3,GKL,0
4nv6,A,160,181,21,FSYILVAFLTLVTTIGVYANQ,0
4nv6,A,283,291,8,LEHHHHHH,0
2o9d,A,-1,4,5,HMFRK,0
2o9d,A,5,22,17,AAESFGTFWLVFGGSGS,0
2o9d,A,38,55,17,VALAFGLTVLTMAFAVG,0
2o9d,A,56,58,2,IS,0
2o9d,A,59,73,14,GHFNPAVTIGLWAG,0
2o9d,A,74,80,6,RFPAKE,0
2o9d,A,81,99,18,VGYVIAQVVGGIVAAALL,0
2o9d,A,136,153,17,VELVLSAGFLLVIHGAT,0
2o9d,A,154,161,7,KFAPAGF,0
2o9d,A,162,177,15,PIAIGLALTLIHLIS,0
2o9d,A,184,193,9,VNPARSTAV,0
2o9d,A,206,227,21,FFWVVPIVGGIIGGLIYRTLL,0
2o9d,A,228,229,1,K,0
2o9d,A,230,231,1,D,0
1xqe,C,1,2,1,P,0
1xqe,C,3,14,11,VADKADNAFMM,0
1xqe,C,15,31,16,CTALVLFMTIPGIALF,0
1xqe,C,48,64,16,TVTFALVCILWVVYGY,0
1xqe,C,65,101,36,LAFGEGNNFFGNINWLMLKNIELTAVMGSIYQYIHV,0
1xqe,C,102,118,16,FQGSFACITVGLIVGA,0
1xqe,C,129,147,18,IFVVVWLTLSYIPIAHMV,0
1xqe,C,148,160,12,GGGLLASHGALD,0
1xqe,C,161,178,17,AGGTVVHINAAIAGLVG,0
1xqe,C,184,194,10,RVGFGKEAFK,0
1xqe,C,203,219,16,GTAILYIGWFGFNAGS,0
1xqe,C,220,230,10,GTANEIAALA,0
1xqe,C,231,248,17,VNTVVATAAAILGWIFG,0
1xqe,C,262,276,14,SGAIAGLVGVTPAC,0
1xqe,C,277,281,4,YIGV,0
1xqe,C,282,298,16,GALIIGVVAGLAGLWG,0
1xqe,C,302,308,6,KRLLRV,0
1xqe,C,314,332,18,FGVHGVCGIVGCIMTGIF,0
1xqe,C,333,352,19,ASSLGGVGFAEGVTMGHQL,0
1xqe,C,353,377,24,VQLESIAITIVWSGVVAFIGYKLA,0
1xqe,C,387,418,31,EQEREGLDVNSHGENAYNADQAQQPAQADLE,0
3rfu,A,1,73,72,KHDHHQGHTHSGKGHACHHEHNSPKTQQASSKMEGPIVYTCPMHPEIRQSAPGHCPLCGMALEPETVTVSEV,0
3rfu,A,85,104,19,WIALMLTIPVVILEMGGHG,0
3rfu,A,105,113,8,KHFISGNG,0
3rfu,A,114,132,18,SWIQLLLATPVVLWGGWP,0
3rfu,A,133,141,8,FKRGWQSL,0
3rfu,A,149,168,19,TLIAMGIGVAWIYSMVAVL,0
3rfu,A,169,185,16,PGVFPHAFRSQEGVVA,0
3rfu,A,186,199,13,YFEAAAVITTLVL,0
3rfu,A,341,359,18,WFVPAVILVAVLSFIVWA,0
3rfu,A,360,370,10,LGPQPALSYG,0
3rfu,A,371,386,15,IAAVSVLIIACPCAL,0
3rfu,A,684,701,17,AFIYNVLGVPLAAGVLY,0
3rfu,A,702,706,4,LTGL,0
3rfu,A,707,723,16,LSPMIAAAAMALSSVS,0
2jp3,A,14,37,23,ESLQLGGLIFGGLLCIAGIALAL,0
2jp3,A,38,67,29,GKCKCRRNHTPSSLPEKVTPLITPGSAST,0
4ki0,G,1,7,6,AMVQPK,0
4ki0,G,8,14,6,QKARLF,0
4ki0,G,15,32,17,THLLLLLFIAAIMFPLL,0
4ki0,G,57,63,6,HWKLAL,0
4ki0,G,86,107,21,NSVKVAGISAIGIVALSTTCA,0
4ki0,G,108,116,8,AFARMRFP,0
4ki0,G,117,133,16,KATLLKGMLIFQMFPA,0
4ki0,G,136,150,14,LVALYALFDRLGEY,0
4ki0,G,160,179,19,GVIFAYLGGIALHVWTIKG,0
4ki0,G,180,198,18,FETIDSSLEEAAALDGAT,0
4ki0,G,199,205,6,WQAFRL,0
4ki0,G,207,212,5,LPLSV,0
4ki0,G,213,229,16,ILAVVFILSFIAAITE,0
4ki0,G,269,285,16,SALPITIVFLLAQRWL,0
4ki0,G,286,296,10,NGLTAGGVKG,0
5hkd,D,137,149,12,PSSPSLLRAIPG,0
5hkd,D,157,173,16,LVIFYVFAVMGTKLFA,0
5hkd,D,174,179,5,SFPEW,0
5hkd,D,180,195,15,GTLGASMYTLFQVMT,0
5hkd,D,196,211,15,ESWSMGIARPVIEAY,0
5hkd,D,212,230,18,WAWIYFVSFILVSSFTVL,0
5hkd,D,243,256,13,AHWEGGGGGGGEQ,0
5hkd,D,287,288,1,R,0
3lnm,G,-18,28,46,AHHHHHHHHHHGLVPRGSMTVATGDPVDEAAALPGHPQDTYDPEAD,0
3lnm,G,29,164,135,ESSERVVINISGLRFETQLKTLAQFPETLLGDPKKRMRYFDPLRNEYFFDRNRPSFDAILYYYQSGGRLRRPVNVPLDIFSEEIRFYELGEEAMEMFREDEGYIKEEERPLPENEFQRQVWLLFEYPESSGPARI,0
3lnm,G,165,181,16,AIVSVMVILISIVSFC,0
3lnm,G,225,239,14,ETLCIIWWSFEFLV,0
3lnm,G,240,256,16,FFACPSKAGFFTNIMN,0
3lnm,G,257,271,14,IDIVAIIPYYVTIF,0
3lnm,G,292,304,12,RIMRILRIFKLS,0
3lnm,G,305,307,2,HS,0
3lnm,G,308,320,12,GLQILGQTLKAS,0
3lnm,G,321,324,3,REL,0
3lnm,G,325,342,17,LLIFFLFIGVILFSSAV,0
3lnm,G,362,373,11,WAVVSMTTVGY,0
3lnm,G,385,399,14,VGSLCAIAGVLTIA,0
3lnm,G,400,414,14,PVPVIVSNFNYFYH,0
3lnm,G,415,417,2,ET,0
3lnm,G,418,495,77,GEEQAQYLQVTSSPKIPSSPDLKKSRSASTISKSDYMEIQEGVNNSNEDFREENLKTANSTLANTNYVNITKMLTDV,0
4kk8,B,40,61,21,VVGTLVGLAAVAFDKGVAWLQ,0
4kk8,B,62,83,21,QRMGALVHTADNYPLLLTVAF,0
4kk8,B,84,97,13,CSAVLAMFGYFLV,0
4kk8,B,129,142,13,VKFFGGLGTLGGG,0
4kk8,B,144,156,12,LGRQGPTVQIGG,0
4kk8,B,181,203,22,AAAGLAAAFNAPLAGILFIIEE,0
4kk8,B,216,232,16,AVFIGVIMSTIMYRIF,0
4kk8,B,233,252,19,HEVALIDVGKLSDAPLNTL,0
4kk8,B,253,273,20,LYLILGIIFGIFGPIFNKWV,0
4kk8,B,291,304,13,VLMGGAIGGLCGL,0
4kk8,B,305,337,32,GFVAPATSGGGFNLIPIATAGNFSMGMLVFIF,0
4kk8,B,338,351,13,ARVITTLLCFSSG,0
4kk8,B,353,368,15,GGIFAPMLALGTVLG,0
4kk8,B,369,392,23,AFGMVAVELFPQYHLEAGTFAIA,0
4kk8,B,393,415,22,MGALLAASIRAPLTGIILVLEM,0
4kk8,B,416,422,6,DNYQLI,0
4kk8,B,423,439,16,PMIITGLGATLLAQFT,0
4kk8,B,460,461,1,K,0
5jqh,A,867,876,9,IFEMLRIDE,0
5jqh,A,932,1031,99,NQDVDAAVRGILRNAKLKPVYDSLDAVRRAALINMVFQMGETGVAGFTNSLRMLQQKRWDEAAVNLAKSRWYNQTPNRAKRVITTFRTGTWDAYAADEV,0
5jqh,A,1032,1057,25,VVGMGIVMSLIVLAIVFGNVLVITA,0
5jqh,A,1070,1095,25,FITSLACADLVMGLAVVPFGAAHIL,0
5jqh,A,1096,1104,8,KTWTFGNF,0
5jqh,A,1105,1129,24,CEFWTSIDVLCVTASIETLCVIAV,0
5jqh,A,1151,1174,23,VIILMVWIVSGLTSFLPIQMHWY,0
5jqh,A,1175,1178,3,ATH,0
5jqh,A,1179,1186,7,EAINCYA,0
5jqh,A,1187,1195,8,ETCCDFFT,0
5jqh,A,1196,1220,24,QAYAIASSIVSFYVPLVIMVFVYS,0
5jqh,A,1275,1299,24,GIIMGTFTLCWLPFFIVNIVHVIQ,0
5jqh,A,1300,1302,2,NL,0
5jqh,A,1303,1327,24,RKEVYILLNWIGYVNSGFNPLIYC,0
5jqh,A,1330,1339,9,DFRIAFQEL,0
5a43,B,1,5,4,IKSL,0
5a43,B,6,23,17,AVIIGGSVGCTLRWLLS,0
5a43,B,24,29,5,KFNSL,0
5a43,B,34,48,14,PGTLVVNLLAGLII,0
5a43,B,49,68,19,TMLAYFLRQPHLDPFWKLM,0
5a43,B,69,84,15,TTGLCGGLSTFSTFS,0
5a43,B,101,114,13,SVLVHVIGSLIMT,0
5a43,B,115,126,11,LGFFIITILFA,0
1ors,C,20,26,6,VMEHPL,0
1ors,C,27,50,23,ELGVSYAALLSVIVVVVEYTMQL,0
1ors,C,55,75,20,VRLYLVDLILVIILWADYAY,0
1ors,C,76,87,11,AYKSGDPAGYV,0
1ors,C,88,107,19,KTLYEIPALVPAGLLALIE,0
1ors,C,118,142,24,VRLLRFLRILLIISRGSKFLSAIA,0
1ors,C,143,151,8,AADKLVPR,0
3rey,A,1,6,5,PIMGS,0
3rey,A,8,29,21,YITVELAIAVLAILGNVLVCW,0
3rey,A,30,43,13,VWLNSNLQNVTNY,0
3rey,A,44,67,23,VVSLAAADILVGVLAIPFAITIS,0
3rey,A,76,100,24,CLFIACFVLVLAQSSIFSLLAIAI,0
3rey,A,101,120,19,RYIAIAIPLRYNGLVTGTR,0
3rey,A,121,144,23,AGIIAICWVLSFAIGLTPMLGWN,0
3rey,A,150,157,7,EGKNHSQ,0
3rey,A,173,198,25,MNYMVYFNFFACVLVPLLLMLGVYL,0
3rey,A,199,235,36,IFAAARRQLKQMESQPLPGERARSTLQKEVHAAKSA,0
3rey,A,236,259,23,IIAGLFALCWLPLHIINCFTFFC,0
3rey,A,265,288,23,PLWLMYLAIVLAHTNSVVNPFIY,0
3rey,A,289,292,3,YRI,0
3rey,A,293,304,11,EFRQTFRKIIR,0
3rey,A,306,329,23,VLRQQEPFKAAAAHHHHHHHHHH,0
5abb,Z,35,48,13,VTAALLASTVFFF,0
5abb,Z,49,65,16,ERDRVSAKWKTSLTVS,0
5abb,Z,66,79,13,LVTGIAFWHYMYM,0
1s5l,z,2008,2024,16,LAALVILSFVMVIGVP,0
1s5l,z,2025,2038,13,AYASPQDWDRSKQ,0
1s5l,z,2039,2053,14,IFLGSGLWIALVLV,0
1s5l,z,2059,2062,3,FVV,0
1fx8,D,1,5,4,SQTS,0
1fx8,D,11,28,17,IAEFLGTGLLIFFGVGC,0
1fx8,D,29,42,13,AALKVAGASFGQW,0
1fx8,D,43,60,17,ISVIWGLGVAMAIYLTA,0
1fx8,D,64,78,14,AHLNPAVTIALWLF,0
1fx8,D,86,104,18,IPFIVSQVAGAFCAAALV,0
1fx8,D,105,148,43,GLYYNLFFDFEQTHHIVRGSVESVDLAGTFSTYPNPHINFVQA,0
1fx8,D,149,167,18,AVEMVITAILMGLILALT,0
1fx8,D,179,195,16,PLLIGLLIAVIGASMG,0
1fx8,D,196,198,2,LT,0
1fx8,D,199,213,14,FAMNPARDFGPKVF,0
1fx8,D,214,233,19,WLAGWGNVAFTGGRDIPYF,0
1fx8,D,234,255,21,VPLFGPIVGAIVGAFAYRKLI,0
1fx8,D,260,281,21,CDICVVEEKETTTPSEQKASL,0
5hk2,A,10,31,21,WAALLLAVAAVLTQVVWLWLG,0
5hk2,A,32,218,186,QSFVFQREEIAQLARQYAGLDHELAFSRLIVELRRLHPGHVLPDEELQWVFVNAGGWMGAMCLLHASLSEYVLLFGTALGSRGHSGRYWAEISDTIISGTFHQWREGTTKSEVFYPGETVVHGPGEATAVEWGPNTWMVEYGRGVIPSTLAFALADTVFSTQDFLTLFYTLRSYARGLRLELTTYL,0
