PDB ID,Chain,Helix Start,Helix End,Helix Length,Helix Sequence,Is Transmembrane
4kk5,B,37,60,23,MAAVVGTLVGLAAVAFDKGVAWL,1
4kk5,B,84,97,13,CSAVLAMFGYFLV,1
4kk5,B,129,142,13,VKFFGGLGTLGGG,1
4kk5,B,144,156,12,LGREGPTVQIGG,1
4kk5,B,216,232,16,AVFIGVIMSTIMYRIF,1
4kk5,B,253,277,24,LYLILGIIFGIFGPIFNKWVLGMQ,1
4kk5,B,290,304,14,WVLMGGAIGGLCGL,1
4kk5,B,338,351,13,ARVITTLLCFSSG,1
4kk5,B,353,368,15,GGIFAPMLALGTVLG,1
4kk5,B,423,439,16,PMIITGLGATLLAQFT,1
3b5x,B,30,44,14,TIALVINAAADTYM,1
3b5x,B,68,82,14,FMILGLMFVRGLSG,1
3b5x,B,145,161,16,IVREGASIIGLLTLMF,1
3b5x,B,173,188,15,VAPVVAFAISFVSKR,1
3b5x,B,245,259,14,SAQSIADPVIQMIA,1
3b5x,B,288,301,13,SAMFGLMRPLKAL,1
1xrd,A,13,36,23,LVGLATFLFVLALLIHFILLSTE,1
2fed,B,37,61,24,MAAVVGTLVGLAAVAFDKGVAWLQ,1
2fed,B,81,97,16,AFLCSAVLAMFGYFLV,1
2fed,B,128,142,14,PVKFFGGLGTLGGG,1
2fed,B,144,159,15,LGREGPTVQIGGNIG,1
2fed,B,216,232,16,AVFIGVIMSTIMYRIF,1
2fed,B,253,277,24,LYLILGIIFGIFGPIFNKWVLGMQ,1
2fed,B,290,305,15,WVLMGGAIGGLCGLL,1
2fed,B,337,351,14,VARVITTLLCFSSG,1
2fed,B,353,368,15,GGIFAPMLALGTVLG,1
2fed,B,422,439,17,LPMIITGLGATLLAQFT,1
3ba6,A,55,77,22,QFEDLLVRILLLAACISFVLAW,1
3ba6,A,86,104,18,AFVEPFVILLILIANAIV,1
3ba6,A,257,275,18,EQLSKVISLICVAVWLIN,1
3ba6,A,294,313,19,YFKIAVALAVAAIPEGLPA,1
3ba6,A,760,781,21,IRYLISSNVGEVVCIFLTAAL,1
3ba6,A,787,807,20,IPVQLLWVNLVTDGLPATAL,1
3ba6,A,832,852,20,LFFRYMAIGGYVGAATVGAA,1
3ba6,A,898,916,18,MALSVLVTIEMCNALNSL,1
3ba6,A,932,950,18,LLGSICLSMSLHFLILYV,1
3ba6,A,963,987,24,LTQWLMVLKISLPVIGLDEILKFI,1
4kjp,B,37,61,24,MAAVVGTLVGLAAVAFDKGVAWLQ,1
4kjp,B,84,97,13,CSAVLAMFGYFLV,1
4kjp,B,129,142,13,VKFFGGLGTLGGG,1
4kjp,B,144,156,12,LGREGPTVQIGG,1
4kjp,B,216,232,16,AVFIGVIMSTIMYRIF,1
4kjp,B,253,277,24,LYLILGIIFGIFGPIFNKWVLGMQ,1
4kjp,B,290,305,15,WVLMGGAIGGLCGLL,1
4kjp,B,338,351,13,ARVITTLLCFSSG,1
4kjp,B,353,368,15,GGIFAPMLALGTVLG,1
4kjp,B,423,439,16,PMIITGLGATLLAQFT,1
5jsz,D,29,38,9,YFIIMIFLA,1
5jsz,D,43,56,13,YLVISIFGLAYVF,1
5jsz,D,72,82,10,IWMIVFTSLL,1
5jsz,D,109,122,13,LYVFIRFAMIILV,1
5jsz,D,249,260,11,AYCLLLTILMI,1
2onj,B,10,35,25,PYKYRIFATIIVGIIKFGIPMLIPL,1
2onj,B,64,89,25,IALFIFVIVRPPIEFIRQYLAQWTS,1
2onj,B,133,157,24,FILTGLMNIWLDCITIIIALSIMF,1
2onj,B,165,186,21,AALFIFPFYILTVYVFFGRLR,1
2onj,B,241,263,22,RWNAYSFAAINTVTDIGPIIVI,1
2onj,B,286,308,22,LELLFGPLRRLVASFTTLTQSF,1
4kkc,B,37,61,24,MAAVVGTLVGLAAVAFDKGVAWLQ,1
4kkc,B,84,97,13,CSAVLAMFGYFLV,1
4kkc,B,128,142,14,PVKFFGGLGTLGGG,1
4kkc,B,144,156,12,LGRAGPTVQIGG,1
4kkc,B,216,232,16,AVFIGVIMSTIMYRIF,1
4kkc,B,253,277,24,LYLILGIIFGIFGPIFNKWVLGMQ,1
4kkc,B,290,305,15,WVLMGGAIGGLCGLL,1
4kkc,B,338,351,13,ARVITTLLCFSSG,1
4kkc,B,353,368,15,GGIFAPMLALGTVLG,1
4kkc,B,423,439,16,PMIITGLGATLLAQFT,1
2qei,B,13,32,19,LILAMAGNAVGLGNFLRFP,1
2qei,B,44,63,19,IPYIIAFLLVGIPLMWIEW,1
2qei,B,90,124,34,KILGVFGLWIPLVVAIYYVYIESWTLGFAIKFLV,1
2qei,B,167,185,18,AYIVFLITMFINVSILIR,1
2qei,B,191,212,21,ERFAKIAMPTLFILAVFLVIR,1
2qei,B,242,266,24,VWIAAVGQIFFTLSLGFGAIITYA,1
2qei,B,277,297,20,SGLTAATLNEKAEVILGGSI,1
2qei,B,340,367,27,GFLWFFLLFFAGLTSSIAIMQPMIAFL,1
2qei,B,378,396,18,VLWTAAIVFFSAHLVMFL,1
2qei,B,400,426,26,DEMDFWAGTIGVVFFGLTELIIFFWI,1
2qei,B,445,469,24,RIYYYVMRYITPAFLAVLLVVWAR,1
2qei,B,484,502,18,ITRFYIIGLFLFLTFLVF,1
5v57,A,234,256,22,AAFGAVTGLCTLFTLATFVADW,1
5v57,A,264,286,22,VILFYVNACFFVGSIGWLAQFM,1
5v57,A,313,340,27,CVIIFVIVYYALMAGVVWFVVLTYAWH,1
5v57,A,358,381,23,YFHLLTWSLPFVLTVAILAVAQV,1
5v57,A,398,424,26,YRAGFVLAPIGLVLIVGGYFLIRGVM,1
5v57,A,451,475,24,LGIFGFLAFGFVLITFSCHFYDFF,1
5v57,A,517,542,25,EKINLFAMFGTGIAMSTWVWTKATL,1
2x79,A,34,49,15,IWFAMAIQVAIFIAA,1
2x79,A,62,77,15,VAIAAGCTIAVILLF,1
2x79,A,109,133,24,KALLSLFWFGFQTWLGALALDEIT,1
2x79,A,142,157,15,PLWIVIFGAIQVVTT,1
2x79,A,164,181,17,RWMNVFASPVLLAMGVY,1
2x79,A,210,227,17,TAIMIFVGGWIAVVVSI,1
2x79,A,254,271,17,AQWLGMVPASIIFGFIG,1
2x79,A,301,320,19,FQVFVLLATWSTNPAANLL,1
2x79,A,341,357,16,VSAVVGLLMMPWQFAG,1
2x79,A,360,376,16,TFLNLLASALGPLAGI,1
2x79,A,413,427,14,VYAVALAVSFLTPD,1
2x79,A,429,440,11,FVTGLIAALLL,1
5xaa,A,55,72,17,QFEDLLVRILLLAACIS,1
5xaa,A,91,111,20,FVILLILIANAIVGVWQERN,1
5xaa,A,251,274,23,KLDEFGEQLSKVISLICVAVWLI,1
5xaa,A,297,321,24,IAVALAVAAIPEGLPAVITTCLAL,1
5xaa,A,758,781,23,QFIRYLISSNVGEVVCIFLTAAL,1
5xaa,A,787,809,22,IPVQLLWVNLVTDGLPATALGF,1
5xaa,A,833,852,19,FFRYMAIGGYVGAATVGAA,1
5xaa,A,899,918,19,ALSVLVTIEMCNALNSLSE,1
5xaa,A,927,948,21,WVNIWLLGSICLSMSLHFLIL,1
5xaa,A,967,987,20,LMVLKISLPVIGLDEILKFI,1
5twv,H,33,52,19,VPHVFLLFITFPILFIGWG,1
5twv,H,70,87,17,HNLRWILTFILLFVLVC,1
5twv,H,111,127,16,MAFMAAITSVVYYHNI,1
5twv,H,134,150,16,LLIALLIYWTLAFITK,1
5twv,H,174,189,15,LVILYGMLLLVEVNV,1
5twv,H,301,320,19,SSTFRILADLLGFAGPLCI,1
5twv,H,358,376,18,AVLLFLALLLQRTFLQAS,1
5twv,H,437,453,16,LWTMPVQIIVGVILLY,1
5twv,H,460,477,17,LIGAAVIILLAPVQYFV,1
5twv,H,542,560,18,SIFMNTAIPIAAVLITFV,1
5twv,H,578,594,16,SLSLFHILVTPLFLLS,1
5twv,H,1012,1032,20,LSLLVFSQLLKHMVLVAIDY,1
5twv,H,1072,1087,15,SLGIVLCLVTSVTVE,1
5twv,H,1142,1161,19,LSRSTLLCVSALTVISYVT,1
5twv,H,1164,1179,15,LVALLPLAVVCYFIQ,1
5twv,H,1248,1265,17,EVCMEYIGACVVLIAAA,1
5twv,H,1284,1301,17,LTYALMVSNYLNWMVRN,1
2hg5,J,88,111,23,RLVAVVVMVAGITSFGLVTAALA,1
1sor,D,14,30,16,AEFFATLFYVFFGLGA,1
1sor,D,43,60,17,VALAFGLALATLVQAVG,1
1sor,D,87,104,17,CYVVAQLLGAVAGAAVL,1
1sor,D,129,146,17,ATIVEIFLTLQFVLCIF,1
1sor,D,160,176,16,ALAVGFSLTLGHLFGM,1
1sor,D,202,219,17,VYWVGPVIGAGLGSLLY,1
2oar,E,19,47,28,AVVIGTAFTALVTKFTDSIITPLINRIG,1
2oar,E,67,90,23,DLNVLLSAAINFFLIAFAVYFLV,1
5heu,E,202,222,20,YYLWSFILPLGLIIAASWSV,1
5heu,E,234,253,19,SFTLMLTVVAYAFYTSNIL,1
5heu,E,260,279,19,VIDQMIIAGYGSIFAAILL,1
5heu,E,303,317,14,FPLGFLAIGCVLVI,1
5x5y,F,8,33,25,REVLVTMSAVSAVLLVIIMSGRFIK,1
5x5y,F,53,77,24,FRIPGFLQLILPLGLFLGILLAYG,1
5x5y,F,97,121,24,LLGYTMAPALLVAILVAWLSLFLA,1
5x5y,F,272,293,21,WRLSTPLLVFVVTLLAVPLSR,1
5x5y,F,300,322,22,FLKLLPAILLYMGYLALLIAVR,1
5x5y,F,333,353,20,IGLWWVHGLFLAIGLLLFYW,1
3wt8,A,20,42,22,DAQWVVFAVMALAAIVFSIAVQ,1
3wt8,A,50,73,23,TYYVNIAICTIAATAYYAMAVNG,1
3wt8,A,90,110,20,YARYIDWVFTTPLLLLDLVL,1
3wt8,A,117,139,22,MIAWIMGADIAMIAFGIIGAFT,1
3wt8,A,144,166,22,WFYFVVGCIMLAVLAWGMINPI,1
3wt8,A,180,204,24,YTTLLIYLIVLWVIYPIVWGLGAG,1
3wt8,A,213,235,22,IIAMGILDLLAKPLYAIGVLIT,1
5xa7,A,58,74,16,DLLVRILLLAACISFV,1
5xa7,A,90,104,14,PFVILLILIANAIV,1
5xa7,A,260,274,14,SKVISLICVAVWLI,1
5xa7,A,293,309,16,YYFKIAVALAVAAIPE,1
5xa7,A,763,777,14,LISSNVGEVVCIFL,1
5xa7,A,788,804,16,PVQLLWVNLVTDGLPA,1
5xa7,A,832,849,17,LFFRYMAIGGYVGAATV,1
5xa7,A,900,915,15,LSVLVTIEMCNALNS,1
5xa7,A,934,950,16,GSICLSMSLHFLILYV,1
5xa7,A,968,987,19,MVLKISLPVIGLDEILKFI,1
3wvf,A,356,373,17,SIIIITFIVRGIMYPLT,1
3wvf,A,424,438,14,PLLIQMPIFLALYY,1
3wvf,A,465,477,12,ILPILMGVTMFF,1
3wvf,A,498,510,12,PVIFTVFFLWFP,1
3wvf,A,512,526,14,LVLYYIVSNLVTII,1
3k3f,C,33,46,13,GLLFFAGIFYNST,1
3k3f,C,48,60,12,GVCAVLGTAAST,1
3k3f,C,80,92,12,NGTLAGIALPFF,1
3k3f,C,98,114,16,MLGYVALNGAFTTIIM,1
3k3f,C,130,144,14,APFVLATWLLMFGV,1
3k3f,C,195,205,10,TGVIFVVAIL,1
3k3f,C,212,229,17,LFAVIGSLVGLCTALIM,1
3k3f,C,239,251,12,LYGFNSVLCGIA,1
3k3f,C,266,285,19,ALGCMVLGAIATGAFSVLL,1
3k3f,C,291,304,13,ALTWPFIVVTWLF,1
4l6r,A,140,165,25,FQVMYTVGYSLSLGALLLALAILGG,1
4l6r,A,175,197,22,IHANLFASFVLKASSVLVIDGL,1
4l6r,A,224,248,24,RVAAVFMQYGIVANYCWLLVEGLY,1
4l6r,A,266,287,21,YLGIGWGAPMLFVVPWAVVKC,1
4l6r,A,301,326,25,GFWWILRFPVFLAILINFFIFVRIV,1
4l6r,A,350,371,21,TLTLIPLLGVHEVVFAFVTDE,1
4l6r,A,380,403,23,KLFFDLFLSSFQGLLVAVLYCFL,1
2jj0,M,55,72,17,GVLSLFSGLMWFFTIGI,1
2jj0,M,116,133,17,IASFFMFVAVWSWWGRT,1
2jj0,M,147,167,20,WAFLSAIWLWMVLGFIRPIL,1
2jj0,M,200,221,21,FHGLSIAFLYGSALLFAMHGA,1
2jj0,M,269,286,17,IWMAVLVTLTGGIGILL,1
1oj9,A,491,501,10,LLRLIGLTTI,1
4ikv,A,26,47,21,TLFFTEFWERFSYYGMRAILV,1
4ikv,A,68,88,20,IMSIYGALVYMSGIIGGWLA,1
4ikv,A,95,114,19,RAVFYGGLLIMAGHIALAI,1
4ikv,A,121,140,19,FVSMALIVLGTGLLKPNVS,1
4ikv,A,160,179,19,FYMGINLGAFLAPLVVGTA,1
4ikv,A,188,207,19,FGLAAVGMFLGLVVFVATR,1
4ikv,A,229,249,20,AAAIMAVGAVVIAVLLAILI,1
4ikv,A,254,277,23,TVETFISLVGILGIIIPIIYFVV,1
4ikv,A,294,317,23,YIPLFVASAMFWAIQEQGSTILA,1
4ikv,A,337,357,20,FQSLNPLFIIILAPVFAWMW,1
4ikv,A,365,386,21,TIPQKFALGLLFAGLSFIVIL,1
4ikv,A,401,421,20,LVLSYFIVVLGELCLSPVGL,1
4ikv,A,438,455,17,LWFLSNAAAQAINAQLV,1
4ikv,A,467,485,18,GTIGGAALVLGLILLAIA,1
1dx7,A,22,45,23,YMSGLWLFSAVAIVAHLAVYIWR,1
4ltp,D,151,170,19,WIALLLLVIFYVFAVMGTK,1
4ltp,D,214,236,22,WIYFVSFILVSSFTVLNLFIGI,1
5t4p,V,9,23,14,YMAAAVMMGLAAIG,1
5t4p,V,63,77,14,PMIAVGLGLYVMFA,1
4pgw,A,18,37,19,VFVFTLLIATVGLFIGQFV,1
4pgw,A,42,58,16,LPLSILEVAMIILAFW,1
4pgw,A,66,85,19,YAFVYTFAFVSGITLFPIV,1
4pgw,A,97,115,18,LEAFGSTFVIFAVLGTIG,1
4pgw,A,126,145,19,SFLLVAVLALAVVGIFNIF,1
4pgw,A,153,172,19,MAYSVIGTIVFSLYILYDL,1
4pgw,A,187,207,20,MALSLYLDFINLFINLLRFF,1
4pdl,E,25,45,20,VLFVLTILTLISGTIFYSTV,1
4pdl,E,75,99,24,GKIFTILYIFIGIGLVFGFIHKLA,1
1suk,A,16,39,23,GGAVLGSLQFGYNTGVINAPQKV,1
1suk,A,64,87,23,WSLSVAIFSVGGMIGSFSVGLFV,1
1suk,A,91,113,22,RRNSMLMMNLLAFVSAVLMGFS,1
1suk,A,121,141,20,LILGRFIIGVYCGLTTGFVP,1
1suk,A,157,179,22,TLHQLGIVVGILIAQVFGLDSI,1
1suk,A,188,208,20,LLSIIFIPALLQCIVLPFCP,1
1suk,A,266,292,26,AYRQPILIAVVLQLSQQLSGINAVFY,1
1suk,A,305,328,23,PVYATIGSGIVNTAFTVVSLFVV,1
1suk,A,337,357,20,LIGLAGMAGCAILMTIALAL,1
1suk,A,361,385,24,PWMSYLSIVAIFGFVAFFEVGPGP,1
1suk,A,401,423,22,AAIAVAGFSNWTSNFIVGMCFQ,1
1suk,A,432,453,21,VFIIFTVLLVLFFIFTYFKVP,1
5dhh,A,50,75,25,KVTIVGLYLAVCVGGLLGNCLVMYV,1
5dhh,A,89,112,23,IFNLALADTLVLLTLPFQGTDIL,1
5dhh,A,119,145,26,NALCKTVIAIDYYNMFTSTFTLTAMS,1
5dhh,A,169,191,22,VNVAIWALASVVGVPVAIMGSA,1
5dhh,A,209,233,24,YWGPVFAICIFLFSFIVPVLVISV,1
5dhh,A,266,292,26,VVVAVFVGCWTPVQVFVLAQGLGVQP,1
5dhh,A,297,321,24,VAILRFCTALGYVNSCLNPILYAF,1
1qo1,T,17,30,13,GLAAIGAAIGIGI,1
1qo1,T,53,67,14,FIVMGLVDAIPMIA,1
3ifx,D,26,50,24,RAAGAATVLLVIVLLAGSYLACLA,1
3ifx,D,87,111,24,GRLVAVVVMVAGITSFGLVTAALA,1
1vjm,C,11,34,23,WLALGTALMGLGTLYFLVKGMGV,1
1vjm,C,41,62,21,FYAITTLVPAIAFTMYLSMLL,1
1vjm,C,80,100,20,ARYADWLFTTPLLLLDLALL,1
1vjm,C,106,127,21,TILALVGADGIMIGTGLVGAL,1
1vjm,C,134,157,23,FVWWAISTAAMLYILYVLFFGFT,1
1vjm,C,171,192,21,KVLRNVTVVLWSAYPVVWLIG,1
1vjm,C,204,226,22,TLLFMVLDVSAKVGFGLILLRS,1
3gjc,B,16,35,19,AMAGNAVGLGNFLRFPVQA,1
3gjc,B,42,63,21,FMIPYIIAFLLVGIPLMWIEW,1
3gjc,B,90,124,34,KILGVFGLWIPLVVAIYYVYIESWTLGFAIKFLV,1
3gjc,B,167,184,17,AYIVFLITMFINVSILI,1
3gjc,B,191,214,23,ERFAKIAMPTLFILAVFLVIRVF,1
3gjc,B,242,265,23,VWIAAVGQIFFTLSLGFGAIITY,1
3gjc,B,279,297,18,LTAATLNEKASVILGGSI,1
3gjc,B,340,364,24,GFLWFFLLFFAGLTSSIAIMQPMI,1
3gjc,B,378,396,18,VLWTAAIVFFSAHLVMFL,1
3gjc,B,400,422,22,DEMDFWAGTIGVVFFGLTELII,1
3gjc,B,448,470,22,YYVMRYITPAFLAVLLVVWARE,1
3gjc,B,484,501,17,ITRFYIIGLFLFLTFLV,1
3gi9,C,15,33,18,MAVGVMIGASIFSIFGVG,1
3gi9,C,41,56,15,PETFILSGIYALLVA,1
3gi9,C,92,113,21,LWMSYVISIALFAKGFAGYFL,1
3gi9,C,126,140,14,ITEIGIVAFFTALN,1
3gi9,C,151,170,19,FFIVLVKLLILGLFIFAGL,1
3gi9,C,191,206,15,FASAIFFLSYMGFGV,1
3gi9,C,227,242,15,SILIVMFVYVGVAIS,1
3gi9,C,272,293,21,FLLISIGALFSISSAMNATIY,1
3gi9,C,324,340,16,YITSALGVLFALLFNM,1
3gi9,C,342,357,15,VASITSAVFMVIYLF,1
3gi9,C,375,395,20,VIFSFIVVLGVFLLLLYYQW,1
3gi9,C,400,415,15,VFYGIIATFIGVLIF,1
3nam,A,55,73,18,QFEDLLVRILLLAACISF,1
3nam,A,89,110,21,EPFVILLILIANAIVGVWQER,1
3nam,A,253,275,22,DEFGEQLSKVISLICVAVWLIN,1
3nam,A,296,318,22,KIAVALAVAAIPEGLPAVITTC,1
3nam,A,760,781,21,IRYLISSNVGEVVCIFLTAAL,1
3nam,A,786,808,22,LIPVQLLWVNLVTDGLPATALG,1
3nam,A,830,852,22,GWLFFRYMAIGGYVGAATVGAA,1
3nam,A,898,916,18,MALSVLVTIEMCNALNSL,1
3nam,A,931,950,19,WLLGSICLSMSLHFLILYV,1
3nam,A,965,987,22,QWLMVLKISLPVIGLDEILKFI,1
2atk,F,26,50,24,RAAGAATVLLVIVLLAGSYLAVLA,1
2atk,F,86,111,25,WGRCVAVVVMVAGITSFGLVTAALA,1
4iff,B,32,134,102,RVNYGSFVSEYNDLTKDYTRVND,1
2zbf,A,58,73,15,LLVRILLLAACISFV,1
2zbf,A,90,110,20,FVILLILIANAIVGVWQERN,1
2zbf,A,253,274,21,EFGEQLSKVISLICVAVWLIN,1
2zbf,A,296,318,22,IAVALAVAAIPEGLPAVITTCL,1
2zbf,A,760,781,21,RYLISSNVGEVVCIFLTAALG,1
2zbf,A,786,808,22,IPVQLLWVNLVTDGLPATALGF,1
2zbf,A,833,852,19,FRYMAIGGYVGAATVGAAA,1
2zbf,A,898,916,18,ALSVLVTIEMCNALNSLS,1
2zbf,A,931,950,19,LLGSICLSMSLHFLILYVD,1
2zbf,A,965,987,22,WLMVLKISLPVIGLDEILKFIA,1
2xzb,B,38,59,21,WISLYYVAFYVVMSGIFALCI,1
4uvm,A,14,33,19,PYIIASEACERFSFYGMRN,1
4uvm,A,61,78,17,SFVIGVYFFPLLGGWIA,1
4uvm,A,85,99,14,NTILWLSLIYCVGH,1
4uvm,A,116,131,15,FLIALGSGGIKPLVS,1
4uvm,A,150,165,15,DMFYFTINFGSFFAS,1
4uvm,A,185,199,14,VLMFVATVFFWLGR,1
4uvm,A,237,252,15,ALIGGVSAAYALVNI,1
4uvm,A,256,274,18,IVAGLCCAMVLVMGFVGA,1
4uvm,A,303,319,16,LFALVTPFWSLFDQKA,1
4uvm,A,342,360,18,LNPLLVMLLIPFNNFVLY,1
4uvm,A,375,389,14,MGAGIAITGLSWIV,1
4uvm,A,410,427,17,PYALLTFGEVLVSATGL,1
4uvm,A,444,460,16,FWTLSVTVGNLWVLLA,1
4uvm,A,487,502,15,FAGFAILAAIVFALY,1
5aw8,G,24,40,16,IVAAVLCVIGIIILLA,1
4mrp,B,34,58,24,LRRRVVGAILMVLLGKATTLALPF,1
4mrp,B,86,106,20,YALGRFSGVLFDNLRNIVFE,1
4mrp,B,156,177,21,FLLFNIAPTVIELTAVIVIFW,1
4mrp,B,183,206,23,LVTATILAVIAYVWTTRTITEWR,1
4mrp,B,263,284,21,SLGLLNIAQALIVNLLMAGAM,1
4mrp,B,303,323,20,VNTYLTQLFRPLDMLGMVYR,1
5u09,A,118,142,24,IAVLSLTLGTFTVLENLLVLCVIL,1
5u09,A,154,180,26,FIGSLAVADLLGSVIFVYSFIDFHVF,1
5u09,A,188,215,27,FLFKLGGVTASFTASVGSLFLAAIDRY,1
5u09,A,233,256,23,VVAFCLMWTIAIVIAVLPLLGWN,1
5u09,A,272,300,28,ETYLMFWIGVTSVLLLFIVYAYMYILWK,1
5u09,A,342,365,23,KTLVLILVVLIICWGPLLAIMVY,1
5u09,A,379,401,22,AFCSMLCLLNSTVNPIIYALRS,1
3ag4,Z,16,35,19,IGLSVTFLSFLLPAGWVLY,1
5iux,E,199,218,19,NIILPMLFILFISWTAFWS,1
5iux,E,222,240,18,ANVTLVVSTLIAHIAFNI,1
5iux,E,256,275,19,AIIFMIYLFYFVAVIEVTV,1
5iux,E,292,313,21,RASRIAFPVVFLLANIILAFL,1
4q65,A,15,32,17,ALQIWEYFSFYGMRALL,1
4q65,A,52,68,16,AYCSLVYVTPILGGFL,1
4q65,A,78,94,16,VMLGALLMAIGHVVLG,1
4q65,A,105,121,16,SLAIIVCGYGLFKSNV,1
4q65,A,144,161,17,AAGNVGSIIAPIACGYA,1
4q65,A,170,187,17,FGLAAVGMIAGLVIFLC,1
4q65,A,209,230,21,LPNWGWLLVLLVATPALITIL,1
4q65,A,236,252,16,VYALIVATIIGLGVLA,1
4q65,A,269,289,20,IVTLTFFSMLFWAFAQQGGS,1
4q65,A,312,328,16,FQSINAFAVMLCGVFL,1
4q65,A,345,362,17,GKFALGLGLMSAGFCIL,1
4q65,A,382,399,17,GLAVMGFAELFIDPVAM,1
4q65,A,416,431,15,IYMLLSGAIANYLAG,1
4q65,A,463,479,16,WGALACVGVVLMIWLY,1
4jta,H,164,182,18,IAIVSVMVILISIVSFCL,1
4jta,H,223,242,19,IVETLCIIWFSFEFLVRFF,1
4jta,H,254,272,18,MNIIDIVAIIPYYVTIFL,1
4jta,H,289,307,18,QIFRIMRILRIFKLSRHS,1
4jta,H,321,345,24,RELGLLIFFLFIGVILFSSAVYFA,1
4jta,H,382,403,21,GKIVGSLCAIAGVLTIALPVP,1
5iwp,D,327,349,22,FCVLGAIYVLYIICFTMCCVYR,1
5iwp,D,383,408,25,RLVGELVSIVGAVIILLVEIPDIFR,1
5iwp,D,422,443,21,PFHVIIVTYAFMVLVTMVMRL,1
5iwp,D,449,470,21,VVPMSFALVLGWCNVMYFARG,1
5iwp,D,487,511,24,DLMRFCWQMAVVILGFASAFYIIF,1
5iwp,D,552,576,24,MYSITYAAFAIIATLLMLNLLIAM,1
3mpq,B,13,32,19,LILAMAGNAVGLGNFLRFP,1
3mpq,B,44,63,19,IPYIIAFLLVGIPLMWIEW,1
3mpq,B,90,124,34,KILGVFGLWIPLVVAIYYVYIESWTLGFAIKFLV,1
3mpq,B,167,184,17,AYIVFLITMFINVSILI,1
3mpq,B,191,212,21,ERFAKIAMPTLFCLAVFLVIR,1
3mpq,B,242,265,23,VWIAAVGQIFFTLSLGFGAIITY,1
3mpq,B,278,297,19,GLTAATLNEKAEVILGGSI,1
3mpq,B,340,366,26,GFLWFFLLFFAGLTSSIAIMQPMIAF,1
3mpq,B,378,396,18,VLWTAAIVFFSAHLVMFL,1
3mpq,B,400,425,25,DEMDFWAGTIGVVFFGLTELIIFFW,1
3mpq,B,445,466,21,RIYYYVMRYITPAFLAVLLVV,1
3mpq,B,484,502,18,ITRFYIIGLFLFLTFLVF,1
3qnq,B,25,45,20,RDGLVLTMPFLIIGSIFLII,1
3qnq,B,72,90,18,VSATFNIMALIAVFGIAY,1
3qnq,B,102,115,13,SGALSLVTFLLAT,1
3qnq,B,142,160,18,SQGLFVAMIIAIISTEIY,1
3qnq,B,187,201,14,IPGFIVVTVVWIIR,1
3qnq,B,224,241,17,SILGASLWGAVIAVILV,1
3qnq,B,253,268,15,IVGGVMSPIWLSLMD,1
3qnq,B,284,297,13,TAQFFDLWIYMGG,1
3qnq,B,354,367,13,VPVVLTIVSYFAM,1
3qnq,B,399,414,15,GVILQLVNFALAFVI,1
2k58,B,5,31,26,FYTINLIIPCVLITSLAILVFYLPSD,1
4q9l,A,35,68,33,LTMFRYAGWLDRLYMLVGTLAAIIHGVALPLMM,1
4q9l,A,115,139,24,GIGAGVLIVAYIQVSFWCLAAGRQ,1
4q9l,A,180,204,24,GIGDKIGMFFQAMATFFGGFIIGF,1
4q9l,A,209,231,22,LTLVILAISPVLGLSAGIWAKI,1
4q9l,A,290,312,22,ANISMGAAFLLIYASYALAFWY,1
4q9l,A,329,352,23,VFFSVLIGAFSVGQASPNIEAFA,1
4q9l,A,706,729,23,FVVGIFCAIINGGLQPAFSVIFS,1
4q9l,A,752,773,21,LLFLILGIISFITFFLQGFTF,1
4q9l,A,828,849,21,LAVIFQNIANLGTGIIISLIY,1
4q9l,A,853,878,25,TLLLLAIVPIIAIAGVVEMKMLSGQ,1
4q9l,A,925,952,27,NAMKKAHVFGITFSFTQAMMYFSYAAC,1
4q9l,A,972,991,19,VFSAIVFGAMAVGQVSSFA,1
5uig,A,13,34,21,LAIAVLAILGNVLVCWAVWLN,1
5uig,A,41,60,19,NYFVVSLAAADIAVGVLAI,1
5uig,A,83,102,19,VLVLTQSSIFSLLAIAIDR,1
5uig,A,119,139,20,RAKGIIAICWVLSFAIGLTP,1
5uig,A,176,199,23,MVYFNFFACVLVPLLLMLGVYLR,1
5uig,A,232,255,23,KSLAIIVGLFALCWLPLHIINCF,1
5uig,A,273,293,20,IVLSHTNSVVNPFIYAYRIR,1
1eq8,A,6,20,14,ISVLLAQAVFLLLT,1
5kbs,D,521,543,22,AYEIWMCIVFAYIGVSVVLFLV,1
5kbs,D,594,618,24,SLSGRIVGGVWWFFTLIIISSYTA,1
5kbs,D,790,813,23,NVAGVFYILVGGLGLAMLVALIE,1
4htt,A,8,29,21,ELRYRLIISIIAFLIGSGIAF,1
4htt,A,67,88,21,SLAVGFIIASPVILYQFWRFI,1
4htt,A,101,123,22,PLLLGSILLFMLGALFAYFIVL,1
4htt,A,155,174,19,LVVAFGIAFEMPIVLYVLQ,1
4htt,A,182,203,21,QLASFRKYFIVIAFVIGAIIA,1
4htt,A,209,227,18,VLMAIPLLLLYEISIFLG,1
2ls4,A,5,19,14,CIAVAAGAGTGYFL,1
4ziw,C,12,28,16,WVIAIIIMLAGGLAIL,1
4ziw,C,341,357,16,KTLVEAIILVFLVMYL,1
4ziw,C,366,386,20,IPTIAVPVVLLGTFAVLAAF,1
4ziw,C,395,410,15,FGMVLAIGLLVDDAI,1
4ziw,C,443,458,15,GIAMVLSAVFVPMAF,1
4ziw,C,470,488,18,SITIVSAMALSVLVALIL,1
4ziw,C,541,556,15,LVLYLIIVVGMAYLF,1
4ziw,C,870,886,16,LYAISLIVVFLCLAAL,1
4ziw,C,891,914,23,IPFSVMLVVPLGVIGALLAATFR,1
4ziw,C,923,938,15,VGLLTTIGLSAKNAI,1
4ziw,C,971,987,16,MTSLAFILGVMPLVIS,1
4ziw,C,999,1014,15,TGVMGGMVTATVLAI,1
4zjl,C,13,26,13,VIAIIIMLAGGLA,1
4zjl,C,343,356,13,LVEAIILVFLVMY,1
4zjl,C,367,383,16,PTIAVPVVLLGTFAVL,1
4zjl,C,397,409,12,MVLAIGLLVDDA,1
4zjl,C,443,456,13,GIAMVLSAVFVPM,1
4zjl,C,471,485,14,ITIVSAMALSVLVA,1
4zjl,C,543,556,13,LYLIIVVGMAYLF,1
4zjl,C,877,891,14,AISLIVVFLCLAAL,1
4zjl,C,899,916,17,SVMLVVPLGVIGALLAA,1
4zjl,C,930,943,13,LLTTIGLSAKNAI,1
4zjl,C,976,991,15,MTSLAFILGVMPLVI,1
4zjl,C,1005,1018,13,GVMGGMVTATVLA,1
3c1g,C,15,31,16,CTALVLFMTIPGIALF,1
3c1g,C,46,64,18,QVTVTFALVCILWVVYGY,1
3c1g,C,102,118,16,FQGSFACITVGLIVGA,1
3c1g,C,127,147,20,VLIFVVVWLTLSYIPIAHMV,1
3c1g,C,161,178,17,AGGTVVHINAAIAGLVG,1
3c1g,C,202,219,17,TGTAILYIGWFGFNAGS,1
3c1g,C,231,248,17,VNTVVATAAAILGWIFG,1
3c1g,C,261,276,15,CSGAIAGLVGVTPAC,1
3c1g,C,282,299,17,GALIIGVVAGLAGLWGV,1
3c1g,C,314,332,18,FGVHGVCGIVGCIMTGIF,1
3c1g,C,353,377,24,VQLESIAITIVWSGVVAFIGYKLA,1
4xp6,A,35,50,15,FLLSVIGFAVDLANV,1
4xp6,A,67,85,18,PYGIMLAVGGIPLFYMEL,1
4xp6,A,112,133,21,VVLIAFYVDFYYNVIIAWSLR,1
4xp6,A,236,255,19,WDMALCLLIVYLICYFSLW,1
4xp6,A,261,277,16,GKVVWFTALFPYAVLL,1
4xp6,A,311,329,18,DAATQVFFSLGPGFGVLL,1
4xp6,A,343,359,16,DALLTSFINSATSFIA,1
4xp6,A,412,429,17,MLATLGLDSSFGGSEAI,1
4xp6,A,449,464,15,GLFSLYFVVGLASCT,1
4xp6,A,471,492,21,HLLDRYAAGYSILVAVFFEAI,1
4xp6,A,518,540,22,WQVCWRFVAPIFLLFITVYGLI,1
4xp6,A,556,572,16,NALGWCIAGSSVVMIP,1
5ezm,A,30,45,15,VVLFVAVALVVWFVS,1
5ezm,A,110,126,16,VALSGLLGIGVSMMAA,1
5ezm,A,136,153,17,FTGLALLAAPMWSVAAH,1
5ezm,A,159,173,14,TLAGVMSCVLAFML,1
5ezm,A,188,203,15,MVACWAAMGVAILTK,1
5ezm,A,205,221,16,VGIALPGLVLVVYTLV,1
5ezm,A,232,249,17,LALGVVVMLVITVPWFY,1
5ezm,A,286,307,21,PLVIGGFLPWAGIFPKLWTAM,1
5ezm,A,322,338,16,MAGIWAIAIFVFFSIS,1
5ezm,A,345,361,16,IVPVIPALGILAGVAL,1
5ezm,A,369,383,14,GKQLIGMAIVAACG,1
5ezm,A,414,428,14,VVMLLGIAVARLLL,1
5ezm,A,433,448,15,PSVAVYAMGMYLGFT,1
1rgn,H,13,32,19,SLAIYSFWIFLAGLIYYLQ,1
5gar,Z,22,35,13,VGLAALGTGVAQA,1
5gar,Z,59,72,13,LLPETLVIFGLLI,1
5kum,D,78,104,26,WRYMLLLFSLAFLVSWLLFGLIFWLI,1
5kum,D,156,184,28,LAVFMVVVQSIVGCIIDSFMIGAIMAKM,1
4hw9,G,25,49,24,VIVFCIGFYFSFFLRNKTMKLLSK,1
4hw9,G,56,79,23,FVAQVTFILILIITTIIALSTLG,1
4hw9,G,81,97,16,TTSIITVLGTVGIAVA,1
1e12,D,30,50,20,SSLWVNVALAGIAILVFVYM,1
1e12,D,64,82,18,ATLMIPLVSISSYLGLLS,1
1e12,D,106,123,17,GRYLTWALSTPMILLAL,1
1e12,D,135,154,19,TVIAADIGMCVTGLAAAMT,1
1e12,D,160,180,20,RWAFYAISCAFFVVVLSALV,1
1e12,D,200,217,17,VLTVVLWLGYPIVWAVG,1
1e12,D,229,250,21,TSWAYSVLDVFAKYVFAFILL,1
5iov,D,551,567,16,WVMMFVMLLIVSAVAV,1
5iov,D,610,627,17,SKIMVSVWAFFAVIFLA,1
5iov,D,804,819,15,FYMLAAAMALSLITF,1
3j5q,G,433,453,20,FYFNFFVYCLYMIIFTAAAY,1
3j5q,G,474,498,24,VTGEILSVSGGVYFFFRGIQYFLQ,1
3j5q,G,509,531,22,SYSEILFFVQSLFMLVSVVLYF,1
3j5q,G,538,557,19,ASMVFSLAMGWTNMLYYTR,1
3j5q,G,562,575,13,GIYAVMIEKMILR,1
3j5q,G,577,598,21,CRFMFVYLVFLFGFSTAVVTL,1
3j5q,G,658,683,25,FIILLLAYVILTYILLLNMLIALMG,1
3ar5,A,54,73,19,QFEDLLVRILLLAACISFV,1
3ar5,A,90,111,21,FVILLILIANAIVGVWQERNA,1
3ar5,A,253,274,21,EFGEQLSKVISLICVAVWLIN,1
3ar5,A,296,318,22,IAVALAVAAIPEGLPAVITTCL,1
3ar5,A,760,781,21,RYLISSNVGEVVCIFLTAALG,1
3ar5,A,786,808,22,IPVQLLWVNLVTDGLPATALGF,1
3ar5,A,830,852,22,WLFFRYMAIGGYVGAATVGAAA,1
3ar5,A,898,916,18,ALSVLVTIEMCNALNSLS,1
3ar5,A,931,950,19,LLGSICLSMSLHFLILYVD,1
3ar5,A,965,987,22,WLMVLKISLPVIGLDEILKFIA,1
3vr8,D,56,79,23,TLFKIERYFAAAMVPLIPAAYFI,1
3vr8,D,84,109,25,DLCLALALTLHVHWGVWGVVNDYGR,1
3vr8,D,117,139,22,AAAVRVGAYIFTACLLAGLLYF,1
4hyd,D,14,27,13,MLLFVQIIAIVLV,1
4hyd,D,45,64,19,NPLIFIGMLLAFTLVLLVL,1
4hyd,D,76,93,17,IGFALFMTFLYIFGALS,1
4hyd,D,106,118,12,TLIGAVAVTALL,1
4hyd,D,127,143,16,DILGVLISAGVASIFG,1
4hyd,D,149,163,14,PVLVLLVLLAVYDA,1
4hyd,D,216,231,15,GMGDLIMPSILVVSS,1
4hyd,D,248,260,12,LGAMVGSLVGLA,1
4hyd,D,276,291,15,PLNGGAILGFLVGAA,1
3arc,z,8,25,17,LAALVILSFVMVIGVPV,1
3arc,z,40,54,14,FLGSGLWIALVLVV,1
2i6w,C,11,26,15,AWVIAIIIMLAGGLA,1
2i6w,C,342,357,15,TLVEAIILVFLVMYL,1
2i6w,C,366,383,17,IPTIAVPVVLLGTFAVL,1
2i6w,C,397,410,13,MVLAIGLLVDDAI,1
2i6w,C,442,457,15,VGIAMVLSAVFVPMA,1
2i6w,C,472,489,17,TIVSAMALSVLVALILT,1
2i6w,C,542,556,14,VLYLIIVVGMAYLF,1
2i6w,C,875,891,16,LYAISLIVVFLCLAAL,1
2i6w,C,899,918,19,SVMLVVPLGVIGALLAATF,1
2i6w,C,928,943,15,VGLLTTIGLSAKNAI,1
2i6w,C,976,991,15,MTSLAFILGVMPLVI,1
2i6w,C,1004,1019,15,TGVMGGMVTATVLAI,1
2pno,C,8,21,13,AAVTLLGVLLQAY,1
2pno,C,58,71,13,YFPLFLATLWVAG,1
2pno,C,79,91,12,ALCGLVYLFARL,1
2pno,C,110,124,14,SARALWLLVALAAL,1
2gnu,M,53,71,18,SLGVLSLFSGLMWFFTIG,1
2gnu,M,119,135,16,FFMFVAVWSWWGRTYL,1
2gnu,M,145,163,18,TAWAFLSAIWLWMVLGFI,1
2gnu,M,201,220,19,HGLSIAFLYGSALLFAMHG,1
2gnu,M,268,283,15,AIWMAVLVTLTGGIG,1
3vr9,D,58,78,20,FKIERYFAAAMVPLIPAAYF,1
3vr9,D,84,108,24,DLCLALALTLHVHWGVWGVVNDYG,1
3vr9,D,117,139,22,AAAVRVGAYIFTACLLAGLLYF,1
4tkq,A,18,37,19,VFVFTLLIATVGLFIGQFV,1
4tkq,A,42,61,19,LPLSILEVAMIILAFWMRR,1
4tkq,A,68,86,18,FVYTFAFVSGITLFPIVS,1
4tkq,A,95,115,20,VVLEAFGSTFVIFAVLGTIG,1
4tkq,A,125,144,19,WSFLLVAVLALAVVGIFNI,1
4tkq,A,153,172,19,MAYSVIGTIVFSLYILYDL,1
4tkq,A,187,208,21,MALSLYLDFINLFINLLRFFG,1
1bm1,C,10,33,23,WLALGTALMGLGTLYFLVKGMGV,1
1bm1,C,41,62,21,YAITTLVPAIAFTMYLSMLLG,1
1bm1,C,80,99,19,RYADWLFTTPLLLLDLALL,1
1bm1,C,106,127,21,ILALVGADGIMIGTGLVGALT,1
1bm1,C,134,156,22,VWWAISTAAMLYILYVLFFGFT,1
1bm1,C,171,192,21,VLRNVTVVLWSAYPVVWLIGS,1
1bm1,C,204,225,21,LLFMVLDVSAKVGFGLILLRS,1
2yev,C,8,24,16,LGAALVTLFFYLILNP,1
2yev,C,33,50,17,FDLRFVLFMLLLILLAA,1
3ar4,A,57,75,18,DLLVRILLLAACISFVLA,1
3ar4,A,89,104,15,PFVILLILIANAIVG,1
3ar4,A,258,276,18,LSKVISLICVAVWLINIG,1
3ar4,A,296,314,18,IAVALAVAAIPEGLPAVI,1
3ar4,A,761,781,20,YLISSNVGEVVCIFLTAALG,1
3ar4,A,786,807,21,IPVQLLWVNLVTDGLPATALG,1
3ar4,A,835,851,16,YMAIGGYVGAATVGAA,1
3ar4,A,901,916,15,VLVTIEMCNALNSLS,1
3ar4,A,931,947,16,LLGSICLSMSLHFLIL,1
3ar4,A,971,987,16,ISLPVIGLDEILKFIA,1
1rkl,A,8,29,21,SLAITFGIVMMTLIVIYHAVD,1
3j5p,D,433,454,21,FYFNFFVYCLYMIIFTAAAYY,1
3j5p,D,474,498,24,VTGEILSVSGGVYFFFRGIQYFLQ,1
3j5p,D,509,532,23,SYSEILFFVQSLFMLVSVVLYFS,1
3j5p,D,537,557,20,VASMVFSLAMGWTNMLYYTR,1
3j5p,D,566,598,32,VMIEKMILRDLCRFMFVYLVFLFGFSTAVVTL,1
3j5p,D,658,683,25,FIILLLAYVILTYILLLNMLIALMG,1
5nda,A,9,29,20,RLKLLLLLLLLILLLILGAL,1
4xpa,A,35,57,22,FLLSVIGFAVDLANVWRFPYLC,1
4xpa,A,63,82,19,AFLVPYGIMLAVGGIPLFY,1
4xpa,A,112,133,21,VVLIAFYVDFYYNVIIAWSLR,1
4xpa,A,236,255,19,WDMALCLLIVYLICYFSLW,1
4xpa,A,261,281,20,GKVVWFTALFPYAVLLILLI,1
4xpa,A,304,328,24,YKAEVWVDAATQVFFSLGPGFGVL,1
4xpa,A,345,362,17,LLTSFINSATSFIAGFV,1
4xpa,A,409,430,21,FFMMLATLGLDSSFGGSEAII,1
4xpa,A,447,464,17,VAGLFSLYFVVGLASCT,1
4xpa,A,471,492,21,HLLDRYAAGYSILVAVFFEAI,1
4xpa,A,522,545,23,WRFVAPIFLLFITVYGLIGYEPL,1
4xpa,A,555,573,18,ANALGWCIAGSSVVMIPA,1
1bad,A,13,32,19,LGTALMGLGTLYFLVKGMG,1
1bad,A,44,58,14,TTLVPAIAFTMYLS,1
1bad,A,82,98,16,ADWLFTTPLLLLDLAL,1
1bad,A,107,122,15,LALVGADGIMIGTGL,1
1bad,A,138,153,15,ISTAAMLYILYVLFF,1
1bad,A,174,190,16,NVTVVLWSAYPVVWLI,1
1bad,A,206,223,17,FMVLDVSAKVGFGLILL,1
5gas,Z,19,34,15,GLAVGLAALGTGVAQ,1
5gas,Z,62,76,14,ETLVIFGLLIAFIL,1
4huq,T,27,41,14,SFCYIIVVFLANNI,1
4huq,T,43,60,17,YAILIAFTVGAILSSKI,1
4huq,T,62,87,25,GFFLKGIRPLLWLIVFTVVLQLLFS,1
4huq,T,101,127,26,VTQDGLINAGYIFVRFLLIIMMSTLL,1
4huq,T,248,262,14,TWLLFLLGFVAILI,1
3te2,E,25,47,22,KYLVSSAFAGLYVGIGILLIFT,1
3te2,E,63,79,16,MGLSFAIALSLVIMTG,1
3te2,E,105,129,24,KIWAYSWVGNLIGALVLGIIFVGT,1
3te2,E,154,174,20,ALFFRGILCNILVCVSVLCS,1
3te2,E,180,197,17,TAKIIMIFLCLFAFITS,1
3te2,E,224,249,25,GAIYNLVAVTLGNIVGGALFMGLGT,1
2yiu,F,19,35,16,YYATAGAGTVAAGAAA,1
4or2,B,593,618,25,IIAIAFSCLGILVTLFVTLIFVLYR,1
4or2,B,627,648,21,RELCYIILAGIFLGYVCPFTL,1
4or2,B,659,684,25,QRLLVGLSSAMCYSALVTKTNRIAR,1
4or2,B,701,725,24,SAWAQVIIASILISVQLTLVVTLI,1
4or2,B,753,776,23,VAPLGYNGLLIMSCTYYAFKTRN,1
4or2,B,783,805,22,AKYIAFTMYTTCIIWLAFVPIY,1
4or2,B,814,840,26,TCFAVSLSVTVALGCMFTPKMYIIIA,1
4ziv,C,13,26,13,VIAIIIMLAGGLA,1
4ziv,C,342,356,14,TLVEAIILVFLVMY,1
4ziv,C,367,383,16,PTIAVPVVLLGTFAVL,1
4ziv,C,396,409,13,GMVLAIGLLVDDA,1
4ziv,C,443,456,13,GIAMVLSAVFVPM,1
4ziv,C,471,485,14,ITIVSAMALSVLVA,1
4ziv,C,542,556,14,VLYLIIVVGMAYLF,1
4ziv,C,877,891,14,AISLIVVFLCLAAL,1
4ziv,C,899,916,17,SVMLVVPLGVIGALLAA,1
4ziv,C,930,943,13,LLTTIGLSAKNAI,1
4ziv,C,976,991,15,MTSLAFILGVMPLVI,1
4ziv,C,1004,1018,14,TGVMGGMVTATVLA,1
5kai,r,9,21,12,LPVLLAAGWAVR,1
4x31,C,11,33,22,WLALGTALMGLGTLYFLVKGMG,1
4x31,C,41,62,21,FYAITTLVPAIAFTMYLSMLL,1
4x31,C,80,100,20,ARYADWLFTTPLLLLDLALL,1
4x31,C,106,127,21,TILALVGADGIMIGTGLVGAL,1
4x31,C,134,157,23,FVWWAISTAAMLYILYVLFFGFT,1
4x31,C,171,192,21,KVLRNVTVVLWSAYPVVWLIG,1
4x31,C,204,226,22,TLLFMVLDVSAKVGFGLILLRS,1
2k59,B,4,22,18,LCISVLLALTVFLLLISK,1
2wsc,4,43,56,13,ELVNGRWAMLGVA,1
2wsc,4,92,105,13,IEFILSHYVEIRR,1
2wsc,4,152,166,14,EIANGRLMLAFLGF,1
2wp9,L,15,36,21,FILVRATAIVLTLYIIYMVGF,1
2wp9,L,57,80,23,KVFTLLALFSILIHAWIGMWQVL,1
2wp9,L,89,110,21,RLMLQLVIVVALVVYVIYGFV,1
1btr,A,4,19,15,AVIFIYFAALSPAIT,1
5l1h,D,525,543,18,WMCIVFAYIGVSVVLFLV,1
5l1h,D,597,614,17,GRIVGGVWWFFTLIIIS,1
5l1h,D,793,810,17,GVFYILVGGLGLAMLVA,1
5l22,A,20,42,22,TLIIVGLFSLFINILFLLPSIY,1
5l22,A,65,87,22,AVVLYFALGLLQSVRAKVMQII,1
5l22,A,128,151,23,LTSPVLFAIFDLPWVPIYFGVLF,1
5l22,A,158,180,22,VMAILSMAVIVALAILNEYITK,1
5l22,A,234,256,22,TDRNNFLSNLTRIFRIMAQSLM,1
5l22,A,277,299,22,SILLGRILGPIDTIVNGWRQIG,1
2itc,F,26,50,24,RAAGAATVLLVIVLLAGSYLAVLA,1
2itc,F,87,111,24,GRCVAVVVMVAGITSFGLVTAALA,1
5lid,E,202,225,23,YYLWSFILPLGLIIAASWSVFWL,1
5lid,E,230,253,23,RLQTSFTLMLTVVAYAFYTSNIL,1
5lid,E,260,282,22,VIDQMIIAGYGSIFAAILLIIF,1
5lid,E,298,317,19,RCRLAFPLGFLAIGCVLVI,1
4q4j,B,33,58,25,PHTFTLIMVFVFVTVSSILGVLSPY,1
4q4j,B,84,105,21,TIYALTSLLFWLQGKIMLTLS,1
4q4j,B,151,173,22,GNSIIQFFSGIVTLAGAVIMMF,1
4q4j,B,181,200,19,VTLSIVPLTVLITQIVSSQ,1
4q4j,B,259,278,19,SGVLPPLMNMVNNLGFALI,1
4q4j,B,299,320,21,IGYSRQFTRPLNELSNQFNMI,1
4h99,H,15,32,17,AIYSFWIFLAGLIYYLQ,1
1ymg,D,11,30,19,AICAEFFASLFYVFFGLGA,1
1ymg,D,43,60,17,VALAFGLALATLVQAVG,1
1ymg,D,84,107,23,RAICYMVAQLLGAVAGAAVLYSV,1
1ymg,D,129,149,20,ATIVEIFLTLQFVLCIFATY,1
1ymg,D,158,176,18,SVALAVGFSLTLGHLFGM,1
1ymg,D,202,223,21,VYWVGPVIGAGLGSLLYDFLL,1
3h90,A,17,36,19,AMASLLLLIKIFAWWYTGS,1
3h90,A,40,59,19,AALVDSLVDIGASLTNLLV,1
3h90,A,81,102,21,AALAQSMFISGSALFLFLTGI,1
3h90,A,119,140,21,VTIVALICTIILVSFQRWVVR,1
3h90,A,146,164,18,VRADMLHYQSDVMMNGAI,1
3h90,A,180,202,22,LFALGIGIYILYSALRMGYEAV,1
5iu8,A,6,29,23,SVYITVELAIAVLAILGNVLVCW,1
5iu8,A,45,67,22,VSLAAADILVGVLAIPFAITIS,1
5iu8,A,76,98,22,CLFIACFVLVLAQSSIFSLLAI,1
5iu8,A,123,144,21,IIAICWVLSFAIGLTPMLGWN,1
5iu8,A,173,195,22,MNYMVYFNFFACVLVPLLLMLG,1
5iu8,A,237,259,22,IAGLFALCWLPLHIINCFTFFC,1
5iu8,A,265,287,22,PLWLMYLAIVLAHTNSVVNPFI,1
3f48,B,13,32,19,LILAMAGNAVGLGNFLRFP,1
3f48,B,44,63,19,IPYIIAFLLVGIPLMWIEW,1
3f48,B,90,124,34,KILGVFGLWIPLVVAIYYVYIESWTLGFAIKFLV,1
3f48,B,167,184,17,AYIVFLITMFINVSILI,1
3f48,B,191,212,21,ERFAKIAMPTLFILAVFLVIR,1
3f48,B,242,265,23,VWIAAVGQIFFTLSLGFGAIITY,1
3f48,B,278,297,19,GLTAATLNEKAEVILGGSI,1
3f48,B,340,367,27,GFLWFFLLFFAGLTSSIAIMQPMIAFL,1
3f48,B,378,396,18,VLWTAAIVFFSAHLVMFL,1
3f48,B,400,426,26,DEMDFWAGTIGVVFFGLTELIIFFWI,1
3f48,B,445,469,24,RIYYYVMRYITPAFLAVLLVVWAR,1
3f48,B,484,502,18,ITRFYIIGLFLFLTFLVF,1
4y6k,A,11,27,16,MPLMLLFVQIIAIVLV,1
4y6k,A,44,61,17,ANPLIFIGMLLAFTLVL,1
4y6k,A,76,90,14,IGFALFMTFLYIFG,1
4y6k,A,106,120,14,TLIGAVAVTALLYL,1
4y6k,A,126,146,20,IDILGVLISAGVASIFGISL,1
4y6k,A,148,161,13,LPVLVLLVLLAVY,1
4y6k,A,218,231,13,GDLIMPSILVVSS,1
4y6k,A,248,260,12,LGAMVGSLVGLA,1
4y6k,A,276,292,16,PLNGGAILGFLVGAAL,1
2zbg,A,55,74,19,FEDLLVRILLLAACISFVL,1
2zbg,A,90,110,20,FVILLILIANAIVGVWQERN,1
2zbg,A,253,274,21,EFGEQLSKVISLICVAVWLIN,1
2zbg,A,296,318,22,IAVALAVAAIPEGLPAVITTCL,1
2zbg,A,760,781,21,RYLISSNVGEVVCIFLTAALG,1
2zbg,A,786,808,22,IPVQLLWVNLVTDGLPATALGF,1
2zbg,A,830,852,22,WLFFRYMAIGGYVGAATVGAAA,1
2zbg,A,898,917,19,ALSVLVTIEMCNALNSLSE,1
2zbg,A,927,950,23,VNIWLLGSICLSMSLHFLILYVD,1
2zbg,A,967,987,20,MVLKISLPVIGLDEILKFIA,1
5aw9,G,25,40,15,VAAVLCVIGIIILLA,1
4wol,B,12,34,22,PGVLAGIVVGDLVLTVLIALAV,1
3gi8,C,15,33,18,MAVGVMIGASIFSIFGVG,1
3gi8,C,42,59,17,ETFILSGIYALLVAYSY,1
3gi8,C,89,113,24,SILLWMSYVISIALFAKGFAGYFL,1
3gi8,C,124,140,16,IAITEIGIVAFFTALN,1
3gi8,C,151,170,19,FFIVLVALLILGLFIFAGL,1
3gi8,C,191,206,15,FASAIFFLSYMGFGV,1
3gi8,C,225,242,17,FISILIVMFVYVGVAIS,1
3gi8,C,272,293,21,FLLISIGALFSISSAMNATIY,1
3gi8,C,324,341,17,YITSALGVLFALLFNME,1
3gi8,C,343,360,17,ASITSAVFMVIYLFVIL,1
3gi8,C,373,395,22,EIVIFSFIVVLGVFLLLLYYQW,1
3gi8,C,401,418,17,FYGIIATFIGVLIFEII,1
3nal,A,54,74,20,EQFEDLLVRILLLAACISFV,1
3nal,A,89,110,21,EPFVILLILIANAIVGVWQER,1
3nal,A,254,276,22,EFGEQLSKVISLICVAVWLINI,1
3nal,A,295,318,23,FKIAVALAVAAIPEGLPAVITTC,1
3nal,A,760,782,22,IRYLISSNVGEVVCIFLTAALG,1
3nal,A,786,808,22,LIPVQLLWVNLVTDGLPATALG,1
3nal,A,833,854,21,FFRYMAIGGYVGAATVGAAAW,1
3nal,A,898,916,18,MALSVLVTIEMCNALNSL,1
3nal,A,927,950,23,WVNIWLLGSICLSMSLHFLILYV,1
3nal,A,965,987,22,QWLMVLKISLPVIGLDEILKFI,1
1qm8,C,12,29,17,LALGTALMGLGTLYFLV,1
1qm8,C,45,61,16,TTLVPAIAFTMYLSML,1
1qm8,C,80,95,15,ARYADWLFTTPLLLL,1
1qm8,C,110,126,16,LVGADGIMIGTGLVGA,1
1qm8,C,135,152,17,VWWAISTAAMLYILYVL,1
1qm8,C,175,192,17,NVTVVLWSAYPVVWLIG,1
1qm8,C,204,222,18,TLLFMVLDVSAKVGFGLI,1
4pj0,z,5,24,19,QLALAALVILSFVMVIGVP,1
4pj0,z,40,57,17,FLGSGLWIALVLVVGVL,1
3wmm,0,29,42,13,GLVVIAHLLAWLY,1
1oea,A,16,36,20,MEIFIGLCAIVGNVLVICVV,1
1oea,A,51,70,19,SLALADIAVGVLVMPLAIV,1
1oea,A,86,105,19,CLLLIFTHASIMSLLAIAV,1
1oea,A,129,150,21,LGLCWLVSFLVGLTPMFGWNM,1
1oea,A,176,195,19,VYFSFLTWIFIPLVVMCAI,1
1oea,A,233,252,19,VLFLFALSWLPLSIINCII,1
1oea,A,264,284,20,MGILLSHANSMMNPIVYAYK,1
4n4y,C,7,23,16,ALAVILVLTLTILVFW,1
3lw5,4,92,108,16,QAELVNGRWAMLGVAG,1
3lw5,4,143,157,14,IEFILSHYVEIRRW,1
3lw5,4,202,219,17,KEIANGRLMLAFLGFII,1
5c65,B,7,31,24,PALIFAITVATIGSFQFGYNTGVI,1
5c65,B,62,81,19,WSLSVAIFSVGGMIGSFSV,1
5c65,B,91,111,20,NSMLIVNLLAVTGGCFMGLC,1
5c65,B,117,146,29,EMLILGRLVIGLFCGLCTGFVPMYIGEIS,1
5c65,B,148,166,18,ALRGAFGTLNQLGIVVGI,1
5c65,B,189,208,19,FTILPAILQSAALPFCPES,1
5c65,B,273,288,15,IVLQLSQQLSGINAV,1
5c65,B,316,332,16,IFTVVSLFLVERAGRR,1
5c65,B,334,347,13,HMIGLGGMAFCST,1
5c65,B,374,391,17,AFFEIGPGPIPWFIVAE,1
5c65,B,403,424,21,VAGCSNWTSNFLVGLLFPSAA,1
5c65,B,431,450,19,FIIFTGFLITFLAFTFFKV,1
4pdm,E,25,45,20,VLFVLTILTLISGTIFYSTV,1
4pdm,E,75,99,24,GKIFTILYIFIGIGLVFGFIHKLA,1
4pgv,A,17,37,20,TVFVFTLLIATVGLFIGQFV,1
4pgv,A,42,61,19,LPLSILEVAMIILAFWMRR,1
4pgv,A,66,85,19,YAFVYTFAFVSGITLFPIV,1
4pgv,A,97,116,19,LEAFGSTFVIFAVLGTIGA,1
4pgv,A,126,145,19,SFLLVAVLALAVVGIFNIF,1
4pgv,A,153,173,20,MAYSVIGTIVFSLYILYDLN,1
4pgv,A,187,207,20,MALSLYLDFINLFINLLRFF,1
1xio,B,7,25,18,HWIYVAGMTIGALHFWSL,1
1xio,B,38,55,17,VAMFIPIWSGLAYMAMA,1
1xio,B,70,87,17,ARYIDWMVTTPLLLLSL,1
1xio,B,103,121,18,FLMSTQIVVITSGLIADL,1
1xio,B,127,146,19,RYLWYICGVCAFLIILWGI,1
1xio,B,169,186,17,TYFTVLWIGYPIVWIIG,1
1xio,B,198,217,19,TFLFCLLPFFSKVGFSFLD,1
4ux1,B,36,55,19,WVWISLYYVAFYVVMSGIF,1
5t4q,V,19,32,13,AAIGAAIGIGILG,1
5t4q,V,52,65,13,FFIVMGLVDAIPM,1
5jjn,D,24,38,14,VFIFVGALTVLFGA,1
5jjn,D,66,81,15,LIILLGINLGLVAAT,1
3nmo,A,37,61,24,MAAVVGTLVGLAAVAFDKGVAWLQ,1
3nmo,A,81,97,16,AFLCSAVLAMFGYFLV,1
3nmo,A,129,142,13,VKFFGGLGTLGGG,1
3nmo,A,144,156,12,LGREGPTVQIGG,1
3nmo,A,216,230,14,AVFIGVIMSTIMYR,1
3nmo,A,253,270,17,LYLILGIIFGIFGPIFN,1
3nmo,A,292,305,13,LMGGAIGGLCGLL,1
3nmo,A,335,351,16,IFVARVITTLLCFSSG,1
3nmo,A,353,368,15,GGIFAPMLALGTVLG,1
3nmo,A,423,436,13,PMIITGLGATLLA,1
2moz,A,18,37,19,ALSSFTPVLVILLGVVGLS,1
2moz,A,43,65,22,DYVLLPALAIFIGLTIYAIQRK,1
5c5x,D,15,31,16,AEFLATLIFVFFGLGS,1
5c5x,D,44,61,17,IALAFGLAIGTLAQALG,1
5c5x,D,88,105,17,FYVAAQLVGAIAGAGIL,1
5c5x,D,130,149,19,AMVVELILTFQLALCIFAS,1
5c5x,D,160,177,17,PALSIGLSVTLGHLVGI,1
5c5x,D,204,221,17,VFWVGPIVGAVLAAILY,1
1qcr,K,21,34,13,QLWGAVGAVGLVS,1
4ltq,D,152,171,19,IALLLLVIFYVFAVMGTKL,1
4ltq,D,213,233,20,AWIYFVSFILVSSFTVLNLF,1
2jk5,F,26,50,24,RAAGAATVLLVIVLLAGSYLAVLA,1
2jk5,F,87,112,25,GRCVAVVVMVAGITSFGLVTAALAT,1
3pds,A,33,56,23,VGMGIVMSLIVLAIVFGNVLVIT,1
3pds,A,72,95,23,TSLACADLVMGLAVVPFGAACIL,1
3pds,A,104,126,22,WCEFWTSIDVLCVTASIETLCV,1
3pds,A,154,175,21,LMVWIVSGLTSFLPIQMHWYR,1
3pds,A,192,217,25,FFTNQAYAIASSIVSFYVPLVIMVF,1
3pds,A,277,299,22,IMGTFTLCWLPFFIVNIVHVIQ,1
3pds,A,304,327,23,KEVYILLNWIGYVNSGFNPLIYC,1
4ymk,D,70,92,22,NIILMVLLHLGGLYGIILVPSC,1
4ymk,D,94,107,13,YTCLFGIFYYMTS,1
4ymk,D,214,231,17,KPGLLLMCFILPTLVPW,1
4ymk,D,239,253,14,NSLFVSTFLRYTLV,1
3w5a,C,16,31,15,ITVILIWLLVRSYQY,1
2hrt,C,11,27,16,AWVIAIIIMLAGGLAI,1
2hrt,C,342,358,16,TLVEAIILVFLVMYLF,1
2hrt,C,366,386,20,IPTIAVPVVLLGTFAVLAAF,1
2hrt,C,395,411,16,FGMVLAIGLLVDDAIV,1
2hrt,C,443,457,14,GIAMVLSAVFVPMA,1
2hrt,C,471,489,18,ITIVSAMALSVLVALILT,1
2hrt,C,541,556,15,LVLYLIIVVGMAYLF,1
2hrt,C,875,892,17,LYAISLIVVFLCLAALY,1
2hrt,C,896,919,23,IPFSVMLVVPLGVIGALLAATFR,1
2hrt,C,928,944,16,VGLLTTIGLSAKNAIL,1
2hrt,C,976,991,15,MTSLAFILGVMPLVI,1
2hrt,C,1004,1022,18,TGVMGGMVTATVLAIFFV,1
4ikw,A,26,47,21,TLFFTEFWERFSYYGMRAILV,1
4ikw,A,67,88,21,AIMSIYGALVYMSGIIGGWLA,1
4ikw,A,95,114,19,RAVFYGGLLIMAGHIALAI,1
4ikw,A,120,140,20,LFVSMALIVLGTGLLKPNVS,1
4ikw,A,160,180,20,FYMGINLGAFLAPLVVGTAG,1
4ikw,A,187,207,20,GFGLAAVGMFLGLVVFVATR,1
4ikw,A,229,249,20,AAAIMAVGAVVIAVLLAILI,1
4ikw,A,255,277,22,VETFISLVGILGIIIPIIYFVV,1
4ikw,A,294,317,23,YIPLFVASAMFWAIQEQGSTILA,1
4ikw,A,337,357,20,FQSLNPLFIIILAPVFAWMW,1
4ikw,A,368,387,19,QKFALGLLFAGLSFIVILV,1
4ikw,A,401,421,20,LVLSYFIVVLGELCLSPVGL,1
4ikw,A,438,455,17,LWFLSNAAAQAINAQLV,1
4ikw,A,467,485,18,GTIGGAALVLGLILLAIA,1
5m95,C,70,89,19,ILISSLAAMLLQSMTVRLG,1
5m95,C,109,125,16,IIFWIIAELAIIATDI,1
5m95,C,218,240,22,GIIGATIMPHNLYLHSSIVQSR,1
5m95,C,253,269,16,IKYATIDSNLQLSIAF,1
5m95,C,329,346,17,STITGTLAGQIVMEGFL,1
5m95,C,349,365,16,IPNWLRRLITRSLAVI,1
5m95,C,389,404,15,VFLSIALPFSLIPLQ,1
5m95,C,417,437,20,NKTWVNIISWTLIVILSGLN,1
2mom,C,383,400,17,ALAGVLILVLLAYFIGL,1
2qjp,F,12,32,20,DFLYYATAGAGAVATGAAVW,1
3k3g,C,33,46,13,GLLFFAGIFYNST,1
3k3g,C,48,62,14,GVCAVLGTAASTLT,1
3k3g,C,79,92,13,FNGTLAGIALPFF,1
3k3g,C,98,114,16,MLGYVALNGAFTTIIM,1
3k3g,C,129,144,15,TAPFVLATWLLMFGV,1
3k3g,C,195,205,10,TGVIFVVAIL,1
3k3g,C,210,229,19,SALFAVIGSLVGLCTALIM,1
3k3g,C,239,253,14,LYGFNSVLCGIAMG,1
3k3g,C,265,285,20,YALGCMVLGAIATGAFSVLL,1
3k3g,C,291,304,13,ALTWPFIVVTWLF,1
3wt9,A,20,42,22,DAQWVVFAVMALAAIVFSIAVQ,1
3wt9,A,50,73,23,TYYVNIAICTIAATAYYAMAVNG,1
3wt9,A,90,110,20,YARYIDWVFTTPLLLLDLVL,1
3wt9,A,117,139,22,MIAWIMGADIAMIAFGIIGAFT,1
3wt9,A,144,164,20,WFYFVVGCIMLAVLAWGMIN,1
3wt9,A,181,205,24,TTLLIYLIVLWVIYPIVWGLGAGG,1
3wt9,A,212,235,23,EIIAMGILDLLAKPLYAIGVLIT,1
4bot,E,221,243,22,IINIIAPCVLISSLVVLVYFLP,1
4bot,E,251,273,22,TLSISVLLAQTIFLFLIAQKVP,1
4bot,E,284,308,24,YLIFVMFVSLVIVTNCVIVLNVSL,1
4bot,E,449,473,24,CFWIALLLFSLGTLAIFLTGHLNQ,1
1ap9,C,10,31,21,IWLALGTALMGLGTLYFLVKG,1
1ap9,C,44,62,18,ITTLVPAIAFTMYLSMLL,1
1ap9,C,80,97,17,ARYADWLFTTPLLLLDL,1
1ap9,C,108,127,19,LALVGADGIMIGTGLVGAL,1
1ap9,C,133,153,20,RFVWWAISTAAMLYILYVLF,1
1ap9,C,174,195,21,RNVTVVLWSAYPVVWLIGSEG,1
1ap9,C,204,223,19,TLLFMVLDVSAKVGFGLIL,1
2v8n,A,11,34,23,FGLFFFFYFFIMGAYFPFFPIWL,1
2v8n,A,43,64,21,DTGIIFAAISLFSLLFQPLFG,1
2v8n,A,75,96,21,LLWIITGMLVMFAPFFIFIFG,1
2v8n,A,105,129,24,GSIVGGIYLGFCFNAGAPAVEAFI,1
2v8n,A,143,162,19,RMFGCVGWALCASIVGIMF,1
2v8n,A,168,188,20,VFWLGSGCALILAVLLFFAK,1
2v8n,A,223,247,24,FLSLYVIGVSCTYDVFDQQFANFF,1
2v8n,A,259,279,20,VFGYVTTMGELLNASIMFFA,1
2v8n,A,289,309,20,NALLLAGTIMSVRIIGSSFA,1
2v8n,A,314,333,19,VVILKTLHMFEVPFLLVGC,1
2v8n,A,351,373,22,VCFCFFKQLAMIFMSVLAGNMY,1
2v8n,A,379,400,21,GAYLVLGLVALGFTLISVFTL,1
3pqr,A,40,65,25,AAYMFLLIMLGFPINFLTLYVTVQH,1
3pqr,A,69,96,27,TPLNYILLNLAVADLFMVFGGFTTTLY,1
3pqr,A,113,137,24,GFFATLGGEIALWSLVVLAIERYV,1
3pqr,A,149,172,23,ENHAIMGVAFTWVMALACAAPPL,1
3pqr,A,203,228,25,VIYMFVVHFIIPLIVIFFCYGQLVF,1
3pqr,A,250,274,24,TRMVIIMVIAFLICWLPYAGVAFY,1
3pqr,A,290,311,21,PAFFAKTSAVYNPVIYIMMNK,1
3b9z,C,42,60,18,YSINILAMLLVGFGFLMV,1
3b9z,C,69,88,19,TTGTYLVVATGLPLYILLR,1
3b9z,C,105,123,18,IYAEFAVATGLIAMGAVL,1
3b9z,C,129,150,21,QYALLALFIVPVYLLNEWLVL,1
3b9z,C,162,183,21,SAGSIAIHAFGAYFGLGVSIA,1
3b9z,C,203,221,18,SMLGSMVLWLFWPSFATA,1
3b9z,C,232,252,20,VNTLLALCGATLATYFLSAL,1
3b9z,C,261,278,17,DMANAALAGGVAIGSVC,1
3b9z,C,282,301,19,PVGAFVIGLLGGAISVVGF,1
3b9z,C,317,338,21,CGVHNLHGLPGLLGGFSAILI,1
3b9z,C,344,371,27,AQLTGIGITLALALIGGVIAGALIKLT,1
1mhs,B,113,134,21,LKFLGFFVGPIQFVMEGAAVL,1
1mhs,B,144,164,20,GVICGLLLLNAVVGFVQEFQ,1
1mhs,B,294,313,19,TILLILVIFTLLIVWVSSF,1
1mhs,B,320,341,21,QILEFTLAITIIGVPVGLPAV,1
1mhs,B,690,713,23,YVVYRIALSIHLEIFLGLWIAIL,1
1mhs,B,717,737,20,NIELVVFIAIFADVATLAIA,1
1mhs,B,760,783,23,LLGVVLAVGTWITVTTMYAQGEN,1
1mhs,B,795,813,18,VLFLQISLTENWLIFITR,1
1mhs,B,827,843,16,SGAIFLVDILATCFTI,1
1mhs,B,854,875,21,VAVVRIWIFSFGIFCIMGGVY,1
5v56,A,232,256,24,YIAAFGAVTGLCTLFTLATFVADW,1
5v56,A,263,287,24,AVILFYVNACFFVGSIGWLAQFMD,1
5v56,A,313,343,30,CVIIFVIVYYALMAGVVWFVVLTYAWHTSF,1
5v56,A,356,377,21,TSYFHLLTWSLPFVLTVAILA,1
5v56,A,401,428,27,GFVLAPIGLVLIVGGYFLIRGVMTLFS,1
5v56,A,450,471,21,RLGIFGFLAFGFVLITFSCHF,1
5v56,A,518,539,21,KINLFAMFGTGIAMSTWVWTK,1
4kkb,B,37,61,24,MAAVVGTLVGLAAVAFDKGVAWLQ,1
4kkb,B,84,97,13,CSAVLAMFGYFLV,1
4kkb,B,129,142,13,VKFFGGLGTLGGG,1
4kkb,B,144,156,12,LGRAGPTVQIGG,1
4kkb,B,216,232,16,AVFIGVIMSTIMYRIF,1
4kkb,B,253,277,24,LYLILGIIFGIFGPIFNKWVLGMQ,1
4kkb,B,290,305,15,WVLMGGAIGGLCGLL,1
4kkb,B,338,351,13,ARVITTLLCFSSG,1
4kkb,B,353,368,15,GGIFAPMLALGTVLG,1
4kkb,B,423,439,16,PMIITGLGATLLAQFT,1
5v4s,D,15,30,15,VFICIFWASLESPLR,1
5v4s,D,40,55,15,LTCIYFFIDFVFALD,1
5v4s,D,88,104,16,DLIAALPLEYATTTIF,1
5v4s,D,114,129,15,YLLLGVTRILKVFRI,1
5v4s,D,149,167,18,VLFAFWATLVAHWCAVGW,1
5v4s,D,212,232,20,TIFVMILGAGVYATVIGNIA,1
5f15,A,30,45,15,VVLFVAVALVVWFVS,1
5f15,A,110,125,15,VALSGLLGIGVSMMA,1
5f15,A,136,153,17,FTGLALLAAPMWSVAAH,1
5f15,A,158,173,15,MTLAGVMSCVLAFML,1
5f15,A,188,203,15,MVACWAAMGVAILTK,1
5f15,A,205,218,13,VGIALPGLVLVVY,1
5f15,A,232,246,14,LALGVVVMLVITVP,1
5f15,A,282,304,22,FYFLPLVIGGFLPWAGIFPKLW,1
5f15,A,324,338,14,GIWAIAIFVFFSIS,1
5f15,A,344,358,14,YIVPVIPALGILAG,1
5f15,A,370,386,16,KQLIGMAIVAACGLLA,1
5f15,A,413,427,14,FVVMLLGIAVARLL,1
5f15,A,435,449,14,VAVYAMGMYLGFTV,1
2fee,B,37,61,24,MAAVVGTLVGLAAVAFDKGVAWLQ,1
2fee,B,81,97,16,AFLCSAVLAMFGYFLV,1
2fee,B,128,142,14,PVKFFGGLGTLGGG,1
2fee,B,144,159,15,LGREGPTVQIGGNIG,1
2fee,B,216,232,16,AVFIGVIMSTIMYRIF,1
2fee,B,253,277,24,LYLILGIIFGIFGPIFNKWVLGMQ,1
2fee,B,290,305,15,WVLMGGAIGGLCGLL,1
2fee,B,337,351,14,VARVITTLLCFSSG,1
2fee,B,353,368,15,GGIFAPMLALGTVLG,1
2fee,B,422,439,17,LPMIITGLGATLLAQFT,1
4kjq,B,37,61,24,MAAVVGTLVGLAAVAFDKGVAWLQ,1
4kjq,B,84,97,13,CSAVLAMFGYFLV,1
4kjq,B,128,142,14,PVKFFGGLGTLGGG,1
4kjq,B,144,156,12,LGREGPTVQIGG,1
4kjq,B,216,232,16,AVFIGVIMSTIMYRIF,1
4kjq,B,253,277,24,LYLILGIIFGIFGPIFNKWVLGMQ,1
4kjq,B,290,305,15,WVLMGGAIGGLCGLL,1
4kjq,B,338,351,13,ARVITTLLCFSSG,1
4kjq,B,353,368,15,GGIFAPMLALGTVLG,1
4kjq,B,423,439,16,PMIITGLGATLLAQFT,1
5f1c,C,31,51,20,RLIQLLILGYIIGYVIIYQK,1
5f1c,C,343,366,23,LSPIPIAINIGSGLGLMVVATVL,1
3b5y,B,28,44,16,VAGIALILNAASDTFM,1
3b5y,B,68,85,17,LVVIGLMILRGITSYIS,1
3b5y,B,144,161,17,TVVREGASIIGLFIMMF,1
3b5y,B,168,182,14,IILVVLAPIVSIAI,1
3b5y,B,249,263,14,ISDPIIQLIASLAL,1
3b5y,B,291,303,12,IALMRPLKSLTN,1
4kjs,D,5,19,14,FILVAAGVPLSVIG,1
4kjs,D,30,49,19,AVYCVTIIALASYMGRATE,1
4kjs,D,60,79,19,GLLNATFGNAVELIISMFA,1
4kjs,D,88,110,22,LASLTGSVLGNLLLVAGLSFFV,1
4kjs,D,129,146,17,GLLIFAIIVAFVIPEVF,1
4kjs,D,157,175,18,LSIGISIIMILLYVAALY,1
4kjs,D,206,224,18,TIVLFAATIVVAYISENL,1
4kjs,D,241,260,19,IGVIIVAIVGNAAEHASAI,1
4kjs,D,273,296,23,IAVGSTLQIAMFVAPVLVICSIF,1
4kjs,D,303,324,21,VFTLPELVAMVSAVLLMIAIS,1
4kjs,D,332,349,17,EGATLLAAYVIMAIGFF,1
2v61,A,486,501,15,PSVPGLLRLIGLTTI,1
1j95,D,27,50,23,AAGAATVLLVIVLLAGSYLAVLA,1
1j95,D,87,111,24,GRCVAVVVMVAGITSFGLVTAALA,1
5tzr,A,6,31,25,LSFGLYVAAFALGFPLNVLAIRGAT,1
5tzr,A,42,67,25,VYALNLGCSDLLLTVSLPLKAVEAL,1
5tzr,A,75,103,28,ASLCPVFAVAHFAPLYAGGGFLAALSAA,1
5tzr,A,123,146,23,WGVCAAIWALVLCHLGLVFGLEA,1
5tzr,A,179,204,25,GPARFSLSLLLFFLPLAITAFCFVG,1
5tzr,A,2224,2250,26,VAGGALLTLLLCVGPYNASNVASFLY,1
5tzr,A,2257,2280,23,RKLGLITGAWSVVLNPLVTGYLG,1
5hj8,D,154,170,16,LLLLVIFYVFAVMGTK,1
5hj8,D,214,233,19,WIYFVSFILVSSFTVLNLF,1
4eed,E,294,315,21,TIIATIFMPLTFIAGIYGMNF,1
4eed,E,327,346,19,PVVLAVMGVIAVIMVVYFK,1
4kk6,B,37,61,24,MAAVVGTLVGLAAVAFDKGVAWLQ,1
4kk6,B,84,97,13,CSAVLAMFGYFLV,1
4kk6,B,129,142,13,VKFFGGLGTLGGG,1
4kk6,B,144,156,12,LGREGPTVQIGG,1
4kk6,B,216,232,16,AVFIGVIMSTIMYRIF,1
4kk6,B,253,277,24,LYLILGIIFGIFGPIFNKWVLGMQ,1
4kk6,B,290,305,15,WVLMGGAIGGLCGLL,1
4kk6,B,338,351,13,ARVITTLLCFSSG,1
4kk6,B,353,368,15,GGIFAPMLALGTVLG,1
4kk6,B,423,439,16,PMIITGLGATLLAQFT,1
2xow,A,94,113,19,PVTWVMMIACVVVFIAMQI,1
2xow,A,148,163,15,MHILFNLLWWWYLGG,1
2xow,A,172,190,18,KLIVITLISALLSGYVQQ,1
2xow,A,198,214,16,GLSGVVYALMGYVWLR,1
2xow,A,228,247,19,LIIFALIWIVAGWFDLFGM,1
2xow,A,250,268,18,NGAHIAGLAVGLAMAFVD,1
4b4a,A,9,27,18,LRYRLIISIIAFLIGSGI,1
4b4a,A,70,87,17,VGFIIASPVILYQFWRF,1
4b4a,A,101,122,21,PLLLGSILLFMLGALFAYFIV,1
4b4a,A,155,171,16,LVVAFGIAFEMPIVLY,1
4b4a,A,185,203,18,SFRKYFIVIAFVIGAIIA,1
4b4a,A,207,226,19,TQVLMAIPLLLLYEISIFL,1
2xnd,Q,16,28,12,GVAGSGAGIGTV,1
2xnd,Q,52,65,13,GFALSEAMGLFCL,1
3ubb,C,94,112,18,PVTWVMMIACVVVFIAMQ,1
3ubb,C,140,165,25,HALMHFSLMHILFNLLWWWYLGGAV,1
3ubb,C,172,189,17,KLIVITLISALLSGYVQ,1
3ubb,C,199,214,15,LSGVVYALMGYVWLR,1
3ubb,C,226,242,16,RGLIIFALIWIVAGWF,1
3ubb,C,253,268,15,HIAGLAVGLAMAFVD,1
4ntf,C,8,28,20,ATVTLVGVLLQAYFSLQVIS,1
4ntf,C,52,71,19,QVNCSEYFPLFLATLWVAG,1
4ntf,C,79,97,18,ALCGLFYLFARLRYFQGY,1
4ntf,C,104,124,20,LTPLYASARALWLLVAMAAL,1
1s54,E,10,34,24,IWLALGTALMGLGALYFLVKGMGV,1
1s54,E,40,62,22,KFYAITTLVPAIAFTMYLSMLL,1
1s54,E,80,100,20,ARYADWLFTTPLLLLDLALL,1
1s54,E,104,127,23,QGTILALVGADGIMIGTGLVGAL,1
1s54,E,134,157,23,FVWWAISTAAMLYILYVLFFGFT,1
1s54,E,171,192,21,KVLRNVTVVLWSAYPVVWLIG,1
1s54,E,203,226,23,ETLLFMVLDVSAKVGFGLILLRS,1
2o9j,A,55,73,18,QFEDLLVRILLLAACISF,1
2o9j,A,89,107,18,EPFVILLILIANAIVGVW,1
2o9j,A,254,274,20,EFGEQLSKVISLICVAVWLI,1
2o9j,A,296,317,21,KIAVALAVAAIPEGLPAVITT,1
2o9j,A,760,780,20,IRYLISSNVGEVVCIFLTAA,1
2o9j,A,787,807,20,IPVQLLWVNLVTDGLPATAL,1
2o9j,A,830,852,22,GWLFFRYMAIGGYVGAATVGAA,1
2o9j,A,898,916,18,MALSVLVTIEMCNALNSL,1
2o9j,A,931,950,19,WLLGSICLSMSLHFLILYV,1
2o9j,A,965,987,22,QWLMVLKISLPVIGLDEILKFI,1
1c17,M,103,121,18,LALTIFVWVFLMNLMDLL,1
1c17,M,146,163,17,VNVTLSMALGVFILILF,1
1c17,M,202,219,17,KPVSLGLRLFGNMYAGE,1
1c17,M,245,262,17,ILIITLQAFIFMVLTIV,1
3k0i,C,16,28,12,LMGALFLSIWGT,1
3k0i,C,341,354,13,LLEEFIVVAVVCA,1
3k0i,C,362,380,18,ALVAIISLPLGLCIAFIV,1
3k0i,C,397,408,11,IAVGAMVDAAI,1
3k0i,C,451,462,11,ISLLIITLSFI,1
3k0i,C,483,496,13,YAMAGAALLAIVV,1
3k0i,C,541,552,11,VAALSVLTVLW,1
3k0i,C,876,888,12,PMTLMIIFVLLY,1
3k0i,C,898,914,16,LIISSVPFALVGGIWL,1
3k0i,C,930,942,12,IALAGVAAEFGV,1
3k0i,C,985,997,12,MTVAVIIAGLLP,1
3k0i,C,1014,1027,13,PMIGGMITAPLLS,1
2oa0,A,55,73,18,QFEDLLVRILLLAACISF,1
2oa0,A,90,109,19,PFVILLILIANAIVGVWQE,1
2oa0,A,254,275,21,EFGEQLSKVISLICVAVWLIN,1
2oa0,A,296,318,22,KIAVALAVAAIPEGLPAVITTC,1
2oa0,A,760,781,21,IRYLISSNVGEVVCIFLTAAL,1
2oa0,A,786,808,22,LIPVQLLWVNLVTDGLPATALG,1
2oa0,A,833,852,19,FFRYMAIGGYVGAATVGAA,1
2oa0,A,898,916,18,MALSVLVTIEMCNALNSL,1
2oa0,A,927,948,21,WVNIWLLGSICLSMSLHFLIL,1
2oa0,A,967,987,20,LMVLKISLPVIGLDEILKFI,1
1m2u,A,18,33,15,YFFIMGCYCCCFPCW,1
1m2u,A,49,66,17,AACCLFSCLFCPLCGLL,1
1m2u,A,76,95,19,LWIITGMLVMCAPFFICIF,1
1m2u,A,115,126,11,FCFCAGCPACE,1
1m2u,A,146,158,12,CCVGCCLCCSIC,1
1m2u,A,169,179,10,FCLGSGCALI,1
1m2u,A,233,246,13,CCYDCCDCCCACC,1
1m2u,A,263,275,12,VCTMGELLCASC,1
1m2u,A,296,310,14,TIMSVRIIGSSFAT,1
1m2u,A,317,330,13,LKTLHMFEVPFLL,1
1m2u,A,351,368,17,VCCCCFKQLCCIFMSVL,1
1m2u,A,381,396,15,YLVLGLVACCFCLIS,1
5xab,A,50,77,27,ELVIEQFEDLLVRILLLAACISFVLAW,1
5xab,A,86,105,19,AFVEPFVILLILIANAIVG,1
5xab,A,254,274,20,EFGEQLSKVISLICVAVWLI,1
5xab,A,296,314,18,KIAVALAVAAIPEGLPAV,1
5xab,A,761,780,19,RYLISSNVGEVVCIFLTAA,1
5xab,A,786,806,20,LIPVQLLWVNLVTDGLPATA,1
5xab,A,830,852,22,GWLFFRYMAIGGYVGAATVGAA,1
5xab,A,896,916,20,MTMALSVLVTIEMCNALNSL,1
5xab,A,934,951,17,GSICLSMSLHFLILYVD,1
5xab,A,953,988,35,PMIFKLKALDLTQWLMVLKISLPVIGLDEILKFIA,1
2zy9,B,282,305,23,LARVRWLVILILTGMVTSSILQG,1
2zy9,B,317,335,18,FYVPVLLGTGGNTGNQSA,1
2zy9,B,356,381,25,LKEMGVGLLLGLTLSFLLVGKVYWD,1
2zy9,B,388,409,21,VVGVSLVLIVFFANLVGAMLP,1
2zy9,B,422,443,21,SNPLVATLSDVTGLLIYLSVA,1
4lcz,C,64,82,18,EVIHCRWAMLGALGCVFP,1
4lcz,C,126,142,16,IWACQVILMGAVEGYR,1
4lcz,C,180,197,17,IKNGRLAMFSMFGFFVQ,1
2h3o,A,28,42,14,ILLGVVGLSALTGY,1
2h3o,A,51,65,14,AIFIGLTIYAIQRK,1
4pd9,C,5,21,16,SCCGMAVLLGIAVLLS,1
4pd9,C,30,47,17,TVGGAFAIQFSLGAFIL,1
4pd9,C,103,118,15,TLIFFSALISVLYYL,1
4pd9,C,176,192,16,MCGGLASIAGGVLAGY,1
4pd9,C,202,220,18,VAASFMAAPGGLLFAKLM,1
4pd9,C,242,274,32,ANVIDAAAGGASAGLQLALNVGAMLIAFIGLI,1
4pd9,C,361,379,18,ALCGFANLSSIAILLGGL,1
4pd9,C,395,412,17,KAVIAGTLSNLMAATIA,1
5t4d,D,220,242,22,LRELVTYLLFLIVLCILTYGMM,1
5t4d,D,472,493,21,LAACEIIFCFFIFYYVVEEIL,1
5t4d,D,505,528,23,FWNCLDVVIVVLSVVAIGINIYR,1
5t4d,D,555,580,25,IQFNNIAAVTVFFVWIKLFKFINFN,1
5t4d,D,590,620,30,SRCAKDLFGFAIMFFIIFLAYAQLAYLVFG,1
5t4d,D,654,681,27,VLGPIYFTTFVFFMFFILLNMFLAIIN,1
3w5c,A,61,77,16,VRILLLAACISFVLAW,1
3w5c,A,87,103,16,FVEPFVILLILIANAI,1
3w5c,A,258,276,18,QLSKVISLICVAVWLINI,1
3w5c,A,293,314,21,YYFKIAVALAVAAIPEGLPAV,1
3w5c,A,763,781,18,LISSNVGEVVCIFLTAAL,1
3w5c,A,786,806,20,LIPVQLLWVNLVTDGLPATA,1
3w5c,A,834,851,17,FRYMAIGGYVGAATVGA,1
3w5c,A,898,916,18,MALSVLVTIEMCNALNSL,1
3w5c,A,931,950,19,WLLGSICLSMSLHFLILYV,1
3w5c,A,968,987,19,MVLKISLPVIGLDEILKFI,1
1msl,E,19,42,23,AVVIGTAFTALVTKFTDSIITPL,1
1msl,E,69,90,21,NVLLSAAINFFLIAFAVYFLV,1
2z9r,A,57,77,20,EDLLVRILLLAACISFVLAW,1
2z9r,A,86,104,18,AFVEPFVILLILIANAIV,1
2z9r,A,257,275,18,EQLSKVISLICVAVWLIN,1
2z9r,A,294,313,19,YFKIAVALAVAAIPEGLPA,1
2z9r,A,760,780,20,IRYLISSNVGEVVCIFLTAA,1
2z9r,A,787,807,20,IPVQLLWVNLVTDGLPATAL,1
2z9r,A,832,852,20,LFFRYMAIGGYVGAATVGAA,1
2z9r,A,898,916,18,MALSVLVTIEMCNALNSL,1
2z9r,A,932,950,18,LLGSICLSMSLHFLILYV,1
2z9r,A,965,987,22,QWLMVLKISLPVIGLDEILKFI,1
3kso,C,16,31,15,LMGALFLSIWGTWTI,1
3kso,C,339,355,16,GKLLEEFIVVAVVCAL,1
3kso,C,361,381,20,SALVAIISLPLGLCIAFIVM,1
3kso,C,395,409,14,IAIAVGAMVDAAIV,1
3kso,C,449,465,16,LFISLLIITLSFIPIF,1
3kso,C,480,500,20,TKTYAMAGAALLAIVVIPIL,1
3kso,C,539,554,15,LLVAALSVLTVLWPL,1
3kso,C,873,889,16,LMVPMTLMIIFVLLYL,1
3kso,C,898,918,20,LIISSVPFALVGGIWLLWWM,1
3kso,C,927,942,15,TGFIALAGVAAEFGV,1
3kso,C,985,1000,15,MTVAVIIAGLLPILW,1
3kso,C,1013,1027,14,APMIGGMITAPLLS,1
3wmo,0,29,42,13,GLVVIAHLLAWLY,1
5m7j,D,12,29,17,AQLVWYAQWLVIWTVVL,1
5jdg,A,7,28,21,YFLLGLILLYYGSDWFVLGSE,1
5jdg,A,39,57,18,VIGATVMAIGTSLPEILT,1
5jdg,A,74,93,19,IGSCICNIGLVLGLSAIIS,1
5jdg,A,102,120,18,KNILVYLLFVIFAAVIGI,1
5jdg,A,127,144,17,GVVLLILFIIYLRWTVK,1
5jdg,A,163,183,20,SLVLLIIGLIGVLVGAELFV,1
5jdg,A,205,222,17,AFGTSLPELMVSLAAAK,1
5jdg,A,227,247,20,MVLGNVIGSNIADIGGALAV,1
5jdg,A,259,276,17,QMAVLVIMSLLLYLFAK,1
5jdg,A,281,299,18,RWQGILFLALYIIAIASL,1
4ybq,A,22,38,16,AAFGSSFQYGYNVAAV,1
4ybq,A,74,91,17,SMFPFGGFIGSLMVGFL,1
4ybq,A,101,120,19,LFNNIFSILPAILMGCSKI,1
4ybq,A,126,146,20,IIASRLLVGICAGISSNVVP,1
4ybq,A,164,183,19,PQLFITVGILVAQLFGLRS,1
4ybq,A,191,207,16,PILLGLTGVPAGLQLL,1
4ybq,A,278,296,18,STIVLMAGQQLSGVNAIY,1
4ybq,A,316,335,19,TAGTGAVNVFMTMVTVFVV,1
4ybq,A,341,358,17,NLLLIGFSTCLTACIVL,1
4ybq,A,377,398,21,CVIVYVIGHAVGPSPIPALFI,1
4ybq,A,411,428,17,MIGGSVHWLSNFIVGLI,1
4ybq,A,442,459,17,IFAIICLLTTIYIFMVV,1
4buo,A,62,83,21,SKVLVTAIYLALFVVGTVGNS,1
4buo,A,110,132,22,LSDLLILLLAMPVELYNFIWVH,1
4buo,A,136,158,22,FGDAGCRGYYFLRDACTYATAL,1
4buo,A,194,210,16,LASALLAIPMLFTMGL,1
4buo,A,226,251,25,PIVDTATLKVVIQVNTFMSFLFPML,1
4buo,A,315,334,19,AFVVCWLPYHVRRLMFCYI,1
4buo,A,346,367,21,YHYFYMLTNALVYVSAAINPI,1
5awz,A,11,33,22,GTDAQWVVFAVMALAAIVFSIA,1
5awz,A,45,67,22,YVNIAICTIAATAYYAMAVNGG,1
5awz,A,83,103,20,YARYIDWVFTTPLLLLDLVL,1
5awz,A,110,132,22,MIAWIMGADIAMIAFGIIGAFT,1
5awz,A,137,160,23,WFYFVVGCIMLAVLAWGMINPIF,1
5awz,A,174,197,23,TTLLIYLIVLWVIYPIVWGLGAG,1
5awz,A,204,227,23,VEIIAMGILDLLAKPLYAIGVLI,1
4i0u,E,296,315,19,IATIFMPLTFIAGIYGMNF,1
4i0u,E,324,344,20,WGYPVVLAVMGVIAVIMVVY,1
2zbe,A,50,76,26,LVIEQFEDLLVRILLLAACISFVLAW,1
2zbe,A,87,106,19,VEPFVILLILIANAIVGVW,1
2zbe,A,254,273,19,FGEQLSKVISLICVAVWLI,1
2zbe,A,297,317,20,AVALAVAAIPEGLPAVITTC,1
2zbe,A,759,777,18,IRYLISSNVGEVVCIFLT,1
2zbe,A,787,807,20,PVQLLWVNLVTDGLPATALG,1
2zbe,A,830,852,22,WLFFRYMAIGGYVGAATVGAAA,1
2zbe,A,898,916,18,ALSVLVTIEMCNALNSLS,1
2zbe,A,932,950,18,LGSICLSMSLHFLILYVD,1
2zbe,A,965,987,22,WLMVLKISLPVIGLDEILKFIA,1
3utx,A,10,32,22,IWLALGTALMGLGTLYFLVKGM,1
3utx,A,42,66,24,YAIATLVPAIAFTMYLSMLLGYGL,1
3utx,A,79,99,20,WARYADWLFTTPLLLLDLAL,1
3utx,A,106,128,22,TILALVGADGIMIGTGLVGALT,1
3utx,A,134,157,23,FVWWAISTAAMLYILYVLFFGFT,1
3utx,A,171,195,24,KVLRNVTVVLWSAYPVVWLIGSEG,1
3utx,A,202,225,23,IETLLFMVLDVSAKVGFGLILLR,1
4n7w,B,6,19,13,RLFPVWALLLSVA,1
4n7w,B,34,47,13,GPLLMLIMFAMGV,1
4n7w,B,68,82,14,FLHYLIMPLTAWIL,1
4n7w,B,97,108,11,LVGSVASGTAS,1
4n7w,B,127,141,14,VSTLVGVFATPLLT,1
4n7w,B,157,171,14,KSILQIVVIPITAG,1
4n7w,B,189,202,13,PAMSMVCILAIIS,1
4n7w,B,220,234,14,IAVILHNGIGLLSG,1
4n7w,B,253,266,13,EVGMQNSGLAATL,1
4n7w,B,279,293,14,ALFSVWHNLSGSLL,1
2aul,A,34,61,27,YYSVGIFIGVVGIIGILGNGVVIYLFS,1
2aul,A,70,98,28,NMFIINLAMSDLSFSAINGFPLKTISAF,1
2aul,A,108,132,24,CQLYGLLGGIFGFMSINTMAMISI,1
2aul,A,153,176,23,FLMIIFVWMWSIVWSVGPVFNWG,1
2aul,A,198,222,24,RSFILCMYFCGFMLPIIIIAFCYF,1
2aul,A,264,288,24,MVIITQFMLSWSPYAIIALLAQFG,1
2aul,A,294,318,24,PYAAELPVLFAKASAIHNPIVYSV,1
5c8j,I,28,45,17,AILIIAIIVSLIINIAT,1
5c8j,I,103,119,16,IYTWVPIILIFIYLRH,1
5c8j,I,142,163,21,IILSKILFIDFWHWLGSIFYK,1
5c8j,I,175,192,17,WLGWYILCSFATSTVLR,1
3nan,A,57,75,18,EDLLVRILLLAACISFVL,1
3nan,A,89,104,15,EPFVILLILIANAIV,1
3nan,A,257,276,19,EQLSKVISLICVAVWLINI,1
3nan,A,296,314,18,KIAVALAVAAIPEGLPAV,1
3nan,A,761,781,20,RYLISSNVGEVVCIFLTAAL,1
3nan,A,786,807,21,LIPVQLLWVNLVTDGLPATAL,1
3nan,A,834,851,17,FRYMAIGGYVGAATVGA,1
3nan,A,900,916,16,LSVLVTIEMCNALNSL,1
3nan,A,922,948,26,MRMPPWVNIWLLGSICLSMSLHFLIL,1
3nan,A,969,987,18,VLKISLPVIGLDEILKFI,1
4lz9,A,25,39,14,AMIGMFVMALYNVV,1
4lz9,A,60,74,14,PIMMIMMSMAGALG,1
4lz9,A,103,117,14,ILVLSVIGFISAFT,1
4lz9,A,142,157,15,ILLGSIFFFFAFAAN,1
4lz9,A,169,183,14,MVTMIVPAVLNILL,1
4lz9,A,200,213,13,ATVIAQASVTGLV,1
4lz9,A,246,259,13,PAFVQQSSASLMM,1
4lz9,A,282,294,12,RIMMFVMMPMMG,1
4lz9,A,326,341,15,TIFSIGIFALLMLFP,1
4lz9,A,363,376,13,ILFCVTFLIGAQI,1
4lz9,A,392,409,17,ILSLSRQIIFLIPLVLI,1
4lz9,A,420,433,13,WAFPIADVLSFIL,1
1h68,A,6,26,20,LFWLGAIGMLVGTLAFAWAG,1
1h68,A,36,56,20,YVTLVGISGIAAVAYVVMAL,1
1h68,A,70,91,21,PRYIDWILTTPLIVYFLGLLA,1
1h68,A,96,115,19,EFGIVITLNTVVMLAGFAG,1
1h68,A,126,146,20,FGMGAVAFLGLVYYLVGPMT,1
1h68,A,160,179,19,VRLRNLTVILWAIYPFIWL,1
1h68,A,194,214,20,ALIVYLDLVTKVGFGFIALD,1
3pjz,B,7,31,24,RIVGLLLALFSVTMLAPALVALLY,1
3pjz,B,37,58,21,PFVTTFFVLLFCGAMCWFPNR,1
3pjz,B,70,91,21,LIVVLFWTVLGSAGSLPFLIA,1
3pjz,B,126,147,21,ILFYRQFLQWFGGMGIIVLAV,1
3pjz,B,183,206,23,ALWYIYLSLTIACAVAFWLAGMT,1
3pjz,B,236,257,21,AINLITVVFLLISACNFTLHF,1
3pjz,B,275,296,21,FRAFIFIQVLLFLVCFLLLLK,1
3pjz,B,333,350,17,FLPVLLLFSSFIGGCAG,1
3pjz,B,352,366,14,GGGMKVIRILLLTL,1
3pjz,B,400,423,23,GFFSAYALVFVVCMLGLIATGMD,1
3pjz,B,455,475,20,AKWVLIVSMLFGRLEIFTLL,1
3v3c,N,15,36,21,AVGLASIGPGVGQGTAAGQAV,1
3v3c,N,50,72,22,GTLLLSLAFMEALTIYGLVVAL,1
3a3y,G,23,40,17,LIVAAVLCVIGIIILLA,1
5e7c,z,8,25,17,LAALVILSFVMVIGVPV,1
5e7c,z,40,55,15,FLGSGLWIALVLVVG,1
4msw,F,30,50,20,AATVLLVIVLLAGSYLAVLA,1
4msw,F,87,107,20,GRLVAVVVMVAGITSFGLVT,1
3a0b,z,5007,5023,16,ALAALVILSFVMVIGV,1
3a0b,z,5041,5055,14,LGSGLWIALVLVVG,1
2k9y,A,537,560,23,IGGVAVGVVLLLVLAGVGFFIHR,1
2nr1,A,9,24,15,SSAMWFSWGVLLNSG,1
4mrs,B,34,58,24,LRRRVVGAILMVLLGKATTLALPF,1
4mrs,B,86,106,20,YALGRFSGVLFDNLRNIVFE,1
4mrs,B,156,177,21,FLLFNIAPTVIELTAVIVIFW,1
4mrs,B,183,205,22,LVTATILAVIAYVWTTRTITEW,1
4mrs,B,263,284,21,SLGLLNIAQALIVNLLMAGAM,1
4mrs,B,304,323,19,NTYLTQLFRPLDMLGMVYR,1
4q4h,B,33,57,24,PHTFTLIMVFVFVTVSSILGVLSP,1
4q4h,B,84,105,21,TIYALTSLLFWLQGKIMLTLS,1
4q4h,B,151,172,21,GNSIIQFFSGIVTLAGAVIMM,1
4q4h,B,181,201,20,VTLSIVPLTVLITQIVSSQT,1
4q4h,B,258,278,20,FSGVLPPLMNMVNNLGFALI,1
4q4h,B,300,321,21,GYSRQFTRPLNELSNQFNMIQ,1
2ita,A,21,45,24,WVAFQMMKGAGWAGGVFFGTLLLI,1
5iws,B,13,33,20,KALLVVVAVMPAAGLMISIG,1
5iws,B,53,76,23,EDIGWAIITNLHILFAVAIGGSW,1
5iws,B,82,98,16,GAFAALLAFVLTNRIT,1
5iws,B,142,157,15,VFVGIITGFLGATLY,1
5iws,B,178,198,20,VPFVVIVWSTVTAIVLSLLW,1
5iws,B,308,322,14,GQVIGSTAALMGIA,1
5iws,B,367,383,16,LYVVYAITTGLAFALA,1
5iws,B,415,432,17,NFVIVSLVFFGLNFTLF,1
2nrg,A,31,56,25,GWAGGVFFGTLLLIGFFRVVGRMLP,1
2lkg,A,17,38,21,CVFDKICKIGTESVEAGRLIE,1
2lkg,A,47,68,21,GPLYFVVNVIEPCKKFSELTG,1
2lkg,A,82,103,21,ESKSVLKSLTEKLKKIVELIP,1
2lkg,A,109,129,20,PLIGKYMLFTKEFVESSIKI,1
3dts,H,16,32,16,IYSFWIFLAGLIYYLQ,1
1y5i,F,5,28,23,MFFFDIYPYIAGAVFLIGSWLRY,1
1y5i,F,48,72,24,NLASNLFHIGILGIFVGHFFGMLT,1
1y5i,F,87,114,27,KMAMFAGGASGVLCLIGGVLLLKRRLF,1
1y5i,F,125,145,20,DILILSLLVIQCALGLLTIP,1
1y5i,F,183,204,21,FRLHLVLGMTLFLLFPFSRLI,1
4dve,A,14,28,14,FMTAFIIILGFLPG,1
4dve,A,39,49,10,LQNMGIMMAG,1
4dve,A,57,72,15,TISVGAFLALALIGL,1
4dve,A,90,103,13,GYRIAWLFTPFLI,1
4dve,A,123,140,17,IVLLFGVIFVDFVGAIW,1
4dve,A,157,173,16,VFIPGDCIKAILTVVI,1
1n7l,A,28,50,22,LQNLFINFALILIFLLLIAIIV,1
3odu,B,40,60,20,LPTIYSIIFLTGIVGNGLVI,1
3odu,B,78,98,20,HLSVADLLFVITLPFWAVDA,1
3odu,B,103,131,28,FGNFLCKAVHVIYTVNLYSSVWILAFIS,1
3odu,B,157,176,19,VGVWIPALLLTIPDFIFAN,1
3odu,B,196,220,24,VVFQFQHIMVGLILPGIVILSCYC,1
3odu,B,242,261,19,ILILAFFACWLPYYIGISI,1
3odu,B,284,301,17,SITEALAFFHCCLNPIL,1
1y4z,F,5,28,23,MFFFDIYPYIAGAVFLIGSWLRY,1
1y4z,F,48,72,24,NLASNLFHIGILGIFVGHFFGMLT,1
1y4z,F,87,114,27,KMAMFAGGASGVLCLIGGVLLLKRRLF,1
1y4z,F,125,145,20,DILILSLLVIQCALGLLTIP,1
1y4z,F,183,204,21,FRLHLVLGMTLFLLFPFSRLI,1
2k73,A,13,34,21,AWLLMAFTALALELTALWFQH,1
2k73,A,41,62,21,VLSIYERAALFGVLGAALIGA,1
2k73,A,73,95,22,MVIWLYSAFRGVQLTYEHTMLQ,1
2k73,A,137,161,24,LGLEMPQWLLGIFIAYLIVAVLVV,1
3te0,E,25,47,22,KYLVSSAFAGLYVGIGILLIFT,1
3te0,E,63,79,16,MGLSFAIALSLVIMTG,1
3te0,E,105,129,24,KIWAYSWVGNLIGALVLGIIFVGT,1
3te0,E,154,177,23,ALFFRGILCNILVCVSVLCSFRT,1
3te0,E,180,197,17,TAKIIMIFLCLFAFITS,1
3te0,E,224,249,25,GAIYNLVAVTLGNIVGGALFMGLGT,1
1lly,A,30,47,17,WWNFGSLLAVCLMTQIL,1
1lly,A,88,104,16,SFFFICIFLHIGRGLY,1
1lly,A,114,128,14,NTGVILLLTLMATA,1
1lly,A,186,198,12,PFAIAGITIIHL,1
1lly,A,226,240,14,FKDILGLTLMLTPF,1
1lly,A,290,305,15,GVLALAASVLILFLI,1
1lly,A,324,337,13,LFWLLVANLLILT,1
1lly,A,351,367,16,GQMASLSYFTILLILF,1
4xp5,A,35,57,22,FLLSVIGFAVDLANVWRFPYLC,1
4xp5,A,61,84,23,GGAFLVPYGIMLAVGGIPLFYME,1
4xp5,A,110,136,26,YAVVLIAFYVDFYYNVIIAWSLRFFF,1
4xp5,A,236,255,19,WDMALCLLIVYLICYFSLW,1
4xp5,A,261,281,20,GKVVWFTALFPYAVLLILLI,1
4xp5,A,304,328,24,YKAEVWVDAATQVFFSLGPGFGVL,1
4xp5,A,345,363,18,LLTSFINSATSFIAGFVI,1
4xp5,A,409,430,21,FFMMLATLGLDSSFGGSEAII,1
4xp5,A,446,464,18,FVAGLFSLYFVVGLASCT,1
4xp5,A,468,492,24,YFFHLLDRYAAGYSILVAVFFEAI,1
4xp5,A,522,545,23,WRFVAPIFLLFITVYGLIGYEPL,1
4xp5,A,555,573,18,ANALGWCIAGSSVVMIPA,1
4xpt,A,35,57,22,FLLSVIGFAVDLANVWRFPYLC,1
4xpt,A,63,82,19,AFLVPYGIMLAVGGIPLFY,1
4xpt,A,113,133,20,VLIAFYVGFYYNVIIAWSLR,1
4xpt,A,238,255,17,MALCLLIVYLICYFSLW,1
4xpt,A,261,280,19,GKVVWFTALFPYAVLLILL,1
4xpt,A,302,328,26,AIYKAEVWVDAATQVFFSLGPGFGVL,1
4xpt,A,345,362,17,LLTSFINSATSFIAGFV,1
4xpt,A,410,429,19,FMMLATLGLDSSFGGMEAI,1
4xpt,A,449,464,15,GLFSLYFVVGLASCT,1
4xpt,A,468,489,21,YFFHLLDRYAAGYSILVAVFF,1
4xpt,A,526,545,19,APIFLLFITVYGLIGYEPL,1
4xpt,A,555,570,15,ANALGWCIAGSSVVM,1
4zit,C,12,26,14,WVIAIIIMLAGGLA,1
4zit,C,343,357,14,LVEAIILVFLVMYL,1
4zit,C,366,383,17,IPTIAVPVVLLGTFAVL,1
4zit,C,398,410,12,VLAIGLLVDDAI,1
4zit,C,443,455,12,GIAMVLSAVFVP,1
4zit,C,471,488,17,ITIVSAMALSVLVALIL,1
4zit,C,541,555,14,LVLYLIIVVGMAYL,1
4zit,C,878,891,13,ISLIVVFLCLAAL,1
4zit,C,898,916,18,FSVMLVVPLGVIGALLAA,1
4zit,C,930,943,13,LLTTIGLSAKNAI,1
4zit,C,976,991,15,MTSLAFILGVMPLVI,1
4zit,C,1005,1019,14,GVMGGMVTATVLAI,1
4zjo,C,12,28,16,WVIAIIIMLAGGLAIL,1
4zjo,C,341,357,16,KTLVEAIILVFLVMYL,1
4zjo,C,366,386,20,IPTIAVPVVLLGTFAVLAAF,1
4zjo,C,395,410,15,FGMVLAIGLLVDDAI,1
4zjo,C,443,458,15,GIAMVLSAVFVPMAF,1
4zjo,C,468,485,17,QFSITIVSAMALSVLVA,1
4zjo,C,542,558,16,VLYLIIVVGMAYLFVR,1
4zjo,C,874,891,17,SLYAISLIVVFLCLAAL,1
4zjo,C,898,919,21,FSVMLVVPLGVIGALLAATFR,1
4zjo,C,927,943,16,QVGLLTTIGLSAKNAI,1
4zjo,C,976,992,16,MTSLAFILGVMPLVIS,1
4zjo,C,1001,1018,17,AVGTGVMGGMVTATVLA,1
4hwl,A,9,31,22,WIWLALGTALMGLGTLYFLVKG,1
4hwl,A,43,67,24,AITTLVPAIAFTMYLSMLLGYGLT,1
4hwl,A,79,98,19,WARYADWLFTTPLLLLDLA,1
4hwl,A,106,128,22,TILALVGADGIMIGTGLVGALT,1
4hwl,A,134,157,23,FVWWAISTAAMLYILYVLFFGFT,1
4hwl,A,171,195,24,KVLRNVTVVLWSAYPVVWLIGSEG,1
4hwl,A,202,225,23,IETLLFMVLDVSAKVGFGLILLR,1
5iou,D,551,571,20,WVMMFVMLLIVSAVAVFVFE,1
5iou,D,608,626,18,TTSKIMVSVWAFFAVIFL,1
5iou,D,804,821,17,FYMLAAAMALSLITFIM,1
1nw0,B,23,42,19,SSILVFFGVAAFAHLLVWI,1
2kwx,D,25,48,23,LAVAASIIGILHLILWILDRLFF,1
3ar6,A,54,74,20,QFEDLLVRILLLAACISFVL,1
3ar6,A,90,111,21,FVILLILIANAIVGVWQERNA,1
3ar6,A,253,276,23,EFGEQLSKVISLICVAVWLINIG,1
3ar6,A,296,318,22,IAVALAVAAIPEGLPAVITTCL,1
3ar6,A,758,783,25,FIRYLISSNVGEVVCIFLTAALGLP,1
3ar6,A,786,809,23,IPVQLLWVNLVTDGLPATALGFN,1
3ar6,A,833,854,21,FRYMAIGGYVGAATVGAAAWW,1
3ar6,A,898,917,19,ALSVLVTIEMCNALNSLSE,1
3ar6,A,927,950,23,VNIWLLGSICLSMSLHFLILYVD,1
3ar6,A,965,987,22,WLMVLKISLPVIGLDEILKFIA,1
4cjz,C,31,47,16,RQEGVAVLLAVVIACW,1
4cjz,C,53,69,16,TRVLLISSVMLVMIVE,1
4cjz,C,100,116,16,VLIAIIDAVITWCILL,1
5br5,C,10,33,23,IWLALGTALMGLGTLYFLVKGMG,1
5br5,C,41,62,21,FYAITTLVPAIAFTMYLSMLL,1
5br5,C,79,100,21,WARYADWLFTTPLLLLDLALL,1
5br5,C,106,128,22,TILALVGADGIMIGTGLVGALT,1
5br5,C,134,156,22,FVWWAISTAAMLYILYVLFFGF,1
5br5,C,171,192,21,KVLRNVTVVLWSAYPVVWLIG,1
5br5,C,203,226,23,ETLLFMVLDVSAKVGFGLILLRS,1
1kg9,C,11,31,20,WLALGTALMGLGTLYFLVKG,1
1kg9,C,44,62,18,ITTLVPAIAFTMYLSMLL,1
1kg9,C,80,97,17,ARYADWLFTTPLLLLDL,1
1kg9,C,108,127,19,LALVGADGIMIGTGLVGAL,1
1kg9,C,134,153,19,FVWWAISTAAMLYILYVLF,1
1kg9,C,174,192,18,RNVTVVLWSAYPVVWLIG,1
1kg9,C,204,224,20,TLLFMVLDVSAKVGFGLILL,1
2ndj,A,49,78,29,LPGRDDNSYMYILFVMFLFAVTVGSLILG,1
3j5r,D,433,454,21,FYFNFFVYCLYMIIFTAAAYY,1
3j5r,D,474,497,23,VTGEILSVSGGVYFFFRGIQYFL,1
3j5r,D,511,532,21,SEILFFVQSLFMLVSVVLYFS,1
3j5r,D,537,557,20,VASMVFSLAMGWTNMLYYTR,1
3j5r,D,566,598,32,VMIEKMILRDLCRFMFVYLVFLFGFSTAVVTL,1
3j5r,D,658,682,24,FIILLLAYVILTYILLLNMLIALM,1
4hyg,A,11,27,16,MPLMLLFVQIIAIVLV,1
4hyg,A,45,61,16,NPLIFIGMLLAFTLVL,1
4hyg,A,76,92,16,IGFALFMTFLYIFGAL,1
4hyg,A,105,119,14,GTLIGAVAVTALLY,1
4hyg,A,126,145,19,IDILGVLISAGVASIFGIS,1
4hyg,A,149,164,15,PVLVLLVLLAVYDAI,1
4hyg,A,215,230,15,MGMGDLIMPSILVVS,1
4hyg,A,249,262,13,GAMVGSLVGLAVL,1
4hyg,A,275,289,14,PPLNGGAILGFLVG,1
4dop,I,16,32,16,LMGALFLSIWGTWTII,1
4dop,I,339,356,17,GKLLEEFIVVAVVCALF,1
4dop,I,364,384,20,VAIISLPLGLCIAFIVMHFQ,1
4dop,I,393,409,16,GGIAIAVGAMVDAAIV,1
4dop,I,451,466,15,ISLLIITLSFIPIFT,1
4dop,I,478,497,19,AFTKTYAMAGAALLAIVVI,1
4dop,I,540,555,15,LVAALSVLTVLWPLN,1
4dop,I,873,890,17,LMVPMTLMIIFVLLYLA,1
4dop,I,898,918,20,LIISSVPFALVGGIWLLWWM,1
4dop,I,927,943,16,TGFIALAGVAAEFGVV,1
4dop,I,985,1000,15,MTVAVIIAGLLPILW,1
4dop,I,1010,1028,18,RIAAPMIGGMITAPLLSL,1
5kxi,E,219,231,12,CVLITSLAILVF,1
5kxi,E,241,252,11,TLCISVLLALT,1
5kxi,E,276,291,15,MFTMVLVTFSIVTSV,1
5kxi,E,354,368,14,WIFVFVCVFGTIGM,1
4j72,B,25,41,16,SFTAVLIAFFLTLVLS,1
4j72,B,78,93,15,IVILIVVTLSTLLLM,1
4j72,B,101,117,16,VVLLSFLSFGTIGFWD,1
4j72,B,131,145,14,TKFLLQVLSASLIS,1
4j72,B,176,193,17,FAVFVIVGSANAVNLTD,1
4j72,B,199,213,14,IGPAMTTATALGVV,1
4j72,B,238,253,15,VFCFALVGAGLGFLW,1
4j72,B,264,280,16,DVGSLSIGASLATVAL,1
4j72,B,285,304,19,FIFAVAAGVFVFETISVIL,1
4j72,B,340,355,15,MWIISILLAIIAISM,1
3jcu,z,8,24,16,VFALIATSSILLISVP,1
3jcu,z,40,55,15,FSGTSLWLGLVFLVG,1
4dnt,I,16,32,16,LMGALFLSIWGTWTII,1
4dnt,I,339,355,16,GKLLEEFIVVAVVCAL,1
4dnt,I,364,384,20,VAIISLPLGLCIAFIVMHFQ,1
4dnt,I,393,408,15,GGIAIAVGAMVAAAI,1
4dnt,I,451,466,15,ISLLIITLSFIPIFT,1
4dnt,I,478,497,19,AFTKTYAMAGAALLAIVVI,1
4dnt,I,540,555,15,LVAALSVLTVLWPLN,1
4dnt,I,873,890,17,LMVPMTLMIIFVLLYLA,1
4dnt,I,898,918,20,LIISSVPFALVGGIWLLWWM,1
4dnt,I,927,943,16,TGFIALAGVAAEFGVV,1
4dnt,I,985,1000,15,MTVAVIIAGLLPILW,1
4dnt,I,1010,1028,18,RIAAPMIGGMITAPLLSL,1
4z3p,A,33,53,20,RMALPMFVGMLTQVTYAIAD,1
4z3p,A,75,94,19,PVGMGLFAIANGIQIGMGS,1
4z3p,A,116,134,18,IIALFFAIVITVLGYVYA,1
4z3p,A,155,176,21,YYSLLTVFSIMLIGVMMGLFQ,1
4z3p,A,182,202,20,VIMKASLLGALVNIMLDPIM,1
4z3p,A,212,231,19,VALASFLAQLSMVAYFIYT,1
4z3p,A,257,277,20,SVGMAQMLMQLIIAVGIVIY,1
4z3p,A,296,314,18,RIDYFIITPMLAIATALL,1
4z3p,A,334,355,21,AAVALAFSIVLVLAVMHIVLA,1
4z3p,A,376,397,21,RIMALALPFVAISLLASEYYQ,1
4z3p,A,402,424,22,WYSVLLTLMRHVFISVPVVYLL,1
4z3p,A,435,453,18,YFGAMSGTFVAALLAWRL,1
4tkr,A,10,29,19,ECAIFAAVAMVLSFIPLDI,1
4tkr,A,34,46,12,ISLGMIPMYVIA,1
4tkr,A,52,71,19,AAGFAGLLWGLLHFLTGKA,1
4tkr,A,78,95,17,AIIEYILAFSFIAFSGV,1
4tkr,A,117,135,18,GTMIIGGVARYFWHYVAG,1
4tkr,A,154,175,21,VMNGASCLGTVLVSGIIISIL,1
2i5n,M,52,70,18,ASGIAAFAFGSTAILIIL,1
2i5n,M,116,132,16,GLFMTLSLGSWWIRVY,1
2i5n,M,144,162,18,AWNFAAAIFFVLCIGCIH,1
2i5n,M,198,218,20,WHGFSIGFAYGCGLLFAAHG,1
2i5n,M,267,284,17,WFFSLMVMVSASVGILL,1
2yfy,A,57,75,18,EDLLVRILLLAACISFVL,1
2yfy,A,89,104,15,EPFVILLILIANAIV,1
2yfy,A,257,276,19,EQLSKVISLICVAVWLINI,1
2yfy,A,296,314,18,KIAVALAVAAIPEGLPAV,1
2yfy,A,761,781,20,RYLISSNVGEVVCIFLTAAL,1
2yfy,A,787,807,20,IPVQLLWVNLVTDGLPATAL,1
2yfy,A,834,851,17,FRYMAIGGYVGAATVGA,1
2yfy,A,901,916,15,SVLVTIEMCNALNSL,1
2yfy,A,922,947,25,MRMPPWVNIWLLGSICLSMSLHFLI,1
2yfy,A,971,987,16,KISLPVIGLDEILKFI,1
2n02,A,7,28,21,AVGLTLVPSLGGFMGAYFVRG,1
2n02,A,41,64,23,WHPPRWTLAPIWGTLYSAMGYGS,1
2n02,A,82,102,20,GLYTGQLALNWAWPPIFFGA,1
2n02,A,107,128,21,ALADLLLVSGVATATTLAWHR,1
2n02,A,134,153,19,RLLYPYLAWLAFTTVLNYY,1
1kg8,C,11,32,21,WLALGTALMGLGTLYFLVKGM,1
1kg8,C,42,62,20,YAITTLVPAIAFTMYLSMLL,1
1kg8,C,80,98,18,ARYADWLFTTPLLLLDLA,1
1kg8,C,107,127,20,ILALVGADGIMIGTGLVGAL,1
1kg8,C,134,155,21,FVWWAISTAAMLYILYVLFFG,1
1kg8,C,173,192,19,LRNVTVVLWSAYPVVWLIG,1
1kg8,C,204,225,21,TLLFMVLDVSAKVGFGLILLR,1
4ja4,A,12,33,21,ITLVATLGGLLFGYDTAVISG,1
4ja4,A,59,75,16,CVASALIGCIIGGALG,1
4ja4,A,86,105,19,SLKIAAVLFFISGVGSAWP,1
4ja4,A,127,148,21,EFVIYRIIGGIGVGLASMLSP,1
4ja4,A,165,182,17,FNQFAIIFGQLLVYCVN,1
4ja4,A,203,220,17,ASECIPALLFLMLLYTV,1
4ja4,A,280,300,20,GVMLSIFQQFVGINVVLYYA,1
4ja4,A,318,336,18,IIVGVINLTFTVLAIMTV,1
4ja4,A,343,361,18,LQIIGALGMAIGMFSLGT,1
4ja4,A,373,392,19,LSMLFYVAAFAMSWGPVCW,1
4ja4,A,410,429,19,AVAAQWLANYFVSWTFPMM,1
4ja4,A,444,462,18,YWIYGCMGVLAALFMWKF,1
3ar7,A,57,77,20,DLLVRILLLAACISFVLAWF,1
3ar7,A,87,104,17,VEPFVILLILIANAIVG,1
3ar7,A,260,279,19,KVISLICVAVWLINIGHFN,1
3ar7,A,293,314,21,YFKIAVALAVAAIPEGLPAVI,1
3ar7,A,761,783,22,YLISSNVGEVVCIFLTAALGLP,1
3ar7,A,786,807,21,IPVQLLWVNLVTDGLPATALG,1
3ar7,A,835,852,17,YMAIGGYVGAATVGAAA,1
3ar7,A,898,916,18,ALSVLVTIEMCNALNSLS,1
3ar7,A,931,950,19,LLGSICLSMSLHFLILYVD,1
3ar7,A,968,987,19,VLKISLPVIGLDEILKFIA,1
1rh5,C,33,50,17,IGVTVAFVIIEAILTYG,1
2w0f,F,26,50,24,RAAGAATVLLVIVLLAGSYLAVLA,1
2w0f,F,87,111,24,GRCVAVVVMVAGITSFGLVTAALA,1
4zj8,A,45,69,24,EWVLIAAYVAVFVVALVGNTLVCL,1
4zj8,A,85,108,23,VNLSLADVLVTAICLPASLLVDI,1
4zj8,A,118,141,23,CKVIPYLQAVSVSVAVLTLSFIA,1
4zj8,A,163,183,20,SILGIWAVSLAIMVPQAAVM,1
4zj8,A,211,234,23,PKIYHSCFFIVTYLAPLGLMAMA,1
4zj8,A,302,324,22,VLLVFALCYLPISVLNILKRVF,1
4zj8,A,336,358,22,YACFTFSHWLVYANSAANPIIY,1
2ez0,B,37,61,24,MAAVVGTLVGLAAVAFDKGVAWLQ,1
2ez0,B,84,97,13,CSAVLAMFGYFLV,1
2ez0,B,128,142,14,PVKFFGGLGTLGGG,1
2ez0,B,144,159,15,LGRQGPTVQIGGNIG,1
2ez0,B,216,232,16,AVFIGVIMSTIMYRIF,1
2ez0,B,253,277,24,LYLILGIIFGIFGPIFNKWVLGMQ,1
2ez0,B,290,305,15,WVLMGGAIGGLCGLL,1
2ez0,B,337,351,14,VARVITTLLCFSSG,1
2ez0,B,353,368,15,GGIFAPMLALGTVLG,1
2ez0,B,422,439,17,LPMIITGLGATLLAQFT,1
2w1b,C,11,27,16,AWVIAIIIMLAGGLAI,1
2w1b,C,341,357,16,KTLVEAIILVFLVMYL,1
2w1b,C,366,386,20,IPTIAVPVVLLGTFAVLAAF,1
2w1b,C,395,410,15,FGMVLAIGLLVDDAI,1
2w1b,C,443,457,14,GIAMVLSAVFVPMA,1
2w1b,C,471,489,18,ITIVSAMALSVLVALILT,1
2w1b,C,543,558,15,LYLIIVVGMAYLFVR,1
2w1b,C,875,890,15,LYAISLIVVFLCLAA,1
2w1b,C,899,919,20,SVMLVVPLGVIGALLAATFR,1
2w1b,C,928,943,15,VGLLTTIGLSAKNAI,1
2w1b,C,976,992,16,MTSLAFILGVMPLVIS,1
2w1b,C,1002,1018,16,VGTGVMGGMVTATVLA,1
4xpb,A,35,57,22,FLLSVIGFAVDLANVWRFPYLC,1
4xpb,A,63,82,19,AFLVPYGIMLAVGGIPLFY,1
4xpb,A,113,133,20,VLIAFYVGFYYNVIIAWSLR,1
4xpb,A,238,255,17,MALCLLIVYLICYFSLW,1
4xpb,A,261,280,19,GKVVWFTALFPYAVLLILL,1
4xpb,A,304,328,24,YKAEVWVDAATQVFFSLGPGFGVL,1
4xpb,A,346,362,16,LTSFINSATSFIAGFV,1
4xpb,A,409,429,20,FFMMLATLGLDSSFGGMEAI,1
4xpb,A,449,464,15,GLFSLYFVVGLASCT,1
4xpb,A,468,489,21,YFFHLLDRYAAGYSILVAVFF,1
4xpb,A,526,545,19,APIFLLFITVYGLIGYEPL,1
4xpb,A,554,570,16,WANALGWCIAGSSVVM,1
1ntk,K,22,38,16,LWGAVGAVGLVWATDW,1
2exy,B,37,61,24,MAAVVGTLVGLAAVAFDKGVAWLQ,1
2exy,B,81,97,16,AFLCSAVLAMFGYFLV,1
2exy,B,128,142,14,PVKFFGGLGTLGGG,1
2exy,B,144,159,15,LGRQGPTVQIGGNIG,1
2exy,B,216,232,16,AVFIGVIMSTIMYRIF,1
2exy,B,253,277,24,LYLILGIIFGIFGPIFNKWVLGMQ,1
2exy,B,290,305,15,WVLMGGAIGGLCGLL,1
2exy,B,337,351,14,VARVITTLLCFSSG,1
2exy,B,353,368,15,GGIFAPMLALGTVLG,1
2exy,B,422,439,17,LPMIITGLGATLLAQFT,1
3j9p,C,720,740,20,MNLGSYCLGLIPMTILVVNI,1
3j9p,C,769,785,16,IKTCMILVFLSSIFGY,1
3j9p,C,804,824,20,NVLEWIIYTTGIIFVLPLFV,1
3j9p,C,831,852,21,WQCGAIAVYFYWMNFLLYLQR,1
3j9p,C,860,892,32,VMLEVILKTLLRSTVVFIFLLLAFGLSFYILL,1
3j9p,C,934,961,27,VLSFAQLVSFTIFVPIVLMNLLIGLAV,1
4fxz,B,14,35,21,ILAMAGNAVGLGNFLRFPVQA,1
4fxz,B,42,63,21,FMIPYIIAFLLVGIPLMWIEW,1
4fxz,B,89,124,35,AKILGVFGLWIPLVVAIYYVYIESWTLGFAIKFLV,1
4fxz,B,167,185,18,AYIVFLITMFINVSILIR,1
4fxz,B,191,214,23,ERFAKIAMPTLFILAVFLVIRVF,1
4fxz,B,242,265,23,VWIAAVGQIFATLSLGFGAIITY,1
4fxz,B,278,298,20,GLTAATLNEKAEVILGGSIS,1
4fxz,B,340,367,27,GFLWFFLLFFAGLTSSIAIMQPMIAFL,1
4fxz,B,377,396,19,AVLWTAAIVFFSAHLVMFL,1
4fxz,B,400,425,25,DEMDFWAGTIGVVFFGLTELIIFFW,1
4fxz,B,445,472,27,RIYYYVMRYITPAFLAVLLVVWAREYI,1
4fxz,B,484,502,18,ITRFYIIGLFLFLTFLVF,1
3te1,E,28,48,20,VSSAFAGLYVGIGILLIFTI,1
3te1,E,62,79,17,VMGLSFAIALSLVIMTG,1
3te1,E,105,129,24,KIWAYSWVGNLIGALVLGIIFVGT,1
3te1,E,154,174,20,ALFFRGILCNILVCVSVLCS,1
3te1,E,181,198,17,AKIIMIFLCLFAFITSG,1
3te1,E,224,249,25,GAIYNLVAVTLGNIVGGALFMGLGT,1
4xp4,A,31,53,22,GKVDFLLSVIGFAVDLANVWRF,1
4xp4,A,66,89,23,VPYGIMLAVGGIPLFYMELALGQ,1
4xp4,A,109,132,23,GYAVVLIAFYVDFYYNVIIAWSL,1
4xp4,A,238,258,20,MALCLLIVYLICYFSLWKGI,1
4xp4,A,260,277,17,SGKVVWFTALFPYAVLL,1
4xp4,A,308,335,27,VWVDAATQVFFSLGPGFGVLLAYASYN,1
4xp4,A,340,359,19,VYKDALLTSFINSATSFIA,1
4xp4,A,412,433,21,MLATLGLDSSFGGSEAIITAL,1
4xp4,A,445,464,19,LFVAGLFSLYFVVGLASCT,1
4xp4,A,470,496,26,FHLLDRYAAGYSILVAVFFEAIAVSW,1
4xp4,A,516,545,29,RYWQVCWRFVAPIFLLFITVYGLIGYEPL,1
4xp4,A,554,574,20,WANALGWCIAGSSVVMIPAV,1
4x32,C,12,28,16,LALGTALMGLGTLYFL,1
4x32,C,47,61,14,LVPAIAFTMYLSML,1
4x32,C,80,94,14,ARYADWLFTTPLLL,1
4x32,C,111,126,15,VGADGIMIGTGLVGA,1
4x32,C,135,150,15,VWWAISTAAMLYILY,1
4x32,C,178,192,14,VVLWSAYPVVWLIG,1
4x32,C,204,220,16,TLLFMVLDVSAKVGFG,1
3hb3,B,35,55,20,HFVLYIITAVTIFVCLLLLI,1
3hb3,B,78,97,19,VIWTLVPVLILVAIGAFSL,1
2wsw,C,15,29,14,FPPLIIVGILCWLT,1
2wsw,C,47,64,17,TNVWGWAFEWYMVIMFG,1
2wsw,C,96,109,13,ASCTSAAVLFWGS,1
2wsw,C,134,150,16,LAYSLFHWGPLPWATY,1
2wsw,C,192,216,24,DNFYLVALILAMGTSLGLATPLVT,1
2wsw,C,233,248,15,IIISCWILLNAICVA,1
2wsw,C,255,278,23,KIASDVRTYLSFLMLGWVFIVGG,1
2wsw,C,314,331,17,AWTVFYWAWWVIYAIQM,1
2wsw,C,353,369,16,GLTAGTWLIWTILGGN,1
2wsw,C,407,431,24,MWGFFILCFIATVTLINACSYTLA,1
2wsw,C,447,463,16,VRIGWSVLVGIIGIIL,1
2wsw,C,472,488,16,QTAIIAGGCPLFFVNI,1
5kc4,A,8,28,20,FVGIFSALATLVMFLEFPIF,1
5kc4,A,35,48,13,YDPSEIPALIVSF,1
5kc4,A,52,71,19,GVGMFVVLVKDILFFLMKS,1
5kc4,A,77,94,17,AMNAVLGMSFVGIAGLI,1
5kc4,A,106,123,17,GMIVATLFATAFALGLN,1
5kc4,A,144,162,18,ILAFNLVKFGIDSVVTFF,1
4qnz,A,92,108,16,AGPVTWVMMIACVVVF,1
4qnz,A,149,166,17,HILFNLLWWWYLGGAVE,1
4qnz,A,172,189,17,KLIVITLISALLSGYVQ,1
4qnz,A,199,213,14,LSGVVYALMGYVWL,1
4qnz,A,226,242,16,RGLIIFALIWIVAGWF,1
4qnz,A,251,267,16,GAHIAGLAVGLAMAFV,1
5k47,D,221,242,21,RELVTYLLFLIVLCILTYGMM,1
5k47,D,470,496,26,FFLAACEIIFCFFIFYYVVEEILEIR,1
5k47,D,503,528,25,RSFWNCLDVVIVVLSVVAIGINIYR,1
5k47,D,557,578,21,FNNIAAVTVFFVWIKLFKFIN,1
5k47,D,594,620,26,KDLFGFAIMFFIIFLAYAQLAYLVFG,1
5k47,D,654,681,27,VLGPIYFTTFVFFMFFILLNMFLAIIN,1
4xe5,G,16,32,16,GGLIFAALAFIVGLVI,1
3dtr,H,13,32,19,SLAIYSFWIFLAGLIYYLQ,1
4ogq,P,2,22,20,AIVAYIGFLALFTGIAAGLL,1
3vi0,C,10,30,20,IWLALGTALMGLGTLYFLVK,1
3vi0,C,44,62,18,ITTLVPAIAFTMYLSMLL,1
3vi0,C,79,96,17,WARYADWLFTTPLALLD,1
3vi0,C,109,128,19,ALVGADGIMIGTGLVGALT,1
3vi0,C,134,153,19,FVWWAISTAAMLYILYVLF,1
3vi0,C,175,192,17,NVTVVLWSAYPVVWLIG,1
3vi0,C,203,222,19,ETLLFMVLDVSAKVGFGLI,1
1ih5,D,12,32,20,AVVAEFLATTLFVFISIGSA,1
1ih5,D,48,65,17,NVKVSLAFGLSIATLAQ,1
1ih5,D,95,114,19,MYIIAQCVGAIVATAILSG,1
1ih5,D,140,156,16,IEIIGTLQLVLCVLAT,1
1ih5,D,168,185,17,PLAIGLSVALGHLLAID,1
1ih5,D,210,229,19,IFWVGPFIGGALAVLIYDF,1
1kp1,A,48,69,21,YSLVFIFGFVGNMLVVLILIN,1
1kp1,A,77,99,22,DIYLLNLAISDLLFLITLPLWA,1
1kp1,A,115,136,21,FTGLYHIGYFGGIFFIILLTI,1
1kp1,A,158,177,19,VTSVITWLVAVFASVPGII,1
1kp1,A,201,223,22,HTIMRNILGLVLPLLIMVICYS,1
1kp1,A,245,265,20,FTIMIVYFLFWTPYNIVILL,1
1kp1,A,298,317,19,CINPIIYAFVGEKFRRYLS,1
3f7v,F,33,50,17,VLLVIVLLAGSYLAVLA,1
3f7v,F,87,107,20,GRCVAVVVMVAGITSFGLVT,1
5b0w,D,37,57,20,LYINIALAGLSILLFVFMTR,1
5b0w,D,66,87,21,IAVSTILVPVVSIASYTGLAS,1
5b0w,D,121,141,20,GRYLTWALSTPMILLALGLL,1
5b0w,D,147,168,21,KLFTAITFDIAMCVTGLAAAL,1
5b0w,D,175,199,24,RWFWYAISCACFIVVLYILLVEWA,1
5b0w,D,211,232,21,STLKLLTVVMWLGYPIVWALG,1
5b0w,D,244,268,24,SWAYSALDIVAKYIFAFLLLNYLT,1
4jtc,B,164,188,24,IAIVSVMVILISIVSFCLETLPIF,1
4jtc,B,207,217,10,STIGYQQSTS,1
4jtc,B,219,242,23,DPFFIVETLCIIWFSFEFLVRFF,1
4jtc,B,252,277,25,NIMNIIDIVAIIPYYVTIFLTESNK,1
4jtc,B,285,307,22,RRVVQIFRIMRILRIFKLSRHS,1
4jtc,B,321,348,27,RELGLLIFFLFIGVILFSSAVYFAEAD,1
4jtc,B,353,370,17,FPSIPDAFWWAVVSMTT,1
4jtc,B,381,402,21,GGKIVGSLCAIAGVLTIALPV,1
4h9l,H,12,28,16,ASLAIYSFWIFLAGLI,1
3qbg,D,37,57,20,LYINIALAGLSILLFVFMTR,1
3qbg,D,66,87,21,IAVSTILVPVVSIASYTGLAS,1
3qbg,D,121,141,20,GRYLTWALSTPMILLALGLL,1
3qbg,D,147,168,21,KLFTAITFDIAMCVTGLAAAL,1
3qbg,D,176,199,23,WFWYAISCACFIVVLYILLVEWA,1
3qbg,D,211,232,21,STLKLLTVVMWLGYPIVWALG,1
3qbg,D,244,267,23,SWAYSALDIVAKYIFAFLLLNYL,1
2nrf,C,96,114,18,TWVMMIACVVVFIAMQIL,1
2nrf,C,140,163,23,HALMHFSLMHILFNLLWWWYLGG,1
2nrf,C,174,191,17,IVITLISALLSGYVQQK,1
2nrf,C,198,213,15,GLSGVVYALMGYVWL,1
2nrf,C,226,247,21,RGLIIFALIWIVAGWFDLFGM,1
2nrf,C,249,267,18,ANGAHIAGLAVGLAMAFV,1
5iwr,D,327,349,22,FCVLGAIYVLYIICFTMCCVYR,1
5iwr,D,383,408,25,RLVGELVSIVGAVIILLVEIPDIFR,1
5iwr,D,422,443,21,PFHVIIVTYAFMVLVTMVMRL,1
5iwr,D,449,470,21,VVPMSFALVLGWCNVMYFARG,1
5iwr,D,486,511,25,GDLMRFCWQMAVVILGFASAFYIIF,1
5iwr,D,552,576,24,MYSITYAAFAIIATLLMLNLLIAM,1
2ypt,A,19,37,18,FGAVLLFSWTVYLWETFL,1
2ypt,A,80,102,22,SGLYSETEGTLILLFGGIPYLW,1
2ypt,A,120,141,21,TQSLVFLLLATLFSALAGLPW,1
2ypt,A,168,189,21,KKFVVTQCILLPVSSLLLYII,1
2ypt,A,196,215,19,FIYAWLFTLVVSLVLVTIY,1
2ypt,A,347,367,20,NIIISQMNSFLCFFLFAVLI,1
2ypt,A,384,410,26,LIGLLIIFQFIFSPYNEVLSFCLTVL,1
3qak,A,7,25,18,VYITVELAIAVLAILGNV,1
3qak,A,49,67,18,AADIAVGVLAIPFAITIS,1
3qak,A,76,96,20,CLFIACFVLVLTQSSIFSLL,1
3qak,A,127,145,18,CWVLSFAIGLTPMLGWNN,1
3qak,A,172,194,22,PMNYMVYFNFFACVLVPLLLML,1
3qak,A,238,259,21,VGLFALCWLPLHIINCFTFFC,1
3qak,A,266,286,20,LWLMYLAIVLSHTNSVVNPF,1
3syo,D,80,116,36,DIFTTLVDLKWRFNLLIFVMVYTVTWLFFGMIWWLI,1
3syo,D,168,197,29,GIILLLIQSVLGSIVNAFMVGCMFVKISQ,1
4f4s,T,13,33,20,ISTIGLLGAGIGIAIVFAAL,1
4f4s,T,49,71,22,MAILGFALSEATGLFCLMVSFL,1
4mrr,B,34,58,24,LRRRVVGAILMVLLGKATTLALPF,1
4mrr,B,86,108,22,YALGRFSGVLFDNLRNIVFERV,1
4mrr,B,155,177,22,YFLLFNIAPTVIELTAVIVIFW,1
4mrr,B,183,206,23,LVTATILAVIAYVWTTRTITEWR,1
4mrr,B,263,284,21,SLGLLNIAQALIVNLLMAGAM,1
4mrr,B,304,325,21,NTYLTQLFRPLDMLGMVYRTI,1
3uty,A,10,32,22,IWLALGTALMGLGTLYFLVKGM,1
3uty,A,42,66,24,YAIATLVAAIAFTMYLSMLLGYGL,1
3uty,A,79,99,20,WARYADWLFTTPLLLLDLAL,1
3uty,A,104,127,23,QGTILALVGADGIMIGTGLVGAL,1
3uty,A,134,157,23,FVWWAISTAAMLYILYVLFFGFT,1
3uty,A,171,195,24,KVLRNVTVVLWSAYPVVWLIGSEG,1
3uty,A,202,225,23,IETLLFMVLDVSAKVGFGLILLR,1
2zbd,A,61,77,16,RILLLAACISFVLAWF,1
2zbd,A,86,102,16,FVEPFVILLILIANAI,1
2zbd,A,257,274,17,QLSKVISLICVAVWLIN,1
2zbd,A,296,311,15,IAVALAVAAIPEGLP,1
2zbd,A,761,777,16,YLISSNVGEVVCIFLT,1
2zbd,A,788,806,18,VQLLWVNLVTDGLPATAL,1
2zbd,A,832,851,19,FFRYMAIGGYVGAATVGAA,1
2zbd,A,899,916,17,LSVLVTIEMCNALNSLS,1
2zbd,A,933,950,17,GSICLSMSLHFLILYVD,1
2zbd,A,968,988,20,VLKISLPVIGLDEILKFIAR,1
5jdq,A,8,27,19,FLLGLILLYYGSDWFVLGS,1
5jdq,A,40,57,17,IGATVMAIGTSLPEILT,1
5jdq,A,74,93,19,IGSCICNIGLVLGLSAIIS,1
5jdq,A,105,120,15,LVYLLFVIFAAVIGI,1
5jdq,A,126,142,16,DGVVLLILFIIYLRWT,1
5jdq,A,166,183,17,LLIIGLIGVLVGAELFV,1
5jdq,A,207,222,15,GTSLPELMVSLAAAK,1
5jdq,A,229,247,18,LGNVIGSNIADIGGALAV,1
5jdq,A,259,275,16,QMAVLVIMSLLLYLFA,1
5jdq,A,281,296,15,RWQGILFLALYIIAI,1
1x0s,C,12,29,17,LALGTALMGLGTLYFLV,1
1x0s,C,45,61,16,TTLVPAIAFTMYLSML,1
1x0s,C,80,95,15,ARYADWLFTTPLLLL,1
1x0s,C,110,126,16,LVGADGIMIGTGLVGA,1
1x0s,C,135,153,18,VWWAISTAAMLYILYVLF,1
1x0s,C,175,192,17,NVTVVLWSAYPVVWLIG,1
1x0s,C,204,222,18,TLLFMVLDVSAKVGFGLI,1
5jdf,A,5,24,19,VGYFLLGLILLYYGSDWFV,1
5jdf,A,40,58,18,IGATVMAIGTSLPEILTS,1
5jdf,A,72,92,20,NAIGSCICNIGLVLGLSAII,1
5jdf,A,104,120,16,ILVYLLFVIFAAVIGI,1
5jdf,A,127,143,16,GVVLLILFIIYLRWTV,1
5jdf,A,166,186,20,LLIIGLIGVLVGAELFVDGA,1
5jdf,A,205,222,17,AFGTSLPELMVSLAAAK,1
5jdf,A,229,247,18,LGNVIGSNIADIGGALAV,1
5jdf,A,259,275,16,QMAVLVIMSLLLYLFA,1
5jdf,A,281,299,18,RWQGILFLALYIIAIASL,1
5m7k,D,13,33,20,QLVWYAQWLVIWTVVLLYLR,1
4phz,G,25,39,14,IGLVLLNVFYLIVR,1
4phz,G,65,79,14,LWTEIPLELVSGLG,1
4phz,G,112,126,14,VYGIAIYWGASFFT,1
4phz,G,148,162,14,EFYMSYPIYSVIAV,1
4phz,G,185,196,11,VAIGPFMIIPN,1
3wmn,0,29,41,12,GLVVIAHLLAWL,1
3n8g,A,55,78,23,QFEDLLVRILLLAACISFVLAWF,1
3n8g,A,86,104,18,AFVEPFVILLILIANAIV,1
3n8g,A,257,275,18,EQLSKVISLICVAVWLIN,1
3n8g,A,294,313,19,YFKIAVALAVAAIPEGLPA,1
3n8g,A,760,781,21,IRYLISSNVGEVVCIFLTAAL,1
3n8g,A,787,807,20,IPVQLLWVNLVTDGLPATAL,1
3n8g,A,832,852,20,LFFRYMAIGGYVGAATVGAA,1
3n8g,A,898,916,18,MALSVLVTIEMCNALNSL,1
3n8g,A,932,950,18,LLGSICLSMSLHFLILYV,1
3n8g,A,964,987,23,TQWLMVLKISLPVIGLDEILKFI,1
4ux2,B,38,58,20,WISLYYVAFYVVMSGIFALC,1
5jki,A,2,20,18,KPVSLFLFFLILAAAIHT,1
5jki,A,45,71,26,MTGITHLGASSFLLPLIVIIGAGMFF,1
5jki,A,77,99,22,GLLMLLVFGTDRLLNKVLKEWI,1
5jki,A,117,137,20,PSGHSMNAACVYPVIAYFLV,1
5jki,A,149,167,18,VYIIAGVIAVLVGISRVY,1
5jki,A,172,193,21,VTDVLGGFSLGLLLFFLVKGF,1
4pgu,A,17,38,21,TVFVFTLLIATVGLFIGQFVP,1
4pgu,A,42,61,19,LPLSILEVAMIILAFWMRR,1
4pgu,A,68,86,18,FVYTFAFVSGITLFPIVS,1
4pgu,A,96,116,20,VLEAFGSTFVIFAVLGTIGA,1
4pgu,A,123,144,21,FLWSFLLVAVLALAVVGIFNI,1
4pgu,A,156,174,18,SVIGTIVFSLYILYDLNQ,1
4pgu,A,187,207,20,MALSLYLDFINLFINLLRFF,1
3w5b,A,48,70,22,LWELVIEQFEDLLVRILLLAAC,1
3w5b,A,91,108,17,FVILLILIANAIVGVWQ,1
3w5b,A,257,274,17,EQLSKVISLICVAVWLI,1
3w5b,A,296,311,15,KIAVALAVAAIPEGL,1
3w5b,A,761,781,20,RYLISSNVGEVVCIFLTAAL,1
3w5b,A,786,807,21,LIPVQLLWVNLVTDGLPATAL,1
3w5b,A,832,852,20,LFFRYMAIGGYVGAATVGAA,1
3w5b,A,898,916,18,MALSVLVTIEMCNALNSL,1
3w5b,A,931,950,19,WLLGSICLSMSLHFLILYV,1
3w5b,A,965,987,22,QWLMVLKISLPVIGLDEILKFI,1
4ltr,D,152,171,19,IALLLLVIFYVFAVMGTKL,1
4ltr,D,213,233,20,AWIYFVSFILVSSFTVLNLF,1
4pd8,C,5,21,16,SCCGMAVLLGIAVLLS,1
4pd8,C,30,47,17,TVGGAFAIQFSLGAFIL,1
4pd8,C,103,118,15,TLIFFSALISVLYYL,1
4pd8,C,176,192,16,MCGGLASIAGGVLAGY,1
4pd8,C,202,220,18,VAASFMAAPGGLLFAKLM,1
4pd8,C,242,274,32,ANVIDAAAGGASAGLQLALNVGAMLIAFIGLI,1
4pd8,C,359,379,20,SFALCGFANLSSIAILLGGL,1
4pd8,C,395,414,19,KAVIAGTLSNLMAATIAGF,1
5an8,D,393,411,18,NFLCYLVYMLIFTAVAYH,1
5an8,D,432,452,20,LLGHILILLGGVYLLLGQLW,1
5an8,D,470,490,20,EILFLLQALLTVLSQVLCFL,1
5an8,D,495,514,19,LPLLVSSLVLGWLNLLYYT,1
5an8,D,536,556,20,RFLLVYLVFLFGFAVALVSL,1
5an8,D,619,639,20,VLLLLLAYVLLTYVLLLNML,1
3kdp,H,32,47,15,FAALAFIVGLIILLS,1
2hfe,J,87,111,24,GRLVAVVVMVAGITSFGLVTAALA,1
2amk,A,70,93,23,AFLTGFLALVTIIGNILVIVAFK,1
2amk,A,104,128,24,FLLSLACADLIIGVISMNLFTTYI,1
2amk,A,139,162,23,CDLWLSIDYVASNASVMNLLVIS,1
2amk,A,185,210,25,VMIGLAWVISFVLWAPAILFWQYFV,1
2amk,A,227,250,23,PTITFGTAIAAFYMPVTIMTILY,1
2amk,A,492,516,24,SAILLAFIITWTPYNIMVLVNTFC,1
2amk,A,524,546,22,WNLGYWLCYINSTVNPVCYALC,1
5hew,E,211,222,11,LGLIIAASWSV,1
5hew,E,233,246,13,TSFTLMLTVVAYA,1
5hew,E,266,279,13,IAGYGSIFAAILL,1
5hew,E,303,315,12,FPLGFLAIGCVL,1
5xat,A,32,44,12,FALITLLLSHFY,1
5xat,A,47,69,22,PTDIVGGFAIMFIIGAIFGEIG,1
5xat,A,81,94,13,APVMIFLVAAYFV,1
5xat,A,115,127,12,FLNLFIAVLITG,1
5xat,A,142,162,20,GYIPTILMGIVGASIFGIAI,1
5xat,A,217,230,13,IANIFAIVFAAVL,1
5xat,A,270,286,16,GLVLSTTCFLLAYVVA,1
5xat,A,299,311,12,YFAWMVLIVAAL,1
5xat,A,336,349,13,LWVLMVGVGVCYT,1
5xat,A,364,381,17,IAAIIVIGAVLGAAIGG,1
5xat,A,420,434,14,SYAQISSRLGGGIV,1
3b9y,C,43,60,17,SINILAMLLVGFGFLMV,1
3b9y,C,69,88,19,TTGTYLVVATGLPLYILLR,1
3b9y,C,105,123,18,IYAEFAVATGLIAMGAVL,1
3b9y,C,129,150,21,QYALLALFIVPVYLLNEWLVL,1
3b9y,C,163,183,20,AGSIAIHAFGAYFGLGVSIA,1
3b9y,C,203,221,18,SMLGSMVLWLFWPSFATA,1
3b9y,C,233,250,17,NTLLALCGATLATYFLS,1
3b9y,C,261,278,17,DMANAALAGGVAIGSVC,1
3b9y,C,284,301,17,GAFVIGLLGGAISVVGF,1
3b9y,C,317,338,21,CGVHNLHGLPGLLGGFSAILI,1
3b9y,C,347,371,24,TGIGITLALALIGGVIAGALIKLT,1
4prc,H,13,32,19,QLVWYAQWLVIWTVVLLYL,1
1m0k,C,12,30,18,LALGTALMGLGTLYFLVK,1
1m0k,C,44,61,17,ITTLVPAIAFTMYLSML,1
1m0k,C,80,97,17,ARYADWLFTTPLLLLDL,1
1m0k,C,109,126,17,ALVGADGIMIGTGLVGA,1
1m0k,C,135,153,18,VWWAISTAAMLYILYVLF,1
1m0k,C,175,192,17,NVTVVLWSAYPVVWLIG,1
1m0k,C,204,222,18,TLLFMVLDVSAKVGFGLI,1
2voy,L,790,804,14,QLLWVNLVTDGLPA,1
5fil,W,13,26,13,ILGLPLVTLIVLF,1
5fil,W,77,89,12,FIGSTNLLGLLP,1
5fil,W,96,110,14,QLSMNLGMAIPLWA,1
5fil,W,150,171,21,IQPMALAVRLTANITAGHLLI,1
5fil,W,194,212,18,ILILLTILEFAVAMIQAY,1
4r0c,B,20,35,15,PTLLFVWFCLLLLPL,1
4r0c,B,73,97,24,VGNFTGFAPLGVVLVAMLGLGVAE,1
4r0c,B,166,190,24,SGGFSANLLVGPVDATLAGLSTEA,1
4r0c,B,201,220,19,ATGNYWFIIASTFLVTGLV,1
4r0c,B,255,270,15,TGLTLAILLAGLALL,1
4r0c,B,292,310,18,HGLVVIVALIAGICGAVY,1
4r0c,B,324,351,27,TAMEVTMASMAGYLVLMFFAAQFVAWF,1
4r0c,B,377,393,16,LLLLFVVLTALINLMI,1
4r0c,B,395,408,13,ASAKWSILAPVFI,1
4r0c,B,419,433,14,ASQAAYRVGDSSTN,1
4r0c,B,470,485,15,TLLLGWSVLLGVWIG,1
2hjf,F,25,50,25,WRAAGAATVLLVIVLLAGSYLAVLA,1
2hjf,F,87,113,26,GRCVAVVVMVAGITSFGLVTAALATW,1
4kka,B,37,61,24,MAAVVGTLVGLAAVAFDKGVAWLQ,1
4kka,B,84,97,13,CSAVLAMFGYFLV,1
4kka,B,128,142,14,PVKFFGGLGTLGGG,1
4kka,B,144,156,12,LGRAGPTVQIGG,1
4kka,B,216,232,16,AVFIGVIMSTIMYRIF,1
4kka,B,253,277,24,LYLILGIIFGIFGPIFNKWVLGMQ,1
4kka,B,290,305,15,WVLMGGAIGGLCGLL,1
4kka,B,338,351,13,ARVITTLLCFSSG,1
4kka,B,353,368,15,GGIFAPMLALGTVLG,1
4kka,B,423,439,16,PMIITGLGATLLAQFT,1
4rfs,T,27,41,14,SFCYIIVVFLANNI,1
4rfs,T,43,57,14,YAILIAFTVGAILS,1
4rfs,T,70,89,19,PLLWLIVFTVVLQLLFSPA,1
4rfs,T,104,124,20,DGLINAGYIFVRFLLIIMMS,1
4rfs,T,248,263,15,TWLLFLLGFVAILIF,1
2ac6,A,32,54,22,TLYSIIFVVGIFGNSLVVIVIY,1
2ac6,A,64,86,22,VFLLNLALADLCFLLTLPLWAV,1
2ac6,A,102,124,22,IASASVSFNLYASVFLLTCLSI,1
2ac6,A,147,168,21,TCIIIWLMAGLASLPAVIHRN,1
2ac6,A,195,216,21,GLTKNILGFLFPFLIILTSYT,1
2ac6,A,241,263,22,IMAIVLFFFFSWVPHQIFTFLD,1
2ac6,A,287,305,18,ICIAYFNNCLNPLFYGFL,1
5a6u,G,37,51,14,MATAIGFAIMGFIG,1
3b5z,B,32,47,15,ALILNAASDTFMLSL,1
3b5z,B,64,82,18,LWMPLVVIGLMILRGITS,1
3b5z,B,147,162,15,REGASIIGLFIMMFY,1
3b5z,B,168,182,14,IILVVLAPIVSIAI,1
3b5z,B,249,263,14,ISDPIIQLIASLAL,1
3b5z,B,290,303,13,MIALMRPLKSLTN,1
3rfm,A,8,29,21,YITVELAIAVLAILGNVLVCW,1
3rfm,A,44,68,24,VVSLAAADILVGVLAIPFAITIST,1
3rfm,A,75,100,25,GCLFIACFVLVLAQSSIFSLLAIAI,1
3rfm,A,122,144,22,GIIAICWVLSFAIGLTPMLGWN,1
3rfm,A,172,198,26,PMNYMVYFNFFACVLVPLLLMLGVYL,1
3rfm,A,236,259,23,IIAGLFALCWLPLHIINCFTFFC,1
3rfm,A,265,288,23,PLWLMYLAIVLAHTNSVVNPFIY,1
2zw3,F,25,50,25,TVLFIFRIMILVVAAKEVWGDEQAD,1
2zw3,F,66,89,23,HYFPISHIRLWALQLIFVSTPAL,1
2zw3,F,140,159,19,FFRVIFEAAFMYVFYVMYD,1
2zw3,F,183,208,25,RPTEKTVFTVFMIAVSGICILLNVT,1
2xov,A,94,113,19,PVTWVMMIACVVVFIAMQI,1
2xov,A,144,166,22,HFSLMHILFNLLWWWYLGGAVE,1
2xov,A,172,190,18,KLIVITLISALLSGYVQQ,1
2xov,A,198,214,16,GLSGVVYALMGYVWLR,1
2xov,A,226,245,19,RGLIIFALIWIVAGWFDLF,1
2xov,A,247,268,21,SMANGAHIAGLAVGLAMAFVD,1
4kjr,D,5,19,14,FILVAAGVPLSVIG,1
4kjr,D,30,45,15,AVYCVTIIALASYMG,1
4kjr,D,63,79,16,NATFGNAVELIISMFA,1
4kjr,D,88,106,18,LASLTGSVLGNLLLVAGL,1
4kjr,D,130,146,16,LLIFAIIVAFVIPEVF,1
4kjr,D,158,172,14,SIGISIIMILLYVA,1
4kjr,D,208,224,16,VLFAATIVVAYISENL,1
4kjr,D,242,257,15,GVIIVAIVGNAAEHA,1
4kjr,D,276,295,19,GSTLQIAMFVAPVLVICSI,1
4kjr,D,303,322,19,VFTLPELVAMVSAVLLMIA,1
4kjr,D,335,349,14,TLLAAYVIMAIGFF,1
2v60,A,486,498,12,PSVPGLLRLIGL,1
5cxv,A,25,48,23,AFIGITTGLLSLATVTGNLLVLI,1
5cxv,A,64,87,23,LSLACADLIIGTFSMNLYTTYLL,1
5cxv,A,94,120,26,TLACDLWLALDYVASQASVMNLLLIS,1
5cxv,A,147,168,21,LAWLVSFVLWAPAILFWQYLV,1
5cxv,A,179,208,29,IQFLSQPIITFGTAMAAFYLPVTVMCTLY,1
5cxv,A,367,391,24,SAILLAFILTWTPYNIMVLVSTFC,1
5cxv,A,399,420,21,WELGYWLCYVNSTINPMCYAL,1
1s51,E,10,33,23,IWLALGTALMGLGSLYFLVKGMG,1
1s51,E,41,62,21,FYAITTLVPAIAFTMYLSMLL,1
1s51,E,80,99,19,ARYADWLFTTPLLLLDLAL,1
1s51,E,106,127,21,TILALVGADGIMIGTGLVGAL,1
1s51,E,134,157,23,FVWWAISTAAMLYILYVLFFGFT,1
1s51,E,171,192,21,KVLRNVTVVLWSAYPVVWLIG,1
1s51,E,203,225,22,ETLLFMVLDVSAKVGFGLILLR,1
4ire,E,195,218,23,SYIPNIILPMLFILFISWTAFWS,1
4ire,E,222,244,22,ANVTLVVSTLIAHIAFNILVET,1
4ire,E,252,275,23,TYTGAIIFMIYLFYFVAVIEVTV,1
4ire,E,295,316,21,RIAFPVVFLLANIILAFLFFG,1
3egw,F,5,28,23,MFFFDIYPYIAGAVFLIGSWLRY,1
3egw,F,48,73,25,NLASNLFHIGILGIFVGHFFGMLTP,1
3egw,F,87,114,27,KMAMFAGGASGVLCLIGGVLLLKRRLF,1
3egw,F,125,145,20,DILILSLLVIQCALGLLTIP,1
3egw,F,183,204,21,FRLHLVLGMTLFLLFPFSRLI,1
4ub8,z,8,25,17,LAALVILSFVMVIGVPV,1
4ub8,z,40,55,15,FLGSGLWIALVLVVG,1
4ytn,D,58,79,21,FKIERYFAAAMVPLIPAAYFI,1
4ytn,D,84,108,24,DLCLALALTLHVHWGVWGVVNDYG,1
4ytn,D,117,138,21,AAAVRVGAYIFTACLLAGLLY,1
5vb2,D,2015,2033,18,KFIIYLIVLNGITMGLET,1
5vb2,D,2045,2064,19,TLFNQIVITIFTIEIILRI,1
5vb2,D,2076,2091,15,SLFDFFVVAISLVPT,1
5vb2,D,2096,2113,17,ILRVLRVLRLFRLVTAV,1
5vb2,D,2131,2151,20,SVIALMTLFFYIFAIMATQL,1
5vb2,D,2194,2213,19,WVFFIPFIFVVFFVMINLY,1
4umv,A,131,146,15,ITLIVMMAISWGLEQ,1
4umv,A,152,173,21,QLAFIATTLVGLYPIARQALR,1
4umv,A,181,198,17,AIETLMSVAAIGALFIG,1
4umv,A,200,212,12,AEAAMVLLLFLI,1
4umv,A,351,366,15,RIYTPAIMAVALLVT,1
4umv,A,385,399,14,TLLLIGCPCALVIS,1
4umv,A,685,700,15,ITIALGLKGIFLVTT,1
4umv,A,708,723,15,LAVLADTGATVLVTA,1
5xap,A,35,50,15,LLLLLTLLGSLLYIW,1
5xap,A,300,315,15,IAALVGIGLVFVMLF,1
5xap,A,325,343,18,GALGLLFSSIIILGILGG,1
5xap,A,353,367,14,AGLVLTIGAAVDGN,1
5xap,A,400,415,15,DVNASHLLSALALYN,1
5xap,A,425,443,18,VTLIIGVIASTFSNLVFA,1
5xap,A,478,493,15,TLSVLLALAGAALVA,1
5xap,A,603,617,14,LLGLGLILVYVGFR,1
5xap,A,624,644,20,GSIIAAIHDVAIAMGLFSLL,1
5xap,A,654,668,14,ALLTLIGYSLNDSI,1
5xap,A,703,718,15,TSVSTMLPLISLLIF,1
5xap,A,725,741,16,FSLILLVGILVGTYSS,1
1jb0,X,13,30,17,FWAVLLLAINFLVAAYY,1
2vl0,E,210,224,14,LGLIIAASWSVFWL,1
2vl0,E,229,244,15,RLQTSFTLMLTVVAY,1
2vl0,E,265,281,16,IAGYGSIFAAILLIIF,1
2vl0,E,299,313,14,RLAFPLGFLAIGCV,1
4gp4,C,7,24,17,ALAVILVLTLTILVFWL,1
3nym,A,52,72,20,EFKEDLKNFLDYMEVCQLAL,1
3nym,A,79,99,20,ASNSLFMAMIYAGNLSLIFD,1
2qks,E,42,67,25,RWFFVSLAVLFLLLNTAFATLYMLG,1
2qks,E,104,128,24,AHWIATLEIFVGMSSIALATGCAF,1
2x5v,L,32,51,19,FFGVSAIFFIFLGVSLIGY,1
2x5v,L,89,105,16,TVCALGAFISWMLREV,1
2x5v,L,116,134,18,VPLAFCVPIFMFCVLQVF,1
2x5v,L,172,190,18,HMSSVSFLFVNAMALGLH,1
2x5v,L,230,247,17,RLGLFLASNIFLTGAFG,1
2hg3,H,16,32,16,IYSFWIFLAGLIYYLQ,1
4k0e,C,15,31,16,VALVFAMVALYGWYAW,1
4k0e,C,336,352,16,TLMEGMFLVSLVLLLF,1
4k0e,C,357,380,23,AAIIVAVTIPLSLLMAFILMHHF,1
4k0e,C,390,402,12,AIDFGIIVDGAI,1
4k0e,C,437,452,15,FGMIVIITAYLPLFA,1
4k0e,C,465,483,18,FAVGFALFGALLVALLLI,1
4k0e,C,526,541,15,IAVATLVGVMILGAT,1
4k0e,C,860,875,15,VILPMVLALMFVLLF,1
4k0e,C,885,905,20,LILMAVPLATLGGLVALHLR,1
4k0e,C,914,929,15,VGFIALFGVAVLNAI,1
4k0e,C,962,977,15,MTATVAALGLIPAAL,1
4k0e,C,988,1004,16,LATVVVGGLITATALT,1
5h2p,C,12,28,16,LALGTALMGLGTLYFL,1
5h2p,C,47,61,14,LVPAIAFTMYLSML,1
5h2p,C,80,94,14,ARYADWLFTTPLLL,1
5h2p,C,111,126,15,VGADGIMIGTGLVGA,1
5h2p,C,135,150,15,VWWAISTAAMLYILY,1
5h2p,C,178,192,14,VVLWSAYPVVWLIG,1
5h2p,C,204,220,16,TLLFMVLDVSAKVGFG,1
4u9n,B,278,305,27,VALWLARVRWLVILILTGMVTSSILQG,1
4u9n,B,317,338,21,FYVPVLLGTGGNTGNQSATLI,1
4u9n,B,353,381,28,RVFLKEMGVGLLLGLTLSFLLVGKVYWD,1
4u9n,B,388,412,24,VVGVSLVLIVFFANLVGAMLPFLL,1
4u9n,B,422,443,21,SNPLVATLSDVTGLLIYLSVA,1
5h35,E,4,22,18,LELLNIIGIIAFTISGSL,1
5h35,E,32,52,20,GVVTLGVITSYAGGIIADIL,1
5h35,E,59,77,18,ILKELNYLLLSVGISIFV,1
5h35,E,94,112,18,ISDAVGLSTFATLGASLA,1
5h35,E,120,140,20,SVGLIAAIVGTGGGVIRDVL,1
5h35,E,151,167,16,IYATAALLSGFIYYFT,1
5h35,E,175,190,15,LFVAFLGSFLLRILS,1
3uza,A,10,29,19,TVELAIAVLAILGNVLVCW,1
3uza,A,44,63,19,VVSLAAADILVGVLAIPFA,1
3uza,A,83,100,17,VLVLAQSSIFSLLAIAI,1
3uza,A,122,138,16,GIIAICWVLSFAIGLT,1
3uza,A,177,198,21,VYFNFFACVLVPLLLMLGVYL,1
3uza,A,236,252,16,IIAGLFALCWLPLHII,1
3uza,A,273,289,16,IVLAHTNSVVNPFIYA,1
3gd8,D,38,55,17,TAEFLAMLIFVLLSLGS,1
3gd8,D,72,89,17,ISLCFGLSIATMVQCFG,1
3gd8,D,116,133,17,FYIAAQCLGAIIGAGIL,1
3gd8,D,158,177,19,GLLVELIITFQLVFTIFAS,1
3gd8,D,188,205,17,IALAIGFSVAIGHLFAI,1
3gd8,D,231,248,17,IYWVGPIIGAVLAGGLY,1
4p1a,C,13,30,17,QKILIGLILGAIVGLIL,1
4p1a,C,43,67,24,KPFGDLFVRLLCMLVMPIVFASLV,1
4p1a,C,94,110,16,FAVTLGIIMARLFNPG,1
4p1a,C,131,140,9,HILLDIVPT,1
4p1a,C,151,161,10,LPTIFFAIIL,1
4p1a,C,198,218,20,NGVMQYAPIGVFALIAYVMA,1
4p1a,C,223,242,19,VVGELAKVTAAVYVGLTLQ,1
4p1a,C,312,328,16,GTALYQGVATFFIANA,1
4p1a,C,334,350,16,VGQQLTIVLTAVLASI,1
4p1a,C,357,375,18,AGAIMLCMVLHSVGLPLT,1
4p1a,C,380,397,17,AAYAMILGIDAILDMGR,1
4p2z,F,135,153,18,ALLTVVFYIAAVMATNLY,1
4p2z,F,194,214,20,AWVFFIPFIMLTAFTVLNLA,1
4uxw,C,33,47,14,EGVAVLLAVVIACW,1
4uxw,C,53,68,15,TRVLLISSVMLVMIV,1
4uxw,C,102,116,14,IAIIDAVITWCILL,1
2d2c,U,4,22,18,GWVALLVVFTWSIAMVVW,1
5c76,D,22,38,16,FSVFVSFIETFAISLV,1
5c76,D,78,93,15,LIVFYVFRALLNAYY,1
5c76,D,155,168,13,EIFVVLLLYALML,1
5c76,D,175,189,14,LFLSIFMVLNAFIL,1
5c76,D,260,273,13,IYLEGIGFCVLVF,1
5c76,D,294,307,13,IFVLALYRLMPSA,1
4ksc,A,43,68,25,WLDRLYMLVGTLAAIIHGVALPLMM,1
4ksc,A,118,137,19,AGVLIVAYIQVSFWCLAAG,1
4ksc,A,183,204,21,DKIGMFFQAMATFFGGFIIGF,1
4ksc,A,209,228,19,LTLVILAISPVLGLSAGIW,1
4ksc,A,292,312,20,ISMGAAFLLIYASYALAFWY,1
4ksc,A,330,348,18,FFSVLIGAFSVGQASPNI,1
4ksc,A,708,729,21,VGIFCAIINGGLQPAFSVIFS,1
4ksc,A,752,772,20,LLFLILGIISFITFFLQGFT,1
4ksc,A,829,847,18,AVIFQNIANLGTGIIISL,1
4ksc,A,855,875,20,LLLAIVPIIAIAGVVEMKML,1
4ksc,A,928,952,24,KKAHVFGITFSFTQAMMYFSYAAC,1
4ksc,A,972,990,18,VFSAIVFGAMAVGQVSSF,1
2mmu,A,31,53,22,WFVSLFIGLMLIGLIWLMVFQL,1
2mmu,A,71,91,20,PWNYAIAFAFMITGLLLTMR,1
5ax1,A,14,36,22,AQWVVFAVMALAAIVFSIAVQF,1
5ax1,A,43,66,23,TYYVNIAICTIAATAYYAMAVNG,1
5ax1,A,83,104,21,YARYIDWVFTTPLLLLDLVLL,1
5ax1,A,110,132,22,MIAWIMGADIAMIAFGIIGAFT,1
5ax1,A,137,160,23,WFYFVVGCIMLAVLAWGMINPIF,1
5ax1,A,172,197,25,AYTTLLIYLIVLWVIYPIVWGLGAG,1
5ax1,A,207,230,23,IAMGILDLLAKPLYAIGVLITVE,1
1fbk,C,10,32,22,IWLALGTALMGLGTLYFLVKGM,1
1fbk,C,43,62,19,AITTLVPAIAFTMYLSMLL,1
1fbk,C,79,98,19,WARYADWLFTTPLLLLGLA,1
1fbk,C,108,128,20,LALVGADGIMIGTGLVGALT,1
1fbk,C,134,154,20,FVWWAISTAAMLYILYVLFF,1
1fbk,C,174,192,18,RNVTVVLWSAYPVVWLIG,1
1fbk,C,204,224,20,TLLFMVLDVSAKVGLGLILL,1
4esl,C,7,25,18,ALAVILVLTLTILVFWLG,1
3uu8,E,199,218,19,NIILPMLFILFISWTAFWS,1
3uu8,E,222,241,19,ANVTLVVSTLIAHIAFNIL,1
3uu8,E,256,275,19,AIIFMIYLFYFVAVIEVTV,1
3uu8,E,292,313,21,RASRIAFPVVFLLANIILAFL,1
4uu1,A,54,76,22,EQFEDLLVRILLLAACISFVLA,1
4uu1,A,89,107,18,EPFVILLILIANAIVGVW,1
4uu1,A,257,277,20,EQLSKVISLICVAVWLINIG,1
4uu1,A,293,317,24,YYFKIAVALAVAAIPEGLPAVITT,1
4uu1,A,760,783,23,IRYLISSNVGEVVCIFLTAALGL,1
4uu1,A,786,807,21,LIPVQLLWVNLVTDGLPATAL,1
4uu1,A,834,853,19,FRYMAIGGYVGAATVGAAA,1
4uu1,A,898,916,18,MALSVLVTIEMCNALNSL,1
4uu1,A,927,950,23,WVNIWLLGSICLSMSLHFLILYV,1
4uu1,A,967,987,20,LMVLKISLPVIGLDEILKFI,1
4bv0,A,60,87,27,IYSKVLVTAIYLALFVVGTVGNGVTLF,1
4bv0,A,107,132,25,SLALSDLLILLFALPVDVYNFIWVH,1
4bv0,A,136,161,25,FGDAGCKGYYFLREACTYATALNVV,1
4bv0,A,191,210,19,AIWLASALLAIPMLFTVGL,1
4bv0,A,226,255,29,PIVDTATLKVVIQLNTFMSFLFPMLVASI,1
4bv0,A,312,334,22,MVIAFVVCWLPYHVRRLMFVYI,1
4bv0,A,346,368,22,YHYFYMLSNALVYVSAAINPIL,1
1q90,Q,79,94,15,TCVMFSFSLSLVVWG,1
5j0z,E,199,215,16,NIILPMLFILFISWTA,1
5j0z,E,226,240,14,LVVSTLIAHIAFNI,1
5j0z,E,256,272,16,AIIFMIYLFYFVAVIE,1
5j0z,E,296,313,17,IAFPVVFLLANIILAFL,1
4nab,A,54,71,17,EQFEDLLVRILLLAACI,1
4nab,A,90,106,16,PFVILLILIANAIVGV,1
4nab,A,258,274,16,QLSKVISLICVAVWLI,1
4nab,A,296,310,14,KIAVALAVAAIPQG,1
4nab,A,762,778,16,YLISSNVGEVVCIFLT,1
4nab,A,787,805,18,IPVQLLWVNLVTDGLPAT,1
4nab,A,832,851,19,LFFRYMAIGGYVGAATVGA,1
4nab,A,899,915,16,ALSVLVTIEMCNALNS,1
4nab,A,934,950,16,GSICLSMSLHFLILYV,1
4nab,A,968,987,19,MVLKISLPVIGLDEILKFI,1
2z55,F,16,36,20,LGIGTLLMLIGTFYFIARGW,1
2z55,F,47,66,19,AITILVPGIASAAYLAMFF,1
2z55,F,85,103,18,ARYADWLFTTPLLLLDLA,1
2z55,F,112,132,20,IGTLIGVDALMIVTGLIGAL,1
2z55,F,139,159,20,YTWWLFSTIAFLFVLYYLLT,1
2z55,F,178,197,19,LTALVAVLWTAYPILWIVG,1
2z55,F,209,230,21,TLAFMVLDVTAKVGFGFVLLR,1
2aui,A,93,113,20,GRVAMIGFAASLLGEALTGK,1
2aui,A,131,149,18,PLLLFFILFTLLGAIGAL,1
2aui,A,194,217,23,LFVGRLAQLGIAFSLIGEIITGK,1
2aui,A,230,247,17,IQDIEPLVLLNVAFFFF,1
5jeq,B,15,37,22,FYIVLLSILSTGIALLTLASSL,1
5jeq,B,143,165,22,ERKMLLVVAISLAGGIGIFTLV,1
5djq,N,9,27,18,GVVTVGLMVAFLAGFGYF,1
1qov,H,13,32,19,SLAIYSFWIFLAGLIYYLQ,1
1aij,H,13,29,16,SLAIYSFWIFLAGLIY,1
3rqw,E,211,225,14,LGLIIAASWSVFWL,1
3rqw,E,230,245,15,RLQTSFTLMLTVVAY,1
3rqw,E,266,282,16,IAGYGSIFAAILLIIF,1
3rqw,E,298,315,17,RCRLAFPLGFLAIGCVL,1
4bwb,A,62,83,21,SKVLVTAIYLALFVVGTVGNG,1
4bwb,A,110,131,21,LSDLLILLFALPVDLYNFIWV,1
4bwb,A,136,161,25,FGDAGCKGYYFLREACTYATALNVV,1
4bwb,A,193,210,17,WLASALLAIPMLFTMGL,1
4bwb,A,233,254,21,LRVVIQLNTFMSFLFPMLVAS,1
4bwb,A,313,333,20,VIAFVVCWLPYHVRRLMFVY,1
4bwb,A,347,365,18,HYFYMLSNALVYVSAAIN,1
2m6b,A,224,243,19,IQLYIPSLLIVILSWISFW,1
2m6b,A,250,269,19,ARVGLGITTVLTLTTQSSG,1
2m6b,A,282,303,21,IDIWLAVCLLFVFSALLEYAA,1
2m6b,A,398,420,22,SRIGFPLAFLIFNLFYWIIYKI,1
5jef,B,13,35,22,AFFYIVLLSILSTGIALLTLAS,1
5jef,B,147,170,23,LLVVAISLAGGIGIFTLVFFTLR,1
5kli,G,15,31,16,YYATAGAGAVATGAAV,1
2itd,F,26,50,24,RAAGAATVLLVIVLLAGSYLAVLA,1
2itd,F,87,111,24,GRCVAVVVMVAGITSFGLVTAALA,1
3fb8,G,30,50,20,AATVLLVIVLLAGSYLAVLA,1
3fb8,G,87,107,20,GRCVAVVVMVAGITSFGLVT,1
3f4i,B,13,32,19,LILAMAGNAVGLGNFLRFP,1
3f4i,B,44,63,19,IPYIIAFLLVGIPLMWIEW,1
3f4i,B,90,124,34,KILGVFGLWIPLVVAIYYVYIESWTLGFAIKFLV,1
3f4i,B,167,184,17,AYIVFLITMFINVSILI,1
3f4i,B,191,212,21,ERFAKIAMPTLFILAVFLVIR,1
3f4i,B,242,265,23,VWIAAVGQIFFTLSLGFGAIITY,1
3f4i,B,278,297,19,GLTAATLNEKAEVILGGSI,1
3f4i,B,340,367,27,GFLWFFLLFFAGLTSSIAIMQPMIAFL,1
3f4i,B,378,396,18,VLWTAAIVFFSAHLVMFL,1
3f4i,B,400,426,26,DEMDFWAGTIGVVFFGLTELIIFFWI,1
3f4i,B,445,469,24,RIYYYVMRYITPAFLAVLLVVWAR,1
3f4i,B,484,502,18,ITRFYIIGLFLFLTFLVF,1
4v1g,I,18,40,22,LIMGGGAIGAGIGDGIAGNALI,1
4v1g,I,54,76,22,TPFFITVGLVEAAYFINLAFMA,1
5ebm,F,29,50,21,GAATVLLVIVLLAGSYLAVLA,1
5ebm,F,87,108,21,GRLVAVVVMVAGITSFGLVTA,1
1kqg,I,13,33,20,DRACHWTVVICFFLVALSGI,1
1kqg,I,58,77,19,FFGIAIFVALMFMFVRFVH,1
1kqg,I,112,131,19,QKMMFWSIMSMIFVLLVTG,1
1kqg,I,155,175,20,AAAGIILIHAILIHMYMAFW,1
4zp2,A,20,40,20,CLVLYEFSTYIGNDMIQPGM,1
4zp2,A,55,72,17,TSMTAYLAGGMFLQWLL,1
4zp2,A,84,102,18,MLAGVVWFIVTCLAILLA,1
4zp2,A,107,126,19,FTLLRFLQGISLCFIGAVG,1
4zp2,A,144,164,20,LMANVALIAPLLGPLVGAAW,1
4zp2,A,171,189,18,GMFVLFAALAAISFFGLQ,1
4zp2,A,223,242,19,GALALGFVSLPLLAWIAQS,1
4zp2,A,259,277,18,LQVPIFGALIAGNLLLAR,1
4zp2,A,287,305,18,IIMGGWPIMIGLLVAAAA,1
4zp2,A,315,335,20,MTAGLSIYAFGIGLANAGLV,1
4zp2,A,351,369,18,AMGMLQMLIFTVGIEISK,1
4zp2,A,380,398,18,NLFNLVNGILWLSLMVIF,1
4mrv,B,34,58,24,LRRRVVGAILMVLLGKATTLALPF,1
4mrv,B,86,108,22,YALGRFSGVLFDNLRNIVFERV,1
4mrv,B,156,177,21,FLLFNIAPTVIELTAVIVIFW,1
4mrv,B,183,206,23,LVTATILAVIAYVWTTRTITEWR,1
4mrv,B,263,284,21,SLGLLNIAQALIVNLLMAGAM,1
4mrv,B,304,323,19,NTYLTQLFRPLDMLGMVYR,1
3h9v,C,35,55,20,RFTQALVIAYVIGYVFVYNK,1
3h9v,C,332,360,28,FNIIPTLLNIGAGLALLGLVNVICDWIV,1
3ag2,Z,16,35,19,IGLSVTFLSFLLPAGWVLY,1
2npj,C,18,31,13,LVLFMTIPGIALF,1
2npj,C,47,63,16,VTVTFALVCILWVVYG,1
2npj,C,106,118,12,FACITVGLIVGA,1
2npj,C,128,143,15,LIFVVVWLTLSYIPI,1
2npj,C,163,178,15,GTVVHINAAIAGLVG,1
2npj,C,203,216,13,GTAILYIGWFGFN,1
2npj,C,234,248,14,VVATAAAILGWIFG,1
2npj,C,261,274,13,CSGAIAGLVGVTP,1
2npj,C,285,299,14,IIGVVAGLAGLWGV,1
2npj,C,315,328,13,GVFGVCGIVGCIM,1
2npj,C,357,377,20,SIAITIVWSGVVAFIGYKLA,1
5kc0,A,8,28,20,FVGIFSALATLVMFLEFPIF,1
5kc0,A,35,47,12,YDPSEIPALIVS,1
5kc0,A,52,70,18,GVGMFVVLVKDILFFLMK,1
5kc0,A,77,94,17,AMNAVLGMSFVGIAGLI,1
5kc0,A,107,123,16,MIVATLFATAFALGLN,1
5kc0,A,143,161,18,FILAFNLVKFGIDSVVTF,1
4x1h,A,40,65,25,AAYMFLLIMLGFPINFLTLYVTVQH,1
4x1h,A,69,96,27,TPLNYILLNLAVADLFMVFGGFTTTLY,1
4x1h,A,113,137,24,GFFATLGGEIALWSLVVLAIERYV,1
4x1h,A,151,172,21,HAIMGVAFTWVMALACAAPPL,1
4x1h,A,203,227,24,VIYMFVVHFIIPLIVIFFCYGQLV,1
4x1h,A,252,274,22,MVIIMVIAFLICWLPYAGVAFY,1
4x1h,A,288,310,22,TIPAFFAKTSAVYNPVIYIMMN,1
4x2s,C,13,27,14,QKILIGLILGAIVG,1
4x2s,C,44,64,20,PFGDLFVRLLKMLVMPIVFA,1
4x2s,C,91,107,16,TSAFAVTLGIIMARLF,1
4x2s,C,131,140,9,HILLDIVPT,1
4x2s,C,151,160,9,LPTIFFAII,1
4x2s,C,198,215,17,NGVMQYAPIGVFALIAY,1
4x2s,C,226,246,20,ELAKVTAAVYVGLTLQILLV,1
4x2s,C,311,325,14,DGTALYQGVATFFI,1
4x2s,C,337,355,18,QLTIVLTAVLASIGTAGV,1
4x2s,C,357,370,13,AGAIMLAMVLHSV,1
4x2s,C,383,401,18,AMILGIDAILDRGRTMVN,1
3dta,H,12,32,20,ASLAIYSFWIFLAGLIYYLQ,1
5kbu,D,526,543,17,MCIVFAYIGVSVVLFLV,1
5kbu,D,594,614,20,SLSGRIVGGVWWFFTLIIIS,1
5kbu,D,794,813,19,VFYILVGGLGLAMLVALIE,1
4hbh,H,12,29,17,ASLAIYSFWIFLAGLIY,1
1y5l,F,5,28,23,MFFFDIYPYIAGAVFLIGSWLRY,1
1y5l,F,48,66,18,NLASNLFHIGILGIFVGY,1
1y5l,F,87,114,27,KMAMFAGGASGVLCLIGGVLLLKRRLF,1
1y5l,F,125,145,20,DILILSLLVIQCALGLLTIP,1
1y5l,F,184,204,20,RLHLVLGMTLFLLFPFSRLI,1
4q9j,A,35,68,33,LTMFRYAGWLDRLYMLVGTLAAIIHGVALPLMM,1
4q9j,A,118,140,22,AGVLIVAYIQVSFWCLAAGRQI,1
4q9j,A,180,204,24,GIGDKIGMFFQAMATFFGGFIIGF,1
4q9j,A,209,232,23,LTLVILAISPVLGLSAGIWAKIL,1
4q9j,A,290,313,23,ANISMGAAFLLIYASYALAFWYG,1
4q9j,A,329,352,23,VFFSVLIGAFSVGQASPNIEAFA,1
4q9j,A,706,729,23,FVVGIFCAIINGGLQPAFSVIFS,1
4q9j,A,751,773,22,SLLFLILGIISFITFFLQGFTF,1
4q9j,A,828,848,20,LAVIFQNIANLGTGIIISLI,1
4q9j,A,855,879,24,LLLAIVPIIAIAGVVEMKMLSGQA,1
4q9j,A,925,949,24,NAMKKAHVFGITFSFTQAMMYFSY,1
4q9j,A,973,991,18,FSAIVFGAMAVGQVSSFA,1
3stl,F,26,50,24,RAAGAATVLLVIVLLAGSYLAVLA,1
3stl,F,87,111,24,GRLVAVVVMVAGITSFGLVTAALA,1
2ka1,B,164,186,22,FLPSLLLSHLLAIGLGIYIGRR,1
3du3,H,12,29,17,ASLAIYSFWIFLAGLIY,1
5l25,B,36,58,22,LAPTTYIFFASAIPVISFGEQL,1
5l25,B,67,83,16,AVQTLASTAICGMIHS,1
5l25,B,91,109,18,ILGVAEPTVIMYTFMFNF,1
5l25,B,124,140,16,SGWVCVWTALMLFVLA,1
5l25,B,158,176,18,FGLLIAMLFMQQAIKGLV,1
5l25,B,204,219,15,LVLSFGLLLTGLRSR,1
5l25,B,234,251,17,IADYGVPLMVLVWTGVS,1
5l25,B,292,312,20,YIIGAFIPASMIAVLYYFDH,1
5l25,B,337,350,13,LLGFLTLMCGLLG,1
5l25,B,465,481,16,SNLLQSTMVGGCVAAM,1
5l25,B,489,504,15,SVLWGYFAFMAIESL,1
4xpf,A,38,57,19,SVIGFAVDLANVWRFPYLC,1
4xpf,A,63,82,19,AFLVPYGIMLAVGGIPLFY,1
4xpf,A,112,133,21,VVLIAFYVGFYYNVIIAWSLR,1
4xpf,A,240,255,15,LCLLIVYLICYFSLW,1
4xpf,A,261,281,20,GKVVWFTALFPYAVLLILLI,1
4xpf,A,302,328,26,AIYKAEVWVDAATQVFFSLGPGFGVL,1
4xpf,A,346,362,16,LTSFINSATSFIAGFV,1
4xpf,A,409,430,21,FFMMLATLGLDSSFGGMEAII,1
4xpf,A,447,463,16,VAGLFSLYFVVGLASC,1
4xpf,A,471,491,20,HLLDRYAAGYSILVAVFFEA,1
4xpf,A,526,542,16,APIFLLFITVYGLIGY,1
4xpf,A,555,573,18,ANALGWCIAGSSVVMIPA,1
1e14,H,12,29,17,ASLAIYSFWIFLAGLIY,1
1bac,A,13,32,19,LGTALMGLGTLYFLVKGMG,1
1bac,A,44,60,16,TTLVPAIAFTMYLSML,1
1bac,A,81,98,17,YADWLFTTPLLLLDLAL,1
1bac,A,107,123,16,LALVGADGIMIGTGLV,1
1bac,A,138,153,15,ISTAAMLYILYVLFF,1
1bac,A,174,190,16,NVTVVLWSAYPVVWLI,1
1bac,A,206,223,17,FMVLDVSAKVGFGLILL,1
1llk,A,15,34,19,WPIFGAAAALLTTSGLIMW,1
1llk,A,40,59,19,TLLTMGLLSMLLVMLQWWR,1
1llk,A,79,99,20,RYGMILFITSEAFFFLGFFW,1
1llk,A,128,149,21,VPLLNTAILLASGVTVTWAHH,1
1llk,A,159,181,22,IHALTLTILLGFYFTALQAMEY,1
1llk,A,199,221,22,ATGFHGLHVIIGSSFLTVCLLR,1
1llk,A,234,257,23,FEAAAWYWHFVDIIWLFLYMSMY,1
5lri,H,15,29,14,AIYSFWIFLAGLIY,1
3zk1,K,11,33,22,GCSAVGAGLAMIAGLGPGIGEG,1
3zk1,K,62,85,23,VAESTGIYSLVIALILLYANPFL,1
5kuk,D,78,104,26,WRYMLLLFSLAFLVSWLLFGLIFWLI,1
5kuk,D,156,184,28,LAVFMVVVQSIVGCIIDSFMIGAIMAKM,1
1r2c,H,13,32,19,QLVWYAQWLVIWTVVLLYL,1
3tet,E,25,45,20,VLFVLTILTLISGTIFYSTV,1
3tet,E,75,99,24,GKIFTILYIFIGIGLVFGFIHKLA,1
2ls2,A,4,21,17,GEMAGAFVAVFLLAMFY,1
3j9t,a,19,35,16,AIIFTSLGAAYGTAKS,1
3j9t,a,56,72,16,VIMAGIIAIYGLVVSV,1
3j9t,a,96,112,16,VGLSGLAAGFAIGIVG,1
3j9t,a,131,147,16,ILIFAEVLGLYGLIVA,1
3tdp,E,25,46,21,KYLVSSAFAGLYVGIGILLIF,1
3tdp,E,63,79,16,MGLSFAIALSLVIMTG,1
3tdp,E,105,129,24,KIWAYSWVGNLIGALVLGIIFVGT,1
3tdp,E,154,177,23,ALFFRGILCNILVCVSVLCSFRT,1
3tdp,E,180,198,18,TAKIIMIFLCLFAFITSG,1
3tdp,E,227,252,25,YNLVAVTLGNIVGGALFMGLGTYIL,1
1ucq,C,10,32,22,IWLALGTALMGLGTLYFLVKGM,1
1ucq,C,43,62,19,AITTLVPAIAFTMYLSMLL,1
1ucq,C,80,97,17,ARYADWLFTTPLLLLDL,1
1ucq,C,108,128,20,LALVGADGIMIGTGLVGALT,1
1ucq,C,134,154,20,FVWWAISTAAMLYILYVLFF,1
1ucq,C,174,192,18,RNVTVVLWSAYPVVWLIG,1
1ucq,C,204,224,20,TLLFMVLDVSAKVGFGLILL,1
5kyh,A,4,26,22,IATLLLILIAVAAAVLLYTWVS,1
4z34,A,49,71,22,KLVMGLGITVCIFIMLANLLVM,1
4z34,A,89,110,21,NLAAADFFAGLAYFYLMFNTG,1
4z34,A,117,141,24,VSTWLLRQGLIDTSLTASVANLLA,1
4z34,A,169,189,20,VIWTMAIVMGAIPSVGWNCI,1
4z34,A,196,223,27,NMAPLYSDSYLVFWAIFNLVTFVVMVV,1
4z34,A,262,285,23,VLGAFIICWTPGLVLLLLDVCCP,1
4z34,A,288,310,22,VLAYEKFFLLLAEFNSAMNPII,1
4chw,D,13,29,16,NAVLAAPGLLAVAALT,1
4chw,D,41,60,19,AALLAVIWGAYLLQLAATL,1
4chw,D,75,92,17,AIDVLAVLVPLAAFLLD,1
4chw,D,98,112,14,LYCAVWLLKPLRDS,1
4chw,D,130,147,17,GVTTLFGVVLFAVALAA,1
4chw,D,188,210,22,RVLAGAVMMSGIGIFGLWAGIL,1
4aps,A,18,34,16,FMTEMWERFSYYGMRA,1
4aps,A,59,74,15,MAIYASMVYLSGTIG,1
4aps,A,88,101,13,FWGGVLIMLGHIV,1
4aps,A,113,127,14,SIILIIIGTGFLKP,1
4aps,A,152,166,14,FGINLGAFIAPLIV,1
4aps,A,180,195,15,LAAIGMFIGLLVYYF,1
4aps,A,225,241,16,LAVAGFIAIIVVMNLV,1
4aps,A,249,263,14,INLLTIVAIAIPVF,1
4aps,A,288,304,16,FIAAVLFWAIEEQGSV,1
4aps,A,325,339,14,SLNPLFIMLYTPFF,1
4aps,A,358,370,12,VGLMFAGLSFLL,1
4aps,A,391,404,13,SWALVILGEMLIS,1
4aps,A,429,442,13,SSSVGSALNAQLV,1
4aps,A,456,470,14,FGLGSVVLGIVLVF,1
3ar3,A,54,74,20,QFEDLLVRILLLAACISFVL,1
3ar3,A,89,111,22,PFVILLILIANAIVGVWQERNA,1
3ar3,A,253,277,24,EFGEQLSKVISLICVAVWLINIGH,1
3ar3,A,296,318,22,IAVALAVAAIPEGLPAVITTCL,1
3ar3,A,760,783,23,RYLISSNVGEVVCIFLTAALGLP,1
3ar3,A,786,809,23,IPVQLLWVNLVTDGLPATALGFN,1
3ar3,A,833,854,21,FRYMAIGGYVGAATVGAAAWW,1
3ar3,A,897,916,19,MALSVLVTIEMCNALNSLS,1
3ar3,A,927,950,23,VNIWLLGSICLSMSLHFLILYVD,1
3ar3,A,965,987,22,WLMVLKISLPVIGLDEILKFIA,1
1kfy,P,13,38,25,WGLFGAGGMWSAIIAPVMILLVGIL,1
1kfy,P,62,83,21,GRVFLFLMIVLPLWCGLHRMH,1
1kfy,P,94,116,22,AGKWVFYGLAAILTVVTLIGVV,1
3jcg,E,296,310,14,IATIFMPLTFIAGI,1
3jcg,E,331,343,12,AVMGVIAVIMVV,1
5bqj,J,13,33,20,ISTIGLLGAGIGIAIVFAAL,1
5bqj,J,49,71,22,MAILGFALSEATGLFCLMVSFL,1
2kyv,E,31,49,18,FINFCLILICLLLICIIV,1
3jcf,E,294,315,21,TIIATIFMPLTFIAGIYGMNF,1
3jcf,E,326,346,20,YPVVLAVMGVIAVIMVVYFK,1
6prc,H,16,33,17,WYAQWLVIWTVVLLYLR,1
1ehk,C,9,23,14,AVILVLTLTILVFW,1
3ar2,A,57,77,20,DLLVRILLLAACISFVLAWF,1
3ar2,A,87,104,17,VEPFVILLILIANAIVG,1
3ar2,A,257,274,17,QLSKVISLICVAVWLIN,1
3ar2,A,294,311,17,FKIAVALAVAAIPEGLP,1
3ar2,A,760,780,20,RYLISSNVGEVVCIFLTAAL,1
3ar2,A,787,807,20,PVQLLWVNLVTDGLPATALG,1
3ar2,A,832,851,19,FFRYMAIGGYVGAATVGAA,1
3ar2,A,899,916,17,LSVLVTIEMCNALNSLS,1
3ar2,A,932,950,18,LGSICLSMSLHFLILYVD,1
3ar2,A,965,987,22,WLMVLKISLPVIGLDEILKFIA,1
4hyt,G,29,47,18,GLIFAALAFIVGLIIILS,1
4z35,A,51,75,24,VMGLGITVCIFIMLANLLVMVAIY,1
4z35,A,86,109,23,LMANLAAADFFAGLAYFYLMFNT,1
4z35,A,121,144,23,LLRQGLIDTSLTASVANLLAIAI,1
4z35,A,164,187,23,VVVIVVIWTMAIVMGAIPSVGWN,1
4z35,A,203,226,23,DSYLVFWAIFNLVTFVVMVVLYA,1
4z35,A,260,284,24,VIVLGAFIICWTPGLVLLLLDVCC,1
4z35,A,288,314,26,VLAYEKFFLLLAEFNSAMNPIIYSYR,1
4jc9,M,53,69,16,SLGVLSLFSGLMWFFT,1
4jc9,M,118,135,17,SFFMFVAVWSWWGRTYL,1
4jc9,M,145,163,18,TAWAFLSAIWLWMVLGFI,1
4jc9,M,201,221,20,HGLSIAFLYGSALLFAMHGA,1
4jc9,M,268,285,17,AIWMAVLVTLTGGIGIL,1
4chv,D,14,29,15,AVLAAPGLLAVAALT,1
4chv,D,41,58,17,AALLAVIWGAYLLQLAA,1
4chv,D,75,92,17,AIDVLAVLVPLAAFLLD,1
4chv,D,98,112,14,LYCAVWLLKPLRDS,1
4chv,D,127,146,19,NLIGVTTLFGVVLFAVALA,1
4chv,D,191,211,20,AGAVMMSGIGIFGLWAGILA,1
4hyc,D,11,26,15,MPLMLLFVQIIAIVL,1
4hyc,D,48,64,16,IFIGMLLAFTLVLLVL,1
4hyc,D,73,90,17,AAFIGFALFMTFLYIFG,1
4hyc,D,106,119,13,TLIGAVAVTALLY,1
4hyc,D,127,143,16,DILGVLISAGVASIFG,1
4hyc,D,152,164,12,VLLVLLAVYDAI,1
4hyc,D,215,229,14,MGMGDLIMPSILVV,1
4hyc,D,249,262,13,GAMVGSLVGLAVL,1
4hyc,D,275,289,14,PPLNGGAILGFLVG,1
3j9u,W,14,36,22,IGCASAIIFTSLGAAYGTAKSG,1
3j9u,W,56,77,21,VIMAGIIAIYGLVVSVLVCYS,1
3j9u,W,91,112,21,GAGLSVGLSGLAAGFAIGIVG,1
3j9u,W,131,152,21,ILIFAEVLGLYGLIVALLLNS,1
4hts,A,8,28,20,ELRYRLIISIIAFLIGSGIA,1
4hts,A,70,87,17,VGFIIASPVILYQFWRF,1
4hts,A,104,123,19,LGSILLFMLGALFAYFIVL,1
4hts,A,155,170,15,LVVAFGIAFEMPIVL,1
4hts,A,185,203,18,SFRKYFIVIAFVIGAIIA,1
4hts,A,207,223,16,TQVLMAIPLLLLYEIS,1
2ls3,A,5,27,22,TVLHIIQVVISYFLMLIFMTYN,1
1ba4,A,27,36,9,KGAIIGLMV,1
2w1p,D,48,66,18,SGEFVGTFLFLWSAFVIA,1
2w1p,D,87,104,17,ISFGFGFGVMVGVFITY,1
2w1p,D,131,151,20,LMAFTQIVAGMAAAGAASAM,1
2w1p,D,170,189,19,GLFLEAFGTAILCLTVLML,1
2w1p,D,200,216,16,PFVIGIALLIAHLICI,1
2w1p,D,243,260,17,IYWLGPILGAFLAYSIW,1
4xp1,A,35,54,19,FLLSVIGFAVDLANVWRFP,1
4xp1,A,64,82,18,FLVPYGIMLAVGGIPLFY,1
4xp1,A,113,133,20,VLIAFYVDFYYNVIIAWSLR,1
4xp1,A,236,255,19,WDMALCLLIVYLICYFSLW,1
4xp1,A,261,280,19,GKVVWFTALFPYAVLLILL,1
4xp1,A,305,328,23,KAEVWVDAATQVFFSLGPGFGVL,1
4xp1,A,345,361,16,LLTSFINSATSFIAGF,1
4xp1,A,409,429,20,FFMMLATLGLDSSFGGSEAI,1
4xp1,A,449,464,15,GLFSLYFVVGLASCT,1
4xp1,A,468,489,21,YFFHLLDRYAAGYSILVAVFF,1
4xp1,A,526,545,19,APIFLLFITVYGLIGYEPL,1
4xp1,A,555,570,15,ANALGWCIAGSSVVM,1
5iof,A,29,49,20,VVALALIPEAIAFSIIAGVD,1
5iof,A,51,68,17,VGLYASFIIALITAFLG,1
5iof,A,75,89,14,AATGAMALLMTGLV,1
5iof,A,95,114,19,YLFAATVLTGVLQVVFGWA,1
5iof,A,128,147,19,VGFVNALAILIFMAQLPQF,1
5iof,A,153,169,16,MYAMVAAGLAIIYLLP,1
5iof,A,176,192,16,SALVAIVVLTVVAVVT,1
5iof,A,224,242,18,AIIFPVALTLSLVGLLES,1
5iof,A,264,276,12,GQGVANIVTGFF,1
5iof,A,301,320,19,TFVAGAFLMVLILALQPLL,1
5iof,A,322,341,19,IPMAALVAVMMVVAISTFD,1
5iof,A,358,370,12,MLATVAVTVFTH,1
5iof,A,372,385,13,SLGVLIGVVLSAL,1
1e0p,C,12,33,21,LALGTALMGLGTLYFLVKGMG,1
1e0p,C,41,62,21,FYAITTLVPAIAFTMYLSMLL,1
1e0p,C,80,100,20,ARYADWLFTTPLLLLDLALL,1
1e0p,C,106,127,21,TILALVGADGIMIGTGLVGAL,1
1e0p,C,134,157,23,FVWWAISTAAMLYILYVLFFGFT,1
1e0p,C,171,192,21,KVLRNVTVVLWSAYPVVWLIG,1
1e0p,C,204,226,22,TLLFMVLDVSAKVGFGLILLRS,1
3fye,B,61,80,19,LVIIAAITIFVTLLILYAV,1
3fye,B,99,117,18,LEIAWTIVPIVILVAIGA,1
3c02,D,14,31,17,GEFLGTFVLMFLGEGAT,1
3c02,D,45,62,17,LCLGWGLAVFFGILVSA,1
3c02,D,88,106,18,PVYFFAQLLGAFVGTSTV,1
3c02,D,138,155,17,FNELILTGILLLVILVV,1
3c02,D,168,185,17,LSSVVGLIILCIGITFG,1
3c02,D,221,238,17,VPLVAPCVGSVVFCQFY,1
4xpg,A,35,54,19,FLLSVIGFAVDLANVWRFP,1
4xpg,A,64,82,18,FLVPYGIMLAVGGIPLFY,1
4xpg,A,113,133,20,VLIAFYVGFYYNVIIAWSLR,1
4xpg,A,238,255,17,MALCLLIVYLICYFSLW,1
4xpg,A,261,280,19,GKVVWFTALFPYAALLILL,1
4xpg,A,305,328,23,KAEVWADAATQVFFSLGPGFGVL,1
4xpg,A,345,360,15,LLTSFINSATSFIAG,1
4xpg,A,410,429,19,FMMLATLGLDSSFGGMEAI,1
4xpg,A,449,464,15,GLFSLYFVVGLASCT,1
4xpg,A,468,491,23,YFFHLLDRYAAGYSILVAVFFEA,1
4xpg,A,522,545,23,WRFVAPIFLLFITVYLLIGYEPL,1
4xpg,A,555,571,16,ANALGWCIAGSSVVMI,1
3du2,H,16,32,16,IYSFWIFLAGLIYYLQ,1
1btt,A,3,21,18,SELLISTAVQGILFALLG,1
2r9h,B,37,61,24,MAAVVGTLVGLAAVAFDKGVAWLQ,1
2r9h,B,81,97,16,AFLCSAVLAMFGYFLV,1
2r9h,B,128,142,14,PVKFFGGLGTLGGG,1
2r9h,B,144,159,15,LGREGPTVQIGGNIG,1
2r9h,B,216,232,16,AVFIGVIMSTIMYRIF,1
2r9h,B,253,277,24,LYLILGIIFGIFGPIFNKWVLGMQ,1
2r9h,B,290,305,15,WVLMGGAIGGLCGLL,1
2r9h,B,337,351,14,VARVITTLLCFSSG,1
2r9h,B,353,368,15,GGIFAPMLALGTVLG,1
2r9h,B,422,439,17,LPMIITGLGATLLAQFT,1
5l24,B,5,20,15,SLLGMAVLIAIAVLL,1
5l24,B,31,46,15,VAGAFLIQVALGALV,1
5l24,B,103,132,29,MIVFFSSLMAVLYYIGVMQLLIKVIGGFL,1
5l24,B,176,191,15,MSGGLASVAGSVLAG,1
5l24,B,203,220,17,AASFMAAPGGLLFAKLL,1
5l24,B,242,274,32,TNVIDAAASGAVTGAQIAIAVGASLLAFVALI,1
5l24,B,362,375,13,LCGFANLGSIAVL,1
5l24,B,395,412,17,KAVVAGSLSNLMSAVIA,1
2wse,4,46,59,13,NGRWAMLGVAGML,1
2wse,4,91,103,12,VIEFILSHYVEI,1
2wse,4,155,170,15,NGRLMLAFLGFIIQH,1
4q9k,A,43,69,26,WLDRLYMLVGTLAAIIHGVALPLMML,1
4q9k,A,115,138,23,GIGAGVLIVAYIQVSFWCLAAGR,1
4q9k,A,181,204,23,IGDKIGMFFQAMATFFGGFIIGF,1
4q9k,A,211,232,21,LVILAISPVLGLSAGIWAKIL,1
4q9k,A,286,310,24,KAITANISMGAAFLLIYASYALAF,1
4q9k,A,329,352,23,VFFSVLIGAFSVGQASPNIEAFA,1
4q9k,A,704,728,24,PYFVVGIFCAIINGGLQPAFSVIF,1
4q9k,A,754,776,22,FLILGIISFITFFLQGFTFGKA,1
4q9k,A,826,848,22,SRLAVIFQNIANLGTGIIISLI,1
4q9k,A,853,876,23,TLLLLAIVPIIAIAGVVEMKMLS,1
4q9k,A,928,952,24,KKAHVFGITFSFTQAMMYFSYAAC,1
4q9k,A,972,991,19,VFSAIVFGAMAVGQVSSFA,1
4tpj,B,15,35,20,TVSLIELWERFGYYGMQALI,1
4tpj,B,51,72,21,LVWSACAALIYVSPAIGGWVG,1
4tpj,B,75,97,22,LGTKRTMLLGAGILSVGYALMT,1
4tpj,B,106,126,20,FSALGVIVVGNGLFKPNAGN,1
4tpj,B,143,162,19,TIYYMAVNVGSTFSMLLTP,1
4tpj,B,181,200,19,FAVCCVGILVGLGNYALMH,1
4tpj,B,215,261,46,NKKSLAIVLALAALSVVASAIILEYEDVARVFVYAAGVAVLGIFFH,1
4tpj,B,277,299,22,LILTVQTVFFFIFYQQMSTSLA,1
4tpj,B,323,342,19,QFQALNPIWIMVLSPVLAW,1
4tpj,B,357,376,19,AKFALGFAVVAIGFFIYGF,1
4tpj,B,389,411,22,VMIWGYASYSLGELLVSGLGLA,1
4tpj,B,425,444,19,MGAYFVASGISQYLGGVVA,1
4tpj,B,466,485,19,FNKLGVAAVVCTIIALAVL,1
4csk,D,14,32,18,VAEFLATTLFVFISIGSA,1
4csk,D,50,68,18,KVSLAFGLSIATLAQSVG,1
4csk,D,93,112,19,ALMYIIAQCVGAIVATAIL,1
4csk,D,138,156,18,LGIEIIGTLQLVLCVLAT,1
4csk,D,167,184,17,APLAIGLSVALGHLLAI,1
4csk,D,210,227,17,IFWVGPFIGGALAVLIY,1
5l2b,C,7,22,15,LGMAVLIAIAVLLST,1
5l2b,C,28,42,14,IRTVAGAFLIQVAL,1
5l2b,C,103,135,32,MIVFFSSLMAVLYYIGVMQLLIKVIGGFLQKM,1
5l2b,C,137,152,15,TSKAESMSAAASIFV,1
5l2b,C,154,165,11,TEAPLVVRPYI,1
5l2b,C,172,184,12,LFAVMSGGLASV,1
5l2b,C,207,222,15,MAAPGGLLFAKLLVP,1
5l2b,C,243,274,31,NVIDAAASGAVTGAQIAIAVGASLLAFVALI,1
5l2b,C,366,384,18,ANLGSIAVLVGGLSIMAP,1
5l2b,C,387,408,21,KDVARLGIKAVVAGSLSNLMS,1
5kbt,D,522,543,21,YEIWMCIVFAYIGVSVVLFLV,1
5kbt,D,596,617,21,SGRIVGGVWWFFTLIIISSYT,1
5kbt,D,792,812,20,AGVFYILVGGLGLAMLVALI,1
2ws3,L,15,35,20,FILVRATAIVLTLYIIYMVG,1
2ws3,L,59,80,21,FTLLALFSILIHAWIGMWQVL,1
2ws3,L,89,109,20,RLMLQLVIVVALVVYVIYGF,1
2bhw,C,64,82,18,EVIHSRWAMLGALGSVFP,1
2bhw,C,125,142,17,AIWATQVILMGAVEGYR,1
2bhw,C,180,199,19,LKNGRLAMFSMFGFFVQAI,1
5lev,A,12,25,13,INLIVSLLGFVAT,1
5lev,A,60,76,16,ISGAVFLIILFCFIPF,1
5lev,A,99,112,13,GALLAICCMIFLG,1
5lev,A,124,138,14,KLLLPTAASLPLLM,1
5lev,A,171,187,16,YMGLLAVFCTNAINIL,1
5lev,A,195,209,14,GQSLVISASIIVFN,1
5lev,A,225,237,12,YFMIPFFFTTLG,1
5lev,A,254,267,13,CYFAGMTFAGVGI,1
5lev,A,273,291,18,TMLLFFMPQVFNFLYSLP,1
5lev,A,383,397,14,LLLQILGSAITFSI,1
3stz,F,26,50,24,RAAGAATVLLVIVLLAGSYLAVLA,1
3stz,F,87,111,24,GRLVAVVVMVAGITSFGLVTAALA,1
4oj2,C,11,30,19,AVFAEFLATLLFVFFGLGS,1
4oj2,C,43,60,17,IAMAFGLGIGTLVQALG,1
4oj2,C,84,104,20,RAAFYVAAQLLGAVAGAALL,1
4oj2,C,129,149,20,AVTVELFLTLQLVLCIFAST,1
4oj2,C,159,176,17,PALSIGFSVALGHLLGI,1
4oj2,C,202,219,17,VFWIGPLVGAILGSLLY,1
2npk,C,15,33,18,CTALVLFMTIPGIALFYG,1
2npk,C,45,64,19,TQVTVTFALVCILWVVYGY,1
2npk,C,102,120,18,FQGSFACITVGLIVGALA,1
2npk,C,126,147,21,AVLIFVVVWLTLSYIPIAHMV,1
2npk,C,161,180,19,AGGTVVAINAAIAGLVGAY,1
2npk,C,200,219,19,VFTGTAILYIGWFGFNAGS,1
2npk,C,231,251,20,VNTVVATAAAILGWIFGEWA,1
2npk,C,259,276,17,GACSGAIAGLVGVTPAC,1
2npk,C,282,302,20,GALIIGVVAGLAGLWGVTML,1
2npk,C,313,332,19,VFGVAGVCGIVGCIMTGIF,1
2npk,C,353,381,28,VQLESIAITIVWSGVVAFIGYKLADLTV,1
3ag3,Z,17,35,18,GLSVTFLSFLLPAGWVLY,1
1kqf,I,13,33,20,DRACHWTVVICFFLVALSGI,1
1kqf,I,58,77,19,FFGIAIFVALMFMFVRFVH,1
1kqf,I,112,131,19,QKMMFWSIMSMIFVLLVTG,1
1kqf,I,155,175,20,AAAGIILIHAILIHMYMAFW,1
5ebl,F,26,50,24,RAAGAATVLLVIVLLAGSYLAVLA,1
5ebl,F,87,113,26,GRLVAVVVMVAGITSFGLVTAALATW,1
5b1a,Z,17,37,20,GLSVTFLSFLLPAGWVLYHL,1
2bg9,E,226,243,17,APCVLISSLVVLVYFLP,1
2bg9,E,251,268,17,TLSISVLLAQTIFLFLI,1
2bg9,E,289,308,19,MFVSLVIVTNCVIVLNVSL,1
2bg9,E,449,466,17,CFWIALLLFSLGTLAIF,1
3zrs,D,47,68,21,VFITLITGLYLVTNALFALAY,1
3zrs,D,109,132,23,NTLVTLEALCGMLGLAVAARLIY,1
2r6g,G,15,32,17,THLLLLLFIAAIMFPLL,1
2r6g,G,86,107,21,NSVKVAGISAIGIVALSTTCA,1
2r6g,G,117,133,16,KATLLKGMLIFQMFPA,1
2r6g,G,160,178,18,GVIFAYLGGIALHVWTIK,1
2r6g,G,214,229,15,LAVVFILSFIAAITE,1
2r6g,G,269,285,16,SALPITIVFLLAQRWL,1
4v1f,I,17,39,22,GLIMGGGAIGAGIGDGIAGNAL,1
4v1f,I,55,77,22,PFFITVGLVEAAYFINLAFMAL,1
2k9j,B,692,714,22,ILVVLLSVMGAILLIGLAALLI,1
5ko2,A,43,69,26,WLDRLYMLVGTLAAIIHGVALPLMML,1
5ko2,A,115,138,23,GIGAGVLIVAYIQVSFWCLAAGR,1
5ko2,A,181,204,23,IGDKIGMFFQAMATFFGGFIIGF,1
5ko2,A,211,232,21,LVILAISPVLGLSAGIWAKIL,1
5ko2,A,288,310,22,ITANISMGAAFLLIYASYALAF,1
5ko2,A,330,352,22,FFSVLIGAFSVGQASPNIEAFA,1
5ko2,A,704,728,24,PYFVVGIFCAIINGGLQPAFSVIF,1
5ko2,A,753,776,23,LFLILGIISFITFFLQGFTFGKA,1
5ko2,A,824,847,23,TGSRLAVIFQNIANLGTGIIISL,1
5ko2,A,855,878,23,LLLAIVPIIAIAGVVEMKMLSGQ,1
5ko2,A,927,952,25,MKKAHVFGITFSFTQAMMYFSYAAC,1
5ko2,A,973,995,22,FSAIVFGAMAVGQVSSFAPDYA,1
4fc4,E,26,50,24,FWVSSAMAGAYVGLGIILIFTLGN,1
4fc4,E,57,76,19,PLVMGATFGIALTLVIIAG,1
4fc4,E,102,131,29,AILPQTWLGNLVGSVFVALLYSWGGGSLL,1
4fc4,E,142,174,32,LAKTTAPATVLFFKGALCNWLVCLAIWMAIRT,1
4fc4,E,176,194,18,TAKFLAIWWCLLAFIASG,1
4fc4,E,219,245,26,AGIGHNLLWVTLGNTLSGVVFMGLGY,1
3mp7,B,35,55,20,ITGLGIILIGLIGMLIRIVG,1
5u1l,C,36,49,13,VFSYISFALISDK,1
5u1l,C,330,344,14,IQLAVYIGSVISYF,1
1waz,A,27,40,13,VILLGVVGLSALT,1
1waz,A,49,64,15,ALAIFIGLTIYAIQR,1
2m59,B,107,129,22,IILVGTAVIAMFFWLLLVIILR,1
1f88,C,37,64,27,SMLAAYMFLLIMLGFPINFLTLYVTVQ,1
1f88,C,73,99,26,YILLNLAVADLFMVFGGFTTTLYTSL,1
1f88,C,109,133,24,CNLEGFFATLGGEIALWSLVVLAI,1
1f88,C,154,176,22,MGVAFTWVMALACAAPPLVGWS,1
1f88,C,199,223,24,NESFVIYMFVVHFIIPLIVIFFCY,1
1f88,C,254,279,25,IIMVIAFLICWLPYAGVAFYIFTHQ,1
1f88,C,286,308,22,FMTIPAFFAKTSAVYNPVIYIM,1
2maw,A,8,30,22,YGLNLLIPCVLISALALLVFLL,1
2maw,A,36,57,21,KISLGITVLLSLTVFMLLVAE,1
2maw,A,68,90,22,IAQYFASTMIIVGLSVVVTVIV,1
2maw,A,108,130,22,DRLCLMAFSVFTIICTIGILMS,1
2m7g,A,4,27,23,ELLIVVAIIGILAAIAIPQFSAY,1
4yay,A,32,57,25,TLYSIIFVVGIFGNSLVVIVIYFYM,1
4yay,A,63,85,22,SVFLLNLALADLCFLLTLPLWA,1
4yay,A,103,127,24,ASASVSFNLYASVFLLTCLSIDRY,1
4yay,A,144,165,21,AKVTCIIIWLLAGLASLPAII,1
4yay,A,194,220,26,LGLTKNILGFLFPFLIILTSYTLIWK,1
4yay,A,238,261,23,FKIIMAIVLFFFFSWIPHQIFTF,1
4yay,A,286,307,21,TICIAYFNNCLNPLFYGFLGK,1
3gjd,B,13,32,19,LILAMAGNAVGLGNFLRFP,1
3gjd,B,44,63,19,IPYIIAFLLVGIPLMWIEW,1
3gjd,B,90,124,34,KILGVFGLWIPLVVAIYYVYIESWTLGFAIKFLV,1
3gjd,B,167,185,18,AYIVFLITMFINVSILIR,1
3gjd,B,191,212,21,ERFAKIAMPTLFILAVFLVIR,1
3gjd,B,244,266,22,IAAVGQIFFTLSLGFGAIITYA,1
3gjd,B,277,297,20,SGLTAATLNEKAEVILGGSI,1
3gjd,B,340,367,27,GFLWFFLLFFAGLTSSIAIMQPMIAFL,1
3gjd,B,378,396,18,VLWTAAIVFFSAHLVMFL,1
3gjd,B,400,426,26,DEMDFWAGTIGVVFFGLTELIIFFWI,1
3gjd,B,445,469,24,RIYYYVMRYITPAFLAVLLVVWAR,1
3gjd,B,484,502,18,ITRFYIIGLFLFLTFLVF,1
4bw5,B,78,98,20,AIFVVVVVYLVTGGLVFRAL,1
4bw5,B,185,208,23,KIFCILYAIFGIPLFGFLLAGIG,1
4bw5,B,243,263,20,FILAGCIVFVTIPAVIFKYI,1
4bw5,B,299,324,25,WYKPLVWFWILVGLAYFAAVLSMIG,1
5avz,G,25,40,15,VAAVLCVIGIIILLA,1
4uu0,A,55,74,19,QFEDLLVRILLLAACISFV,1
4uu0,A,90,107,17,PFVILLILIANAIVGVW,1
4uu0,A,257,276,19,EQLSKVISLICVAVWLINI,1
4uu0,A,296,317,21,KIAVALAVAAIPEGLPAVITT,1
4uu0,A,760,781,21,IRYLISSNVGEVVCIFLTAAL,1
4uu0,A,786,807,21,LIPVQLLWVNLVTDGLPATAL,1
4uu0,A,834,851,17,FRYMAIGGYVGAATVGA,1
4uu0,A,899,916,17,ALSVLVTIEMCNALNSL,1
4uu0,A,927,947,20,WVNIWLLGSICLSMSLHFLI,1
4uu0,A,968,987,19,MVLKISLPVIGLDEILKFI,1
1f4z,C,11,32,21,WLALGTALMGLGTLYFLVKGM,1
1f4z,C,41,62,21,FYAITTLVPAIAFTMYLSMLL,1
1f4z,C,80,99,19,ARYADWLFTTPLLLLDLAL,1
1f4z,C,106,127,21,TILALVGADGIMIGTGLVGAL,1
1f4z,C,134,156,22,FVWWAISTAAMLYILYVLFFGF,1
1f4z,C,172,192,20,VLRNVTVVLWSAYPVVWLIG,1
1f4z,C,204,225,21,TLLFMVLDVSAKVGFGLILLR,1
5m87,A,41,55,14,GALVAVGYMDPGNW,1
5m87,A,70,85,15,SIIVISSLLAMLLQN,1
5m87,A,113,137,24,FWILTELAIMATDIAEVIGAAIAL,1
5m87,A,147,162,15,AVVITVLDVFLLLLL,1
5m87,A,170,187,17,EALVVCLIFVILFVFLY,1
5m87,A,223,241,18,ASLGIIGATIMPHNLFLH,1
5m87,A,268,284,16,SNIQLSLAMVVNALLL,1
5m87,A,332,351,19,AVALLASGQNSTITGTITG,1
5m87,A,366,382,16,LRRLVTRLIAIIPVVV,1
5m87,A,403,419,16,NNSQVFLALALPFSIV,1
5m87,A,444,465,21,GWLTVIILTLLNLISISSQIA,1
5m87,A,480,497,17,QVISIGIILAMIGLLIW,1
5ax0,A,13,35,22,DAQWVVFAVMALAAIVFSIAVQ,1
5ax0,A,43,66,23,TYYVNIAICTIAATAYYAMAVNG,1
5ax0,A,83,103,20,YARYIDWVFTTPLLLLDLVL,1
5ax0,A,110,132,22,MIAWIMGADIAMIAFGIIGAFT,1
5ax0,A,137,159,22,WFYFVVGCIMLAVLAWGMINPI,1
5ax0,A,174,197,23,TTLLIYLIVLWVIYPIVWGLGAG,1
5ax0,A,205,228,23,EIIAMGILDLLAKPLYAIGVLIT,1
1a11,A,5,22,17,STAISVLLAQAVFLLLT,1
4ksb,A,44,68,24,LDRLYMLVGTLAAIIHGVALPLMM,1
4ksb,A,118,136,18,AGVLIVAYIQVSFWCLAA,1
4ksb,A,183,204,21,DKIGMFFQAMATFFGGFIIGF,1
4ksb,A,209,228,19,LTLVILAISPVLGLSAGIW,1
4ksb,A,292,312,20,ISMGAAFLLIYASYALAFWY,1
4ksb,A,330,348,18,FFSVLIGAFSVGQASPNI,1
4ksb,A,708,729,21,VGIFCAIINGGLQPAFSVIFS,1
4ksb,A,752,772,20,LLFLILGIISFITFFLQGFT,1
4ksb,A,828,847,19,LAVIFQNIANLGTGIIISL,1
4ksb,A,855,875,20,LLLAIVPIIAIAGVVEMKML,1
4ksb,A,929,952,23,KAHVFGITFSFTQAMMYFSYAAC,1
4ksb,A,972,991,19,VFSAIVFGAMAVGQVSSFA,1
5m8a,A,41,58,17,GALVAVGYMDPGNWSTS,1
5m8a,A,68,85,17,LLSIIVISSLLAMLLQN,1
5m8a,A,113,137,24,FWILTELAIMATDIAAVIGAAIAL,1
5m8a,A,147,163,16,AVVITVLDVFLLLLLN,1
5m8a,A,170,190,20,EALVVCLIFVILFVFLYQII,1
5m8a,A,223,241,18,ASLGIIGATIMPHNLFLH,1
5m8a,A,269,285,16,NIQLSLAMVVNALLLI,1
5m8a,A,332,351,19,AVALLASGQNSTITGTITG,1
5m8a,A,366,382,16,LRRLVTRLIAIIPVVV,1
5m8a,A,403,419,16,NNSQVFLALALPFSIV,1
5m8a,A,444,465,21,GWLTVIILTLLNLISISSQIA,1
5m8a,A,480,497,17,QVISIGIILAMIGLLIW,1
3w4t,A,24,44,20,IAMMIGMSVQTLYNLADGIW,1
3w4t,A,60,78,18,PVFMGIIALAAGLGVGTS,1
3w4t,A,101,119,18,ILSLILGVTITITMLPAI,1
3w4t,A,139,161,22,ARVLLAGAFIIVFNNVGNGILR,1
3w4t,A,167,188,21,RAMLAMVLGSGLNIVLDPIFI,1
3w4t,A,197,215,18,AAYATLLSMVVTSLFIAY,1
3w4t,A,243,263,20,RVGLPSSLSQLSMSIAMFFL,1
3w4t,A,281,301,20,AWRITMLGIVPILGMAAATT,1
3w4t,A,324,346,22,KIAFMIELAVVAFIMLFAPQVA,1
3w4t,A,366,387,21,RTLPVFLVLTPFGMMTSAMFQ,1
3w4t,A,392,414,22,EKSLILTIFRTLVMQVGFAYIF,1
3w4t,A,425,445,20,WIGIVIGNMVAAIVGFLWGR,1
4wav,A,17,39,22,IWLALGTIGMLLGMLYFIADGL,1
4wav,A,48,69,21,FYVITILIPAIAAASYLSMFF,1
4wav,A,88,108,20,ARYANWLFTTPLLLLDIGLL,1
4wav,A,112,134,22,QRDIGALVGIDAFMIVTGLVAT,1
4wav,A,144,165,21,FWTISTISMVFLLYYLVAVFG,1
4wav,A,180,200,20,ALRNIILVTWAIYPVAWLVG,1
4wav,A,211,233,22,ETLLFMVLDLVAKVGFGFILLR,1
1mps,H,12,31,19,ASLAIYSFWIFLAGLIYYL,1
3rko,J,8,21,13,GLIAILATLRVIT,1
3rko,J,29,42,13,LYLIISLLAISGV,1
3rko,J,52,67,15,ALEIIVYAGAIMVLF,1
3rko,J,94,106,12,GPAILSAIMLVV,1
3rko,J,142,155,13,LASMLLLAGLVVA,1
2oau,G,31,52,21,VAALAIIIVGLIIARMISNAV,1
2oau,G,71,90,19,LVRYGIIAFTLIAALGRVG,1
2oau,G,92,104,12,TASVIAVLGAAG,1
2mxb,A,15,38,23,LILTLSLILVLISLLLTVLALLS,1
4bor,E,221,243,22,IINIIAPCVLISSLVVLVYFLP,1
4bor,E,251,273,22,TLSISVLLAQTIFLFLIAQKVP,1
4bor,E,284,308,24,YLIFVMFVSLVIVTNCVIVLNVSL,1
4bor,E,449,473,24,CFWIALLLFSLGTLAIFLTGHLNQ,1
4umw,A,130,145,15,LITLIVMMAISWGLE,1
4umw,A,152,176,24,QLAFIATTLVGLYPIARQALRLIK,1
4umw,A,180,198,18,FAIETLMSVAAIGALFIG,1
4umw,A,200,213,13,AEAAMVLLLFLIG,1
4umw,A,351,366,15,RIYTPAIMAVALLVT,1
4umw,A,385,399,14,TLLLIGCPCALVIS,1
4umw,A,685,701,16,ITIALGLKGIFLVTTL,1
4umw,A,706,724,18,LWLAVLADTGATVLVTAN,1
2dqs,A,54,73,19,QFEDLLVRILLLAACISFV,1
2dqs,A,90,111,21,FVILLILIANAIVGVWQERNA,1
2dqs,A,254,276,22,FGEQLSKVISLICVAVWLINIG,1
2dqs,A,296,318,22,IAVALAVAAIPEGLPAVITTCL,1
2dqs,A,760,781,21,RYLISSNVGEVVCIFLTAALG,1
2dqs,A,786,808,22,IPVQLLWVNLVTDGLPATALGF,1
2dqs,A,833,852,19,FRYMAIGGYVGAATVGAAA,1
2dqs,A,898,916,18,ALSVLVTIEMCNALNSLS,1
2dqs,A,927,948,21,VNIWLLGSICLSMSLHFLILY,1
2dqs,A,967,987,20,MVLKISLPVIGLDEILKFIA,1
5h2f,z,8,25,17,LAALVILSFVMVIGVPV,1
5h2f,z,40,54,14,FLGSGLWIALVLVV,1
5ctg,C,11,28,17,AGLAGNIFALALFLSPV,1
5ctg,C,46,63,17,PYLFSLLNCLICLWYGL,1
5ctg,C,71,92,21,LVATVNGIGAVFQLAYICLFI,1
5ctg,C,104,122,18,IGLLVLVVCGFALVSHAS,1
5ctg,C,134,154,20,VGAVSMASLISMFASPLAVM,1
5ctg,C,167,186,19,FYLSLSTFLMSASFALYGL,1
5ctg,C,191,213,22,FIYFPNGLGLILGAMQLALYAY,1
4gp5,C,10,27,17,VILVLTLTILVFWLGVY,1
2vl1,A,254,263,9,TVHGVGAHA,1
2vl1,A,269,288,19,LRKDALLMSSKMIVAASEI,1
2vl1,A,336,349,13,AAEFDRLIKINDG,1
2hhk,H,12,29,17,ASLAIYSFWIFLAGLIY,1
2fec,B,37,61,24,MAAVVGTLVGLAAVAFDKGVAWLQ,1
2fec,B,81,98,17,AFLCSAVLAMFGYFLVR,1
2fec,B,128,142,14,PVKFFGGLGTLGGG,1
2fec,B,144,159,15,LGREGPTVQIGGNIG,1
2fec,B,216,233,17,AVFIGVIMSTIMYRIFN,1
2fec,B,253,277,24,LYLILGIIFGIFGPIFNKWVLGMQ,1
2fec,B,290,305,15,WVLMGGAIGGLCGLL,1
2fec,B,335,351,16,IFVARVITTLLCFSSG,1
2fec,B,353,368,15,GGIFAPMLALGTVLG,1
2fec,B,422,439,17,LPMIITGLGATLLAQFT,1
2ff9,A,64,84,20,LALIVLLIVVGNVLVIVAIA,1
2ff9,A,94,116,22,LFIMSLASADLVMGLLVVPFGA,1
2ff9,A,133,154,21,WTSVDVLCVTASIETLCVIAL,1
2ff9,A,176,196,20,ALVCTVWAISALVSFLPILM,1
2ff9,A,224,244,20,AIASSVVSFYVPLCIMAFVY,1
2ff9,A,314,333,19,LGIIMGVFTLCWLPFFLAN,1
2ff9,A,351,368,17,NWLGYANSAFNPIIYCR,1
5a6g,B,253,267,14,ICTLLCLVFTGTCG,1
5a6g,B,308,322,14,LVVIMICVALVVLP,1
4kjw,B,37,61,24,MAAVVGTLVGLAAVAFDKGVAWLQ,1
4kjw,B,84,97,13,CSAVLAMFGYFLV,1
4kjw,B,129,142,13,VKFFGGLGTLGGG,1
4kjw,B,144,156,12,LGREGPTVQIGG,1
4kjw,B,216,232,16,AVFIGVIMSTIMYRIF,1
4kjw,B,253,277,24,LYLILGIIFGIFGPIFNKWVLGMQ,1
4kjw,B,290,305,15,WVLMGGAIGGLCGLL,1
4kjw,B,338,351,13,ARVITTLLCFSSG,1
4kjw,B,353,368,15,GGIFAPMLALGTVLG,1
4kjw,B,423,439,16,PMIITGLGATLLAQFT,1
4ntb,C,8,27,19,ATVTLVGVLLQAYFSLQVI,1
4ntb,C,52,71,19,QVNCSEYFPLFLATLWVAG,1
4ntb,C,79,97,18,ALCGLFYLFARLRYFQGY,1
4ntb,C,104,124,20,LTPLYASARALWLLVAMAAL,1
1c0v,A,8,33,25,LYMAAAVMMGLAAIGAAIGIGILGG,1
1c0v,A,54,77,23,IVMGLVDAIPMIAVGLGLYVMFA,1
3b60,B,28,44,16,VAGIALILNAASDTFM,1
3b60,B,69,89,20,VVIGLMILRGITSYISSYCI,1
3b60,B,142,162,20,LITVVREGASIIGLFIMMFY,1
3b60,B,168,185,17,IILVVLAPIVSIAIRVV,1
3b60,B,249,265,16,ISDPIIQLIASLALAF,1
3b60,B,291,305,14,IALMRPLKSLTNVN,1
2f2b,D,8,25,17,IAEFIGTFILVFFGAGS,1
2f2b,D,56,74,18,AIGLAFGFAIAASIYALG,1
2f2b,D,101,118,17,PYIIAQLLGAAFGSFIF,1
2f2b,D,147,164,17,LAEVVGTFLLMITIMGI,1
2f2b,D,175,191,16,GIIIGLTVAGIITTLG,1
2f2b,D,223,240,17,IYVIGPIVGAVLAALTY,1
5a63,D,63,78,15,FLFWVIVLTSWITIF,1
5v5s,L,11,28,17,AWVIAIIIMLAGGLAIL,1
5v5s,L,342,358,16,TLVEAIILVFLVMYLF,1
5v5s,L,367,386,19,PTIAVPVVLLGTFAVLAAF,1
5v5s,L,396,412,16,GMVLAIGLLVDDAIVV,1
5v5s,L,442,458,16,VGIAMVLSAVFVPMAF,1
5v5s,L,469,489,20,FSITIVSAMALSVLVALILT,1
5v5s,L,542,559,17,VLYLIIVVGMAYLFVRL,1
5v5s,L,874,891,17,SLYAISLIVVFLCLAAL,1
5v5s,L,899,919,20,SVMLVVPLGVIGALLAATFR,1
5v5s,L,927,943,16,QVGLLTTIGLSAKNAI,1
5v5s,L,976,992,16,MTSLAFILGVMPLVIS,1
5v5s,L,1001,1019,18,AVGTGVMGGMVTATVLAI,1
2v5z,A,486,498,12,PSVPGLLRLIGL,1
1s52,A,9,30,21,WIWLALGTALMGLGVLYFLVK,1
1s52,A,43,67,24,AITTLVPAIAFTMYLSMLLGYGLT,1
1s52,A,79,99,20,WARYADWLFTTPLLLLDLAL,1
1s52,A,106,128,22,TILALVGADGIMIGTGLVGALT,1
1s52,A,134,158,24,FVWWAISTAAMLYILYVLFFGFTS,1
1s52,A,171,195,24,KVLRNVTVVLWSAYPVVWLIGSEG,1
1s52,A,202,224,22,IETLLFMVLDVSAKVGFGLILL,1
4eeb,E,293,311,18,LTIIATIFMPLTFIAGIY,1
4eeb,E,329,346,17,VLAVMGVIAVIMVVYFK,1
4ytm,D,56,79,23,TLFKIERYFAAAMVPLIPAAYFI,1
4ytm,D,84,108,24,DLCLALALTLHVHWGVWGVVNDYG,1
4ytm,D,117,139,22,AAAVRVGAYIFTACLLAGLLYF,1
2x5u,M,52,71,19,ASGIAAFAFGSTAILIILF,1
2x5u,M,115,132,17,AGLFMTLSLGSWWIRVY,1
2x5u,M,144,162,18,AWNFAAAIFFVLCIGCIH,1
2x5u,M,198,219,21,WHGFSIGFAYGCGLLFAAHGA,1
2x5u,M,264,284,20,RWGWFFSLMVMVSASVGILL,1
5dsg,A,34,54,20,IATVTGSLSLVTVVGNILVM,1
5dsg,A,74,93,19,ACADLIIGAFSMNLYTVYI,1
5dsg,A,104,124,20,CDLWLALDYVVSNASVMNLL,1
5dsg,A,154,175,21,AAWVLSFVLWAPAILFWQFVV,1
5dsg,A,191,212,21,NPAVTFGTAIAAFYLPVVIMT,1
5dsg,A,405,427,22,LLAFILTWTPYNVMVLVNTFCQ,1
5dsg,A,434,452,18,WSIGYWLCYVNSTINPAC,1
5fjg,A,15,38,23,EFIDHLLTMGVGVHFAALIFFLV,1
5fjg,A,50,74,24,TALSCIVMVSAGLILNSQAVMWTD,1
5fjg,A,90,112,22,SNGYRYVNWMATIPCLLLQLLI,1
5fjg,A,121,144,23,FSTATWLILAAWGMIITGYVGQL,1
5fjg,A,154,177,23,IWGAVSTAFFVVMNWIVGTKIFK,1
5fjg,A,190,210,20,TKVFWLMMFAWTLYPIAYLV,1
5fjg,A,220,243,23,VLRQLLFTIADISSKVIYGLMIT,1
1vry,A,0,20,20,VGLGITTVLTLTTQSSGSRA,1
1vry,A,27,50,23,VKAIDIWLAVCLLFVFSALLEYA,1
5xas,B,29,41,12,LYAFALITLLLS,1
5xas,B,51,72,21,VGGFAIMFIIGAIFGEIGKRL,1
5xas,B,79,92,13,GGAPVMIFLVAAY,1
5xas,B,115,126,11,FLNLFIAVLIT,1
5xas,B,150,166,16,GIVGASIFGIAIGLVF,1
5xas,B,209,223,14,STAIAILTIANIFA,1
5xas,B,273,288,15,LSTTCFLLAYVVAKK,1
5xas,B,297,310,13,IHYFAWMVLIVAA,1
5xas,B,333,346,13,KQLLWVLMVGVGV,1
5xas,B,358,373,15,TFANVVIAAIIVIGA,1
5xas,B,431,442,11,GIVLVIASIVF,1
4bog,E,221,243,22,IINIIAPCVLISSLVVLVYFLP,1
4bog,E,251,273,22,TLSISVLLAQTIFLFLIAQKVP,1
4bog,E,284,308,24,YLIFVMFVSLVIVTNCVIVLNVSL,1
4bog,E,449,473,24,CFWIALLLFSLGTLAIFLTGHLNQ,1
5h36,C,7,25,18,LLDWFGLCIFTVTGALVA,1
5h36,C,31,53,22,IAGFVLLGAVTGVGGGTIRDLV,1
5h36,C,66,82,16,YVLACLGVAVFTFFFA,1
5h36,C,92,109,17,LWLDAVGLSLFAVTGAE,1
5h36,C,119,140,21,IAIAMGVATATFGGILRDLLG,1
5h36,C,151,166,15,YITAALLGAAAFVAL,1
5h36,C,175,191,16,ALGAGFAAAFLSRAAG,1
1m0l,C,13,29,16,ALGTALMGLGTLYFLV,1
1m0l,C,45,59,14,TTLVPAIAFTMYLS,1
1m0l,C,82,96,14,YADWLFTTPLLLLD,1
1m0l,C,110,124,14,LVGADGIMIGTGLV,1
1m0l,C,137,152,15,WAISTAAMLYILYVL,1
1m0l,C,175,190,15,NVTVVLWSAYPVVWL,1
1m0l,C,206,222,16,LFMVLDVSAKVGFGLI,1
3ny8,A,36,57,21,GIVMSLIVLAIVFGNVLVITA,1
3ny8,A,70,91,21,FITSLACADLVMGLAVVPFGA,1
3ny8,A,109,129,20,TSIDVLCVTASIWTLCVIAV,1
3ny8,A,150,168,18,RVIILMVWIVSGLTSFLP,1
3ny8,A,201,220,19,ASSIVSFYVPLVIMVFVYS,1
3ny8,A,275,295,20,GIIMGTFTLCWLPFFIVNIV,1
3ny8,A,310,327,17,LNWIGYVNSGFNPLIYC,1
5heg,E,202,215,13,PMLFILFISWTAF,1
5heg,E,223,238,15,VTLVVSTLIAHIAFN,1
5heg,E,258,273,15,FMIYLFYFVAVIEVT,1
5heg,E,294,309,15,RIAFPVVFLLANIIL,1
5fik,W,14,29,15,LGLPLVTLIVLFPSL,1
5fik,W,75,89,14,ILFIGSTNLLGLLP,1
5fik,W,96,114,18,QLSMNLGMAIPLWAGAVI,1
5fik,W,143,168,25,IETISLFIQPMALAVRLTANITAGH,1
5fik,W,194,215,21,ILILLTILEFAVAMIQAYVFT,1
2a95,B,41,65,24,AYMFLLIMLGFPINFLTLYVTVQH,1
2a95,B,72,95,23,NYILLNLAVADLFMVFGGFTTTL,1
2a95,B,110,136,26,NLEGFFATLGGEIALWSLVVLAIERY,1
2a95,B,153,178,25,IMGVAFTWVMALACAAPPLVGWSRY,1
2a95,B,202,226,24,FVIYMFVVHFIIPLIVIFFCYGQL,1
2a95,B,250,274,24,TRMVIIMVIAFLICWLPYAGVAFY,1
2a95,B,290,311,21,PAFFAKTSAVYNPVIYIMMNK,1
1vrn,M,55,71,16,IAAFAFGSTAILIILF,1
1vrn,M,115,131,16,AGLFMTLSLGSWWIRV,1
1vrn,M,145,162,17,WNFAAAIFFVLCIGCIH,1
1vrn,M,198,216,18,WHGFSIGFAYGCGLLFAA,1
1vrn,M,267,284,17,WFFSLMVMVSASVGILL,1
5jjj,D,24,38,14,VFIFVGALTVLFGA,1
5jjj,D,65,80,15,GLIILLGINLGLVAA,1
1zrt,R,15,35,20,YHATAATGVVVTGAAVWPLI,1
5d3m,D,27,41,14,TFYFIIMIFLANNW,1
5d3m,D,43,57,14,YLVISIFGLAYVFA,1
5d3m,D,74,87,13,MIVFTSLLQTFFM,1
5d3m,D,106,122,16,INGLYVFIRFAMIILV,1
5d3m,D,246,260,14,IPVAYCLLLTILMI,1
4lwy,M,48,69,21,PIYLGSLGVLSLFSGLMWFFT,1
4lwy,M,119,138,19,FFMFVAVWSWWGRTYLRAQ,1
4lwy,M,144,159,15,HTAWAFLSAIWLWMV,1
4lwy,M,202,224,22,GLSIAFLYGSALLFAMHGATIL,1
4lwy,M,265,283,18,HRWAIWMAVLVTLTGGIG,1
4pgr,A,18,38,20,VFVFTLLIATVGLFIGQFVP,1
4pgr,A,42,61,19,LPLSILEVAMIILAFWMRR,1
4pgr,A,68,86,18,FVYTFAFVSGITLFPIVS,1
4pgr,A,95,116,21,VVLEAFGSTFVIFAVLGTIGA,1
4pgr,A,123,142,19,FLWSFLLVAVLALAVVGIF,1
4pgr,A,156,173,17,SVIGTIVFSLYILYDLN,1
4pgr,A,187,207,20,MALSLYLDFINLFINLLRFF,1
1jv6,A,12,32,20,LALGTALMGLGTLYFLVKGM,1
1jv6,A,42,61,19,YAITTLVPAIAFTMYLSML,1
1jv6,A,82,100,18,YASWLFTTPLLLLDLALL,1
1jv6,A,104,123,19,QGTILALVGADGIMIGTGL,1
1jv6,A,138,157,19,AISTAAMLYILYVLFFGFT,1
1jv6,A,171,189,18,KVLRNVTVVLWSAYPVVW,1
1jv6,A,206,225,19,LFMVLDVSAKVGLGLILLR,1
1vgo,F,15,37,22,WLGIGTLLMLIGTFYFIARGWG,1
1vgo,F,45,66,21,YYAITILVPGIASAAYLAMFF,1
1vgo,F,84,105,21,YARYADWLFTTPLLLLDLALL,1
1vgo,F,111,132,21,TIGTLIGVDALMIVTGLIGAL,1
1vgo,F,139,162,23,YTWWLFSTIAFLFVLYYLLTSLR,1
1vgo,F,176,197,21,NTLTALVAVLWTAYPILWIVG,1
1vgo,F,209,231,22,TLAFMVLDVTAKVGFGFVLLRS,1
5cbh,E,6,19,13,MFKRFFGAVRTSW,1
5cbh,E,28,45,17,LSLAIIVTAATIFYTLA,1
5cbh,E,75,96,21,SKIFTLVYAILVVGLFVTVGG,1
4p3j,C,14,30,16,KILIGLILGAIVGLIL,1
4p3j,C,43,64,21,KPFGDLFVRLLCMLVMPIVFA,1
4p3j,C,94,110,16,FAVTLGIIMARLFNPG,1
4p3j,C,131,140,9,HILLDIVPT,1
4p3j,C,151,161,10,LPTIFFAIIL,1
4p3j,C,201,217,16,MQYAPIGVFALIAYVM,1
4p3j,C,223,242,19,VVGELAKVTAAVYVGLTLQ,1
4p3j,C,312,327,15,GTALYQGVATFFIAN,1
4p3j,C,334,350,16,VGQQLTIVLTAVLASI,1
4p3j,C,357,375,18,AGAIMLCMVLHSVGLPLT,1
4p3j,C,380,397,17,AAYAMILGIDAILDMGR,1
1f6g,D,28,47,19,AGAATVLLVIVLLAGSYLA,1
1f6g,D,86,111,25,WGRCVAVVVMVAGITSFGLVTAALA,1
2df9,A,3,28,25,YVINIIVPCVLISGLVLLAYFLPAQ,1
2df9,A,37,59,22,INVLLAQTVFLFLIAQKIPETS,1
2df9,A,67,91,24,FLIFVMVVATLIVMNCVIVLNVSQ,1
3waj,A,16,25,9,LVIAALISV,1
3waj,A,116,134,18,GVLAILPVYLLTREVFDK,1
3waj,A,136,147,11,AVIAAFLIAIV,1
3waj,A,165,184,19,EAFWQVSALGTFLLAYNRW,1
3waj,A,195,214,19,RQMAYPVIAGITIGLYVLS,1
3waj,A,218,235,17,FIIAPIILAFMFFAFVL,1
3waj,A,246,263,17,SLVAVVTFAVSALIYLP,1
3waj,A,279,297,18,QLLVLLGSAVIAAAFYQI,1
3waj,A,318,333,15,AVIVLTALIMGLFFV,1
3waj,A,382,400,18,ALFFFGMAGILYSAYRFL,1
3waj,A,405,422,17,PEMALLIWAIAMFIALW,1
3waj,A,430,451,21,FAAVSAVYSALALSVVFDKLH,1
3waj,A,470,486,16,VAFALLIALAAIYPTY,1
4y7k,E,24,46,22,MGIASTALIKSFVDNIIMPIIT,1
4y7k,E,67,85,18,WGAFLGELVNFIIIAFAV,1
5avx,G,24,40,16,IVAAVLCVIGIIILLA,1
2m67,A,18,38,20,ALSSFTPVLVILLGVVGLSA,1
2m67,A,43,64,21,DYVLLPALAIFIGLTIYAIQR,1
3wo7,A,66,90,24,VTILIRLALLPLTLKQQKSMRAMQ,1
3wo7,A,131,148,17,PMAGCLPLFIQLPILMA,1
3wo7,A,179,194,15,AGITTYFQFKMTMSH,1
3wo7,A,218,231,13,KVMLYVMPVMIII,1
3wo7,A,244,262,18,VIGNIFMIIQTYFIVVKA,1
4rp8,C,16,29,13,TNAPLLLGIVTCL,1
4rp8,C,46,65,19,KTIIGFMLLQAGSGILTST,1
4rp8,C,106,121,15,AVLLALALNICYVLL,1
4rp8,C,130,144,14,MLTGHIMFQQAGLI,1
4rp8,C,161,177,16,TAILVSLYWGITSNMM,1
4rp8,C,234,249,15,STAIVMTIFFGAILL,1
4rp8,C,265,291,26,TVYILQTGFSFAVAIFIITQGVRMFV,1
4rp8,C,327,343,16,WGFMWGTIGQLIAVGI,1
4rp8,C,356,368,12,FIPMFFSNATIG,1
4rp8,C,381,395,14,KICLVMGMIEIFGC,1
4rp8,C,431,444,13,MAVIIVIALAYMF,1
5m7l,D,13,29,16,QLVWYAQWLVIWTVVL,1
3f4j,B,13,32,19,LILAMAGNAVGLGNFLRFP,1
3f4j,B,44,63,19,IPYIIAFLLVGIPLMWIEW,1
3f4j,B,90,124,34,KILGVFGLWIPLVVAIYYVYIESWTLGFAIKFLV,1
3f4j,B,167,185,18,AYIVFLITMFINVSILIR,1
3f4j,B,191,212,21,ERFAKIAMPTLFILAVFLVIR,1
3f4j,B,244,265,21,IAAVGQIFFTLSLGFGAIITY,1
3f4j,B,277,297,20,SGLTAATLNEKAEVILGGSI,1
3f4j,B,340,367,27,GFLWFFLLFFAGLTSSIAIMQPMIAFL,1
3f4j,B,378,396,18,VLWTAAIVFFSAHLVMFL,1
3f4j,B,400,426,26,DEMDFWAGTIGVVFFGLTELIIFFWI,1
3f4j,B,445,469,24,RIYYYVMRYITPAFLAVLLVVWAR,1
3f4j,B,484,502,18,ITRFYIIGLFLFLTFLVF,1
5gxb,A,10,28,18,MFGLFFFFYFFIMGAYFP,1
5gxb,A,50,67,17,AISLFSLLFQPLFGLLS,1
5gxb,A,75,90,15,LLWIITGMLVMFAPF,1
5gxb,A,109,130,21,GGIYLGFCFNAGAPAVEAFIE,1
5gxb,A,141,157,16,RARMFGCVGWALCASI,1
5gxb,A,170,187,17,WLGSGCALILAVLLFFA,1
5gxb,A,224,243,19,LSLYVIGVSCTYDVFDQQF,1
5gxb,A,263,279,16,VTTMGELLNASIMFFA,1
5gxb,A,292,309,17,LLAGTIMSVRIIGSSFA,1
5gxb,A,314,333,19,VVILKTLHMFEVPFLLVGC,1
5gxb,A,348,369,21,IYLVCFCFFKQLAMIFMSVLA,1
5gxb,A,381,396,15,YLVLGLVALGFTLIS,1
4jtd,B,164,181,17,IAIVSVMVILISIVSFC,1
4jtd,B,225,242,17,ETLCIIWFSFEFLVRFF,1
4jtd,B,255,271,16,NIIDIVAIIPYYVTIF,1
4jtd,B,292,307,15,RIMRILRIFKLSRHS,1
4jtd,B,322,342,20,ELGLLIFFLFIGVILFSSAV,1
4jtd,B,385,402,17,VGSLCAIAGVLTIALPV,1
3q7k,E,36,57,21,LAITAGVFISIAFVFYITATT,1
3q7k,E,64,83,19,GMAKLIGGICFSLGLILCV,1
3q7k,E,115,141,26,NVYFGNLIGALLFVLLMWLSGEYMTA,1
3q7k,E,149,179,30,LQTADHKMHHTFIEAVCLGILANLMVCLAV,1
3q7k,E,193,206,13,IMVLPVAMFVASG,1
3q7k,E,208,226,18,HSIANMFMIPMGIVIRDF,1
3q7k,E,245,268,23,TVMSFITDNLIPVTIGNIIGGGL,1
1kpw,A,56,81,25,SVWMIFVVIASVFTNGLVLAATMKF,1
1kpw,A,85,111,26,HPLNWILVNLAVADLAETVIASTISV,1
1kpw,A,129,153,24,GYTVSLCGITGLWSLAIISWERWM,1
1kpw,A,165,186,21,AKLAIVGIAFSWIWAAVWTAP,1
1kpw,A,222,244,22,LMVTCCITPLSIIVLCYLQVWL,1
1kpw,A,266,289,23,TRMVVVMVLAFCFCWGPYAFFAC,1
1kpw,A,307,326,19,AFFAKSATIYNPVIYVFMN,1
4f4c,A,8,21,13,QSLRTLDSFSLAP,1
4f4c,A,23,34,11,VLKTAIKTVED,1
4f4c,A,70,95,25,TLEKLLLFIGTLVAVITGAGLPLMS,1
4f4c,A,143,164,21,AMTVGMWAAGQITVTCYLYVA,1
4f4c,A,210,232,22,GDKIGMAFQYLSQFITGFIVAF,1
4f4c,A,239,261,22,LVMLAVTPIQALCGFAIAKSMS,1
4f4c,A,313,337,24,LKGLFLGISFGAMQASNFISFALA,1
4f4c,A,359,379,20,SSVMMGSMALGLAGPQLAVL,1
4f4c,A,740,772,32,FEILYHARPHALSLFIGMSTATIGGFIYPTYS,1
4f4c,A,801,825,24,VLAAAQGICSFLMTFFMGIASESL,1
4f4c,A,868,889,21,AIDFRFSTVITTLVSMVAGIG,1
4f4c,A,903,923,20,AILPIVAFGQYLRGRRFTGK,1
4f4c,A,973,994,21,KEAFIQGLSYGCASSVLYLLN,1
4f4c,A,1024,1042,18,TISTSTLGFATSYFPEYA,1
2b2f,C,11,28,17,STALVMLMVPGVGFFYA,1
2b2f,C,40,62,22,ALSFISLIITVLLWIFYGYSVS,1
2b2f,C,91,108,17,YQMMFAAVTIAILTSAI,1
2b2f,C,115,136,21,SFILLSALWLTFVYAPFAHWL,1
2b2f,C,150,170,20,AGGMVVHISSGFAALAVAMT,1
2b2f,C,189,208,19,TLIGAALLWFGWFGFNGGS,1
2b2f,C,220,240,20,VVTNTSAAVAGFVWMVIGWI,1
2b2f,C,247,264,17,GIVSGAIAGLAAITPAA,1
2b2f,C,270,290,20,GAIVIGLVAGIVCYLAMDFR,1
2b2f,C,298,319,21,LDAWAIHGIGGLWGSVAVGIL,1
2b2f,C,342,367,25,IAVASTTAYAFLVTLILAKAVDAAV,1
3ae9,D,39,61,22,SLHWTGERVVSVLLLGLLPAAY,1
3ae9,D,69,89,20,YSLAAALTLHGHWGIGQVVT,1
3ae9,D,98,118,20,KAAKAGLLALSAFTFAGLCY,1
3ag1,Z,20,36,16,VTFLSFLLPAGWVLYH,1
5u1y,C,36,49,13,VFSYISFALISDK,1
5u1y,C,329,344,15,VIQLAVYIGSVISYF,1
5kbv,D,524,543,19,IWMCIVFAYIGVSVVLFLV,1
5kbv,D,597,617,20,GRIVGGVWWFFTLIIISSYT,1
5kbv,D,793,812,19,GVFYILVGGLGLAMLVALI,1
3oe6,B,38,61,23,IFLPTIYSIIFLTGIVGNGLVIL,1
3oe6,B,77,98,21,LHLSVADLLFVITLPFWAVDA,1
3oe6,B,105,129,24,NFLCKAVHVIYTVNLYSSVWILAF,1
3oe6,B,157,176,19,VGVWIPALLLTIPDFIFAN,1
3oe6,B,195,217,22,VVVFQFQHIMVGLILPGIVILS,1
3oe6,B,243,267,24,LILAFFACWLPYYIGISIDSFILL,1
3oe6,B,281,303,22,KWISITEALAFFHCCLNPILYA,1
4tph,B,20,33,13,ELWERFGYYGMQA,1
4tph,B,55,68,13,ACAALIYVSPAIG,1
4tph,B,83,96,13,LGAGILSVGYALM,1
4tph,B,109,122,13,LGVIVVGNGLFKP,1
4tph,B,148,161,13,AVNVGSTFSMLLT,1
4tph,B,183,196,13,VCCVGILVGLGNY,1
4tph,B,221,238,17,IVLALAALSVVASAIIL,1
4tph,B,244,260,16,RVFVYAAGVAVLGIFF,1
4tph,B,279,295,16,LTVQTVFFFIFYQQMS,1
4tph,B,325,340,15,QALNPIWIMVLSPVL,1
4tph,B,360,373,13,ALGFAVVAIGFFI,1
4tph,B,393,406,13,GYASYSLGELLVS,1
4tph,B,428,441,13,YFVASGISQYLGG,1
4tph,B,471,484,13,VAAVVCTIIALAV,1
3han,A,10,32,22,IWLALGTALMGLGTLYFLVKGM,1
3han,A,42,66,24,YAITTLAPAIAFTMYLSMLLGYGL,1
3han,A,79,99,20,WARYADWLFTTPLLLLDLAL,1
3han,A,104,127,23,QGTILALVGADGIMIGTGLVGAL,1
3han,A,135,157,22,VWWAISTAAMLYILYVLFFGFT,1
3han,A,172,195,23,VLRNVTVVLWSAYPVVWLIGSEG,1
3han,A,202,225,23,IETLLFMVLDVSAKVGFGLILLR,1
4dw1,C,38,55,17,QALVIAYVIGYVCVYNK,1
4dw1,C,333,349,16,NIIPTLLNIGAGLALL,1
5l26,C,8,25,17,GMAVLIAIAVLLSTDRK,1
5l26,C,27,42,15,NIRTVAGAFLIQVAL,1
5l26,C,106,140,34,FFSSLMAVLYYIGVMQLLIKVIGGFLQKMLGTSK,1
5l26,C,172,189,17,LFAVMSGGLASVAGSVL,1
5l26,C,206,222,16,FMAAPGGLLFAKLLVP,1
5l26,C,242,252,10,TNVIDAAASG,1
5l26,C,254,270,16,TGAQIAIAVGASLLAF,1
5l26,C,363,382,19,CGFANLGSIAVLVGGLSIM,1
5l26,C,391,408,17,RLGIKAVVAGSLSNLMS,1
4xes,A,62,87,25,SKVLVTAIYLALFVVGTVGNSVTLF,1
4xes,A,106,130,24,GSLALSDLLILLLAMPVELYNFIW,1
4xes,A,138,163,25,DAGCRGYYFLRDACTYATALNVASL,1
4xes,A,189,209,20,ISAIWLASALLAIPMLFTMG,1
4xes,A,226,255,29,PIVDTATVKVVIQVNTFMSFLFPMLVISI,1
4xes,A,312,334,22,VVIAFVVCWLPYHVRRLMFCYI,1
4xes,A,347,370,23,HYFYMLTNALFYASSAINPILYN,1
3duq,H,16,32,16,IYSFWIFLAGLIYYLQ,1
2ka2,B,164,187,23,FLPSLLLSHLLAIGLGIYIGRRL,1
3dtu,B,59,82,23,FILVIIAAITIFVTLLILYAVWR,1
3dtu,B,98,119,21,PLEIAWTIVPIVILVAIGAFS,1
4q9i,A,43,69,26,WLDRLYMLVGTLAAIIHGVALPLMML,1
4q9i,A,115,138,23,GIGAGVLIVAYIQVSFWCLAAGR,1
4q9i,A,181,204,23,IGDKIGMFFQAMATFFGGFIIGF,1
4q9i,A,211,233,22,LVILAISPVLGLSAGIWAKILS,1
4q9i,A,286,310,24,KAITANISMGAAFLLIYASYALAF,1
4q9i,A,329,352,23,VFFSVLIGAFSVGQASPNIEAFA,1
4q9i,A,704,728,24,PYFVVGIFCAIINGGLQPAFSVIF,1
4q9i,A,753,776,23,LFLILGIISFITFFLQGFTFGKA,1
4q9i,A,825,848,23,GSRLAVIFQNIANLGTGIIISLI,1
4q9i,A,853,876,23,TLLLLAIVPIIAIAGVVEMKMLS,1
4q9i,A,928,952,24,KKAHVFGITFSFTQAMMYFSYAAC,1
4q9i,A,973,992,19,FSAIVFGAMAVGQVSSFAP,1
1ln6,A,41,63,22,AYMFLLIMLGFPINFLTLYVTV,1
1ln6,A,75,101,26,LLNLAVADLFMVFGGFTTTLYTSLHG,1
1ln6,A,106,132,26,PTGCNLEGFFATLGGEIALWSLVVLA,1
1ln6,A,154,177,23,MGVAFTWVMALACAAPPLVGWSR,1
1ln6,A,200,222,22,ESFVIYMFVVHFIIPLIVIFFC,1
1ln6,A,257,277,20,VIAFLICWLPYAGVAFYIFT,1
1ln6,A,288,306,18,TIPAFFAKTSAVYNPVIY,1
4daj,A,67,90,23,VFIAFLTGFLALVTIIGNILVIV,1
4daj,A,106,129,23,LSLACADLIIGVISMNLFTTYII,1
4daj,A,140,163,23,DLWLSIDYVASNASVMNLLVISF,1
4daj,A,186,206,20,MIGLAWVISFVLWAPAILFW,1
4daj,A,229,249,20,ITFGTAIAAFYMPVTIMTIL,1
4daj,A,493,516,23,AILLAFIITWTPYNIMVLVNTFC,1
4daj,A,523,543,20,YWNLGYWLCYINSTVNPVCY,1
3zk2,K,11,32,21,GCSAVGAGLAMIAGLGPGIGE,1
3zk2,K,62,84,22,VAESTGIYSLVIALILLYANPF,1
1uaz,F,16,35,19,LWLGIGTLLMLIGTFYFIV,1
1uaz,F,52,69,17,ILVPGIASAAYLSMFFG,1
1uaz,F,85,100,15,YARYADWLFTTPLLL,1
1uaz,F,116,134,18,LVGVDALMIVTGLVGALS,1
1uaz,F,139,156,17,RYTWWLFSTICMIVVLY,1
1uaz,F,182,198,16,LVLVLWTAYPILWIIG,1
1uaz,F,209,227,18,ETLLFMVLDVTAKVGFGF,1
3tds,D,25,46,21,KYLVSSAFAGLYVGIGILLIF,1
3tds,D,63,79,16,MGLSFAIALSLVIMTG,1
3tds,D,105,129,24,KIWAYSWVGNLIGALVLGIIFVGT,1
3tds,D,154,177,23,ALFFRGILCNILVCVSVLCSFRT,1
3tds,D,180,197,17,TAKIIMIFLCLFAIITS,1
3tds,D,227,252,25,YNLVAVTLGNIVGGALFMGLGTYIL,1
2p7t,F,26,50,24,RAAGAATVLLVIVLLAGSYLAVLA,1
2p7t,F,87,113,26,GRCVAVVVMVAGITSFGLVTAALATW,1
4jcz,C,8,25,17,AAVTLLGVLLQAYFSLQ,1
4jcz,C,53,71,18,VNCSEYFPLFLATLWVAG,1
4jcz,C,79,96,17,ALCGLVYLFARLRYFQG,1
4jcz,C,105,124,19,APLYASARALWLLVALAAL,1
4dnr,I,15,31,16,VLMGALFLSIWGTWTI,1
4dnr,I,339,355,16,GKLLEEFIVVAVVCAL,1
4dnr,I,361,381,20,SALVAIISLPLGLCIAFIVM,1
4dnr,I,395,410,15,IAIAVGAMVDAAIVM,1
4dnr,I,449,466,17,LFISLLIITLSFIPIFT,1
4dnr,I,477,497,20,LAFTKTYAMAGAALLAIVVI,1
4dnr,I,541,556,15,VAALSVLTVLWPLNK,1
4dnr,I,873,890,17,LMVPMTLMIIFVLLYLA,1
4dnr,I,898,918,20,LIISSVPFALVGGIWLLWWM,1
4dnr,I,927,943,16,TGFIALAGVAAEFGVV,1
4dnr,I,984,1000,16,AMTVAVIIAGLLPILW,1
4dnr,I,1013,1028,15,APMIGGMITAPLLSL,1
2evu,D,5,25,20,KRCIAEFIGTFILVFFGAGS,1
2evu,D,56,77,21,AIGLAFGFAIAASIYALGNIS,1
2evu,D,95,118,23,PGREVVPYIIAQLLGAAFGSFIF,1
2evu,D,147,166,19,LAEVVGTFLLMITIMGIAV,1
2evu,D,174,191,17,AGIIIGLTVAGIITTLG,1
2evu,D,223,243,20,IYVIGPIVGAVLAALTYQYL,1
4aq5,E,222,243,21,INIIAPCVLISSLVVLVYFLP,1
4aq5,E,251,273,22,TLSISVLLAQTIFLFLIAQKVP,1
4aq5,E,285,308,23,LIFVMFVSLVIVTNCVIVLNVSL,1
4aq5,E,449,473,24,CFWIALLLFSLGTLAIFLTGHLNQ,1
2ic8,A,94,110,16,PVTWVMMIACVVVFIA,1
2ic8,A,148,166,18,MHILFNLLWWWYLGGAVE,1
2ic8,A,172,188,16,KLIVITLISALLSGYV,1
2ic8,A,199,217,18,LSGVVYALMGYVWLRGER,1
2ic8,A,225,241,16,QRGLIIFALIWIVAGW,1
2ic8,A,252,268,16,AHIAGLAVGLAMAFVD,1
1bnx,A,4,24,20,YLSDITDVIFIYFAALSPAI,1
5bqi,B,16,32,16,LLCSTLLVIKMYVVAI,1
5bqi,B,73,90,17,NDMETIYPFLFLGFVYS,1
5bqi,B,99,115,16,WMHFLVFLVGRVAHTV,1
5bqi,B,127,146,19,VTYTLAQLPCASMALQILW,1
1bok,A,37,61,24,SMLAAYMFLLIMLGFPINFLTLYV,1
1bok,A,75,96,21,LLNLAVADLFMVFGGFTTTLY,1
1bok,A,112,130,18,EGFFATLGGEIALWSLVV,1
1bok,A,156,178,22,VAFTWVMALACAAPPLVGWSRY,1
1bok,A,201,220,19,SFVIYMFVVHFIIPLIVIF,1
1bok,A,254,277,23,IIMVIAFLICWLPYAGVAFYIFT,1
1bok,A,286,308,22,FMTIPAFFAKTSAVYNPVIYIM,1
1bl1,A,19,28,9,LGMIYTVGY,1
3s8f,C,10,24,14,VILVLTLTILVFWL,1
2ydv,A,6,29,23,SVYITVELAIAVLAILGNVLVCW,1
2ydv,A,44,68,24,VVSAAAADILVGVLAIPFAIAIST,1
2ydv,A,77,103,26,LFIACFVLVLTASSIFSLLAIAIDRY,1
2ydv,A,120,143,23,AKGIIAICWVLSFAIGLTPMLGW,1
2ydv,A,173,199,26,MNYMVYFNFFACVLVPLLLMLGVYLR,1
2ydv,A,233,256,23,SLAIIVGLFALCWLPLHIINCFT,1
2ydv,A,266,290,24,LWLMYLAIVLSHTNSVVNPFIYAY,1
2g87,A,39,64,25,AAYMFLLIMLGFPINFLTLYVTVQH,1
2g87,A,72,98,26,YILLNLAVADLFMVFGGFTTTLYTSL,1
2g87,A,109,135,26,NLEGFFATLGGEIALWSLVVLAIERY,1
2g87,A,152,176,24,IMGVAFTWVMALACAAPPLVGWSR,1
2g87,A,200,225,25,SFVIYMFVVHFIIPLIVIFFCYGQL,1
2g87,A,252,277,25,VIIMVIAFLICWLPYAGVAFYIFTH,1
2g87,A,288,309,21,IPAFFAKTSAVYNPVIYIMMN,1
1psl,E,39,49,10,ICLLLICIIV,1
4ja3,A,16,39,23,ATLGGLLFGYDTAVISGTVESLN,1
4ja3,A,52,75,23,ANSLLGFCVASALIGCIIGGALG,1
4ja3,A,88,106,18,KIAAVLFFISGVGSAWPE,1
4ja3,A,123,147,24,GYVPEFVIYRIIGGIGVGLASMLS,1
4ja3,A,166,188,22,NQFAIIFGQLLVYCVNYFIARS,1
4ja3,A,198,218,20,WRYMFASECIPALLFLMLLY,1
4ja3,A,280,303,23,GVMLSIFQQFVGINVVLYYAPEV,1
4ja3,A,312,336,24,IALLQTIIVGVINLTFTVLAIMTV,1
4ja3,A,343,364,21,LQIIGALGMAIGMFSLGTAFY,1
4ja3,A,370,392,22,VALLSMLFYVAAFAMSWGPVCW,1
4ja3,A,410,431,21,AVAAQWLANYFVSWTFPMMDK,1
4ja3,A,442,462,20,FSYWIYGCMGVLAALFMWKF,1
3fwl,A,70,86,16,KLAIVFAVLIAIYGVY,1
4j7c,L,22,40,18,GFFLTIIIGAVLLMLPIS,1
4j7c,L,73,91,18,VFGQTVIMGLIQIGGLGF,1
4j7c,L,138,154,16,SIELIAALILSIRLVP,1
4j7c,L,159,174,15,SGLFASLFHAISAFN,1
4j7c,L,189,207,18,GDPTVNLVITFLFITGGI,1
4j7c,L,235,251,16,LMLNAIAMLTVFILEY,1
4j7c,L,263,278,15,DKLWASYFQAVTPRT,1
4j7c,L,290,306,16,EGTIVFTLLLMFIGAG,1
4j7c,L,356,372,16,TSLFIVFLGIFALTIT,1
4j7c,L,404,420,16,GKCIIIVIMFIGRIGP,1
1boj,A,37,61,24,SMLAAYMFLLIMLGFPINFLTLYV,1
1boj,A,75,96,21,LLNLAVADLFMVFGGFTTTLY,1
1boj,A,112,131,19,EGFFATLGGEIALWSLVVL,1
1boj,A,155,177,22,GVAFTWVMALACAAPPLVGWSR,1
1boj,A,201,220,19,SFVIYMFVVHFIIPLIVIF,1
1boj,A,254,277,23,IIMVIAFLICWLPYAGVAFYIFT,1
1boj,A,287,308,21,MTIPAFFAKTSAVYNPVIYIM,1
5ndd,A,73,98,25,TTVFLPIVYTIVFVVALPSNGMALW,1
5ndd,A,114,136,22,ANLALADLLSVIWFPLKIAYHI,1
5ndd,A,144,168,24,EALCNVLIGFFYANMYCSILFLTC,1
5ndd,A,194,214,20,SLAIWLLILLVTIPLYVVKQ,1
5ndd,A,236,259,23,GDMFNYFLSLAIGVFLFPAFLTA,1
5ndd,A,291,313,22,VAAMYLICFTPSNLLLVVHYFL,1
5ndd,A,322,343,21,YALYIVALCLSTLNSCIDPFV,1
5br2,C,10,32,22,IWLALGTALMGLGTLYFLVKGM,1
5br2,C,40,62,22,KFYAITTLVPAIAFTMYLSMLL,1
5br2,C,80,100,20,ARYADWLFTTPLLLLDLALL,1
5br2,C,106,127,21,TILALVGADGIMIGTGLVGAL,1
5br2,C,134,156,22,FVWWAISTAAMLYILYVLFFGF,1
5br2,C,171,192,21,KVLRNVTVVLWSAYPVVWLIG,1
5br2,C,203,226,23,ETLLFMVLDVSAKVGFGLILLRS,1
5bqh,B,16,34,18,LLCSTLLVIKMYVVAIIT,1
5bqh,B,72,90,18,RNDMETIYPFLFLGFVYS,1
5bqh,B,99,117,18,WMHFLVFLVGRVAHTVAY,1
5bqh,B,126,146,20,SVTYTLAQLPCASMALQILW,1
3s8g,C,7,24,17,ALAVILVLTLTILVFWL,1
4j7t,C,5,28,23,ALLAAVTLLGVLLQAYFSLQVIS,1
4j7t,C,52,74,22,QVNCSEYFPLFLATLWVAGIFF,1
4j7t,C,76,97,21,GAAALCGLVYLFARLRYFQGY,1
4j7t,C,104,131,27,LAPLYASARALWLLVALAALGLLAHFL,1
1umx,M,55,72,17,GVLSLFSGLMWFFTIGI,1
1umx,M,118,133,15,SFFMFVAVWSWWGRT,1
1umx,M,147,163,16,WAFLSAIWLWMVLGFI,1
1umx,M,201,221,20,HGLSIAFLYGSALLFAMHGA,1
1umx,M,269,285,16,IWMAVLVTLTGGIGIL,1
4z36,A,49,72,23,KLVMGLGITVCIFIMLANLLVMV,1
4z36,A,89,109,20,NLAAADFFAGLAYFYLMFNT,1
4z36,A,120,141,21,WLLRQGLIDTSLTASVANLLA,1
4z36,A,167,187,20,IVVIWTMAIVMGAIPSVGWN,1
4z36,A,203,222,19,CSYLVFWAIFNLVTFVVMV,1
4z36,A,263,284,21,LGAFIICWTPGLVLLLLDCCC,1
4z36,A,288,310,22,VLAYEKFFLLLAEFNSAMNPII,1
4quv,A,24,40,16,WLVLMIALPPLVYYLW,1
4quv,A,74,92,18,GLYAAWFLGQAALQVWAP,1
4quv,A,112,126,14,GIFSFLFTLAVVFG,1
4quv,A,146,162,16,TVVNIFTFVFAGFLYF,1
4quv,A,197,214,17,LFCEARPGMIFWLLMNL,1
4quv,A,231,249,18,LLVVGFQSFYLIDYFIHE,1
4quv,A,265,283,18,MLCWGDLVWLPFTYTLQA,1
4quv,A,296,313,17,GIIAIVALNLAGYAIFR,1
4quv,A,361,376,15,GDLMIALSWCLPAAF,1
4quv,A,379,393,14,IPYFHIVYFTILLL,1
1ntz,K,23,38,15,WGAVGAVGLVWATDW,1
3tdr,E,25,45,20,KYLVSSAFAGLYVGIGILLI,1
3tdr,E,64,79,15,GLSFAIALSLVIMTG,1
3tdr,E,105,129,24,KIWAYSWVGNLIGALVLGIIFVGT,1
3tdr,E,154,177,23,ALFFRGILCNILVCVSVLCSFRT,1
3tdr,E,180,197,17,TAKIIMIFLCLFAFITS,1
3tdr,E,227,252,25,YNLVAVTLGNIVGGALFMGLGTYIL,1
3j9v,T,14,36,22,IGCASAIIFTSLGAAYGTAKSG,1
3j9v,T,56,76,20,VIMAGIIAIYGLVVSVLVCY,1
3j9v,T,90,111,21,LGAGLSVGLSGLAAGFAIGIV,1
3j9v,T,131,152,21,ILIFAEVLGLYGLIVALLLNS,1
3zkr,E,211,225,14,LGLIIAASWSVFWL,1
3zkr,E,230,245,15,RLQTSFTLMLTVVAY,1
3zkr,E,266,282,16,IAGYGSIFAAILLIIF,1
3zkr,E,300,315,15,RLAFPLGFLAIGCVL,1
1ntm,K,22,38,16,LWGAVGAVGLVWATDW,1
4q9h,A,40,68,28,YAGWLDRLYMLVGTLAAIIHGVALPLMM,1
4q9h,A,118,139,21,AGVLIVAYIQVSFWCLAAGRQ,1
4q9h,A,180,204,24,GIGDKIGMFFQAMATFFGGFIIGF,1
4q9h,A,209,232,23,LTLVILAISPVLGLSAGIWAKIL,1
4q9h,A,289,311,22,TANISMGAAFLLIYASYALAFW,1
4q9h,A,331,352,21,FSVLIGAFSVGQASPNIEAFA,1
4q9h,A,704,728,24,PYFVVGIFCAIINGGLQPAFSVIF,1
4q9h,A,753,776,23,LFLILGIISFITFFLQGFTFGKA,1
4q9h,A,824,846,22,TGSRLAVIFQNIANLGTGIIIS,1
4q9h,A,858,879,21,AIVPIIAIAGVVEMKMLSGQA,1
4q9h,A,925,949,24,NAMKKAHVFGITFSFTQAMMYFSY,1
4q9h,A,974,994,20,SAIVFGAMAVGQVSSFAPDY,1
1uv3,A,37,64,27,RLQAAFMGFVFFVGTPLNAIVLVATLH,1
1uv3,A,73,99,26,YILVNVSLGGFLFCIFSVFTVFIASC,1
1uv3,A,109,133,24,CALEAFLGSVAGLVTGWSLAFLAF,1
1uv3,A,154,176,22,MVVLATWIIGIGVSIPPFFGWS,1
1uv3,A,199,224,25,SEYYTWFLFIFCFIIPLSLICFSYS,1
1uv3,A,254,277,23,VVMVGSFCLCYVPYAALAMYMVN,1
1uv3,A,287,309,22,VTIPAFFSKSSCVYNPIIYCFM,1
1y5n,F,4,28,24,NMFFFDIYPYIAGAVFLIGSWLRY,1
1y5n,F,48,72,24,NLASNLFHIGILGIFVGHFFGMLT,1
1y5n,F,87,114,27,KMAMFAGGASGVLCLIGGVLLLKRRLF,1
1y5n,F,125,145,20,DILILSLLVIQCALGLLTIP,1
1y5n,F,183,204,21,FRLHLVLGMTLFLLFPFSRLI,1
4hbj,H,16,32,16,IYSFWIFLAGLIYYLQ,1
2wsf,4,42,56,14,AELVNGRWAMLGVA,1
2wsf,4,93,106,13,EFILSHYVEIRRW,1
2wsf,4,150,166,16,EKEIANGRLMLAFLGF,1
2wqy,D,9,28,19,WTSERAVSALLLGLLPAAY,1
2wqy,D,35,56,21,DYSLAAALTLHGHWGLGQVIT,1
2wqy,D,66,85,19,VANTGLYVLSAITFTGLCY,1
5l27,C,7,21,14,LGMAVLIAIAVLLS,1
5l27,C,28,46,18,IRTVAGAFLIQVALGALV,1
5l27,C,103,136,33,MIVFFSSLMAVLYYIGVMQLLIKVIGGFLQKML,1
5l27,C,173,189,16,FAVMSGGLASVAGSVL,1
5l27,C,204,221,17,ASFMAAPGGLLFAKLLV,1
5l27,C,242,274,32,TNVIDAAASGAVTGAQIAIAVGASLLAFVALI,1
5l27,C,365,381,16,FANLGSIAVLVGGLSI,1
5l27,C,392,411,19,LGIKAVVAGSLSNLMSAVI,1
3hao,C,10,33,23,IWLALGTALMGLGTLYFLVKGMG,1
3hao,C,41,62,21,FYAITTLVPAIAFTMYLSMLL,1
3hao,C,80,99,19,ARYADWLFTTPLLALDLAL,1
3hao,C,106,127,21,TILALVGADGIMIGTGLVGAL,1
3hao,C,134,157,23,FVWWAISTAAMLYILYVLFFGFT,1
3hao,C,171,192,21,KVLRNVTVVLWSAYPVVWLIG,1
3hao,C,204,226,22,TLLFMVLDVSAKVGFGLILLRS,1
4dw0,C,37,55,18,TQALVIAYVIGYVFVYNK,1
4dw0,C,334,356,22,IIPTLLNIGAGLALLGLVNVIC,1
2k74,A,14,35,21,WLLMAFTALALELTALWFQHV,1
2k74,A,41,62,21,VLSIYERAALFGVLGAALIGA,1
2k74,A,71,92,21,VAMVIWLYSAFRGVQLTYEHT,1
2k74,A,141,162,21,MPQWLLGIFIAYLIVAVLVVI,1
5l2a,C,7,21,14,LGMAVLIAIAVLLS,1
5l2a,C,28,42,14,IRTVAGAFLIQVAL,1
5l2a,C,103,118,15,MIVFFSSLMAVLYYI,1
5l2a,C,120,152,32,MQLLIKVIGGFLQKMLGTSKAESMSAAASIFV,1
5l2a,C,154,165,11,TEAPLVVRPYI,1
5l2a,C,172,184,12,LFAVMSGGLASV,1
5l2a,C,207,221,14,MAAPGGLLFAKLLV,1
5l2a,C,243,274,31,NVIDAAASGAVTGAQIAIAVGASLLAFVALI,1
5l2a,C,366,384,18,ANLGSIAVLVGGLSIMAP,1
5l2a,C,387,408,21,KDVARLGIKAVVAGSLSNLMS,1
5kbw,A,8,28,20,FVGIFSALATLVMFLEFPIF,1
5kbw,A,35,48,13,YDPSEIPALIVSF,1
5kbw,A,52,71,19,GVGMFVVLVKDILFFLMKS,1
5kbw,A,75,94,19,GIAMNAVLGMSFVGIAGLI,1
5kbw,A,106,123,17,GMIVATLFATAFALGLN,1
5kbw,A,143,163,20,FILAFNLVKFGIDSVVTFFV,1
5uj9,A,330,346,16,FKAVHDLMMFAGPEIL,1
5uj9,A,368,382,14,LLFISACLQTLVLH,1
5uj9,A,446,459,13,APLQVILALYLLW,1
5uj9,A,465,480,15,VLAGVAVMVLMVPLN,1
5uj9,A,548,564,16,GTFTWVCTPFLVALST,1
5uj9,A,584,599,15,SLALFNILRFPLNIL,1
5uj9,A,972,992,20,ISFLSIFLFLCNHVASLVSN,1
5uj9,A,1020,1036,16,LGISQGITVFGYSMAV,1
5uj9,A,1091,1108,17,MFMGSLFNVIGACIIIL,1
5uj9,A,1115,1129,14,VIIPPLGLIYFFVQ,1
5uj9,A,1200,1214,14,RLECVGNCIVLFAS,1
5uj9,A,1233,1247,14,SYSLQVTTYLNWLV,1
4xee,A,61,86,25,YSKVLVTAIYLALFVVGTVGNSVTL,1
4xee,A,106,131,25,GSLALSDLLILLLAMPVELYNFIWV,1
4xee,A,136,165,29,FGDAGCRGYYFLRDACTYATALNVASLSV,1
4xee,A,189,209,20,ISAIWLASALLAIPMLFTMG,1
4xee,A,234,259,25,KVVIQVNTFMSFLFPMLVISILNTV,1
4xee,A,309,333,24,LRAVVIAFVVCWLPYHVRRLMFCY,1
4xee,A,348,370,22,YFYMLTNALFYASSAINPILYN,1
2klu,A,374,397,23,IVLGGVAGLLLFIGLGIFFSVRS,1
4zp0,A,20,40,20,CLVLYEFSTYIGNDMIQPGM,1
4zp0,A,55,73,18,TSMTAYLAGGMFLQWLLG,1
4zp0,A,84,102,18,MLAGVVWFIVTCLAILLA,1
4zp0,A,107,126,19,FTLLRFLQGISLCFIGAVG,1
4zp0,A,145,165,20,MANVALIAPLLGPLVGAAWI,1
4zp0,A,171,190,19,GMFVLFAALAAISFFGLQR,1
4zp0,A,223,243,20,GALALGFVSLPLLAWIAQSP,1
4zp0,A,256,275,19,YGLLQVPIFGALIAGNLLL,1
4zp0,A,288,307,19,IMGGWPIMIGLLVAAAATV,1
4zp0,A,314,335,21,WMTAGLSIYAFGIGLANAGLV,1
4zp0,A,351,372,21,AMGMLQMLIFTVGIEISKHAW,1
4zp0,A,378,398,20,LFNLFNLVNGILWLSLMVIF,1
1bzk,A,3,12,9,YYLSDITDA,1
1bzk,A,19,41,22,AVIFIYFAALSPAITFGGLLGE,1
5u1x,C,33,48,15,HALVFSYISFALISD,1
5u1x,C,330,348,18,IQLAVYIGSVISYFGLAT,1
5b1b,Z,17,36,19,GLSVTFLSFLLPAGWVLYH,1
2lj2,A,20,41,21,SSFTPVLVILLGVVGLSALTG,1
2lj2,A,47,67,20,LPALAIFIGLTIYAIQRKRQ,1
4xk8,4,95,111,16,LVNGRWAMLGVAGMLL,1
4xk8,4,141,154,13,FVIEFILFHYVEI,1
4xk8,4,204,220,16,IANGRLAMLAFLGFII,1
5b2n,A,18,41,23,DHLLTMGVGVHFAALIFFLVVSQ,1
5b2n,A,48,70,22,IATALSCIVMVSAGLILNSQAV,1
5b2n,A,93,114,21,YRYVNWMATIPCLLLQLLIVL,1
5b2n,A,121,143,22,FSTATWLILAAWGMIITGYVGQ,1
5b2n,A,153,176,23,MIWGAVSTAFFVVMNWIVGTKIF,1
5b2n,A,190,210,20,TKVFWLMMFAWTLYPIAYLV,1
5b2n,A,222,246,24,RQLLFTIADISSKVIYGLMITYIA,1
3ae8,D,39,61,22,SLHWTGERVVSVLLLGLLPAAY,1
3ae8,D,68,92,24,DYSLAAALTLHGHWGIGQVVTDYV,1
3ae8,D,97,117,20,QKAAKAGLLALSAFTFAGLC,1
5iwt,D,327,349,22,FCVLGAIYVLYIICFTMCCVYR,1
5iwt,D,383,408,25,RLVGELVSIVGAVIILLVEIPDIFR,1
5iwt,D,422,443,21,PFHVIIVTYAFMVLVTMVMRL,1
5iwt,D,449,470,21,VVPMSFALVLGWCNVMYFARG,1
5iwt,D,486,511,25,GDLMRFCWQMAVVILGFASAFYIIF,1
5iwt,D,552,576,24,MYSITYAAFAIIATLLMLNLLIAM,1
2b0x,A,17,41,24,FPIVYSIIFVLGVIANGYVLWVFA,1
2b0x,A,55,78,23,MVNLTMADMLFLITLPLWIVYYQ,1
2b0x,A,89,113,24,CNVAGCLFFINTYCSVAFLGVITY,1
2b0x,A,133,154,21,GISLSLVIWVAIVGAASYFLI,1
2b0x,A,183,206,23,VLIIHIFIVFSFFLVFLIILFCN,1
2b0x,A,233,256,23,VCTVLAVFIICFVPHHVVQLPWT,1
2b0x,A,273,295,22,AHQVTLCLLSTNCVLDPVIYCF,1
5lki,E,2120,2144,24,AAGLTTAVQASRLAGAAADLVPNI,1
5lki,E,2152,2173,21,RWGAIAEATGYVMEFSANVMN,1
2iub,E,294,310,16,TIIATIFMPLTFIAGI,1
2iub,E,332,347,15,VMGVIAVIMVVYFKK,1
4mqx,B,37,61,24,MAAVVGTLVGLAAVAFDKGVAWLQ,1
4mqx,B,84,97,13,ASAVLAMFGYFLV,1
4mqx,B,129,142,13,VKFFGGLGTLGGG,1
4mqx,B,144,156,12,LGREGPTVQIGG,1
4mqx,B,216,232,16,AVFIGVIMSTIMYRIF,1
4mqx,B,253,277,24,LYLILGIIFGIFGPIFNKWVLGMQ,1
4mqx,B,290,305,15,WVLMGGAIGGLAGLL,1
4mqx,B,338,351,13,ARVITTLLSFSSG,1
4mqx,B,353,368,15,GGIFAPMLALGTVLG,1
4mqx,B,423,439,16,PMIITGLGCTLLAQFT,1
4q7c,B,179,193,14,FSFFLSLVGSALFL,1
4q7c,B,199,214,15,TLLAGVIIQLHSIID,1
4q7c,B,238,252,14,DRYSDFIIVFSITY,1
4q7c,B,262,277,15,IIGFLAAFASLMIAY,1
4q7c,B,297,316,19,PITRDFRLLIIFACSVVNL,1
4q7c,B,318,337,19,LALVIIALLGNFEALRRIV,1
3v2w,A,51,68,17,FILICCFIILENIFVLL,1
3v2w,A,84,101,17,GNLALSDLLAGVAYTAN,1
3v2w,A,122,138,16,SMFVALSASVFSLLAI,1
3v2w,A,162,178,16,LISACWVISLILGGLP,1
3v2w,A,202,219,17,ILFCTTVFTLLLLSIVI,1
3v2w,A,260,278,18,VLSVFIACWAPLFILLLL,1
3v2w,A,295,311,16,FLVLAVLNSGTNPIIY,1
4ycr,C,14,26,12,GIPLGLAALSLA,1
4ycr,C,41,58,17,DVLGIVASAVWILFILM,1
4ycr,C,84,97,13,LIPITTMLVGDIL,1
4ycr,C,105,122,17,EVLIWIGTIGQLLFSTL,1
4ycr,C,144,154,10,PAVAANFTSA,1
4ycr,C,166,182,16,YLFFGAGMIAWIIFEP,1
4ycr,C,203,215,12,VLAPAFVCVSAY,1
4ycr,C,227,243,16,KILWGYGFLQLFFLLR,1
4ycr,C,258,271,13,AFSFGLASMANSA,1
4ycr,C,284,304,20,IFAFVFSNVMIGLLVLMTIY,1
2at9,C,13,29,16,LGTALMGLGTLYFLVK,1
2at9,C,46,60,14,LVPAIAFTMYLSML,1
2at9,C,81,94,13,YADWLFTTPLLLL,1
2at9,C,111,126,15,GADGIMIGTGLVGAL,1
2at9,C,136,150,14,WAISTAAMLYILYV,1
2at9,C,177,190,13,VVLWSAYPVVWLI,1
2at9,C,205,221,16,LFMVLDVSAKVGFGLI,1
4rp9,B,7,29,22,FTVFFNQVMTNAPLLLGIVTCL,1
4rp9,B,46,70,24,KTIIGFMLLQAGSGILTSTFKPVV,1
4rp9,B,105,122,17,YAVLLALALNICYVLLR,1
4rp9,B,128,145,17,TIMLTGHIMFQQAGLIA,1
4rp9,B,160,177,17,CTAILVSLYWGITSNMM,1
4rp9,B,233,251,18,VSTAIVMTIFFGAILLSF,1
4rp9,B,264,287,23,WTVYILQTGFSFAVAIFIITQGV,1
4rp9,B,324,343,19,AVVWGFMWGTIGQLIAVGI,1
4rp9,B,356,371,15,FIPMFFSNATIGVFA,1
4rp9,B,378,395,17,AALKICLVMGMIEIFGC,1
4rp9,B,430,444,14,FMAVIIVIALAYMF,1
3wo6,A,65,87,22,IVTILIRLALLPLTLKQQKSMR,1
3wo6,A,132,149,17,MAGCLPLFIQLPILMAF,1
3wo6,A,178,194,16,VAGITTYFQFKMTMSH,1
3wo6,A,216,233,17,QMKVMLYVMPVMIIIAG,1
3wo6,A,241,256,15,LYWVIGNIFMIIQTY,1
3rqu,E,211,225,14,LGLIIAASWSVFWL,1
3rqu,E,231,245,14,LQTSFTLMLTVVAY,1
3rqu,E,266,282,16,IAGYGSIFAAILLIIF,1
3rqu,E,299,315,16,CRLAFPLGFLAIGCVL,1
1oed,E,222,244,22,IINIIAPCVLISSLVVLVYFLP,1
1oed,E,253,273,20,LSISVLLAQTIFLFLIAQKV,1
1oed,E,286,309,23,LIFVMFVSMLIVMNCVIVLNVSL,1
1oed,E,450,473,23,CFWIALLLFSIGTLAIFLTGHFN,1
1h6i,A,14,32,18,VAEFLATTLFVFISIGSA,1
1h6i,A,50,68,18,KVSLAFGLSIATLAQSVG,1
1h6i,A,94,114,20,LMYIIAQCVGAIVATAILSG,1
1h6i,A,139,156,17,GIEIIGTLQLVLCVLAT,1
1h6i,A,168,184,16,PLAIGLSVALGHLLAI,1
1h6i,A,210,231,21,IFWVGPFIGGALAVLIYDFIL,1
5tl9,C,16,32,16,LLCSTLLVIKMYVVAI,1
5tl9,C,73,90,17,NDMETIYPFLFLGFVYS,1
5tl9,C,99,115,16,WMHFLVFLVGRVAHTV,1
5tl9,C,127,146,19,VTYTLAQLPCASMALQILW,1
2vt4,A,41,63,22,AGMSLLMALVVLLIVAGNVLVI,1
2vt4,A,82,103,21,LACADLVVGLLVVPFGATLVV,1
2vt4,A,108,133,25,WGSFLCELWTSLDVLCVTASIETLC,1
2vt4,A,163,184,21,TVWAISALVSFLPIMMHWWRD,1
2vt4,A,200,225,25,FVTNRAYAIASSIISFYIPLLIMIF,1
2vt4,A,294,316,22,IMGVFTLCWLPFFLVNIVNVFN,1
2vt4,A,323,342,19,LFVAFNWLGYANSAMNPII,1
4y7j,E,20,40,20,IAFIMGIASTALIKSFVDNI,1
4y7j,E,69,89,20,AFLGELVNFIIIAFAVFIIA,1
5avy,G,25,40,15,VAAVLCVIGIIILLA,1
4wab,B,16,32,16,LLCSTLLVIKMYVVAI,1
4wab,B,73,90,17,NDMETIYPFLFLGFVYS,1
4wab,B,99,115,16,WMHFLVFLVGRVAHTV,1
4wab,B,129,146,17,YTLAQLPCASMALQILW,1
1dxr,M,54,70,16,GIAAFAFGSTAILIIL,1
1dxr,M,116,132,16,GLFMTLSLGSWWIRVY,1
1dxr,M,145,162,17,WNFAAAIFFVLCIGCIH,1
1dxr,M,198,216,18,WHGFSIGFAYGCGLLFAA,1
1dxr,M,267,284,17,WFFSLMVMVSASVGILL,1
3wak,A,8,24,16,KKYWHLSVLVIAALIS,1
3wak,A,118,134,16,LAILPVYLLTREVFDK,1
3wak,A,136,147,11,AVIAAFLIAIV,1
3wak,A,167,181,14,FWQVSALGTFLLAY,1
3wak,A,199,212,13,YPVIAGITIGLYV,1
3wak,A,219,232,13,IIAPIILAFMFFA,1
3wak,A,247,262,15,LVAVVTFAVSALIYL,1
3wak,A,281,294,13,LVLLGSAVIAAAF,1
3wak,A,321,335,14,VLTALIMGLFFVIS,1
3wak,A,382,397,15,ALFFFGMAGILYSAY,1
3wak,A,407,421,14,MALLIWAIAMFIAL,1
3wak,A,431,447,16,AAVSAVYSALALSVVF,1
3wak,A,470,486,16,VAFALLIALAAIYPTY,1
4w6v,A,19,39,20,LSGLFLSEMWERFSFYGIRP,1
4w6v,A,63,83,20,IVGIFAGSMYLAALPGGLLA,1
4w6v,A,90,107,17,RAVWYGSILIALGHLSI,1
4w6v,A,120,140,20,GLVFIVLGTGLFKTCISVMV,1
4w6v,A,155,172,17,SLFYMGINMGSFIAPLL,1
4w6v,A,188,207,19,GGIGMLVALLIFRGFAIPA,1
4w6v,A,233,250,17,WVTAIMAVVVVIIALIS,1
4w6v,A,259,278,19,MIASLLVYVIAASVTLYFI,1
4w6v,A,298,318,20,ILLVSAAFFWSAFEQKPTSF,1
4w6v,A,340,358,18,QSINALFIILLAPVFSWA,1
4w6v,A,372,390,18,TKFVIGILCAAAGFAVMM,1
4w6v,A,409,428,19,VMSILLLTLGELCLSPIGL,1
4w6v,A,444,462,18,GLWFCASSLGNLAAGLIG,1
4w6v,A,477,494,17,ARCSIALVICAAVLILL,1
3w5d,A,55,74,19,QFEDLLVRILLLAACISFV,1
3w5d,A,89,108,19,EPFVILLILIANAIVGVWQ,1
3w5d,A,254,276,22,EFGEQLSKVISLICVAVWLINI,1
3w5d,A,296,317,21,KIAVALAVAAIPEGLPAVITT,1
3w5d,A,760,781,21,IRYLISSNVGEVVCIFLTAAL,1
3w5d,A,786,807,21,LIPVQLLWVNLVTDGLPATAL,1
3w5d,A,833,852,19,FFRYMAIGGYVGAATVGAA,1
3w5d,A,898,916,18,MALSVLVTIEMCNALNSL,1
3w5d,A,927,950,23,WVNIWLLGSICLSMSLHFLILYV,1
3w5d,A,967,987,20,LMVLKISLPVIGLDEILKFI,1
2hpy,A,39,63,24,AAYMFLLIMLGFPINFLTLYVTVQ,1
2hpy,A,73,99,26,ILLNLAVADLFMVFGGFTTTLYTSLH,1
2hpy,A,108,133,25,CNLEGFFATLGGEIALWSLVVLAIE,1
2hpy,A,154,181,27,GVAFTWVMALACAAPPLVGWSRYIPEG,1
2hpy,A,199,225,26,ESFVIYMFVVHFIIPLIVIFFCYGQL,1
2hpy,A,252,277,25,VIIMVIAFLICWLPYAGVAFYIFTH,1
2hpy,A,288,309,21,IPAFFAKTSAVYNPVIYIMMN,1
4gd3,B,19,37,18,IWHWLTVLCMAVLMVTGY,1
4gd3,B,63,80,17,FSAGMVFTVVLLMRIYW,1
4gd3,B,130,149,19,AAMFGYFLMSVFMIITGFA,1
4gd3,B,184,204,20,RLGMWLIGAFVIGHVYMALR,1
1jv7,A,12,32,20,LALGTALMGLGTLYFLVKGM,1
1jv7,A,42,61,19,YAITTLVPAIAFTMYLSML,1
1jv7,A,81,100,19,RYASWLFTTPLLLLDLALL,1
1jv7,A,104,123,19,QGTILALVGADGIMIGTGL,1
1jv7,A,138,157,19,AISTAAMLYILYVLFFGFT,1
1jv7,A,171,189,18,KVLRNVTVVLWSAYPVVW,1
1jv7,A,206,225,19,LFMVLDVSAKVGFGLILLR,1
3uzc,A,11,29,18,VELAIAVLAILGNVLVCW,1
3uzc,A,45,63,18,VSLAAADILVGVLAIPFA,1
3uzc,A,83,99,16,VLVLAQSSIFSLLAIA,1
3uzc,A,123,138,15,IIAICWVLSFAIGLT,1
3uzc,A,177,196,19,VYFNFFACVLVPLLLMLGV,1
3uzc,A,236,252,16,IIAGLFALCWLPLHII,1
3uzc,A,272,288,16,AIVLAHTNSVVNPFIY,1
4pgs,A,18,37,19,VFVFTLLIATVGLFIGQFV,1
4pgs,A,42,61,19,LPLSILEVAMIILAFWMRR,1
4pgs,A,66,86,20,YAFVYTFAFVSGITLFPIVS,1
4pgs,A,95,112,17,VVLEAFGSTFVIFAVLG,1
4pgs,A,126,144,18,SFLLVAVLALAVVGIFNI,1
4pgs,A,153,171,18,MAYSVIGTIVFSLYILYD,1
4pgs,A,187,210,23,MALSLYLDFINLFINLLRFFGIL,1
2jiy,M,55,74,19,GVLSLFSGLMWFFTIGIWF,1
2jiy,M,115,133,18,LIASFFMFVAVWSWWGRT,1
2jiy,M,147,168,21,WWFLSAIWLWMVLGFIRPILM,1
2jiy,M,197,221,24,YNPFHGLSIAFLYGSALLFAMHGA,1
2jiy,M,269,287,18,IWMAVLVTLTGGIGILLS,1
5fij,W,13,26,13,ILGLPLVTLIVLF,1
5fij,W,77,89,12,FIGSTNLLGLLP,1
5fij,W,92,110,18,TPTTQLSMNLGMAIPLWA,1
5fij,W,150,168,18,IQPMALAVRLTANITAGH,1
5fij,W,194,212,18,ILILLTILEFAVAMIQAY,1
1mgy,A,13,31,18,ALGTALMGLGTLYFLVKG,1
1mgy,A,42,60,18,YAITTLVPAIAFTMYLSM,1
1mgy,A,82,100,18,YASWLFTTPLLLLDLALL,1
1mgy,A,104,123,19,QGTILALVGADGIMIGTGL,1
1mgy,A,139,157,18,ISTAAMLYILYVLFFGFT,1
1mgy,A,171,189,18,KVLRNVTVVLWSAYPVVW,1
1mgy,A,207,225,18,FMVLDVSAKVGFGLILLR,1
4k1c,A,35,52,17,KASPLNFLLVFVPLGLI,1
4k1c,A,65,86,21,FNFLAIIPLAAILANATEELA,1
4k1c,A,93,112,19,GGLLNATFGNAVELIVSII,1
4k1c,A,123,144,21,ASMLGSLLSNLLLVLGLCFIF,1
4k1c,A,160,176,16,TMSSLLAIACASLLIP,1
4k1c,A,202,219,17,TSIVILIVYVLFLYFQL,1
4k1c,A,251,269,18,SSLVILLGTTVIISFCAD,1
4k1c,A,291,308,17,IVIPIVGNAAEHVTSVL,1
4k1c,A,319,340,21,GVAIGSSLQVALFVTPFMVLV,1
4k1c,A,357,373,16,ATLFIAVFLSNYLILD,1
4k1c,A,377,394,17,WLEGVMSLAMYILIAMA,1
3ny9,A,36,59,23,GIVMSLIVLAIVFGNVLVITAIA,1
3ny9,A,69,91,22,YFITSLACADLVMGLAVVPFGA,1
3ny9,A,109,130,21,TSIDVLCVTASIWTLCVIAVD,1
3ny9,A,149,168,19,ARVIILMVWIVSGLTSFLP,1
3ny9,A,202,221,19,SSIVSFYVPLVIMVFVYSR,1
3ny9,A,275,294,19,GIIMGTFTLCWLPFFIVNI,1
3ny9,A,311,327,16,NWIGYVNSGFNPLIYC,1
4u9l,B,278,305,27,VALWLARVRWLVILILTGMVTSSILQG,1
4u9l,B,318,338,20,YVPVLLGTGGNTGNQSATLI,1
4u9l,B,353,381,28,RVFLKEMGVGLLLGLTLSFLLVGKVYWD,1
4u9l,B,388,412,24,VVGVSLVLIVFFANLVGAMLPFLL,1
4u9l,B,422,443,21,SNPLVATLSDVTGLLIYLSVA,1
1m0m,C,11,28,17,WLALGTALMGLGTLYFL,1
1m0m,C,47,62,15,LVPAIAFTMYLSMLL,1
1m0m,C,80,94,14,ARYADWLFTTPLLL,1
1m0m,C,112,127,15,GADGIMIGTGLVGAL,1
1m0m,C,134,149,15,FVWWAISTAAMLYIL,1
1m0m,C,178,192,14,VVLWSAYPVVWLIG,1
1m0m,C,204,220,16,TLLFMVLDVSAKVGFG,1
4l6v,K,57,73,16,LSVGIIMCLCNVFAFV,1
4l6v,K,103,122,19,LLATMSFGHILGAGMVLGL,1
3k08,E,26,45,19,LFVLTILTLISGTIFYSTV,1
3k08,E,74,98,24,GKIFTILYIFIGIGLVFGFIHKLA,1
5xar,B,23,42,19,FGMPLPLYAFALITLLLSH,1
5xar,B,51,73,22,VGGFAIMFIIGAIFGEIGKRLP,1
5xar,B,75,93,18,NKYIGGAPVMIFLVAAYF,1
5xar,B,115,131,16,FLNLFIAVLITGAILS,1
5xar,B,146,166,20,TILMGIVGASIFGIAIGLVF,1
5xar,B,210,226,16,TAIAILTIANIFAIVF,1
5xar,B,266,286,20,ETAVGLVLSTTCFLLAYVVA,1
5xar,B,299,317,18,YFAWMVLIVAALNASGLC,1
5xar,B,325,346,21,KRLSDFFSKQLLWVLMVGVGV,1
5xar,B,358,380,22,TFANVVIAAIIVIGAVLGAAIG,1
5xar,B,425,441,16,SSRLGGGIVLVIASIV,1
2qju,A,16,35,19,AMAGNAVGLGNFLRFPVQA,1
2qju,A,44,63,19,IPYIIAFLLVGIPLMWIEW,1
2qju,A,89,124,35,AKILGVFGLWIPLVVAIYYVYIESWTLGFAIKFLV,1
2qju,A,167,184,17,AYIVFLITMFINVSILI,1
2qju,A,191,214,23,ERFAKIAMPTLFILAVFLVIRVF,1
2qju,A,242,265,23,VWIAAVGQIFFTLSLGFGAIITY,1
2qju,A,278,298,20,GLTAATLNEKAEVILGGSIS,1
2qju,A,340,366,26,GFLWFFLLFFAGLTSSIAIMQPMIAF,1
2qju,A,378,396,18,VLWTAAIVFFSAHLVMFL,1
2qju,A,400,426,26,DEMDFWAGTIGVVFFGLTELIIFFWI,1
2qju,A,445,469,24,RIYYYVMRYITPAFLAVLLVVWAR,1
2qju,A,484,502,18,ITRFYIIGLFLFLTFLVF,1
3ehz,E,198,216,18,NIILPMLFILFISWTAFW,1
3ehz,E,221,240,19,ANVTLVVSTLIAHIAFNIL,1
3ehz,E,255,274,19,AIIFMIYLFYFVAVIEVTV,1
3ehz,E,294,312,18,RIAFPVVFLLANIILAFL,1
2hj6,H,16,32,16,IYSFWIFLAGLIYYLQ,1
5jsi,A,9,29,20,MVATVGMLAGTVFLLASSRE,1
5jsi,A,36,55,19,GVYISALVCGIAWYHYQKM,1
5jsi,A,67,87,20,LRYVDWVLTVPLMFVEVLAV,1
5jsi,A,96,117,21,AVRNWGIAATVMIGAGYYGET,1
5jsi,A,124,146,22,YWTGFVIAMATYVWLMRNLQAE,1
5jsi,A,157,178,21,FENIKNLILVGWIIYPLGYIA,1
5jsi,A,189,211,22,VLYTIADIINKVGLGVLVLQMA,1
4nta,C,8,28,20,ATVTLVGVLLQAYFSLQVIS,1
4nta,C,52,71,19,QVNCSEYFPLFLATLWVAG,1
4nta,C,79,97,18,ALCGLFYLFARLRYFQGY,1
4nta,C,104,124,20,LTPLYASARALWLLVAMAAL,1
1s53,E,10,34,24,IWLALGTALMGLGTLYFLVKGMGV,1
1s53,E,40,62,22,KFYAISTLVPAIAFTMYLSMLL,1
1s53,E,80,100,20,ARYADWLFTTPLLLLDLALL,1
1s53,E,104,127,23,QGTILALVGADGIMIGTGLVGAL,1
1s53,E,134,157,23,FVWWAISTAAMLYILYVLFFGFT,1
1s53,E,171,192,21,KVLRNVTVVLWSAYPVVWLIG,1
1s53,E,203,226,23,ETLLFMVLDVSAKVGFGLILLRS,1
3b61,A,7,20,13,GGAILAEVIGTTL,1
3b61,A,38,51,13,CYCASFWLLAQTL,1
3b61,A,54,66,12,PTGIAYAIWSGV,1
3eff,N,30,48,18,AATVLLVIVLLAGSYLAV,1
3eff,N,87,107,20,GRLVAVVVMVAGITSFGLVT,1
1jo5,A,12,41,29,DEQAQELHSVYMSGLWLFSAVAIVAHLAV,1
2zt9,Q,2,22,20,AIVAYIGFLALFTGIAAGLL,1
2q7r,C,12,29,17,AIVTLISVVQNGFFAHK,1
2q7r,C,58,75,17,NCVDAYPTFLAVLWSAG,1
2q7r,C,83,99,16,AFAGLMYLFVRQKYFV,1
2q7r,C,113,128,15,FGKRIILFLFLMSVA,1
4u16,A,67,93,26,VFIAFLTGFLALVTIIGNILVIVAFK,1
4u16,A,105,129,24,LLSLACADLIIGVISMNLFTTYII,1
4u16,A,139,163,24,CDLWLSIDYVASNASVMNLLVISF,1
4u16,A,185,206,21,VMIGLAWVISFVLWAPAILFW,1
4u16,A,221,251,30,IQFLSEPTITFGTAIAAFYMPVTIMTILYW,1
4u16,A,492,516,24,SAILLAFIITWTPYNIMVLVNTFC,1
4u16,A,523,545,22,YWNLGYWLCYINSTVNPVCYAL,1
4u1w,D,524,540,16,IWMAIVFAYIGVSVVL,1
4u1w,D,597,617,20,ARIVAGVWWFFTLIIISSYT,1
4u1w,D,790,808,18,NVAGVFYILVGGLGLAML,1
2q67,D,26,42,16,LFVLTILTLISGTIFY,1
2q67,D,76,94,18,KIFTILYIFIGIGLVFGF,1
1s3b,A,486,498,12,PSVPGLLRLIGL,1
3klz,E,35,52,17,LAISAGIQIGIAFVFYT,1
3klz,E,68,84,16,LGGLAFSLGLILVVIT,1
3klz,E,114,134,20,VVYFGNLCGSIILVFIMLAT,1
3klz,E,161,180,19,QAFALGLMCNILVCLAVWM,1
3klz,E,189,205,16,KVMVLILPVAMFVSSG,1
3klz,E,250,268,18,VNNLIPVTLGNIVGGGVF,1
4ysx,D,58,78,20,FKIERYFAAAMVPLIPAAYF,1
4ysx,D,84,108,24,DLCLALALTLHVHWGVWGVVNDYG,1
4ysx,D,118,140,22,AAVRVGAYIFTACLLAGLLYFN,1
5mrl,A,491,501,10,LLRLIGLTTI,1
1s2q,A,491,501,10,LLRLIGLTTI,1
4px7,A,5,25,20,RRTAVGAALLLVMPVAVWIS,1
4px7,A,40,65,25,AFWVTETVTQPWGVITHLILFGWFL,1
4px7,A,76,97,21,VLFAILAAAILVGQGVKSWIK,1
4px7,A,159,179,20,PSGHTMFAASWALLAVGLLW,1
4px7,A,184,203,19,LTIAILLVWATGVMGSRLL,1
4px7,A,207,230,23,WPRDLVVATLISWALVAVATWLA,1
2q6a,D,26,45,19,LFVLTILTLISGTIFYSTV,1
2q6a,D,75,94,19,GKIFTILYIFIGIGLVFGF,1
1t5s,A,55,78,23,QFEDLLVRILLLAACISFVLAWF,1
1t5s,A,86,104,18,AFVEPFVILLILIANAIV,1
1t5s,A,257,276,19,EQLSKVISLICVAVWLINI,1
1t5s,A,293,313,20,YYFKIAVALAVAAIPEGLPA,1
1t5s,A,760,781,21,IRYLISSNVGEVVCIFLTAAL,1
1t5s,A,786,807,21,LIPVQLLWVNLVTDGLPATAL,1
1t5s,A,832,852,20,LFFRYMAIGGYVGAATVGAA,1
1t5s,A,898,916,18,MALSVLVTIEMCNALNSL,1
1t5s,A,931,950,19,WLLGSICLSMSLHFLILYV,1
1t5s,A,964,987,23,TQWLMVLKISLPVIGLDEILKFI,1
2cpb,A,21,43,22,IGYAWAMVVVIVGATIGIKLFK,1
2xfo,A,486,498,12,PSVPGLLRLIGL,1
1jgx,H,16,32,16,IYSFWIFLAGLIYYLQ,1
3ukm,B,22,44,22,FGFLVLGYLLYLVFGAVVFSSV,1
3ukm,B,129,157,28,GKAFCIIYSVIGIPFTLLFLTAVVQRIT,1
3ukm,B,183,206,23,AVLLGFVTVSCFFFIPAAVFSVL,1
3ukm,B,244,268,24,YKIGITCYLLLGLIAMLVVLETFC,1
2f95,D,27,38,11,FVGALTVLFGA,1
2f95,D,65,79,14,GLIILLGINLGLVA,1
5fl7,T,14,26,12,ASIGLVGAGIGI,1
5fl7,T,56,68,12,LSEATGLFALMI,1
3kcu,E,36,56,20,LAITAGVFISIAFVFYITAT,1
3kcu,E,67,85,18,KLVGGICFSLGLILCVVC,1
3kcu,E,114,135,21,LNVYFGNLVGALLFVLLMWLS,1
3kcu,E,162,182,20,EAVCLGILANLMVCLAVWMS,1
3kcu,E,189,219,30,DKAFIMVLPVAMFVASGFEHSIANMFMIPM,1
3kcu,E,248,272,24,NFITDNLIPVTIGNIIGGGLLVGL,1
5j9p,F,26,50,24,RAAGAATVLLVIVLLAGSYLAVLA,1
5j9p,F,87,111,24,GRLVAVVVMVAGITSFGLVTAALA,1
2c32,D,13,30,17,CAEFFASLFYVFFGLGA,1
2c32,D,43,60,17,VALAFGLALATLVQAVG,1
2c32,D,87,104,17,CYMVAQLLGAVAGAAVL,1
2c32,D,129,148,19,ATIVEIFLTLQFVLCIFAT,1
2c32,D,159,176,17,VALAVGFSLTLGHLFGM,1
2c32,D,202,219,17,VYWVGPVIGAGLGSLLY,1
1xme,C,5,27,22,KGALAVILVLTLTILVFWLGVY,1
4gc0,A,15,35,20,VATLGGLLFGYDTAVISGTV,1
4gc0,A,56,75,19,LGFCVASALIGCIIGGALG,1
4gc0,A,88,105,17,KIAAVLFFISGVGSAWP,1
4gc0,A,125,148,23,VPEFVIYRIIGGIGVGLASMLSP,1
4gc0,A,163,185,22,VSFNQFAIIFGQLLVYCVNYFI,1
4gc0,A,198,217,19,WRYMFASECIPALLFLMLL,1
4gc0,A,281,302,21,VMLSIFQQFVGINVVLYYAPE,1
4gc0,A,316,336,20,QTIIVGVINLTFTVLAIMTV,1
4gc0,A,342,363,21,PLQIIGALGMAIGMFSLGTAF,1
4gc0,A,372,395,23,LLSMLFYVAAFAMSWGPVCWVLL,1
4gc0,A,410,431,21,AVAAQWLANYFVSWTFPMMDK,1
4gc0,A,442,460,18,FSYWIYGCMGVLAALFMW,1
1zwi,F,27,50,23,AAGAATVLLVIVLLAGSYLAVLA,1
1zwi,F,87,110,23,GRCVAVVVMVAGITSFGLVTAAL,1
5d7t,D,27,41,14,TFYFIIMIFLANNW,1
5d7t,D,43,59,16,YLVISIFGLAYVFATG,1
5d7t,D,73,90,17,WMIVFTSLLQTFFMAGG,1
5d7t,D,100,123,23,LSSEGLINGLYVFIRFAMIILVS,1
5d7t,D,246,257,11,IPVAYCLLLTI,1
5t36,C,16,32,16,LLCSTLLVIKMYVVAI,1
5t36,C,73,90,17,NDMETIYPFLFLGFVYS,1
5t36,C,98,115,17,AWMHFLVFLVGRVAHTV,1
5t36,C,129,146,17,YTLAQLPCASMALQILW,1
2vpz,G,16,36,20,NALHFVLVGLAGGVALLAAL,1
2vpz,G,50,66,16,YALMLIALDLFILWAE,1
2vpz,G,89,105,16,WGAWGLGLGFLTGGLL,1
2vpz,G,115,132,17,AWALLVFSLVALSYPGL,1
2vpz,G,147,163,16,AGLFPLTALVLALGLA,1
2vpz,G,175,189,14,RVLAGASLLLALLY,1
2vpz,G,207,221,14,WYGLFLLLGLGTFW,1
2vpz,G,226,241,15,PWAGLLAAAGLRALL,1
3uq5,E,205,221,16,WSFILPLGLIIAASWS,1
3uq5,E,235,250,15,FTLMATVVAYALYTS,1
3uq5,E,262,278,16,DQMIIAGYGSIFAAIL,1
3uq5,E,305,317,12,LGFLAIGCVLVI,1
3n23,G,30,46,16,LIFAALAFIVGLIIIL,1
1occ,Z,17,36,19,GLSVTFLSFLLPAGWVLYH,1
4p9o,F,132,152,20,SVAALLTVVFYIAAVMATNL,1
4p9o,F,195,218,23,WVFFIPFIMLTTFTVLNLFIGII,1
3po7,A,486,501,15,PSVPGLLRLIGLTTI,1
4yeu,E,206,220,14,NIILPMLFILFISW,1
4yeu,E,236,248,12,STLIAHIAFNIL,1
4yeu,E,262,276,14,GAIIFMIYLFYFVA,1
4yeu,E,307,320,13,VVFLLANIILAFL,1
5tis,r,9,23,14,LPVLLAAGWAVRNI,1
4g80,T,119,140,21,VFGVFLIFLDIILMIIDLSLP,1
4g80,T,146,169,23,QSFYDGMALALSCYFMLDLGLRI,1
4g80,T,183,204,21,VADGLIIVVTFVVTIFYTVLD,1
4g80,T,213,231,18,GLGRLVVLARLLRVVRLA,1
3usk,B,17,32,15,MAGNAVGLGNFLRFP,1
3usk,B,44,62,18,IPYIIAFLLVGIPLMWIE,1
3usk,B,90,124,34,KILGVFGLWIPLVVAIYYVYIESWTLGFAIKFLV,1
3usk,B,167,183,16,AYIVFLITMFINVSIL,1
3usk,B,195,214,19,KIAMPTLFILAVFLVIRVF,1
3usk,B,244,263,19,IAAVGQIFFTLSLGFGAII,1
3usk,B,280,297,17,TAATLNEKAEVILGGSI,1
3usk,B,340,364,24,GFLWFFLLFFAGLTSSIAIMQPMI,1
3usk,B,380,395,15,WTAAIVFFSAHLVMF,1
3usk,B,400,422,22,DEMDFWAGTIGVVFFGLTELII,1
3usk,B,451,469,18,MRYITPAFLAVLLVVWAR,1
3usk,B,485,500,15,TRFYIIGLFLFLTFL,1
5ara,W,13,27,14,ILGLPLVTLIVLFP,1
5ara,W,75,89,14,ILFIGSTNLLGLLP,1
5ara,W,95,110,15,TQLSMNLGMAIPLWA,1
5ara,W,144,169,25,ETISLFIQPMALAVRLTANITAGHL,1
5ara,W,194,215,21,ILILLTILEFAVAMIQAYVFT,1
4us4,A,21,39,18,AMGSAVGLGNIWRFSYVT,1
4us4,A,45,63,18,AFLLVYLGFIALIGIPIV,1
4us4,A,93,120,27,GLMGVAAGFLILSFYGVIAGWILFYLF,1
4us4,A,150,166,16,FWQALFMIATIWIVAI,1
4us4,A,169,192,23,KGIERSNKILMPLLGVLLIALAI,1
4us4,A,216,239,23,DPGVYLAAISQAFFTLSLGMGAL,1
4us4,A,256,273,17,VSVAGLDTAFAIIAGIM,1
4us4,A,309,333,24,GIAFFILLGAAALSSAVSLLEVPV,1
4us4,A,346,363,17,AAITLGVIITLLGIPSS,1
4us4,A,381,402,21,DSVDFIASSVFLPLGGMIIAL,1
4us4,A,431,449,18,LRFIAPIAILIVFLSAFQ,1
4ev3,C,10,27,17,VILVLTLTILVFWLGVY,1
3abm,Z,13,33,20,EQAIGLSVTFLSFLLPAGWV,1
2bcc,J,19,42,23,FALTIVVGALLFERAFDQGADAI,1
5l8r,L,101,115,14,VGLAHGFLLVGPFV,1
5l8r,L,131,144,13,LAAGGLVVILSIC,1
5l8r,L,190,203,13,FGGISGVIWAFFL,1
2iqm,A,49,73,24,IAITALYSAVCAVGLLGNVLVMFG,1
2iqm,A,88,108,20,FNLALADALATSTLPFQSAK,1
2iqm,A,120,141,21,CKAVLSIDYYNMFTSIFTLTM,1
2iqm,A,168,191,23,NICIWVLASGVGVPIMVMAVTRP,1
2iqm,A,209,230,21,DTVTKICVFLFAFVVPILIIT,1
2iqm,A,265,288,23,VVGAFVVCWAPIHIFVIVWTLVD,1
2iqm,A,297,320,23,AALHLCIALGYANSSLNPVLYAF,1
2irv,C,94,113,19,PVTWVMMIACVVVFIAMQI,1
2irv,C,148,166,18,MHILFNLLWWWYLGGAVE,1
2irv,C,172,189,17,KLIVITLISALLSGYVQ,1
2irv,C,198,214,16,GLSGVVYALMGYVWLR,1
2irv,C,225,241,16,QRGLIIFALIWIVAGW,1
2irv,C,252,268,16,AHIAGLAVGLAMAFVD,1
2loo,A,29,46,17,IAGLFVGCLAGYGAYRV,1
2loo,A,52,66,14,VKVSLFTAFFLATI,1
2loo,A,81,97,16,LVAGLSLMMILRLVLL,1
4a79,A,486,501,15,PSVPGLLRLIGLTTI,1
5kkh,C,18,36,18,WLALGTIGMLLGMLYFIA,1
5kkh,C,52,69,17,TILIPAIAAASYLSMFF,1
5kkh,C,88,103,15,ARYADWLFTTPLLLL,1
5kkh,C,118,136,18,LVGIDAFMIVTGLVATLT,1
5kkh,C,142,160,18,YAFWTISTISMVFLLYYL,1
5kkh,C,183,200,17,NIILVTWAIYPVAWLVG,1
5kkh,C,212,230,18,TLLFMVLDLVAKVGFGFI,1
5b6v,C,12,28,16,LALGTALMGLGTLYFL,1
5b6v,C,47,61,14,LVPAIAFTMYLSML,1
5b6v,C,80,94,14,ARYADWLFTTPLLL,1
5b6v,C,111,126,15,VGADGIMIGTGLVGA,1
5b6v,C,135,150,15,VWWAISTAAMLYILY,1
5b6v,C,178,192,14,VVLWSAYPVVWLIG,1
5b6v,C,204,220,16,TLLFMVLDVSAKVGFG,1
5khs,A,23,39,16,SLLIAAFSGVYVARHF,1
5khs,A,280,295,15,GVVTLLVVFVILWLA,1
5khs,A,303,325,22,SVLVTLFVGLVVTAALGLAMVG,1
5khs,A,332,347,15,AFMVLFVGLGVDFSI,1
5khs,A,382,395,13,TAVAASFFSFIPT,1
5khs,A,401,418,17,ELGLIAGVGMFVALLTT,1
5khs,A,458,473,15,IGTLAVVIGALPLLA,1
5khs,A,720,734,14,LHAALWSIISITIL,1
5khs,A,749,766,17,VPLLVSGIVTLEMCVVL,1
5khs,A,776,789,13,ALPLMLGVGVAFK,1
5khs,A,813,827,14,FSAATTATAFGSLW,1
5khs,A,838,855,17,KLLALALTCTLIGAVVF,1
3hkk,C,9,25,16,AVTLLGVLLQAYFSLQ,1
3hkk,C,53,71,18,VNCSEYFPLFLATLWVAG,1
3hkk,C,79,95,16,ALCGLVYLFARLRYFQ,1
3hkk,C,106,124,18,PLYASARALWLLVALAAL,1
2prc,H,13,30,17,QLVWYAQWLVIWTVVLL,1
5ekp,D,231,252,21,TYLGSIISLLSLAYASFLILK,1
5ekp,D,260,283,23,PGYASLMVAILFLGGVQLISLGV,1
4hfe,E,199,218,19,NIILPMLFILFISWTAFWS,1
4hfe,E,222,240,18,ANVTLVVSTLIAHIAANI,1
4hfe,E,256,275,19,AIIFMIYLFYFVAVIEVTV,1
4hfe,E,292,313,21,RASRIAFPVVFLLANIILAFL,1
4myc,B,107,132,25,RIRVLIALGLLISAKILNVQVPFFF,1
4myc,B,159,182,23,CYGVARFGSVLFGELRNAVFAKV,1
4myc,B,229,252,23,TAMVFHIIPISFEISVVCGILTY,1
4myc,B,257,280,23,FAAITFSTMLLYSIFTIKTTAWR,1
4myc,B,334,358,24,VSQSLAFLNSGQNLIFTTALTAMM,1
4myc,B,377,396,19,INQLVFQLSVPLNFLGSVY,1
4zzb,E,199,218,19,NIILPMLFILFISWTAFWS,1
4zzb,E,222,242,20,ANVTLVVSTLIAHIAFNILV,1
4zzb,E,256,276,20,AIIFMIYLFYFVAVIEVTVQ,1
4zzb,E,292,313,21,RASRIAFPVVFLLANIILAFL,1
2bns,C,13,31,18,SLAIYSFWIFLAGLIYYL,1
2ik5,_,47,68,21,YSIETVVGVLGNLCLMCVTVR,1
2ik5,_,76,96,20,NLLIANLAFSDFLMCLLCQP,1
2ik5,_,119,140,21,IQCMSVTVSILSLVLVALERH,1
2ik5,_,154,173,19,QAYLGIVLIWVIACVLSLP,1
2ik5,_,216,238,22,FLLLFQYCLPLGFILVCYARIY,1
2ik5,_,264,283,19,VVLVVMVVAFAVLWLPLHV,1
2ik5,_,307,326,19,HLLAMASTCVNPFIYGFLN,1
2ks1,B,147,171,24,TGMVGALLLLLVVALGIGLFMRRR,1
2nmr,C,15,32,17,CTALVLFMTIPGIALFY,1
2nmr,C,46,64,18,QVTVTFALVCILWVVYGY,1
2nmr,C,102,119,17,FQGSFACITVGLIVGAL,1
2nmr,C,127,147,20,VLIFVVVWLTLSYIPIAHMV,1
2nmr,C,161,178,17,AGGTVVHINAAIAGLVG,1
2nmr,C,202,219,17,TGTAILYIGWFGFNAGS,1
2nmr,C,231,248,17,VNTVVATAAAILGWIFG,1
2nmr,C,261,276,15,CSGAIAGLVGVTPAC,1
2nmr,C,282,299,17,GALIIGVVAGLAGLWGV,1
2nmr,C,313,332,19,VFGVHGVCGIVGCIMTGIF,1
2nmr,C,353,377,24,VQLESIAITIVWSGVVAFIGYKLA,1
1yst,H,16,31,15,IYSFWIFLAGLIYYL,1
4mlb,A,21,42,21,RLSIPMMIGMSVQTLYNLADG,1
4mlb,A,57,79,22,LFFPVFMGIIALAAGLGVGTSS,1
4mlb,A,101,123,22,ILSLILGVTITITMLPAIDSLF,1
4mlb,A,137,161,24,EYARVLLAGAFIIVFNNVGNGILR,1
4mlb,A,166,187,21,NRAMLAMVLGSGLNIVLDPIF,1
4mlb,A,197,218,21,AAYATLLSMVVTSLFIAYWLF,1
4mlb,A,243,266,23,RVGLPSSLSQLSMSIAMFFLNSV,1
4mlb,A,280,301,21,SAWRITMLGIVPILGMATATT,1
4mlb,A,321,342,21,YAIKIAFMIELAVVAFIMLFA,1
4mlb,A,366,388,22,RTLPVFLVLTPFGMMTSAMFQG,1
4mlb,A,392,418,26,EKSLILTIFRTLVMQVGFAYIFVHYT,1
4mlb,A,424,444,20,VWIGIVIGNMVAAIVGFLWG,1
3ayg,A,21,45,24,LKSILIFTILISSTVLLVGGYWIF,1
3ayg,A,254,278,24,GASVTILILFIGIILYVFYRYQLS,1
3ayg,A,306,328,22,KYFVVVSALFFVQTMFGALLAH,1
3ayg,A,350,372,22,AKGYHLQLAIFWIATAWLGMGI,1
3ayg,A,390,411,21,DLLFWALVVLVGGSMIGQWLG,1
3ayg,A,419,452,33,WFLLGHQGWEYIELGRIWQIILVVGMLLWLFIV,1
3ayg,A,473,491,18,FYSAIAVPFFYIFAFFIQ,1
3ayg,A,499,524,25,DFWRWWIIHLWVEGIFEVFAVVVIG,1
3ayg,A,541,561,20,LYFQFTILLGSGVIGIGHHY,1
3ayg,A,570,596,26,IALGAVFSALEVIPLTLLILEAYEQY,1
3ayg,A,610,635,25,TFWFLISTAIWNLVGAGVFGFLINL,1
3ayg,A,648,672,24,PAHGHAAMMGVYGMFAIAVLLYSL,1
3ayg,A,684,706,22,WLKFSCWMLNIGLAGMVVITLL,1
3ayg,A,742,764,22,AVPDTIFLIGVVALLVFAIKAL,1
3zoj,D,49,66,17,GEFVGTFLFLWSAFVIA,1
3zoj,D,87,104,17,ISFGFGFGVMVGVFITY,1
3zoj,D,131,148,17,LMAFTQIVAGMAAAGAA,1
3zoj,D,172,189,17,FLEAFGTAILCLTVLML,1
3zoj,D,200,216,16,PFVIGIALLIAHLICI,1
3zoj,D,243,260,17,IYWLGPILGAFLAYSIW,1
1iw6,C,12,29,17,LALGTALMGLGTLYFLV,1
1iw6,C,45,61,16,TTLVPAIAFTMYLSML,1
1iw6,C,80,95,15,ARYADWLFTTPLLLL,1
1iw6,C,110,126,16,LVGADGIMIGTGLVGA,1
1iw6,C,135,153,18,VWWAISTAAMLYILYVLF,1
1iw6,C,175,192,17,NVTVVLWSAYPVVWLIG,1
1iw6,C,204,222,18,TLLFMVLDVSAKVGFGLI,1
4mmf,B,13,32,19,LILAMAGYAVDLGNFLRFP,1
4mmf,B,42,63,21,FMIPYIIAFLLVGIPLMWIEW,1
4mmf,B,90,124,34,KILGVFGLWIPLVVAIYYVYIESWTLGFAIKFLV,1
4mmf,B,167,185,18,AYIVFLITMFINVSILIR,1
4mmf,B,191,214,23,ERFAKIAMPTLFILAVFLVIRVF,1
4mmf,B,242,265,23,VWIAAVGQIFFSLGLGFGAIITY,1
4mmf,B,278,298,20,GLTAATLNEKAEVILGGSIS,1
4mmf,B,340,367,27,GFLWFFLLFFAGLTSSIAGMQPMIAFL,1
4mmf,B,378,396,18,VLWTAAIVFFSAHLVMFL,1
4mmf,B,400,425,25,DEMDFWAGTIGVVFFGLTELIIFFW,1
4mmf,B,448,472,24,YYVMRYITPAFLAVLLVVWAREYI,1
4mmf,B,484,502,18,ITRFYIIGLFLFLTFLVF,1
1e7p,F,29,50,21,QSATGLFLGLFMIGHMFFVST,1
1e7p,F,78,101,23,VSFLAAFVFAVFIAHAFLAMRKF,1
1e7p,F,125,151,26,WWIQAMTGFAMFFLGSVHLYIMMTQP,1
1e7p,F,168,192,24,WPLYLVLLFAVELHGSVGLYRLAV,1
1e7p,F,206,229,23,ANLKKLKTLMSAFLIVLGLLTFG,1
5eqi,A,17,37,20,GAVLGSLQFGYNTGVINAPQ,1
5eqi,A,64,86,22,WSLSVAIFSVGGMIGSFSVGLF,1
5eqi,A,94,113,19,SMLMMNLLAFVSAVLMGFS,1
5eqi,A,119,141,22,EMLILGRFIIGVYCGLTTGFVP,1
5eqi,A,158,178,20,LHQLGIVVGILIAQVFGLDS,1
5eqi,A,186,205,19,PLLLSIIFIPALLQCIVLP,1
5eqi,A,273,298,25,IAVVLQLSQQLSGINAVFYYSTSIF,1
5eqi,A,307,328,21,YATIGSGIVNTAFTVVSLFVV,1
5eqi,A,334,354,20,TLHLIGLAGMAGCAILMTIA,1
5eqi,A,367,391,24,SIVAIFGFVAFFEVGPGPIPWFIV,1
5eqi,A,404,426,22,AVAGFSNWTSNFIVGMCFQYVE,1
5eqi,A,433,452,19,FIIFTVLLVLFFIFTYFKV,1
5ide,D,528,542,14,MCIVFAYIGVSVVL,1
5ide,D,603,617,14,IVGGVWWFFTLIII,1
5ide,D,799,813,14,FYILVGGLGLAMMV,1
1pw4,A,30,52,22,FLGIFFGYAAYYLVRKNFALAM,1
1pw4,A,64,84,20,LGFALSGISIAYGFSKFIMG,1
1pw4,A,91,111,20,PRVFLPAGLILAAAVMLFMG,1
1pw4,A,122,141,19,MFVLLFLCGWFQGMGWPPC,1
1pw4,A,160,179,19,WNCAHNVGGGIPPLLFLLG,1
1pw4,A,190,208,18,YMPAFCAILVALFAFAMM,1
1pw4,A,257,280,23,IAIANVFVYLLRYGILDWSPTYL,1
1pw4,A,291,310,19,SWAYFLYEYAGIPGTLLCG,1
1pw4,A,323,342,19,TGVFFMTLVTIATIVYWMN,1
1pw4,A,347,369,22,TVDMICMIVIGFLIYGPVMLIG,1
1pw4,A,387,408,21,TGLFGYLGGSVAASAIVGYTV,1
1pw4,A,414,433,19,GGFMVMIGGSILAVILLIV,1
3vvr,A,24,44,20,IPMMIGMSVQTLYNLADGIW,1
3vvr,A,57,79,22,LFFPVFMGIIALAAGLGVGTSS,1
3vvr,A,100,120,20,LILSLILGVTITITMLPAID,1
3vvr,A,138,161,23,YARVLLAGAFIIVFNNVGNGILR,1
3vvr,A,167,188,21,RAMLAMVLGSGLNIVLDPIFI,1
3vvr,A,197,218,21,AAYATLLSMVVTSLFIAYWLF,1
3vvr,A,243,264,21,RVGLPSSLSQLSMSIAMFFLN,1
3vvr,A,280,301,21,SAWRITMLGIVPILGMAAATT,1
3vvr,A,324,346,22,KIAFMIELAVVAFIMLFAPQVA,1
3vvr,A,364,388,24,ALRTLPVFLVLTPFGMMTSAMFQG,1
3vvr,A,392,415,23,EKSLILTIFRTLVMQVGFAYIFV,1
3vvr,A,424,444,20,VWIGIVIGNMVAAIVGFLWG,1
3vw7,A,105,131,26,PSVYTGVFVVSLPLNIMAIVVFILKM,1
3vw7,A,137,159,22,VVYMLHLATADVLFVSVLPFKI,1
3vw7,A,178,200,22,TAAFYCNMYASILLMTVISIDR,1
3vw7,A,217,238,21,RASFTCLAIWALAIAGVVPLL,1
3vw7,A,267,291,24,AYYFSAFSAVFFFVPLIISTVCYV,1
3vw7,A,311,340,29,LFLSAAVFCIFIICFGPTNVLLIAHYSFL,1
3vw7,A,353,375,22,LLCVCVSSISCCIDPLIYYYAS,1
2lx0,A,7,27,20,VIAGLVALLTFLAFGFWLFK,1
4m48,A,35,57,22,FLLSVIGFAVDLANVWRFPYLC,1
4m48,A,63,82,19,AFLVPYGIMLAVGGIPLFY,1
4m48,A,112,133,21,VVLIAFYVDFYYNVIIAWSLR,1
4m48,A,238,255,17,MALCLLIVYLICYFSLW,1
4m48,A,261,281,20,GKVVWFTALFPYAALLILLI,1
4m48,A,304,328,24,YKAEVWADAATQVFFSLGPGFGVL,1
4m48,A,345,362,17,LLTSFINSATSFIAGFV,1
4m48,A,409,429,20,FFMMLATLGLDSSFGGSEAI,1
4m48,A,448,464,16,AGLFSLYFVVGLASCT,1
4m48,A,468,491,23,YFFHLLDRYAAGYSILVAVFFEA,1
4m48,A,526,545,19,APIFLLFITVYLLIGYEPL,1
4m48,A,555,572,17,ANALGWCIAGSSVVMIP,1
4c9q,B,18,38,20,GGVSAAIAKTAASPIERVKI,1
4c9q,B,79,93,14,TANVIRYFPTQALN,1
4c9q,B,124,142,18,AAGALSLLFVYSLDFART,1
4c9q,B,179,196,17,RGFMPSVVGIVVYRGLY,1
4c9q,B,225,242,17,VTTGASTCSYPLDTVRR,1
4c9q,B,274,294,20,KGCGANILRSVAGAGVISMY,1
5lx9,A,147,169,22,NIWTHLLGCVFFLCLGIFYMFR,1
5lx9,A,180,203,23,KVVFGLFFLGAILCLSFSWLFHT,1
5lx9,A,215,239,24,SKLDYSGIALLIMGSFVPWLYYSF,1
5lx9,A,245,266,21,CFIYLIVICVLGIAAIIVSQW,1
5lx9,A,276,298,22,VRAGVFLGLGLSGIIPTLHYVI,1
5lx9,A,310,333,23,IGWLMLMASLYITGAALYAARIP,1
5lx9,A,345,369,24,HSHQLFHIFVVAGAFVHFHGVSNL,1
3din,E,15,29,14,LIYMVQVQMSKFSE,1
3din,E,54,66,12,ITLVLSVLFFVS,1
1k6l,H,12,32,20,ASLAIYSFWIFLAGLIYYLQ,1
1k4d,L,26,50,24,RAAGAATVLLVIVLLAGSYLAVLA,1
1k4d,L,87,112,25,GRCVAVVVMVAGITSFGLVTAALAT,1
4tnh,z,3,20,17,LFQLALAALVILSFVMV,1
4tnh,z,44,58,14,GLWIALVLVVGVLN,1
5id3,E,216,235,19,AGFAASGVQTGLFARLTWW,1
5id3,E,240,257,17,IVEPVTYFATYSTVAAT,1
3j1z,Q,312,329,17,ASVATALTLITIKLLAW,1
3j1z,Q,339,355,16,SLTDSFADTLASIINF,1
3j1z,Q,388,403,15,MGSAFLLLFYGGERL,1
3j1z,Q,422,439,17,IVLTLALVLLQKRALAA,1
3j1z,Q,446,459,13,ADSLHYKSDLFLN,1
3j1z,Q,477,492,15,GLFAVLIACYIGQQA,1
4djk,A,23,35,12,SMVMAVYEYPTF,1
4djk,A,42,58,16,VFFLLLGGILWFIPVG,1
4djk,A,95,114,19,YLQIAIGFIPMLYFVLGAL,1
4djk,A,131,147,16,IAALIILWALALTQFG,1
4djk,A,152,173,21,ARIAKVGFFAGILLPAFILIA,1
4djk,A,205,217,12,VFVAFILSYMGV,1
4djk,A,237,254,17,MLLLMVAAICLSSVGGL,1
4djk,A,293,312,19,SALLLLGVLAEIASWIVGP,1
4djk,A,343,359,16,SQLVITSIALIILTNT,1
4djk,A,367,383,16,LIALALTVVIYLCAYF,1
4djk,A,415,433,18,AIVGLLTSIMAFIVSFLP,1
4djk,A,446,459,13,ELLVVSFLVVLAL,1
4c9g,A,31,49,18,VSAAVAKTAASPIERVKL,1
4c9g,A,87,103,16,RGNTANVIRYFPTQAL,1
4c9g,A,135,153,18,AAGALSLLFVYSLDYART,1
4c9g,A,186,211,25,AGLYRGFLPSVVGIVVYRGLYFGMY,1
4c9g,A,232,253,21,LGWVVTTGASTCSYPLDTVRR,1
4c9g,A,288,305,17,GANILRGVAGAGVISMY,1
3mbv,C,10,32,22,IWLALGTALMGLGTLYFLVKGM,1
3mbv,C,43,62,19,AITTLVPAIAFTMYLSMLL,1
3mbv,C,80,98,18,ARYADWLFTTPLLLLDLA,1
3mbv,C,107,127,20,ILALVGADGIMIGTGLVGAL,1
3mbv,C,134,154,20,FVWWAISTAAMLYILYVLFF,1
3mbv,C,174,192,18,RNVTVVLWSAYPVVWLIG,1
3mbv,C,203,224,21,ETLLFMVLDVSAKVGFGLILL,1
4tni,z,3,20,17,LFQLALAALVILSFVMV,1
4tni,z,43,57,14,SGLWIALVLVVGVL,1
1lgh,X,21,40,19,TTFSAFIILAAVAHVLVWV,1
5lzq,B,4,17,13,ALFFLIPLVALGF,1
5lzq,B,56,70,14,IFKVAIVIAILLMI,1
5lzq,B,75,90,15,TGVAFLLGAVMSASA,1
5lzq,B,131,147,16,SVGGFALLGLVLVYLI,1
5lzq,B,176,190,14,SGYALGCSIIAMFD,1
5lzq,B,241,255,14,ADLLESFVGAIVSS,1
5lzq,B,291,306,15,FFALVGLGCSMLGIL,1
5lzq,B,325,339,14,WTSALLTVVLTAFL,1
5lzq,B,364,380,16,SAIIGIFSGILIGFWA,1
5lzq,B,415,431,16,SVFPPTLTLVLGILFA,1
5lzq,B,441,455,14,IAALGMLSFVATSV,1
5lzq,B,498,513,15,KGFAIGSAIFAALSL,1
5lzq,B,546,559,13,GALLGAAITYYFS,1
5lzq,B,613,626,13,PAFIAILTPLVTG,1
5lzq,B,635,651,16,GVLIGTVLSGAMLAIL,1
5lzq,B,700,713,13,SLDILIKIMSVVS,1
4av6,B,7,20,13,FLIPLVALGFAAA,1
4av6,B,55,70,15,AIFKVAIVIAILLMI,1
4av6,B,77,91,14,VAFLLGAVMSASAG,1
4av6,B,130,144,14,LSVGGFALLGLVLV,1
4av6,B,177,192,15,GYALGCSIIAMFDRV,1
4av6,B,241,254,13,ADLLESFVGAIVS,1
4av6,B,291,307,16,FFALVGLGCSMLGILY,1
4av6,B,323,337,14,SLWTSALLTVVLTA,1
4av6,B,364,380,16,SAIIGIFSGILIGFWA,1
4av6,B,415,431,16,SVFPPTLTLVLGILFA,1
4av6,B,441,456,15,IAALGMLSFVATSVS,1
4av6,B,498,514,16,KGFAIGSAIFAALSLF,1
4av6,B,545,559,14,AGALLGAAITYYFS,1
4av6,B,612,629,17,YPAFIAILTPLVTGFLL,1
4av6,B,634,651,17,GGVLIGTVLSGAMLAIL,1
4av6,B,700,716,16,SLDILIKIMSVVSVIA,1
5i31,A,361,374,13,TACSSGLVFVRVT,1
5i31,A,622,635,13,TVVISYAIMFLYI,1
5i31,A,665,684,19,SSVACSLGVFSYIGLPLTL,1
5i31,A,686,701,15,IEVIPFLVLAVGVDN,1
5i31,A,739,752,13,FSETVAFFLGALS,1
5i31,A,758,771,13,TFSLFAGLAVFID,1
5i31,A,834,850,16,RPIVIAIFVGVLSFSI,1
5i31,A,1100,1114,14,NLGVSLGAIFLVTM,1
5i31,A,1121,1137,16,WSAVIMCATIAMVLVN,1
5i31,A,1150,1162,12,AVSLVNLVMSCG,1
5i31,A,1193,1207,14,MGSSVFSGITLTKF,1
5i31,A,1222,1242,20,IFYFRMYLAMVLLGATHGLI,1
4oxs,F,133,150,17,VAALLTVVFYIAAVMAT,1
4oxs,F,195,215,20,WVFFIPFIMLTTFTVLNLFI,1
3vvs,A,24,44,20,IPMMIGMSVQTLYNLADGIW,1
3vvs,A,57,78,21,LFFPVFMGIIALAAGLGVGTS,1
3vvs,A,101,120,19,ILSLILGVTITITMLPAID,1
3vvs,A,138,161,23,YARVLLAGAFIIVFNNVGNGILR,1
3vvs,A,167,188,21,RAMLAMVLGSGLNIVLDPIFI,1
3vvs,A,197,216,19,AAYATLLSMVVTSLFIAYW,1
3vvs,A,243,264,21,RVGLPSSLSQLSMSIAMFFLN,1
3vvs,A,280,301,21,SAWRITMLGIVPILGMAAATT,1
3vvs,A,324,346,22,KIAFMIELAVVAFIMLFAPQVA,1
3vvs,A,364,387,23,ALRTLPVFLVLTPFGMMTSAMFQ,1
3vvs,A,392,414,22,EKSLILTIFRTLVMQVGFAYIF,1
3vvs,A,424,444,20,VWIGIVIGNMVAAIVGFLWG,1
5eqh,A,14,35,21,AVGGAVLGSLQFGYNTGVINA,1
5eqh,A,67,87,20,SVAIFSVGGMIGSFSVGLFV,1
5eqh,A,93,111,18,NSMLMMNLLAFVSAVLMG,1
5eqh,A,121,141,20,LILGRFIIGVYCGLTTGFVP,1
5eqh,A,158,175,17,LHQLGIVVGILIAQVFG,1
5eqh,A,189,207,18,LSIIFIPALLQCIVLPFC,1
5eqh,A,274,295,21,AVVLQLSQQLSGINAVFYYST,1
5eqh,A,308,328,20,ATIGSGIVNTAFTVVSLFVV,1
5eqh,A,336,355,19,HLIGLAGMAGCAILMTIAL,1
5eqh,A,367,388,21,SIVAIFGFVAFFEVGPGPIPW,1
5eqh,A,405,426,21,VAGFSNWTSNFIVGMCFQYVE,1
5eqh,A,432,450,18,VFIIFTVLLVLFFIFTYF,1
2ksf,A,403,421,18,VAAALSAVITLIAMQWLM,1
2ksf,A,425,443,18,ANLVMLYLLGVVVVALFY,1
2ksf,A,450,466,16,ATVINVVSFDLFFIAP,1
2ksf,A,475,495,20,QYLLTFAVMLTVGLVIGNLT,1
2ux3,M,55,72,17,GVLSLFSGLMWFFTIGI,1
2ux3,M,117,133,16,ASFFMFVAVWSWWGRT,1
2ux3,M,147,164,17,WAFLSAIWLWMVLGFIR,1
2ux3,M,200,221,21,FHGLSIAFLYGSALLFAMHGA,1
2ux3,M,269,286,17,IWMAVLVTLTGGIGILL,1
3ayf,A,20,37,17,FLKSILIFTILISSTVL,1
3ayf,A,261,278,17,ILFIGIILYVFYRYQLS,1
3ayf,A,309,325,16,VVVSALFFVQTMFGAL,1
3ayf,A,352,371,19,GYHLQLAIFWIATAWLGMG,1
3ayf,A,392,408,16,LFWALVVLVGGSMIGQ,1
3ayf,A,431,452,21,ELGRIWQIILVVGMLLWLFIV,1
3ayf,A,472,488,16,LFYSAIAVPFFYIFAF,1
3ayf,A,505,523,18,IIHLWVEGIFEVFAVVVI,1
3ayf,A,541,557,16,LYFQFTILLGSGVIGI,1
3ayf,A,578,594,16,ALEVIPLTLLILEAYE,1
3ayf,A,613,631,18,FLISTAIWNLVGAGVFGF,1
3ayf,A,651,668,17,GHAAMMGVYGMFAIAVL,1
3ayf,A,686,703,17,KFSCWMLNIGLAGMVVI,1
3ayf,A,742,761,19,AVPDTIFLIGVVALLVFAI,1
4jkv,B,228,250,22,DMHSYIAAFGAVTGLCTLFTLA,1
4jkv,B,267,290,23,FYVNACFFVGSIGWLAQFMDGAR,1
4jkv,B,312,337,25,SCVIIFVIVYYALMAGVVWFVVLTY,1
4jkv,B,360,384,24,HLLTWSLPFVLTVAILAVAQVDGD,1
4jkv,B,398,423,25,YRAGFVLAPIGLVLIVGGYFLIRGV,1
4jkv,B,454,475,21,FGFLAFGFVLITFSCHFYDFF,1
4jkv,B,515,535,20,LVEKINLFAMFGTGIAMSTW,1
2w5j,V,14,34,20,LAVGLASIGPGVGQGTAAGQ,1
2w5j,V,51,74,23,TLLLSLAFMEALTIYGLVVALAL,1
4zln,C,11,25,14,AWVIAIIIMLAGGL,1
4zln,C,342,357,15,TLVEAIILVFLVMYL,1
4zln,C,366,383,17,IPTIAVPVVLLGTFAVL,1
4zln,C,397,411,14,MVLAIGLLVDDAIV,1
4zln,C,443,456,13,GIAMVLSAVFVPM,1
4zln,C,472,489,17,TIVSAMALSVLVALILT,1
4zln,C,542,556,14,VLYLIIVVGMAYLF,1
4zln,C,870,886,16,LYAISLIVVFLCLAAL,1
4zln,C,894,911,17,SVMLVVPLGVIGALLAA,1
4zln,C,924,938,14,GLLTTIGLSAKNAI,1
4zln,C,971,986,15,MTSLAFILGVMPLVI,1
4zln,C,999,1014,15,TGVMGGMVTATVLAI,1
3t4d,H,22,45,23,EFQVLFVLTILTLISGTIFYSTV,1
3t4d,H,75,102,27,GKIFTILYIFIGIGLVFGFIHKLAVNV,1
4ayx,B,168,189,21,RRLAAAVGFLTMSSVISMSAP,1
4ayx,B,219,239,20,AVFLCGAAANAIRVYLMQTS,1
4ayx,B,285,308,23,VTENLSDGLRAGAQASVGISMMF,1
4ayx,B,316,337,21,FVLSVVPPVSIIAVIYGRYLR,1
4ayx,B,391,413,22,AFARAGFFGATGLSGNLIVLSV,1
4ayx,B,435,455,20,MYAFWVGISIGGLSSFYSEL,1
1rc2,B,6,22,16,AECFGTFWLVFGGCGS,1
1rc2,B,38,55,17,VALAFGLTVLTMAFAVG,1
1rc2,B,82,99,17,GYVIAQVVGGIVAAALL,1
1rc2,B,135,152,17,VVELVLSAGFLLVIHGA,1
1rc2,B,162,178,16,PIAIGLALTLIHLISI,1
1rc2,B,206,223,17,FFWVVPIVGGIIGGLIY,1
4twk,B,45,68,23,TVSTIFLVVVLYLIIGATVFKAL,1
4twk,B,154,182,28,GKIFCIIYALLGIPLFGFLLAGVGDQLG,1
4twk,B,209,230,21,STIIFILFGCVLFVALPAIIF,1
4twk,B,272,297,25,VVWFWILVGLAYFAAVLSMIGDWLR,1
4zzc,E,199,218,19,NIILPMLFILFISWTAFWS,1
4zzc,E,222,240,18,ANVTLVVSTLIAHIAFNI,1
4zzc,E,256,275,19,AIIFMIYLFYFVAVIEVTV,1
4zzc,E,295,313,18,RIAFPVVFLLANIILAFL,1
4hfd,E,196,218,22,YIPNIILPMLFILFISWTAFWS,1
4hfd,E,222,243,21,ANVTLVVSTLIAHIAANILVE,1
4hfd,E,253,275,22,YTGAIIFMIYLFYFVAVIEVTV,1
4hfd,E,292,315,23,RASRIAFPVVFLLANIILAFLFF,1
1yg1,A,27,45,18,SSFQYGYNVAAVNSPALL,1
1yg1,A,70,93,23,WSVTVSMFPFGGFIGSLLVGPLV,1
1yg1,A,97,119,22,RKGALLFNNIFSIVPAILMGCS,1
1yg1,A,127,147,20,IIISRLLVGICAGVSSNVVP,1
1yg1,A,163,185,22,VVPQLFITVGILVAQIFGLRNL,1
1yg1,A,194,213,19,LLGLTGVPAALQLLLLPFF,1
1yg1,A,269,298,29,RMRSLRWQLLSIIVLMGGQQLSGVNAIYY,1
1yg1,A,311,336,25,EHVQYVTAGTGAVNVVMTFCAVFVV,1
1yg1,A,344,365,21,LLLGFSICLIACCVLTAALAL,1
1yg1,A,370,394,24,WMPYISIVCVISYVIGHALGPSPI,1
1yg1,A,408,430,22,PSAFMVGGSVHWLSNFTVGLIF,1
1yg1,A,441,462,21,FIVFAVICLLTTIYIFLIVPE,1
4amj,A,42,63,21,GMSLLMALVVLLIVAGNVLVI,1
4amj,A,80,103,23,TSLACADLVVGLLVVPFGATLVV,1
4amj,A,108,136,28,WGSFLCELWTSLDVLCVTASIETLCVIA,1
4amj,A,162,183,21,CTVWAISALVSFLPIMMHWWR,1
4amj,A,200,228,28,FVTNRAYAIASSIISFYIPLLIMIFVAL,1
4amj,A,292,315,23,GIIMGVFTLCWLPFFLVNIVNVF,1
4amj,A,324,344,20,FVAFNWLGYANSAMNPIIYC,1
5k2a,A,5,28,23,SSVYITVELAIAVLAILGNVLVC,1
5k2a,A,45,67,22,VSLAAADIAVGVLAIPFAITIS,1
5k2a,A,76,97,21,CLFIACFVLVLTQSSIFSLLA,1
5k2a,A,124,144,20,IAICWVLSFAIGLTPMLGWN,1
5k2a,A,172,195,23,PMNYMVYFNFFACVLVPLLLMLG,1
5k2a,A,237,259,22,IVGLFALCWLPLHIINCFTFFC,1
5k2a,A,265,287,22,PLWLMYLAIVLSHTNSVVNPFI,1
5k0i,C,16,32,16,LLCSTLLVIKMYVVAI,1
5k0i,C,73,90,17,NDMETIYPFLFLGFVYS,1
5k0i,C,99,115,16,WMHFLVFLVGRVAHTV,1
5k0i,C,127,146,19,VTYTLAQLPCASMALQILW,1
4zyo,A,79,94,15,SLLHLGALYGITLIP,1
4zyo,A,99,113,14,TWLWGVFYYFVSAL,1
4zyo,A,221,237,16,LLMMCFILPTLVPWYF,1
4zyo,A,241,260,19,FQNSVFVATFLRYAVVLNA,1
3oax,C,37,64,27,MLAAYMFLLIMLGFPINFLTLYVTVQH,1
3oax,C,73,98,25,ILLNLAVADLFMVFGGFTTTLYTSL,1
3oax,C,109,133,24,NLEGFFATLGGEIALWSLVVLAIE,1
3oax,C,154,176,22,GVAFTWVMALACAAPPLVGWSR,1
3oax,C,199,224,25,ESFVIYMFVVHFIIPLIVIFFCYGQ,1
3oax,C,254,278,24,IMVIAFLICWLPYAGVAFYIFTHQ,1
3oax,C,287,309,22,TIPAFFAKTSAVYNPVIYIMMN,1
4hg6,B,696,712,16,LLGGMLGLAWISAAIA,1
5ek0,D,1510,1525,15,IYLIVLNMVTMMVEK,1
5ek0,D,1535,1553,18,LYWINVVFIILFTIEIIL,1
5ek0,D,1570,1587,17,DFVVVIISIVGMFLADL,1
5ek0,D,1598,1616,18,RVIRLARIGRILRLVTAV,1
5ek0,D,1637,1655,18,ALMTLFFYIFAIMATQLF,1
5ek0,D,1697,1716,19,WVFFIPFIFVVTFVMINLV,1
1y2l,A,37,56,19,ALYSIVCVVGLFGNFLVMY,1
1y2l,A,74,92,18,LALADALATSTLPFQSVN,1
1y2l,A,107,124,17,VISIDYYNMFTSIFTLC,1
1y2l,A,155,173,18,NWILSSAIGLPVMFMATT,1
1y2l,A,196,214,18,LKICVFIFAFIMPVLIIT,1
1y2l,A,247,267,20,LVVVAVFIVCWTPIHIYVII,1
1y2l,A,282,301,19,WHFCIALGYTNSCLNPVLY,1
3v5u,A,4,24,20,GVGYFLLGLILLYYGSDWFV,1
3v5u,A,42,59,17,ATVMAIGTSLPEILTSA,1
3v5u,A,72,92,20,NAIGSCICNIGLVLGLSAII,1
3v5u,A,104,120,16,ILVYLLFVIFAAVIGI,1
3v5u,A,126,142,16,DGVVLLILFIIYLRWT,1
3v5u,A,167,186,19,LIIGLIGVLVGAELFVDGA,1
3v5u,A,205,221,16,AFGTSLPELMVSLAAA,1
3v5u,A,229,250,21,LGNVIGSNIADIGGALAVGSL,1
3v5u,A,259,275,16,QMAVLVIMSLLLYLFA,1
3v5u,A,281,298,17,RWQGILFLALYIIAIAS,1
4fe1,X,13,28,15,FWAVLLLAINFLVAA,1
5b66,z,8,25,17,LAALVILSFVMVIGVPV,1
5b66,z,40,54,14,FLGSGLWIALVLVV,1
5b6w,C,12,28,16,LALGTALMGLGTLYFL,1
5b6w,C,47,61,14,LVPAIAFTMYLSML,1
5b6w,C,80,94,14,ARYADWLFTTPLLL,1
5b6w,C,111,126,15,VGADGIMIGTGLVGA,1
5b6w,C,135,150,15,VWWAISTAAMLYILY,1
5b6w,C,178,192,14,VVLWSAYPVVWLIG,1
5b6w,C,204,220,16,TLLFMVLDVSAKVGFG,1
2kih,D,28,49,21,AANIIGILHLILWILDRLFFK,1
2iql,A,68,94,26,ITIMALYSIVCVVGLFGNFLVMYVIV,1
2iql,A,104,129,25,IYIFNLALADALATSTLPFQSVNYL,1
2iql,A,138,164,26,LCKIVISIDYYNMFTSIFTLCTMSVD,1
2iql,A,185,211,26,IVNVCNWILSSAIGLPVMFMATTKYR,1
2iql,A,229,253,24,NLLKICVFIFAFIMPVLIITVCYG,1
2iql,A,281,305,24,VLVVVAVFIVCWTPIHIYVIIKAL,1
2iql,A,316,339,23,SWHFCIALGYTNSCLNPVLYAFL,1
1pb4,D,44,63,19,ALSVVPLATTAMLTTGPLS,1
1pb4,D,65,83,18,ADSFFSVMLLGYCYMEFN,1
1pb4,D,100,123,23,YAMYMLGLGSAVSLFGIYKLETE,1
3abl,Z,20,34,14,VTFLSFLLPAGWVL,1
4cza,B,3,24,21,LSLAEALFLILFTGVISMLIS,1
4cza,B,30,46,16,YVPIFILTGLVIGPLL,1
4cza,B,54,74,20,HEIFDFVRVFGLVIILFTEG,1
4cza,B,91,108,17,LDTIGLILTALIAGFIF,1
4cza,B,120,133,13,LFGAIIGATDPAT,1
4cza,B,155,170,15,IFNDPLGIVLTLIAI,1
4cza,B,193,214,21,GGVIYFLYNVSVSISLGIFLG,1
4cza,B,234,250,16,FSLSLAFLGFFIGERL,1
4cza,B,252,262,10,SGYLVATVTG,1
4cza,B,295,313,18,TLAALATIFIFVLLGAEM,1
4cza,B,323,343,20,KGLLVALGVMILARPLATLP,1
4cza,B,358,372,14,EGPRGVVPSALASL,1
4cza,B,394,411,17,ATVVITVLTSVIVETLW,1
2m0q,A,45,70,25,FYYVILYLMVMIGMFSFIIVAILVS,1
2m0q,A,84,103,19,HQYIVEDWQEKYKSQILNL,1
5tji,D,21,40,19,SSLVTFGSGLVVIIIYRIV,1
5tji,D,102,118,16,VGLVFLLSIASLIIYF,1
5tji,D,141,158,17,DLAFNVFFMIYFFIRFV,1
5tji,D,164,183,19,WFWVELFSFVDYFTIPPSF,1
5tji,D,195,206,11,RFLRALRLMSI,1
5tji,D,228,244,16,VSFVSLWLTAAGFLHL,1
5tji,D,289,305,16,RTFVVIFIMIFIGLFA,1
3usj,A,14,32,18,ILAMAGNAVGLGNFLRFP,1
3usj,A,44,63,19,IPYIIAFLLVGIPLMWIEW,1
3usj,A,89,124,35,AKILGVFGLWIPLVVAIYYVYIESWTLGFAIKFLV,1
3usj,A,167,184,17,AYIVFLITMFINVSILI,1
3usj,A,191,214,23,ERFAKIAMPTLFILAVFLVIRVF,1
3usj,A,244,266,22,IAAVGQIFFTLSLGFGAIITYA,1
3usj,A,277,297,20,SGLTAATLNEKAEVILGGSI,1
3usj,A,340,367,27,GFLWFFLLFFAGLTSSIAIMQPMIAFL,1
3usj,A,378,396,18,VLWTAAIVFFSAHLVMFL,1
3usj,A,400,426,26,DEMDFWAGTIGVVFFGLTELIIFFWI,1
3usj,A,445,469,24,RIYYYVMRYITPAFLAVLLVVWAR,1
3usj,A,484,502,18,ITRFYIIGLFLFLTFLVF,1
4rue,B,33,51,18,ALLALVLLYLVSGALVFR,1
4rue,B,141,165,24,GRLFCIFYALVGIPLFGILLAGVG,1
4rue,B,200,220,20,FLLIGCLLFVLTPTFVFCYM,1
4rue,B,255,277,22,AYQPLVWFWILLGLAYFASVLT,1
4kx6,P,13,37,24,WGLFGAGGMWSAIIAPVMILLVGI,1
4kx6,P,62,86,24,GRVFLFLMIVLPLWCGLHRMHHAM,1
4kx6,P,94,116,22,AGKWVFYGLAAILTVVTLIGVV,1
1sqv,K,23,38,15,WGAVGAVGLVWATDW,1
3uq4,E,205,225,20,WSFILPLGLIIAASWSVFWL,1
3uq4,E,231,250,19,LQTSFTLMLTVVAYALYTS,1
3uq4,E,262,282,20,DQMIIAGYGSIFAAILLIIF,1
3uq4,E,298,317,19,RCRLAFPLGFLAIGCVLVI,1
2c3e,A,5,30,25,SFLKDFLAGGVAAAISKTAVAPIER,1
2c3e,A,73,100,27,LANVIRYFPTQALNFAFKDKYKQIFLG,1
2c3e,A,109,138,29,RYFAGNLASGGAAGATSLCFVYPLDFART,1
2c3e,A,173,203,30,QGFNVSVQGIIIYRAAYFGVYDTAKGMLPD,1
2c3e,A,207,235,28,HIIVSWMIAQTVTAVAGLVSYPFDTVRR,1
2c3e,A,273,293,20,WSNVLRGMGGAFVLVLYDEI,1
4pa4,F,135,153,18,ALLTVVFYIAAVMATNLY,1
4pa4,F,195,214,19,WVFFIPFIMLTTFTVLNLF,1
4ryq,A,7,26,19,IIVFFLTYGLFYVSSVLFP,1
4ryq,A,46,66,20,IGMIWAVLFGLIALSVAIIY,1
4ryq,A,75,94,19,FWFLFLLNYIFNQAFSYFQ,1
4ryq,A,102,122,20,ATVDCLLVAITTLLLIMFSS,1
4ryq,A,127,147,20,SAWLLIPYFLWSAFATYLSW,1
3p4w,E,199,218,19,NIILPMLFILFISWTAFWS,1
3p4w,E,222,240,18,ANVTLVVSTLIAHIAFNI,1
3p4w,E,256,275,19,AIIFMIYLFYFVAVIEVTV,1
3p4w,E,295,313,18,RIAFPVVFLLANIILAFL,1
5t37,C,16,36,20,LLCSTLLVIKMYVVAIITGQ,1
5t37,C,69,90,21,RAHRNDMETIYPFLFLGFVYS,1
5t37,C,99,119,20,WMHFLVFLVGRVAHTVAYLG,1
5t37,C,125,146,21,RSVTYTLAQLPCASMALQILW,1
1xl6,D,45,71,26,WPVFITLITGLYLVTNALFALAYLAC,1
1xl6,D,108,135,27,ANTLVTLEALCGMLGLAVAASLIYARF,1
5cgc,A,579,600,21,PIAAVVFACLGLLATLFVTVV,1
5cgc,A,617,636,19,CYIILAGICLGYLCTFCLI,1
5cgc,A,646,667,21,QRIGIGLSPAMSYSALVTKTY,1
5cgc,A,692,711,19,QLVIAFILICIQLGIIVAL,1
5cgc,A,739,759,20,VVAPLGYNGLLILACTFYAF,1
5cgc,A,774,793,19,AFTMYTTCIIWLAFVPIYF,1
5cgc,A,799,819,20,ITMCFSVSLSATVALGCMFV,1
1txh,F,23,36,13,WLSVIFIFRIMVL,1
1txh,F,80,93,13,LILVSTPALLVAM,1
1txh,F,134,148,14,YVISVVFRLLFEAV,1
1txh,F,192,207,15,FMLAASGICIILNVA,1
4p6v,F,3,23,20,IIFGVVMFTLIILALVLVIL,1
1fqy,D,12,32,20,AVVAEFLATTLFVFISIGSA,1
1fqy,D,50,68,18,KVSLAFGLSIATLAQSVG,1
1fqy,D,94,112,18,LMYIIAQCVGAIVATAIL,1
1fqy,D,138,156,18,LGIEIIGTLQLVLCVLAT,1
1fqy,D,167,184,17,APLAIGLSVALGHLLAI,1
1fqy,D,208,230,22,HWIFWVGPFIGGALAVLIYDFI,1
2x2v,M,5,18,13,AAIAAGLAAVAGA,1
2x2v,M,55,67,12,VPIIAIVISLLI,1
5xf1,A,138,161,23,SSFQVMYTVGYSLSLGALLLALA,1
5xf1,A,176,200,24,HANLFASFVLKASSVLVIDGLLRT,1
5xf1,A,220,248,28,VAGCRVAAVFMQYGIVANYCWLLVEGLY,1
5xf1,A,265,287,22,LYLGIGWGAPMLFVVPWAVVKC,1
5xf1,A,301,326,25,GFWWILRFPVFLAILINFFIFVRIV,1
5xf1,A,350,370,20,TLTLIPLLGVHEVVFAFVTD,1
5xf1,A,379,402,23,AKLFFDLFLSSFQGLLVAVLYCF,1
5ahy,C,29,53,24,SSSLWVNVALAGIAILVFVYMGRT,1
5ahy,C,61,82,21,IWGATLMIPLVSISSYLGLLS,1
5ahy,C,105,126,21,WGRYLTWALSTPMILLALGLL,1
5ahy,C,132,154,22,SLFTVIAADIGMCVTGLAAAMT,1
5ahy,C,160,183,23,RWAFYAISCAFFVVVLSALVTDW,1
5ahy,C,196,221,25,DTLRVLTVVLWLGYPIVWAVGVEGL,1
5ahy,C,229,252,23,TSWAYSVLDVFAKYVFAFILLRW,1
1jgy,H,16,31,15,IYSFWIFLAGLIYYL,1
2xfn,A,486,498,12,PSVPGLLRLIGL,1
2afl,D,5,20,15,FFLFIGVILFSSAVY,1
2afl,D,59,76,17,GKIVGSLCAIAGVLTIA,1
3udc,G,17,45,28,VKFLLDVLKILIIAFIGIKFADFLIYRF,1
3udc,G,70,88,18,AVRYIIYFLAGASILKLF,1
3udc,G,90,101,11,DMTSLLAVAGI,1
3ug9,B,91,109,18,NILQWITFALSALCLMFY,1
3ug9,B,121,138,17,EIYVATIEMIKFIIEYF,1
3ug9,B,156,172,16,WLRYAEWLLTCPVILI,1
3ug9,B,190,207,17,LLVSDIGTIVWGTTAAL,1
3ug9,B,212,231,19,RVIFFLMGLCYGIYTFFNA,1
3ug9,B,254,272,18,AWLFFVSWGMFPILFILG,1
3ug9,B,284,302,18,TVGHTIIDLMSKNCWGLL,1
2hlf,B,37,57,20,MAAVVGTLVGLAAVAFDKGV,1
2hlf,B,84,98,14,CSAVLAMFGYFLVR,1
2hlf,B,128,142,14,PVKFFGGLGTLGGG,1
2hlf,B,144,159,15,LGREGPTVQIGGNIG,1
2hlf,B,216,229,13,AVFIGVIMSTIMY,1
2hlf,B,256,277,21,ILGIIFGIFGPIFNKWVLGMQ,1
2hlf,B,290,302,12,WVLMGGAIGGLC,1
2hlf,B,338,351,13,ARVITTLLCFSSG,1
2hlf,B,353,364,11,GGIFAPMLALG,1
2hlf,B,423,442,19,PMIITGLGATLLAQFTGGK,1
1mot,A,254,265,11,LGITTVLTMTT,1
4ysy,D,54,79,25,HGTLFKIERYFAAAMVPLIPAAYFI,1
4ysy,D,85,109,24,LCLALALTLHVHWGVWGVVNDYGR,1
4ysy,D,116,139,23,LAAAVRVGAYIFTACLLAGLLYF,1
1zoy,D,41,60,19,HWTGERVVSVLLLGLLPAA,1
1zoy,D,69,88,19,YSLAAALTLHGHWGIGQVV,1
1zoy,D,99,118,19,AAKAGLLALSAFTFAGLCY,1
5hl9,A,70,87,17,KLAIVFAVLIAIYGVYL,1
2q72,B,13,32,19,LILAMAGNAVGLGNFLRFP,1
2q72,B,44,63,19,IPYIIAFLLVGIPLMWIEW,1
2q72,B,90,124,34,KILGVFGLWIPLVVAIYYVYIESWTLGFAIKFLV,1
2q72,B,167,185,18,AYIVFLITMFINVSILIR,1
2q72,B,191,212,21,ERFAKIAMPTLFILAVFLVIR,1
2q72,B,242,265,23,VWIAAVGQIFFTLSLGFGAIITY,1
2q72,B,277,297,20,SGLTAATLNEKAEVILGGSI,1
2q72,B,340,367,27,GFLWFFLLFFAGLTSSIAIMQPMIAFL,1
2q72,B,378,396,18,VLWTAAIVFFSAHLVMFL,1
2q72,B,400,426,26,DEMDFWAGTIGVVFFGLTELIIFFWI,1
2q72,B,445,469,24,RIYYYVMRYITPAFLAVLLVVWAR,1
2q72,B,484,502,18,ITRFYIIGLFLFLTFLVF,1
3u2f,E,13,31,18,ISTIGLLGAGIGIAIVFA,1
3u2f,E,52,71,19,LGFALSEATGLFCLMVSFL,1
5af1,D,34,52,18,SVLVWIMIPGVGLLYSGI,1
5af1,D,62,84,22,WAALMAACVAAFQWFWWGYSLV,1
5af1,D,121,139,18,YQGMFAAVTAILMAGAGC,1
5af1,D,145,166,21,PMMVFLFIWLTVVYCPIAYWT,1
5af1,D,181,201,20,AGGGPVHENSGFAALAYSLW,1
5af1,D,224,242,18,IVMGTIFLWFGWYGFNGG,1
5af1,D,255,275,20,VNTNLAAATGGLTWMLVDWF,1
5af1,D,284,301,17,GLCMGAIAGLVGITPAA,1
5af1,D,307,326,19,TSVIFGIVPAIICNFAVDL,1
5af1,D,336,356,20,DVWALHGVGGFVGNFMTGLF,1
5af1,D,382,409,27,YQLAGSCAVAAWSFTVTSIILLAMDRI,1
3kly,E,35,55,20,LAISAGIQIGIAFVFYTVVT,1
3kly,E,65,82,17,TKLLGGLAFSLGLILVV,1
3kly,E,114,136,22,VVYFGNLCGSIILVFIMLATRQ,1
3kly,E,159,178,19,FLQAFALGLMCNILVCLAV,1
3kly,E,191,203,12,MVLILPVAMFVS,1
3kly,E,209,221,12,IANMFQVPMAIG,1
3kly,E,246,268,22,VNFIVNNLIPVTLGNIVGGGVF,1
2mpn,B,112,137,25,MRQVQIAAGGLILIGVVLGYTVNSG,1
2mpn,B,141,166,25,SGFVGAGLLFAGISGFSGMARLLDK,1
4u15,A,73,90,17,TGFLALVTIIGNILVIV,1
4u15,A,106,122,16,LSLACADLIIGVISMN,1
4u15,A,142,159,17,WLSIDYVASNASVMNLL,1
4u15,A,188,205,17,GLAWVISFVLWAPAILF,1
4u15,A,230,248,18,TFGTAIAAFYMPVTIMTI,1
4u15,A,493,511,18,AILLAFIITWTPYNIMVL,1
4u15,A,528,545,17,YWLCYINSTVNPVCYAL,1
2zqp,E,32,52,20,AILLFTLAFMVILGLYDTVF,1
3beh,D,16,29,13,LAAPGLLAVAALT,1
3beh,D,40,54,14,LAALLAVIWGAYLL,1
3beh,D,79,92,13,LAVLVPLAAFLLD,1
3beh,D,97,108,11,SLYCAVWLLKP,1
3beh,D,134,150,16,LFGVVLFAVALAAYVI,1
3beh,D,187,203,16,GRVLAGAVMMSGIGIF,1
1z9k,C,12,29,17,ASLAIYSFWIFLAGLIY,1
2jtw,A,5,20,15,ASYLRLWALSLAHAQ,1
5f5j,A,93,109,16,GPVTWVMMIACVVVFI,1
5f5j,A,148,167,19,MHILFNLLWWWYLGGAVEK,1
5f5j,A,171,192,21,GKLIVITLISALLSGYVQQKF,1
5f5j,A,198,214,16,GLSGVVFALMGYVWLR,1
5f5j,A,226,245,19,RGLIIFALIWIVAGWFDLF,1
5f5j,A,250,268,18,NGAHIAGLAVGLAMAFVD,1
4ug2,A,9,28,19,ITVELAIAVLAILGNVLVC,1
4ug2,A,46,66,20,SAAAADILVGVLAIPFAIAI,1
4ug2,A,79,99,20,IACFVLVLTASSIFSLLAIA,1
4ug2,A,125,144,19,AICWVLSFAIGLTPMLGWN,1
4ug2,A,173,198,25,MNYMVYFNFFACVLVPLLLMLGVYL,1
4ug2,A,235,255,20,AIIVGLFALCWLPLHIINCF,1
4ug2,A,270,288,18,YLAIVLSHTNSVVNPFIY,1
4py0,A,24,48,24,QVLFPLLYTVLFFVGLITNGLAMR,1
4py0,A,63,85,22,KNTVISDLLMILTFPFKILSDA,1
4py0,A,93,119,26,TFVCQVTSVIFYFTMYISISFLGLIT,1
4py0,A,144,164,20,SVVIWAFMFLLSLPNMILTN,1
4py0,A,180,207,27,EFGLVWHEIVNYICQVIFWINFLIVIV,1
4py0,A,239,264,25,IIIAVFFICFVPFHFARIPYTLSQT,1
4py0,A,276,297,21,FYVKESTLWLTSLNACLNPFI,1
5a1s,B,23,40,17,FGMPLPLYAFALITLLL,1
5a1s,B,51,72,21,VGGFALMFVMGAIFGEIGKRL,1
5a1s,B,74,90,16,FNKYIGGAPVMIFLVA,1
5a1s,B,115,128,13,FLNLFIAVLITGA,1
5a1s,B,149,165,16,AGIVGASLFGIVIGLC,1
5a1s,B,210,226,16,TAIAILTIANIFAIIF,1
5a1s,B,270,288,18,GMVLSTTCFLLAYVVAKK,1
5a1s,B,297,311,14,IHYFAWMVLIVAAL,1
5a1s,B,332,345,13,SKQLLWVLMVGVG,1
5a1s,B,359,376,17,FANVVIAAIIVVGAVVG,1
5a1s,B,428,442,14,LGGGIVLVIASIVF,1
2ad0,D,15,35,20,FILVRATAIVLTLYIIYMVG,1
2ad0,D,56,80,24,TKVFTLLALFSILIHAWIGMWQVL,1
2ad0,D,90,113,23,LMLQLVIVVALVVYVIYGFVVVW,1
4bev,A,82,104,22,RRFWIALMLTIPVVILEMGGHG,1
4bev,A,113,142,29,SSWIQLLLATPVVLWGGWPFFKRGWQSLK,1
4bev,A,147,170,23,MFTLIAMGIGVAWIYSMVAVLWP,1
4bev,A,185,201,16,VYFEAAAVITTLVLLG,1
4bev,A,340,361,21,GWFVPAVILVAVLSFIVWALL,1
4bev,A,367,389,22,SYGLIAAVSVLIIACPCALGLA,1
4bev,A,680,701,21,NLFFAFIYNVLGVPLAAGVLY,1
4bev,A,707,730,23,LSPMIAAAAMALSSVSVIINALR,1
2fbw,D,9,28,19,WTSERAVSALLLGLLPAAY,1
2fbw,D,35,56,21,DYSLAAALTLHGHWGLGQVIT,1
2fbw,D,66,85,19,VANTGLYVLSAITFTGLCY,1
1oy8,C,11,27,16,AWVIAIIIMLAGGLAI,1
1oy8,C,341,357,16,KTLVEAIILVFLVMYL,1
1oy8,C,366,386,20,IPTIAVPVVLLGTFAVLAAF,1
1oy8,C,395,411,16,FGMVLAIGLLVDDAIV,1
1oy8,C,442,458,16,VGIAMVLSAVFVPMAF,1
1oy8,C,469,489,20,FSITIVSAMALSVLVALILT,1
1oy8,C,541,557,16,LVLYLIIVVGMAYLFV,1
1oy8,C,874,891,17,SLYAISLIVVFLCLAAL,1
1oy8,C,898,919,21,FSVMLVVPLGVIGALLAATFR,1
1oy8,C,927,943,16,QVGLLTTIGLSAKNAI,1
1oy8,C,976,992,16,MTSLAFILGVMPLVIS,1
1oy8,C,1004,1021,17,TGVMGGMVTATVLAIFF,1
3ldc,D,24,41,17,LLVLAVIIYGTAGFHFI,1
3ldc,D,71,92,21,GMYFTCTLIVLGIGTFAVAVE,1
5svt,C,28,47,19,VVQLLIISYFVGWVFLHEK,1
5svt,C,316,343,27,NIIPTIISSVAAFTSVGVGTVLCDIIL,1
1dhl,A,5,22,17,ISTIGDLVKWIIDTVNK,1
5tsi,A,85,100,15,GFLLYIGEATKTVQP,1
5tsi,A,129,142,13,LLFTARFLLLQPA,1
5tsi,A,201,216,15,IWISPLQCILCTGLI,1
5tsi,A,224,238,14,FCALAAISLLGVLQ,1
5tsi,A,307,322,15,SSAYFFSAIFVIVAA,1
5tsi,A,342,355,13,YCMVLRMTVTRQL,1
5tsi,A,860,875,15,LIFILFIAAIEIAGS,1
5tsi,A,928,943,15,ATSESLLAMGFFRGL,1
5tsi,A,1002,1018,16,VQLTVVVVGCILVVSI,1
5tsi,A,1023,1037,14,FLAATPLAIIFIVM,1
5tsi,A,1109,1123,14,RADILFVFFFTLAA,1
5tsi,A,1142,1155,13,LAMLILGTFQWCV,1
3iyz,D,38,55,17,TAEFLAMLIFVLLSVGS,1
3iyz,D,71,88,17,LISLCFGLSIATMVQCF,1
3iyz,D,115,133,18,VFYITAQCLGAIIGAGIL,1
3iyz,D,157,174,17,HGLLVELIITFQLVFTI,1
3iyz,D,188,204,16,VALAIGFSVAIGHLFA,1
3iyz,D,230,247,17,WIYWVGPIIGAVLAGAL,1
2hac,B,1,21,20,CYLLDGILFIYGVILTALFL,1
3kcv,E,39,57,18,TAGVFISIAFVFYITATT,1
3kcv,E,64,83,19,GMAKLVGGICFSLGLILCV,1
3kcv,E,115,141,26,NVYFGNLVGALLFVLLMWLSGEYMTA,1
3kcv,E,149,179,30,LQTADHKVHHTFIEAVCLGILANLMVCLAV,1
3kcv,E,193,205,12,IMVLPVAMFVAS,1
3kcv,E,209,223,14,SIANMFMIPMGIVI,1
3kcv,E,246,269,23,VMNFITDNLIPVTIGNIIGGGLL,1
2aki,C,17,27,10,KWVVVVALLL,1
2aki,C,54,65,11,AGGVALLTTKG,1
2aki,C,94,115,21,LIVAAVTAVMSLILWGLDGIL,1
2ah3,A,32,54,22,TLYSIIFVVGIFGNSLVVIVIY,1
2ah3,A,64,86,22,VFLLNLALADLCFLLTLPLWAV,1
2ah3,A,102,124,22,IASASVSFNLYASVFLLTCLSI,1
2ah3,A,147,168,21,TCIIIWLMAGLASLPAVIHRN,1
2ah3,A,195,216,21,GLTKNILGFLFPFLIILTSYT,1
2ah3,A,241,263,22,IMAIVLFFFFSWVPHQIFTFLD,1
2ah3,A,287,305,18,ICIAYFNNCLNPLFYGFL,1
3e9j,C,15,31,16,LLMAFTALALELTALW,1
3e9j,C,48,65,17,VALFGVLGAALIGAIAP,1
3e9j,C,71,86,15,VAMVIWLYSAFRGVQ,1
3e9j,C,146,162,16,LGIFIAYLIVAVLVVI,1
4il3,A,16,35,19,LIISAFSIAQFSFESYLTY,1
4il3,A,74,91,17,FSDIYNLAQKLVFIKYD,1
4il3,A,120,140,20,SLCFLGLLSSMSTLVDLPLS,1
4il3,A,166,187,21,KSLTLAYAIGGPILYLFLKIF,1
4il3,A,194,213,19,LWYIMVFLFVVQILAMTII,1
4il3,A,308,326,18,NMVIFSQLHTFLIFSLFT,1
4il3,A,360,385,25,IIGFMLFNDLLTPLECAMQFIMSLI,1
2d57,D,39,55,16,AEFLAMLIFVLLSVGS,1
2d57,D,72,89,17,ISLCFGLSIATMVQCFG,1
2d57,D,116,133,17,FYITAQCLGAIIGAGIL,1
2d57,D,158,177,19,GLLVELIITFQLVFTIFAS,1
2d57,D,188,205,17,VALAIGFSVAIGHLFAI,1
2d57,D,231,248,17,IYWVGPIIGAVLAGALY,1
2hvj,F,25,50,25,WRAAGAATVLLVIVLLAGSYLAVLA,1
2hvj,F,87,114,27,GRCVAVVVMVAGITSFGLVTAALATWF,1
3pcv,C,8,25,17,AAVTLLGVLLQAYFSLQ,1
3pcv,C,53,71,18,VNCSEYFPLFLATLWVAG,1
3pcv,C,79,95,16,ALCGLVYLFARLRYFQ,1
3pcv,C,106,124,18,PLYASARALWLLVALAAL,1
2ht4,B,37,57,20,MAAVVGTLVGLAAVAFDKGV,1
2ht4,B,84,98,14,CSAVLAMFGYFLVR,1
2ht4,B,128,142,14,PVKFFGGLGTLGGG,1
2ht4,B,144,159,15,LGREGPTVQIGGNIG,1
2ht4,B,216,229,13,AVFIGVIMSTIMY,1
2ht4,B,256,277,21,ILGIIFGIFGPIFNKWVLGMQ,1
2ht4,B,289,302,13,KWVLMGGAIGGLC,1
2ht4,B,338,351,13,ARVITTLLCFSSG,1
2ht4,B,353,364,11,GGIFAPMLALG,1
2ht4,B,423,442,19,PMIITGLGATLLAQFTGGK,1
2xq3,E,198,216,18,NIILPMLFILFISWTAFW,1
2xq3,E,221,240,19,ANVTLVVSTLIAHIAFNIL,1
2xq3,E,255,274,19,AIIFMIYLFYFVAVIEVTV,1
2xq3,E,294,312,18,RIAFPVVFLLANIILAFL,1
1fdm,A,30,44,14,VIVGATIGIKLFKK,1
4ry2,B,163,187,24,PLKKTVLCIFLASLLYTALGIAGS,1
4ry2,B,212,235,23,FAVIFLLQIFLNYYRSILVTKLG,1
4ry2,B,280,302,22,SGATLTIMIDTIMAVIGGILLY,1
4ry2,B,309,330,21,FISFIIILLYGIIVTVFNKPI,1
4ry2,B,386,407,21,MLYINLSSLTGIVAGLGGIVI,1
4ry2,B,429,450,21,ALLAYFLTPVKNLIDLQPLIQ,1
4pa6,F,132,151,19,SVAALLTVVFYIAAVMATN,1
4pa6,F,195,218,23,WVFFIPFIMLTTFTVLNLFIGII,1
1xl4,D,45,71,26,WPVFITLITGLYLVTNALFALAYLAC,1
1xl4,D,108,135,27,ANTLVTLEALCGMLGLAVAASLIYARF,1
2db4,J,16,35,19,LAMATATIFSGIGSAKGVG,1
2db4,J,61,78,17,PGTQGLYGFVIAFLIFI,1
2db4,J,93,110,17,GASLPIAFTGLFSGIAQ,1
2db4,J,137,154,17,VQTYAILGFVISFLLVL,1
3p50,E,195,217,22,SYIPNIILPMLFILFISWTAFW,1
3p50,E,222,244,22,ANVTLVVSTLIAHIAFNILVET,1
3p50,E,252,275,23,TYTGAIIFMIYLFYFVAVIEVTV,1
3p50,E,295,315,20,RIAFPVVFLLANIILAFLFF,1
3g61,A,45,68,23,DRLYMLVGTLAAIIHGVALPLMM,1
3g61,A,115,132,17,GIGAGVLIVAYIQVSFW,1
3g61,A,184,203,19,KIGMFFQAMATFFGGFIIG,1
3g61,A,215,233,18,AISPVLGLSAGIWAKILS,1
3g61,A,291,310,19,NISMGAAFLLIYASYALAF,1
3g61,A,332,349,17,SVLIGAFSVGQASPNIE,1
3g61,A,708,728,20,VGIFCAIINGGLQPAFSVIF,1
3g61,A,754,773,19,FLILGIISFITFFLQGFTF,1
3g61,A,828,847,19,LAVIFQNIANLGTGIIISL,1
3g61,A,854,872,18,LLLLAIVPIIAIAGVVEM,1
3g61,A,932,952,20,VFGITFSFTQAMMYFSYAAC,1
3g61,A,973,990,17,FSAIVFGAMAVGQVSSF,1
3rw0,D,2015,2034,19,KFIIYLIVLNGITMGLETS,1
3rw0,D,2042,2064,22,VYTTLFNQIVITIFTIEIILRI,1
3rw0,D,2076,2094,18,SLFDFFVVAISLVPTSSG,1
3rw0,D,2096,2113,17,ILRVLRVLRLFRLVTAV,1
3rw0,D,2131,2151,20,SVIALMTLFFYIFAIMATQL,1
3rw0,D,2194,2214,20,WVFFIPFIFVVTFVMINLVV,1
2vpy,G,16,36,20,NALHFVLVGLAGGVALLAAL,1
2vpy,G,49,66,17,LYALMLIALDLFILWAE,1
2vpy,G,89,105,16,WGAWGLGLGFLTGGLL,1
2vpy,G,115,132,17,AWALLVFSLVALSYPGL,1
2vpy,G,147,163,16,AGLFPLTALVLALGLA,1
2vpy,G,175,189,14,RVLAGASLLLALLY,1
2vpy,G,207,221,14,WYGLFLLLGLGTFW,1
2vpy,G,226,241,15,PWAGLLAAAGLRALL,1
1qko,C,10,33,23,IWLALGTALMGLGTLYFLVKGMG,1
1qko,C,41,62,21,FYAITTLVPAIAFTMYLSMLL,1
1qko,C,80,100,20,ARYADWLFTTPLLLLDLALL,1
1qko,C,106,127,21,TILALVGADGIMIGTGLVGAL,1
1qko,C,134,157,23,FVWWAISTAAMLYILYVLFFGFT,1
1qko,C,171,192,21,KVLRNVTVVLWSAYPVVWLIG,1
1qko,C,204,226,22,TLLFMVLDVSAKVGFGLILLRS,1
4ky0,C,17,33,16,ILWGLVLGAVFGLIAG,1
4ky0,C,41,65,24,KTYIKPFGDLFVRLLKMLVMPIVL,1
4ky0,C,85,109,24,KIVVYYLATSAMAVFFGLIVGRLF,1
4ky0,C,130,140,10,SLVQTLLNIV,1
4ky0,C,151,160,9,EVLPVIFFA,1
4ky0,C,204,223,19,QYAPIGVFALIAYVMAEQG,1
4ky0,C,234,253,19,GAVYTGLFLQIVITYFILL,1
4ky0,C,305,323,18,LPLGATINMDGTALYQGV,1
4ky0,C,395,413,18,ILDMGRTMVNVTGDLAGT,1
2j58,H,355,374,19,QLVPTISGVHDMTETVRYI,1
4ia4,D,41,58,17,IAEFIATLLFLYITVAT,1
4ia4,D,76,93,17,IAWAFGGMIFVLVYCTA,1
4ia4,D,120,137,17,VYMIAQCLGAICGVGLV,1
4ia4,D,163,182,19,ALGAEIIGTFVLVYTVFSA,1
4ia4,D,198,214,16,PLPIGFAVFMVHLATI,1
4ia4,D,243,260,17,IFWVGPFIGAAVAAAYH,1
2vr0,F,18,31,13,GATLGVVALATVA,1
3i5d,C,39,55,16,ALVIAYVIGYVCVYNK,1
3i5d,C,331,352,21,KFNIIPTLLNIGAGLALLGLV,1
3n2f,G,31,47,16,IFAALAFIVGLIIILS,1
5hxh,A,8,27,19,FLLGLILLYYGSDWFVLGS,1
5hxh,A,42,56,14,ATVMAIGTSLPEIL,1
5hxh,A,75,93,18,GSCICNIGLVLGLSAIIS,1
5hxh,A,105,120,15,LVYLLFVIFAAVIGI,1
5hxh,A,127,142,15,GVVLLILFIIYLRWT,1
5hxh,A,166,182,16,LLIIGLIGVLVGAELF,1
5hxh,A,208,222,14,TSLPELMVSLAAAK,1
5hxh,A,229,247,18,LGNVIGSNIADIGGALAV,1
5hxh,A,259,275,16,QMAVLVIMSLLLYLFA,1
5hxh,A,281,296,15,RWQGILFLALYIIAI,1
4x8a,F,136,152,16,LLTVVFYIAAVMATNL,1
4x8a,F,195,211,16,WVFFIPFIMLTTFTVL,1
5eg1,B,23,46,23,LFFSMLFITSLSSIIISISPLIL,1
5eg1,B,70,93,23,LYMFCVISNKASVFLFMILQSSL,1
5eg1,B,139,163,24,VRNVSQNILSPVIQLISTIVVVLS,1
5eg1,B,168,191,23,SAGVFFLYILVFVIFNTRLTGSL,1
5eg1,B,248,270,22,LSSKVLLLNSLLAVILFGSVFI,1
5eg1,B,288,311,23,ITSYIILLSTPVENIGALLSEIR,1
2iqn,A,61,85,24,ITAVYSVVFVVGLVGNSLVMFVII,1
2iqn,A,96,117,21,YIFNLALADALVTTTMPFQST,1
2iqn,A,130,154,24,CKIVISIDYYNMFTSIFTLTMMSV,1
2iqn,A,176,198,22,IINICIWLLSSSVGISAIVLGG,1
2iqn,A,225,247,22,MKICVFIFAFVIPVLIIIVCYT,1
2iqn,A,276,299,23,LVVVAVFVVCWTPIHIFILVEAL,1
2iqn,A,312,333,21,YFCIALGYTNSSLNPILYAFL,1
3qe7,B,23,37,14,HLFAMFGATVLVPV,1
3qe7,B,43,57,14,ATVLLFNGIGTLLY,1
3qe7,B,67,76,9,YLGSSFAFI,1
3qe7,B,94,111,17,IMCGVLFCLVSFIVKKA,1
3qe7,B,124,141,17,MGAIVAVIGLELAGVAA,1
3qe7,B,159,175,16,IISITTLAVTVLGSVL,1
3qe7,B,183,203,20,PILIGVLVGYALSFAMGIVD,1
3qe7,B,233,246,13,AALVVIAEHVGHL,1
3qe7,B,264,280,16,RSMFANGLSTVISGFF,1
3qe7,B,282,291,9,TPNTTYGEN,1
3qe7,B,310,330,20,IFAILLSCVGKLAAAIQMIP,1
3qe7,B,332,350,18,VMGGVSLLLYGVIGASGI,1
3qe7,B,367,382,15,LTSVILIIGVSGAKV,1
3qe7,B,390,408,18,GMALATIVGIGLSLIFKL,1
4xou,A,55,78,23,QFEDLLVRILLLAACISFVLAWF,1
4xou,A,86,105,19,AFVEPFVILLILIANAIVG,1
4xou,A,257,276,19,EQLSKVISLICVAVWLINI,1
4xou,A,293,313,20,YYFKIAVALAVAAIPEGLPA,1
4xou,A,760,781,21,IRYLISSNVGEVVCIFLTAAL,1
4xou,A,786,807,21,LIPVQLLWVNLVTDGLPATAL,1
4xou,A,833,852,19,FFRYMAIGGYVGAATVGAA,1
4xou,A,898,916,18,MALSVLVTIEMCNALNSL,1
4xou,A,931,950,19,WLLGSICLSMSLHFLILYV,1
4xou,A,964,987,23,TQWLMVLKISLPVIGLDEILKFI,1
4mt1,C,11,24,13,AWVISIFIIAAGI,1
4mt1,C,340,355,15,TLIEAMVLVFVVMYL,1
4mt1,C,364,380,16,IPTIVVPISLLGGFAF,1
4mt1,C,395,408,13,MILVIGIVVDDAI,1
4mt1,C,441,454,13,GITAVLISVFVPL,1
4mt1,C,470,487,17,TMASSIAFSAFLALTLT,1
4mt1,C,539,553,14,VVYIGLAVVGVFLF,1
4mt1,C,874,888,14,GLAVAAVFLVLAAL,1
4mt1,C,895,913,18,LAVILVIPLGLIGAAAGV,1
4mt1,C,938,951,13,FVTVMGLSAKNAI,1
4mt1,C,983,998,15,MTSFAFILGVVPLYI,1
4mt1,C,1012,1029,17,TVFWGMLVGTLLSVFLV,1
2lm2,A,10,31,21,TINLIIPCVLITSLAILVFYL,1
2lm2,A,37,58,21,KMTLCISVLLALTVFLLLISK,1
2lm2,A,69,89,20,VGEYLMFTMVLVTFSIVTSV,1
2lm2,A,112,135,23,FLWIFVFVCVFGTIGMFLQPLFQ,1
3omn,B,61,78,17,LVIIAAITIFVTLLILY,1
3omn,B,100,117,17,EIAWTIVPIVILVAIGA,1
4ac5,M,54,71,17,GIAAFAFGSTAILIILF,1
4ac5,M,114,132,18,MAGLFMTLSLGSWWIRVY,1
4ac5,M,144,162,18,AWNFAAAIFFVLCIGCIH,1
4ac5,M,198,219,21,WHGFSIGFAYGCGLLFAAHGA,1
4ac5,M,266,284,18,GWFFSLMVMVSASVGILL,1
5u6o,D,143,164,21,YWDLIMLIMMVGNLVIIPVGI,1
5u6o,D,175,194,19,IIFNVASDTVFLLDLIMNF,1
5u6o,D,218,239,21,KSWFVVDFISSIPVDYIFLIV,1
5u6o,D,261,279,18,ILSLLRLLRLSRLIRYIH,1
5u6o,D,295,316,21,VRIFNLIGMMLLLCHWDGCLQ,1
5u6o,D,374,397,23,TMLSMIVGATCYAMFVGHATALI,1
3h1l,W,19,43,24,FALTVVLGAVLFERAFDQGADAIF,1
3hfx,C,16,28,12,PPLIIVGILCWL,1
3hfx,C,47,63,16,TNVWGWAFEWYMVVML,1
3hfx,C,97,109,12,SCTSAAVLFWGS,1
3hfx,C,134,149,15,LAYSLFHWGPLPWAT,1
3hfx,C,195,215,20,YLVALIFAMGTSLGLATPLV,1
3hfx,C,233,246,13,IIITCWIILNAIC,1
3hfx,C,258,278,20,SDVRSYLSFLMLGWVFIVSG,1
3hfx,C,314,328,14,GWTVFYWAWWVIYA,1
3hfx,C,356,369,13,ASTWILWTVLGSN,1
3hfx,C,407,427,20,MWGFFILCFIATVTLVNACS,1
3hfx,C,448,463,15,RIGWSILVGIIGIVL,1
3hfx,C,472,486,14,QTAIIAGGCPLFFV,1
3v8g,C,16,30,14,LIGLILGAIVGLIL,1
3v8g,C,43,63,20,KPFGDLFVRLLKMLVMPIVF,1
3v8g,C,86,100,14,VYYLLTSAFAVTLG,1
3v8g,C,131,140,9,HILLDIVPT,1
3v8g,C,151,160,9,LPTIFFAII,1
3v8g,C,202,217,15,QYAPIGVFALIAYVM,1
3v8g,C,236,250,14,VGLTLQILLVYFVL,1
3v8g,C,305,317,12,GATINMDGTALY,1
3v8g,C,392,405,13,LDMGRTMVNVTGD,1
2boc,F,26,50,24,RAAGAATVLLVIVLLAGSYLAVLA,1
2boc,F,87,112,25,GRCVAVVVMVAGITSFGLVTAALAT,1
1rwt,G,65,85,20,VIHCRWAMLGALGCVFPELL,1
1rwt,G,124,142,18,LAIWACQVILMGAVEGYR,1
1rwt,G,180,199,19,IKNGRLAMFSMFGFFVQAI,1
5l7i,A,231,254,23,SYIAAFGAVTGLCTLFTLATFVA,1
5l7i,A,266,287,21,LFYVNACFFVGSIGWLAQFMD,1
5l7i,A,312,337,25,SCVIIFVIVYYALMAGFVWFVVLTY,1
5l7i,A,360,383,23,HLLTWSLPFVLTVAILAVAQVDG,1
5l7i,A,397,420,23,RYRAGFVLAPIGLVLIVGGYFLI,1
5l7i,A,454,476,22,FGFLAFGFVLITFSCHFYDFFN,1
5l7i,A,515,537,22,LVEKINLFAMFGTGIAMSTWVW,1
2lcx,B,51,74,23,LIAAGVIGGLFILVIVGLTFAVY,1
2bnp,C,16,31,15,IYSFWIFLAGLIYYL,1
4h13,P,6,26,20,YAALLSFGLIFVGWGLGVLL,1
1brd,C,13,32,19,LGTALMGLGTLYFLVKGMG,1
1brd,C,43,61,18,ITTLVPAIAFTMYLSMLL,1
1brd,C,81,99,18,YADWLFTTPLLLLDLALL,1
1brd,C,107,122,15,LALVGADGIMIGTGL,1
1brd,C,138,154,16,ISTAAMLYILYVLFFG,1
1brd,C,172,191,19,LRNVTVVLWSAYPVVWLIG,1
1brd,C,206,224,18,FMVLDVSAKVGFGLILLR,1
5k2c,A,6,28,22,SVYITVELAIAVLAILGNVLVC,1
5k2c,A,45,67,22,VSLAAADIAVGVLAIPFAITIS,1
5k2c,A,76,97,21,CLFIACFVLVLTQSSIFSLLA,1
5k2c,A,124,144,20,IAICWVLSFAIGLTPMLGWN,1
5k2c,A,173,195,22,MNYMVYFNFFACVLVPLLLMLG,1
5k2c,A,237,259,22,IVGLFALCWLPLHIINCFTFFC,1
5k2c,A,266,287,21,LWLMYLAIVLSHTNSVVNPFI,1
5l4e,E,199,218,19,NIILPMLFILFISWTAFWS,1
5l4e,E,222,242,20,ANVTLVVSTLIAHIAFNILV,1
5l4e,E,256,275,19,AIIFMIYLFYFVAVIEVTV,1
5l4e,E,292,313,21,RASRIAFPVVFLLANIILAFL,1
5u9w,C,8,22,14,GMAVLIAIAVLLST,1
5u9w,C,28,43,15,IRTVAGAFLIQVALG,1
5u9w,C,103,138,35,MIVFFSSLMAVLYYIGVMQLLIKVIGGFLQKMLGT,1
5u9w,C,173,187,14,FAVMSGGLASVAGS,1
5u9w,C,207,222,15,MAAPGGLLFAKLLVP,1
5u9w,C,242,270,28,TNVIDAAASGAVTGAQIAIAVGASLLAF,1
5u9w,C,366,382,16,ANLGSIAVLVGGLSIM,1
5u9w,C,391,408,17,RLGIKAVVAGSLSNLMS,1
5g28,A,15,38,23,EFIDHLLTMGVGVHFAALIFFLV,1
5g28,A,51,74,23,ALSCIVMVSAGLILNSQAVMWTD,1
5g28,A,91,111,20,NGYRYVNWMATIPCLLLQLL,1
5g28,A,123,146,23,TATWLILAAWGMIITGYVGQLYE,1
5g28,A,153,176,23,MIWGAVSTAFFVVMNWIVGTKIF,1
5g28,A,191,213,22,KVFWLMMFAWTLYPIAYLVPAF,1
5g28,A,220,243,23,VLRQLLFTIADISSKVIYGLMIT,1
1u19,A,39,64,25,AAYMFLLIMLGFPINFLTLYVTVQH,1
1u19,A,72,98,26,YILLNLAVADLFMVFGGFTTTLYTSL,1
1u19,A,109,135,26,NLEGFFATLGGEIALWSLVVLAIERY,1
1u19,A,152,176,24,IMGVAFTWVMALACAAPPLVGWSR,1
1u19,A,200,225,25,SFVIYMFVVHFIIPLIVIFFCYGQL,1
1u19,A,252,277,25,VIIMVIAFLICWLPYAGVAFYIFTH,1
1u19,A,288,309,21,IPAFFAKTSAVYNPVIYIMMN,1
2ltq,A,14,28,14,WLLMAFTALALELT,1
2ltq,A,49,63,14,ALFGVLGAALIGAI,1
2ltq,A,73,86,13,MVIWLYSAFRGVQ,1
2ltq,A,147,162,15,GIFIAYLIVAVLVVI,1
3s3d,C,5,25,20,KGALAVILVLTLTILVFWLG,1
4zow,A,21,40,19,LVLYEFSTYIGNDMIQPGM,1
4zow,A,55,72,17,TSMTAYLAGGMFLQWLL,1
4zow,A,84,102,18,MLAGVVWFIVTCLAILLA,1
4zow,A,108,126,18,TLLRFLQGISLCFIGAVG,1
4zow,A,145,164,19,MANVALIAPLLGPLVGAAW,1
4zow,A,171,189,18,GMFVLFAALAAISFFGLQ,1
4zow,A,222,242,20,AGALALGFVSLPLLAWIAQS,1
4zow,A,258,276,18,LLQVPIFGALIAGNLLLA,1
4zow,A,288,305,17,IMGGWPIMIGLLVAAAA,1
4zow,A,315,335,20,MTAGLSIYAFGIGLANAGLV,1
4zow,A,351,369,18,AMGMLQMLIFTVGIEISK,1
4zow,A,380,398,18,NLFNLVNGILWLSLMVIF,1
4zll,C,11,25,14,AWVIAIIIMLAGGL,1
4zll,C,342,357,15,TLVEAIILVFLVMYL,1
4zll,C,366,383,17,IPTIAVPVVLLGTFAVL,1
4zll,C,398,411,13,VLAIGLLVDDAIV,1
4zll,C,442,456,14,VGIAMVLSAVFVPM,1
4zll,C,471,489,18,ITIVSAMALSVLVALILT,1
4zll,C,542,556,14,VLYLIIVVGMAYLF,1
4zll,C,875,891,16,LYAISLIVVFLCLAAL,1
4zll,C,899,916,17,SVMLVVPLGVIGALLAA,1
4zll,C,928,943,15,VGLLTTIGLSAKNAI,1
4zll,C,976,991,15,MTSLAFILGVMPLVI,1
4zll,C,1004,1019,15,TGVMGGMVTATVLAI,1
4mme,B,14,32,18,ILAMAGYAVDLGNFLRFP,1
4mme,B,42,63,21,FMIPYIIAFLLVGIPLMWIEW,1
4mme,B,90,124,34,KILGVFGLWIPLVVAIYYVYIESWTLGFAIKFLV,1
4mme,B,167,184,17,AYIVFLITMFINVSILI,1
4mme,B,191,214,23,ERFAKIAMPTLFILAVFLVIRVF,1
4mme,B,242,265,23,VWIAAVGQIFFSLGLGFGAIITF,1
4mme,B,279,298,19,LTAATLNEKAEVILGGSIS,1
4mme,B,340,366,26,GFLWFFLLFFAGLTSSIAGMQPMIAF,1
4mme,B,378,396,18,VLWTAAIVFFSAHLVMFL,1
4mme,B,400,425,25,DEMDFWAGTIGVVFFGLTELIIFFW,1
4mme,B,448,472,24,YYVMRYITPAFLAVLLVVWAREYI,1
4mme,B,484,501,17,ITRFYIIGLFLFLTFLV,1
4z91,E,206,225,19,SFILPLGLIIAASWSVFWL,1
4z91,E,230,249,19,RLQTSFTLMLTVVAYAFYT,1
4z91,E,262,282,20,DQMIIAGYGSIFAAILLIIF,1
4z91,E,298,317,19,RCRLAFPLGFLAIGCVLVI,1
4d2d,A,16,37,21,TLFMTEMWERFSYYGMRAILL,1
4d2d,A,57,78,21,SIMAIYASMVYLSGTIGGFVA,1
4d2d,A,85,104,19,PAVFWGGVLIMLGHIVLAL,1
4d2d,A,110,130,20,LFGSIILIIIGTGFLKPNVS,1
4d2d,A,149,169,20,IFVFGINLGAFIAPLIVGAA,1
4d2d,A,177,197,20,AFSLAAIGMFIGLLVYYFGG,1
4d2d,A,220,241,21,LVKVSLAVAGFIAIIVVMNLV,1
4d2d,A,247,267,20,AYINLLTIVAIAIPVFYFAW,1
4d2d,A,283,307,24,SYIPLFIAAVLFWAIEEQGSVVLA,1
4d2d,A,322,340,18,WFQSLNPLFIMLYTPFFA,1
4d2d,A,354,373,19,TKFAVGLMFAGLSFLLMAI,1
4d2d,A,386,408,22,LWLVGSWALVILGEMLISPVGL,1
4d2d,A,425,442,17,MWFLSSSVGSALNAQLV,1
4d2d,A,453,472,19,FSYFGLGSVVLGIVLVFLS,1
2ksd,A,24,47,23,MLLALALVVLAIVVQMAVTMVLH,1
2ksd,A,56,79,23,RSIFFGLLITPWAVYFLSVVVEQ,1
2ycw,A,42,63,21,GMSLLMALVVLLIVAGNVLVI,1
2ycw,A,80,103,23,TSLACADLVVGLLVVPFGATLVV,1
2ycw,A,108,136,28,WGSFLCELWTSLDVLCVTASIETLCVIA,1
2ycw,A,163,183,20,TVWAISALVSFLPIMMHWWR,1
2ycw,A,200,228,28,FVTNRAYAIASSIISFYIPLLIMIFVAL,1
2ycw,A,292,315,23,GIIMGVFTLCWLPFFLVNIVNVF,1
2ycw,A,324,345,21,FVAFNWLGYANSAMNPIIYCR,1
5idf,D,529,542,13,CIVFAYIGVSVVL,1
5idf,D,601,615,14,GRIVGGVWWFFTLI,1
5idf,D,799,813,14,FYILVGGLGLAMMV,1
4fpd,C,11,32,21,WLALGTALMGLGTLYFLVKGM,1
4fpd,C,42,62,20,YAITTLVPAIAFTMYLSMLL,1
4fpd,C,80,98,18,ARYADWLFTTPLLLLGLA,1
4fpd,C,107,127,20,ILALVGADGIMIGTGLVGAL,1
4fpd,C,134,156,22,FVWWAISTAAMLYILYVLFFGF,1
4fpd,C,173,192,19,LRNVTVVLWSAYPVVWLIG,1
4fpd,C,204,225,21,TLLFMVLDVSAKVGLGLILLR,1
1ldf,D,11,28,17,IAEFLGTGLLIFFGVGC,1
1ldf,D,43,60,17,ISVIFGLGVAMAIYLTA,1
1ldf,D,86,104,18,IPFIVSQVAGAFCAAALV,1
1ldf,D,150,166,16,VEMVITAILMGLILAL,1
1ldf,D,179,195,16,PLLIGLLIAVIGASMG,1
1ldf,D,234,255,21,VPLFGPIVGAIVGAFAYRKLI,1
5i1m,V,409,424,15,PTIVTFPFMFAIMFG,1
5i1m,V,427,443,16,HGFLMTLAALSLVLNE,1
5i1m,V,461,480,19,RYIILLMGVFSMYTGFLYN,1
5i1m,V,539,557,18,SILMGFIHMTYSYFFSLA,1
5i1m,V,571,591,20,FIPGLLFMQGIFGYLSVCIV,1
5i1m,V,635,650,15,FLLLMALVCIPWLLL,1
5i1m,V,718,744,26,TIEFCLNCVSHTASYLRLWALSLAHA,1
5i1m,V,779,808,29,LTCAVLVLMEGTSAMLHSLRLHWVESMSK,1
3c9l,A,39,64,25,LAAYMFLLIMLGFPINFLTLYVTVQ,1
3c9l,A,72,96,24,NYILLNLAVADLFMVFGGFTTTLY,1
3c9l,A,110,136,26,NLEGFFATLGGEIALWSLVVLAIERY,1
3c9l,A,152,173,21,AIMGVAFTWVMALACAAPPLV,1
3c9l,A,203,228,25,VIYMFVVHFIIPLIVIFFCYGQLVF,1
3c9l,A,251,274,23,RMVIIMVIAFLICWLPYAGVAFY,1
3c9l,A,289,310,21,IPAFFAKTSAVYNPVIYIMMN,1
4djh,B,58,85,27,PVIITAVYSVVFVVGLVGNSLVMFVII,1
4djh,B,95,116,21,IYIFNLALADALVTTTMPFQS,1
4djh,B,133,155,22,VLSIDYYNMFTSIFTLTMMSVD,1
4djh,B,175,195,20,KIINICIWLLSSSVGISAIV,1
4djh,B,226,247,21,KICVFIFAFVIPVLIIIVCYT,1
4djh,B,276,296,20,LVVVAVFVVCWTPIHIFILV,1
4djh,B,312,333,21,YFCIALGYTNSSLNPILYAFL,1
4dkl,B,67,95,28,AITIMALYSIVCVVGLFGNFLVMYVIVR,1
4dkl,B,101,125,24,ATNIYIFNLALADALATSTLPFQS,1
4dkl,B,143,167,24,ISIDYYNMFTSIFTLCTMSVDRYI,1
4dkl,B,182,203,21,NAKIVNVCNWILSSAIGLPVM,1
4dkl,B,233,255,22,ICVFIFAFIMPVLIITVCYGLM,1
4dkl,B,280,302,22,MVLVVVAVFIVCWTPIHIYVII,1
4dkl,B,317,339,22,WHFCIALGYTNSCLNPVLYAFL,1
4j05,A,40,59,19,GFFLDAYDLFIINQVAPML,1
4j05,A,73,95,22,QDLMKAAANIGCVVGQVMFGVL,1
4j05,A,107,123,16,ELILIIVATIFQMSAP,1
4j05,A,132,151,19,TWITICRVFLGIGIGGDYP,1
4j05,A,175,195,20,NQGWGSFVGSLVTIVTISGF,1
4j05,A,209,227,18,AWRILIGLSLIPAFGTLY,1
4j05,A,315,340,25,SMLGWFLVDIAFYGINLNQSVVLAQ,1
4j05,A,355,376,21,QLATGNIIVTALGFLPGYYFT,1
4j05,A,389,407,18,FMGFIMSGLFLAILAGEI,1
4j05,A,412,435,23,GPLLACFTFMQFFFNFGANTTTF,1
4j05,A,453,473,20,SAAAGKCGAILSSLVFNQLK,1
4j05,A,479,497,18,AVLWIFFSTCILGFISTF,1
4tnk,z,3,20,17,LFQLALAALVILSFVMV,1
4tnk,z,44,57,13,GLWIALVLVVGVL,1
4tnj,z,3,20,17,LFQLALAALVILSFVMV,1
4tnj,z,44,57,13,GLWIALVLVVGVL,1
5lzr,B,7,27,20,FLIPLVALGFAAANFAAVVR,1
5lzr,B,47,69,22,SFLAHETKAIFKVAIVIAILLM,1
5lzr,B,78,98,20,AFLLGAVMSASAGIVGMKMA,1
5lzr,B,121,144,23,AYQGGSVMGLSVGGFALLGLVLV,1
5lzr,B,177,198,21,GYALGCSIIAMFDRVGGGVYT,1
5lzr,B,234,254,20,GDVAGLGADLLESFVGAIVS,1
5lzr,B,292,314,22,FALVGLGCSMLGILYVIVKKPS,1
5lzr,B,318,336,18,RELNISLWTSALLTVVLT,1
5lzr,B,365,385,20,AIIGIFSGILIGFWAEYYTS,1
5lzr,B,410,431,21,SLGMKSVFPPTLTLVLGILFA,1
5lzr,B,441,463,22,IAALGMLSFVATSVSVDSYGPI,1
5lzr,B,492,514,22,TTAAIGKGFAIGSAIFAALSLF,1
5lzr,B,544,566,22,IAGALLGAAITYYFSGYLISAV,1
5lzr,B,605,629,24,NALKQMGYPAFIAILTPLVTGFLL,1
5lzr,B,634,658,24,GGVLIGTVLSGAMLAILTANSGGA,1
5lzr,B,694,716,22,KDTVGPSLDILIKIMSVVSVIA,1
3c9m,A,39,64,25,LAAYMFLLIMLGFPINFLTLYVTVQ,1
3c9m,A,72,96,24,NYILLNLAVADLFMVFGGFTTTLY,1
3c9m,A,110,136,26,NLEGFFATLGGEIALWSLVVLAIERY,1
3c9m,A,152,176,24,AIMGVAFTWVMALACAAPPLVGWS,1
3c9m,A,202,226,24,FVIYMFVVHFIIPLIVIFFCYGQL,1
3c9m,A,252,277,25,MVIIMVIAFLICWLPYAGVAFYIFT,1
3c9m,A,288,310,22,TIPAFFAKTSAVYNPVIYIMMN,1
1gue,A,6,26,20,LFWLGAIGMLVGTLAFAWAG,1
1gue,A,36,56,20,YVTLVGISGIAAVAYVVMAL,1
1gue,A,70,90,20,PRYIDWILTTPLIVYFLGLL,1
1gue,A,96,115,19,EFGIVITLNTVVMLAGFAG,1
1gue,A,126,146,20,FGMGAVAFLGLVYYLVGPMT,1
1gue,A,160,179,19,VRLRNLTVILWAIYPFIWL,1
1gue,A,194,214,20,ALIVYLDLVTKVGFGFIALD,1
4dji,A,14,35,21,LLGFFAITASMVMAVYEYPTF,1
4dji,A,42,65,23,VFFLLLGGILWFIPVGLCAAEMA,1
4dji,A,87,111,24,GFAAISFGYLQIAIGFIPMLYFVL,1
4dji,A,132,149,17,AALIILWALALTQFGGT,1
4dji,A,151,172,21,TARIAKVGFFAGILLPAFILI,1
4dji,A,205,224,19,VFVAFILSYMGVEASATHV,1
4dji,A,231,253,22,RDYPLAMLLLMVAAICLSSVGG,1
4dji,A,294,320,26,ALLLLGVLAEIASWIVGPSRGMYVTA,1
4dji,A,330,358,28,KMNKNGVPVTLVISQLVITSIALIILTN,1
4dji,A,367,391,24,LIALALTVVIYLCAYFMLFIGYIV,1
4dji,A,406,433,27,GGKGVKLVVAIVGLLTSIMAFIVSFLP,1
4dji,A,446,467,21,ELLVVSFLVVLALPFILYAVH,1
3vvp,A,24,42,18,IPMMIGMSVQTLYNLADG,1
3vvp,A,60,79,19,PVFMGIIALAAGLGVGTSS,1
3vvp,A,100,119,19,LILSLILGVTITITMLPAI,1
3vvp,A,140,161,21,RVLLAGAFIIVFNNVGNGILR,1
3vvp,A,166,187,21,NRAMLAMVLGSGLNIVLDPIF,1
3vvp,A,198,219,21,AYATLLSMVVTSLFIAYWLFV,1
3vvp,A,243,264,21,RVGLPSSLSQLSMSIAMFFLN,1
3vvp,A,280,301,21,SAWRITMLGIVPILGMAAATT,1
3vvp,A,324,340,16,KIAFMIELAVVAFIML,1
3vvp,A,364,387,23,ALRTLPVFLVLTPFGMMTSAMFQ,1
3vvp,A,392,415,23,EKSLILTIFRTLVMQVGFAYIFV,1
3vvp,A,424,444,20,VWIGIVIGNMVAAIVGFLWG,1
2lzl,A,374,396,22,GILSYGVGFFLFILVVAAVTLC,1
2gif,C,12,28,16,WVIAIIIMLAGGLAIL,1
2gif,C,341,357,16,KTLVEAIILVFLVMYL,1
2gif,C,366,386,20,IPTIAVPVVLLGTFAVLAAF,1
2gif,C,395,410,15,FGMVLAIGLLVDDAI,1
2gif,C,443,458,15,GIAMVLSAVFVPMAF,1
2gif,C,468,488,20,QFSITIVSAMALSVLVALIL,1
2gif,C,541,558,17,LVLYLIIVVGMAYLFVR,1
2gif,C,874,891,17,SLYAISLIVVFLCLAAL,1
2gif,C,899,919,20,SVMLVVPLGVIGALLAATFR,1
2gif,C,927,943,16,QVGLLTTIGLSAKNAI,1
2gif,C,976,992,16,MTSLAFILGVMPLVIS,1
2gif,C,1001,1019,18,AVGTGVMGGMVTATVLAI,1
2n4x,A,2,13,11,MAFALGILSVF,1
2n4x,A,30,45,15,RALDAFLIVAGLTIS,1
2n4x,A,62,77,15,VAMLFLLIFALILLS,1
2n4x,A,83,96,13,VSIFASRMTSGLS,1
2n4x,A,137,157,20,VMLSYGLGMAVTIAAVFKMG,1
2n4x,A,168,182,14,RKVTGAIVLLYLAY,1
4xxj,C,10,29,19,IWLALGTALMGLGTLYFLV,1
4xxj,C,46,62,16,TLVPAIAFTMYLSMLL,1
4xxj,C,80,94,14,ARYADWLFTTPLLL,1
4xxj,C,110,127,17,LVGADGIMIGTGLVGAL,1
4xxj,C,134,150,16,FVWWAISTAAMLYILY,1
4xxj,C,177,192,15,TVVLWSAYPVVWLIG,1
4xxj,C,203,221,18,ETLLFMVLDVSAKVGFGL,1
1k6n,H,13,32,19,SLAIYSFWIFLAGLIYYLQ,1
5i32,D,21,38,17,LAEFISTLLFVFAGVGS,1
5i32,D,58,75,17,IAVCHGFALFVAVAIGA,1
5i32,D,99,122,23,TGVFYWIAQLLGSTAACFLLKYV,1
5i32,D,141,161,20,GVVMEIIITFALVYTVYATA,1
5i32,D,173,189,16,PLAIGLIVGANILAAG,1
5i32,D,215,232,17,VYWVGPLIGGGLAGLIY,1
4z90,E,206,225,19,SFILPLGLIIAASWSVFWL,1
4z90,E,231,249,18,LQTSFTLMLTVVAYAFYT,1
4z90,E,262,282,20,DQMIIAGYGSIFAAILLIIF,1
4z90,E,300,317,17,RLAFPLGFLAIGCVLVI,1
2kse,A,18,34,16,LILASVTWLLSSFVAW,1
2kse,A,161,177,16,AGQLIPWLVALPIMLI,1
4d2e,C,34,47,13,GVAVLLCVVIAAW,1
4d2e,C,54,68,14,RVLLISSVMLVMIV,1
4d2e,C,102,116,14,IAIIDAVITWAILL,1
4mmd,B,14,35,21,ILAMAGYAVDLGNFLRFPVQA,1
4mmd,B,42,63,21,FMIPYIIAFLLVGIPLMWIEW,1
4mmd,B,90,124,34,KILGVFGLWIPLVVAIYYVYIESWTLGFAIKFLV,1
4mmd,B,167,185,18,AYIVFLITMFINVSILIR,1
4mmd,B,191,214,23,ERFAKIAMPTLFILAVFLVIRVF,1
4mmd,B,242,265,23,VWIAAVGQIFFSLGLGFGAIITF,1
4mmd,B,279,298,19,LTAATLNEKAEVILGGSIS,1
4mmd,B,340,367,27,GFLWFFLLFFAGLTSSIAGMQPMIAFL,1
4mmd,B,378,396,18,VLWTAAIVFFSAHLVMFL,1
4mmd,B,400,425,25,DEMDFWAGTIGVVFFGLTELIIFFW,1
4mmd,B,448,472,24,YYVMRYITPAFLAVLLVVWAREYI,1
4mmd,B,484,502,18,ITRFYIIGLFLFLTFLVF,1
3s33,C,7,22,15,ALAVILVLTLTILVF,1
2ksr,A,29,52,23,FYTINLIIPCVLITSLAILVFYL,1
2ksr,A,59,81,22,MTLCISVLLALTVFLLLISKIV,1
2ksr,A,88,109,21,PLVGKYLMFTMVLVTFSIVTS,1
2ksr,A,138,161,23,LFLWIFVFVCVFGTIGMFLQPLF,1
5k2b,A,5,28,23,SSVYITVELAIAVLAILGNVLVC,1
5k2b,A,45,67,22,VSLAAADIAVGVLAIPFAITIS,1
5k2b,A,76,97,21,CLFIACFVLVLTQSSIFSLLA,1
5k2b,A,124,144,20,IAICWVLSFAIGLTPMLGWN,1
5k2b,A,172,195,23,PMNYMVYFNFFACVLVPLLLMLG,1
5k2b,A,237,259,22,IVGLFALCWLPLHIINCFTFFC,1
5k2b,A,265,287,22,PLWLMYLAIVLSHTNSVVNPFI,1
4ami,A,42,61,19,GMSLLMALVVLLIVAGNVL,1
4ami,A,83,103,20,ACADLVVGLLVVPFGATLVV,1
4ami,A,108,133,25,WGSFLCELWTSLDVLCVTASIETLC,1
4ami,A,164,183,19,VWAISALVSFLPIMMHWWR,1
4ami,A,200,225,25,FVTNRAYAIASSIISFYIPLLIMIF,1
4ami,A,295,316,21,MGVFTLCWLPFFLVNIVNVFN,1
4ami,A,320,342,22,PDWLFVAFNWLGYANSAMNPII,1
3spc,D,78,104,26,WRYMLLLFSLAFLVSWLLFGLIFWLI,1
3spc,D,156,184,28,LAVFMVVVQSIVGCIIDSFMIGAIMAKM,1
1kyk,E,23,40,17,IIGAAFGKIVSSLVADI,1
1kyk,E,78,94,16,IQNVFDFLIVAFAIFM,1
3ob6,B,17,32,15,MVSGNIMGSGVFLLP,1
3ob6,B,42,57,15,IYGWLVTIIGALGLS,1
3ob6,B,92,112,20,YWLACWIGAIAMVVIGVGYL,1
3ob6,B,124,140,16,LTITCVVVLWIFVLLN,1
3ob6,B,147,170,23,TRVQAVATVLALIPIVGIAVFGW,1
3ob6,B,194,209,15,STLNVTLWSFIGVES,1
3ob6,B,229,245,16,GGVLIAAVCYVLSTTA,1
3ob6,B,278,297,19,SFCAAAGCLGSLGGWTLLA,1
3ob6,B,328,342,14,IVGILMTIFQLSSI,1
3ob6,B,350,366,16,GLVSSVSVIFTLVPYL,1
3ob6,B,390,407,17,TTIAFLYCIWAVVGSGA,1
3ob6,B,409,423,14,VMWSFVTLMVITAM,1
5eke,D,231,252,21,TYLGSIISLLSLAYASFLILK,1
5eke,D,260,282,22,PGYASLMVAILFLGGVQLISLG,1
2wu5,L,15,38,23,FILVRATAIVLTLYIIYMVGFFA,1
2wu5,L,57,80,23,KVFTLLALFSILIMAWIGMWQVL,1
2wu5,L,89,110,21,RLMLQLVIVVALVVYVIYGFV,1
4twh,E,211,225,14,LGLIIAASWSVFWL,1
4twh,E,230,245,15,RLQTSFTLMLTVVAY,1
4twh,E,266,282,16,IAGYGSIFAAILLIIF,1
4twh,E,300,315,15,RLAFPLGFLAIGCVL,1
1yf6,H,16,32,16,IYSFWIFLAGLIYYLQ,1
3v8f,C,14,28,14,KILIGLILGAIVGL,1
3v8f,C,43,66,23,KPFGDLFVRLLKMLVMPIVFASL,1
3v8f,C,94,110,16,FAVTLGIIMARLFNPG,1
3v8f,C,131,140,9,HILLDIVPT,1
3v8f,C,151,161,10,LPTIFFAIIL,1
3v8f,C,201,217,16,MQYAPIGVFALIAYCM,1
3v8f,C,225,242,17,GELAKVTAAVYVGLTLQ,1
3v8f,C,313,326,13,TALYQGVATFFIA,1
3v8f,C,334,352,18,VGQQLTIVLTAVLASIGT,1
3v8f,C,358,373,15,GAIMLAMVLHSVGLP,1
3v8f,C,380,397,17,AAYACILGIDAILDMGR,1
1brr,C,10,30,20,IWLALGTALMGLGTLYFLVK,1
1brr,C,44,66,22,ITTLVPAIAFTMYLSMLLGYGL,1
1brr,C,79,97,18,WARYADWLFTTPLLLLDL,1
1brr,C,109,128,19,ALVGADGIMIGTGLVGALT,1
1brr,C,134,153,19,FVWWAISTAAMLYILYVLF,1
1brr,C,175,196,21,NVTVVLWSAYPVVWLIGSEGA,1
1brr,C,202,222,20,IETLLFMVLDVSAKVGFGLI,1
3am6,D,13,33,20,WIVFAIMAAAAIAFGVAVHF,1
3am6,D,40,60,20,AYYINIAICTIAATAYYAMA,1
3am6,D,77,96,19,RYIDWVLTTPLLLLDLIVM,1
3am6,D,102,122,20,MISWVIGADIFMIVFGILGA,1
3am6,D,132,153,21,YFIAGCVMQAVLTYGMYNATW,1
3am6,D,166,186,20,YVSLLVFLSILWVFYPVVWA,1
3am6,D,200,222,22,ILMGILDVLAKPLFGMGCLIAH,1
2bob,F,26,50,24,RAAGAATVLLVIVLLAGSYLAVLA,1
2bob,F,87,111,24,GRCVAVVVMVAGITSFGLVTAALA,1
4h1d,C,94,113,19,PVTWVMMIACVVVFIAMQI,1
4h1d,C,140,165,25,HALMHFSLMHILFNLLWWWYLGGAV,1
4h1d,C,172,189,17,KLIVITLISALLSGYVQ,1
4h1d,C,198,214,16,GLSGVVYALMGYVWLR,1
4h1d,C,226,242,16,RGLIIFALIWIVAGWF,1
4h1d,C,252,267,15,AHIAGLAVGLAMAFV,1
2b5f,D,39,59,20,AAIAEFIATLLFLYITVATV,1
2b5f,D,75,93,18,GIAWAFGGMIFVLVYCTA,1
2b5f,D,117,140,23,RALVYMIAQCLGAICGVGLVKAF,1
2b5f,D,162,182,20,TALGAEIIGTFVLVYTVFSA,1
2b5f,D,198,214,16,PLPIGFAVFMVHLATI,1
2b5f,D,240,262,22,DQWIFWVGPFIGAAVAAAYHQY,1
4czb,B,4,24,20,MAIGYLGLALVLGSLVAKIA,1
4czb,B,30,46,16,DIPLLLLLGLIIGPFL,1
4czb,B,58,74,16,EYAGPIGLIFILLGGA,1
4czb,B,90,108,18,RLDTITFLITLLISGFIF,1
4czb,B,122,135,13,LFGAITAATDPAT,1
4czb,B,156,171,15,SIFNDPLGIVSTSVI,1
4czb,B,184,206,22,IDLITLAGGAIVVGLLLAKIYE,1
4czb,B,218,234,16,APLVLGGAMLLLYVGD,1
4czb,B,245,258,13,SGYMAVAIMGLYL,1
4czb,B,277,296,19,DDLSLLARVFIFVFLGACI,1
4czb,B,306,330,24,PGLLVALGSIFLARPLGVFLGLIG,1
4czb,B,342,358,16,LEGPRGVVPAALAVTV,1
4czb,B,387,403,16,IGTFMTILLSVILEAS,1
1pcr,H,16,31,15,IYSFWIFLAGLIYYL,1
2lom,A,32,48,16,GIAGFAAIVAYGLYKL,1
2lom,A,59,85,26,LIHMRVAAQGFVVGAMTVGMGYSMYR,1
1eys,H,14,28,14,TIWAFWLFFFGLII,1
4f35,A,23,35,12,IVLADVALFLAL,1
4f35,A,51,64,13,LAFIAVLWLTEAL,1
4f35,A,66,76,10,TVTAILVPVM,1
4f35,A,90,106,16,NFANSIIFLFLGGFAL,1
4f35,A,191,209,18,GGIATLVGSPPNAIAAAE,1
4f35,A,213,229,16,FTDWMKFGLPTAMMML,1
4f35,A,267,279,12,FGLTVFLWIFSS,1
4f35,A,291,306,15,DTLVALGAILMLSFA,1
4f35,A,319,332,13,WGVLLLFGGGLCL,1
4f35,A,360,375,15,VILVVATFVVFLTEF,1
4f35,A,377,389,12,NTASAALLIPVF,1
4f35,A,403,414,11,SVLIAVAASCA,1
4f35,A,447,460,13,ACIGLLTAIAMLF,1
4muu,A,22,41,19,EIAFMAALAFIISLIPNTV,1
4muu,A,46,59,13,VEIACIPILLLSL,1
4muu,A,64,83,19,AGLVGGLIWGILSMITGHA,1
4muu,A,90,107,17,AFLEYLVAPVSLGIAGL,1
4muu,A,121,138,17,LGTFVAVLLKYFFHFIA,1
4muu,A,159,179,20,VNGISGILTAIAAFVILIIF,1
2iqo,A,67,94,27,AITIMALYSIVCVVGLFGNFLVMYVIV,1
2iqo,A,105,129,24,YIFNLALADALATSTLPFQSVNYL,1
2iqo,A,139,163,24,CKIVISIDYYNMFTSIFTLCTMSV,1
2iqo,A,184,210,26,KIVNVCNWILSSAIGLPVMFMATTKY,1
2iqo,A,229,253,24,NLLKICVFIFAFIMPVLIITVCYG,1
2iqo,A,281,305,24,VLVVVAVFIVCWTPIHIYVIIKAL,1
2iqo,A,317,338,21,WHFCIALGYTNSCLNPVLYAF,1
5e1a,F,26,50,24,RAAGAATVLLVIVLLAGSYLAVLA,1
5e1a,F,87,114,27,GRLVAVVVMVAGITSFGLVTAALATWF,1
3pl9,A,95,113,18,ELIHGRWAMLATLGALTV,1
3pl9,A,145,162,17,TLIWIEVLVIGYIEFQR,1
3pl9,A,197,214,17,IKHARLAMVGFLGFAVQ,1
4pl0,B,23,46,23,LFFSMLFITSLSSIIISISPLIL,1
4pl0,B,70,92,22,LYMFCVISNKASVFLFMILQSS,1
4pl0,B,139,163,24,VRNVSQNILSPVIQLISTIVVVLS,1
4pl0,B,167,189,22,FSAGVFFLYILVFVIFNTRLTG,1
4pl0,B,248,271,23,LSSKVLLLNSLLAVILFGSVFIY,1
4pl0,B,288,311,23,ITSYIILLSTPVENIGALLSEIR,1
3ne2,D,9,26,17,TAEVVGTFILVFFGPGA,1
3ne2,D,57,75,18,AIGMAFALAIAAVIYSLG,1
3ne2,D,102,119,17,PYIVAQFIGAALGSLLF,1
3ne2,D,146,165,19,AILTEAIGTFLLMLVIMGV,1
3ne2,D,176,192,16,GLVIGLTVGGIITTIG,1
3ne2,D,223,240,17,IYVIGPIVGAVAAAWLY,1
1sqb,K,22,39,17,LWGAVGAVGLVWATDSR,1
2hyd,B,10,34,24,PYKYRIFATIIVGIIKFGIPMLIP,1
2hyd,B,64,89,25,IALFIFVIVRPPIEFIRQYLAQWTS,1
2hyd,B,133,157,24,FILTGLMNIWLDCITIIIALSIMF,1
2hyd,B,165,186,21,AALFIFPFYILTVYVFFGRLR,1
2hyd,B,241,263,22,RWNAYSFAAINTVTDIGPIIVI,1
2hyd,B,286,308,22,LELLFGPLRRLVASFTTLTQSF,1
3uq7,E,205,222,17,WSFILPLGLIIAASWSV,1
3uq7,E,234,250,16,SFTLMSTVVAYALYTS,1
3uq7,E,262,279,17,DQMIIAGYGSIFAAILL,1
3uq7,E,303,317,14,FPLGFLAIGCVLVI,1
2vpx,G,16,36,20,NALHFVLVGLAGGVALLAAL,1
2vpx,G,50,66,16,YALMLIALDLFILWAE,1
2vpx,G,89,105,16,WGAWGLGLGFLTGGLL,1
2vpx,G,115,132,17,AWALLVFSLVALSYPGL,1
2vpx,G,147,163,16,AGLFPLTALVLALGLA,1
2vpx,G,175,189,14,RVLAGASLLLALLY,1
2vpx,G,207,221,14,WYGLFLLLGLGTFW,1
2vpx,G,226,241,15,PWAGLLAAAGLRALL,1
1fjp,A,31,49,18,FINFCLILIFLLLICIIV,1
3usi,A,13,31,18,LILAMAGNAVGLGNFLRF,1
3usi,A,45,63,18,PYIIAFLLVGIPLMWIEW,1
3usi,A,90,124,34,KILGVFGLWIPLVVAIYYVYIESWTLGFAIKFLV,1
3usi,A,167,184,17,AYIVFLITMFINVSILI,1
3usi,A,191,211,20,ERFAKIAMPTLFILAVFLVI,1
3usi,A,245,266,21,AAVGQIFFTLSLGFGAIITYA,1
3usi,A,277,296,19,SGLTAATLNEKAEVILGGS,1
3usi,A,343,366,23,WFFLLFFAGLTSSIAIMQPMIAF,1
3usi,A,379,396,17,LWTAAIVFFSAHLVMFL,1
3usi,A,400,426,26,DEMDFWAGTIGVVFFGLTELIIFFWI,1
3usi,A,445,469,24,RIYYYVMRYITPAFLAVLLVVWAR,1
3usi,A,484,501,17,ITRFYIIGLFLFLTFLV,1
4ruf,B,33,51,18,ALLALVLLYLVSGALVFR,1
4ruf,B,141,165,24,GRLFCIFYALVGIPLFGILLAGVG,1
4ruf,B,200,220,20,FLLIGCLLFVLTPTFVFCYM,1
4ruf,B,255,277,22,AYQPLVSFWILLGLAYFASVLT,1
2jbl,M,52,70,18,ASGIAAFAFGSTAILIIL,1
2jbl,M,116,132,16,GLFMTLSLGSWWIRVY,1
2jbl,M,144,161,17,AWNFAAAIFFVLCIGCI,1
2jbl,M,198,218,20,WHGFSIGFAYGCGLLFAAHG,1
2jbl,M,267,284,17,WFFSLMVMVSASVGILL,1
1h2s,D,24,40,16,VFIFVGALTVLFGAIA,1
1h2s,D,63,80,17,ILGLIILLGINLGLVAA,1
5tgz,A,119,143,24,AVLSLTLGTFTVLENLLVLCVILH,1
5tgz,A,154,176,22,FIGSLAVADLLGSVIFVYSFID,1
5tgz,A,188,212,24,FLFKLGGVTASFTASVGSLFLAAI,1
5tgz,A,235,256,21,AFCLMWTIAIVIAVLPLLGWN,1
5tgz,A,271,295,24,DKTYLMFWIGVVSVLLLFIVYAYM,1
5tgz,A,344,369,25,LVLILVVLIICWGPLLAIMVYDVFG,1
5tgz,A,379,401,22,AFCSMLCLLNSTVNPIIYALRS,1
4lp8,D,47,71,24,VFITLITGLYLVTNALFALAYLAC,1
4lp8,D,108,132,24,ANTLVTLEALCGMLGLAVAARLIY,1
3g60,A,45,68,23,DRLYMLVGTLAAIIHGVALPLMM,1
3g60,A,115,135,20,GIGAGVLIVAYIQVSFWCLA,1
3g60,A,184,203,19,KIGMFFQAMATFFGGFIIG,1
3g60,A,215,233,18,AISPVLGLSAGIWAKILS,1
3g60,A,291,310,19,NISMGAAFLLIYASYALAF,1
3g60,A,331,349,18,FSVLIGAFSVGQASPNIE,1
3g60,A,708,728,20,VGIFCAIINGGLQPAFSVIF,1
3g60,A,753,773,20,LFLILGIISFITFFLQGFTF,1
3g60,A,829,847,18,AVIFQNIANLGTGIIISL,1
3g60,A,854,872,18,LLLLAIVPIIAIAGVVEM,1
3g60,A,932,952,20,VFGITFSFTQAMMYFSYAAC,1
3g60,A,972,990,18,VFSAIVFGAMAVGQVSSF,1
4pa7,F,132,152,20,SVAALLTVVFYIAAVMATNL,1
4pa7,F,195,218,23,WVFFIPFIMLTTFTVLNLFIGII,1
4ryr,A,9,27,18,VFFLTYGLFYVSSVLFPI,1
4ryr,A,46,64,18,IGMIWAVLFGLIALSVAI,1
4ryr,A,76,96,20,WFLFLLNYIFNQAFSYFQFS,1
4ryr,A,102,122,20,ATVDCLLVAITTLLLIMFSS,1
4ryr,A,127,147,20,SAWLLIPYFLWSAFATYLSW,1
5jnq,B,6,19,13,LAIIIAFAISALL,1
5jnq,B,56,69,13,IILSSIIITSVFY,1
5jnq,B,77,90,13,PVLFVTVGFGIIG,1
5jnq,B,112,125,13,VGQFIITGIFAWY,1
5jnq,B,156,172,16,VPALFFIMLGTDNGVN,1
5jnq,B,182,194,12,SVTILVATFLTI,1
5jnq,B,204,218,14,PITGAVVGSLLGFL,1
5jnq,B,233,246,13,SLALGGFVAASCY,1
5jnq,B,251,266,15,LFIPVIGLIYLVEVL,1
5jnq,B,306,319,13,FAIVTAILCMVAY,1
2xqs,P,16,38,22,AVGIGSIGPGLGQGQAAGQAVE,1
2xqs,P,51,73,22,GTLLLSLAFMEALTIYGLVVAL,1
2xq2,B,58,73,15,SLIAANISAEQFIGM,1
2xq2,B,85,97,12,SYEWMSAITLII,1
2xq2,B,130,150,20,AVFWISLYIFVNLTSVLYLG,1
2xq2,B,167,179,12,GLALFALVYSIY,1
2xq2,B,187,201,14,TDVIQVFFLVLGGF,1
2xq2,B,247,268,21,GIAVLIGGLWVANLYYWGFNQ,1
2xq2,B,288,302,14,FAAFLALIVPFLVV,1
2xq2,B,354,374,20,FAALAAAIVSSLASMLNSTA,1
2xq2,B,400,414,14,TAAVVALIIAALIA,1
2xq2,B,424,440,16,QYIQEYTGLVSPGILA,1
2xq2,B,460,473,13,VASIPFALFLKFM,1
2xq2,B,479,493,14,MDQMLYTLLFTMVV,1
2xq2,B,527,541,14,AYGIMIVLAVLYTL,1
2xq2,B,556,572,16,VMAGVIGTILLISYGI,1
5da0,A,22,47,25,KDVLAGIVVALALIPEAIAFSIIAG,1
5da0,A,53,68,15,LYASFIIALITAFLG,1
5da0,A,74,90,16,SAATGAMALLMTGLVK,1
5da0,A,97,113,16,FAATVLTGVLQVVFGW,1
5da0,A,131,147,16,VNALAILIFMAQLPQF,1
5da0,A,155,172,17,AMVAAGLAIIYLLPLVF,1
5da0,A,174,187,13,MPSALVAIVVLTV,1
5da0,A,221,239,18,ETLAIIFPVALTLSLVGL,1
5da0,A,263,277,14,RGQGVANIVTGFFG,1
5da0,A,279,288,9,AGCAMIGQS,1
5da0,A,300,313,13,STFVAGAFLMVLI,1
5da0,A,326,340,14,ALVAVMMVVAISTF,1
4ezd,C,69,83,14,PISGILILVGLLVQ,1
4ezd,C,88,105,17,LNGCVGTVVSTLTALLL,1
4ezd,C,116,128,12,QGYNATLVGILM,1
4ezd,C,143,160,17,PVSAMSMTCPVFSSALN,1
4ezd,C,170,182,12,FTLPFNMALSMY,1
4ezd,C,236,249,13,GGIFLGAILLSSP,1
4ezd,C,251,265,14,CLHAAIGSLLGIIA,1
4ezd,C,282,295,13,FNSSLACIAIGGT,1
4ezd,C,302,321,19,THLLALACALFTAYLGASM,1
4ezd,C,333,347,14,TWPFCLATLLFLLL,1
5te3,B,37,63,26,SMLAAYMFLLIMLGFPINFLTLYVTV,1
5te3,B,75,98,23,LLNLAVADLFMVFGGFTTTLYTS,1
5te3,B,110,133,23,NLEGFFATLGGEIALWSLVVLAI,1
5te3,B,154,176,22,MGVAFTWVMALACAAPPLVGWS,1
5te3,B,199,222,23,NESFVIYMFVVHFIIPLIVIFFC,1
5te3,B,255,279,24,IMVIAFLICWLPYAGVAFYIFTHQ,1
5te3,B,287,309,22,MTIPAFFAKTSAVYNPVIYIMM,1
2hvk,F,25,50,25,WRAAGAATVLLVIVLLAGSYLAVLA,1
2hvk,F,87,113,26,GRCVAVVVMVAGITSFGLVTAALATW,1
2akh,C,20,32,12,VVVALLLVAIVG,1
2akh,C,49,60,11,ILIAAAGGVAL,1
2akh,C,98,115,17,AVTAVMSLILWGLDGIL,1
5x3x,q,22,37,15,KSLIGLGFLALAVTV,1
5x3x,q,43,61,18,VLVTVAILAFTFLGARVP,1
5x3x,q,62,83,21,RFWASVAVLPLGFLTTGAAVL,1
5x3x,q,105,122,17,VMRATAATCCLLFLATT,1
5x3x,q,223,238,15,ARVLGLILTLQAAIL,1
5ahz,C,29,52,23,SSSLWVNVALAGIAILVFVYMGR,1
5ahz,C,63,82,19,GATLMIPLVSISSYLGLLS,1
5ahz,C,105,124,19,WGRYLTWALSTPMILLALG,1
5ahz,C,133,154,21,LFTVIAADIGMCVTGLAAAMT,1
5ahz,C,160,180,20,RWAFYAISCAFFVVVLSALV,1
5ahz,C,199,221,22,RVLTVVLWLGYPIVWAVGVEGL,1
5ahz,C,229,251,22,TSWAYSVLDVFAKYVFAFILLR,1
2o01,4,41,57,16,QAELVNGRWAMLGVAG,1
2o01,4,92,108,16,IEFILSHYVEIRRWQD,1
2o01,4,151,168,17,KEIANGRLAMLAFLGFI,1
4k7q,C,11,27,16,AWVIAIIIMLAGGLAI,1
4k7q,C,341,357,16,KTLVEAIILVFLVMYL,1
4k7q,C,366,386,20,IPTIAVPVVLLGTFAVLAAF,1
4k7q,C,396,411,15,GMVLAIGLLVDDAIV,1
4k7q,C,442,458,16,VGIAMVLSAVFVPMAF,1
4k7q,C,471,489,18,ITIVSAMALSVLVALILT,1
4k7q,C,541,557,16,LVLYLIIVVGMAYLFV,1
4k7q,C,875,892,17,LYAISLIVVFLCLAALY,1
4k7q,C,896,919,23,IPFSVMLVVPLGVIGALLAATFR,1
4k7q,C,928,944,16,VGLLTTIGLSAKNAIL,1
4k7q,C,975,992,17,LMTSLAFILGVMPLVIS,1
4k7q,C,1004,1021,17,TGVMGGMVTATVLAIFF,1
1oz5,A,30,49,19,SLLILSTLLGNTLVCAAVI,1
1oz5,A,60,79,19,FFVISLAVSDLLVAVLVMP,1
1oz5,A,102,119,17,DIMCSTASILNLCVISV,1
1oz5,A,141,157,16,ILISVAWTLSVLISFI,1
1oz5,A,197,216,19,SSVISFYIPVAIMIVTYTR,1
1oz5,A,273,290,17,LSVIMGVFVCCWLPFFI,1
1oz5,A,319,333,14,GWANSSLNPIIYAF,1
1tn0,C,10,34,24,IWLALGTALMGLGTLYFLVKGMGV,1
1tn0,C,41,62,21,FYAITTLVPPIAFTMYLSMLL,1
1tn0,C,79,100,21,WARYADWLFTTPLLLLDLALL,1
1tn0,C,104,128,24,QGTILALVGADGIMIGTGLVGALT,1
1tn0,C,134,157,23,FVWWAISTAAMLYILYVLFFGFT,1
1tn0,C,171,195,24,KVLRNVTVVLWSAYPVVWLIGSEG,1
1tn0,C,203,226,23,ETLLFMVLDVSAKVGFGLILLRS,1
5vhw,D,527,540,13,CIVFAYIGVSVVL,1
5vhw,D,598,613,15,RIVGGVWWFFTLIII,1
5vhw,D,796,809,13,YILVGGLGLAMLV,1
1clt,M,52,71,19,IAGTVSLAFGAAWFFTIGV,1
1clt,M,115,132,17,ASLFMAISVIAWWVRVY,1
1clt,M,144,162,18,AWAFLSAIWLWSVLGFWR,1
1clt,M,198,219,21,FHGLSIAALYGSALLFAMHGA,1
1clt,M,266,284,18,AIWMAVMVTLTGGIGILL,1
1oy9,C,11,27,16,AWVIAIIIMLAGGLAI,1
1oy9,C,341,357,16,KTLVEAIILVFLVMYL,1
1oy9,C,366,386,20,IPTIAVPVVLLGTFAVLAAF,1
1oy9,C,395,411,16,FGMVLAIGLLVDDAIV,1
1oy9,C,442,458,16,VGIAMVLSAVFVPMAF,1
1oy9,C,469,489,20,FSITIVSAMALSVLVALILT,1
1oy9,C,541,557,16,LVLYLIIVVGMAYLFV,1
1oy9,C,874,891,17,SLYAISLIVVFLCLAAL,1
1oy9,C,898,919,21,FSVMLVVPLGVIGALLAATFR,1
1oy9,C,927,943,16,QVGLLTTIGLSAKNAI,1
1oy9,C,975,993,18,LMTSLAFILGVMPLVIST,1
1oy9,C,1001,1021,20,AVGTGVMGGMVTATVLAIFF,1
1ozc,A,55,73,18,YSAVCAVGLLGNVLVMFG,1
1ozc,A,87,105,18,IFNLALADALATSTLPFQ,1
1ozc,A,124,144,20,LSIDYYNMFTSIFTLTMMSV,1
1ozc,A,167,184,17,INICIWVLASGVGVPIM,1
1ozc,A,214,234,20,ICVFLFAFVVPILIITVCYG,1
1ozc,A,263,280,17,LVVVGAFVVCWAPIHIF,1
1ozc,A,304,320,16,ALGYANSSLNPVLYAF,1
4k5y,A,123,143,20,YLGHCISLVALLVAFVLFLR,1
4k5y,A,153,171,18,IHANLIAAFILRNATWFV,1
4k5y,A,194,212,18,YNYFHVTNFFWMFGEGCY,1
4k5y,A,229,247,18,MFICIGWGVPFPIIVAWA,1
4k5y,A,270,289,19,IYQGPMALVLLINFIFLFN,1
4k5y,A,313,332,19,KATLVLLPLLGITYMLAFV,1
4k5y,A,347,366,19,NAFLESFQGFFVSVFACFL,1
3e89,E,26,45,19,LFVLTILTLISGTIFYSTV,1
3e89,E,75,96,21,GKIFTILYIFIGIGLVFGFIH,1
5dwk,B,34,48,14,GVAVLLCVVIAAWL,1
5dwk,B,53,67,14,TRVLLISSVMLVMI,1
5dwk,B,106,120,14,AIIDAVITWAILLW,1
1jgz,H,16,32,16,IYSFWIFLAGLIYYLQ,1
4bew,A,49,74,25,WELVIEQFEDLLVRILLLAACISFV,1
4bew,A,89,107,18,EPFVILLILIANAIVGVW,1
4bew,A,254,277,23,EFGEQLSKVISLICVAVWLINIG,1
4bew,A,296,317,21,KIAVALAVAAIPEGLPAVITT,1
4bew,A,760,781,21,IRYLISSNVGEVVCIFLTAAL,1
4bew,A,786,807,21,LIPVQLLWVNLVTDGLPATAL,1
4bew,A,832,852,20,LFFRYMAIGGYVGAATVGAA,1
4bew,A,898,916,18,MALSVLVTIEMCNALNSL,1
4bew,A,931,950,19,WLLGSICLSMSLHFLILYV,1
4bew,A,968,987,19,MVLKISLPVIGLDEILKFI,1
4ysz,D,56,78,22,TLFKIERYFAAAMVPLIPAAYF,1
4ysz,D,85,108,23,LCLALALTLHVHWGVWGVVNDYG,1
4ysz,D,117,139,22,AAAVRVGAYIFTACLLAGLLYF,1
1mmh,7,273,287,14,VLSHTNSVVNPFIY,1
5f5k,A,94,108,14,PVTWVMMIACVVVF,1
5f5k,A,149,166,17,HILFNLLWWWYLGGAVE,1
5f5k,A,171,188,17,GKLIVITLISALLSGYV,1
5f5k,A,200,214,14,SGVVFALMGYVWLR,1
5f5k,A,226,241,15,RGLIIFALIWIVAGW,1
5f5k,A,251,268,17,GAHIAGLAVGLAMAFVD,1
4pyp,A,14,36,22,AVGGAVLGSLQFGYNTGVINAP,1
4pyp,A,66,87,21,LSVAIFSVGGMIGSFSVGLFV,1
4pyp,A,93,113,20,NSMLMMNLLAFVSAVLMGFS,1
4pyp,A,121,141,20,LILGRFIIGVYCGLTTGFVP,1
4pyp,A,158,176,18,LHQLGIVVGILIAQVFGL,1
4pyp,A,187,207,20,LLLSIIFIPALLQCIVLPFC,1
4pyp,A,273,295,22,IAVVLQLSQQLSGINAVFYYST,1
4pyp,A,308,328,20,ATIGSGIVNTAFTVVSLFVV,1
4pyp,A,334,354,20,TLHLIGLAGMAGCAILMTIA,1
4pyp,A,367,389,22,SIVAIFGFVAFFEVGPGPIPWF,1
4pyp,A,405,426,21,VAGFSNWTSNFIVGMCFQYVE,1
4pyp,A,433,452,19,FIIFTVLLVLFFIFTYFKV,1
1z9j,C,16,32,16,IYSFWIFLAGLIYYLQ,1
1t78,A,27,47,20,FPLLYTVLFFVGLITNGLAM,1
1t78,A,63,80,17,KNTVISDLLMILTFPFK,1
1t78,A,102,121,19,IFYFTMYISISFLGLITID,1
1t78,A,145,157,12,VVIWAFMFLLSL,1
1t78,A,191,211,20,YICQVIFWINFLIVIVCYTL,1
1t78,A,238,258,20,FIIIAVFFICFVPFHFARIP,1
1t78,A,276,300,24,FYVKESTLWLTSLNACLDPFIYFF,1
4u14,A,67,87,20,VFIAFLTGFLALVTIIGNIL,1
4u14,A,109,129,20,ACADLIIGVISMNLFTTYII,1
4u14,A,139,159,20,CDLWLSIDYVASNASVMNLL,1
4u14,A,190,210,20,AWVISFVLWAPAILFWQYFV,1
4u14,A,221,245,24,IQFLSEPTITFGTAIAAFYMPVTI,1
4u14,A,496,516,20,LAFIITWTPYNIMVLVNTFC,1
4u14,A,520,542,22,PKTYWNLGYWLCYINSTVNPVC,1
1jh0,H,16,31,15,IYSFWIFLAGLIYYL,1
1z98,D,41,58,17,IAEFIATLLFLYITVAT,1
1z98,D,76,93,17,IAWAFGGMIFVLVYCTA,1
1z98,D,119,137,18,LVYMIAQCLGAICGVGLV,1
1z98,D,163,182,19,ALGAEIIGTFVLVYTVFSA,1
1z98,D,198,214,16,PLPIGFAVFMVHLATI,1
1z98,D,243,260,17,IFWVGPFIGAAVAAAYH,1
2h88,D,9,28,19,WTSERAVSALLLGLLPAAY,1
2h88,D,35,55,20,DYSLAAALTLHGHWGLGQVI,1
2h88,D,67,87,20,ANTGLYVLSAITFTGLCYFN,1
5dys,A,40,63,23,AAYMFLLIMLGFPINFLTLYVTV,1
5dys,A,74,95,21,ILLNLAVADLFMVFGGFTTIL,1
5dys,A,113,134,21,GFFATLGGEIALWSLVVLAIE,1
5dys,A,153,172,19,IMGVAFTWVMALACAAPPL,1
5dys,A,203,224,21,VIYMFVVHFIIPLIVIFFCYG,1
5dys,A,254,274,20,IIMVIAFLICWLPYAGVAFY,1
5dys,A,290,309,19,PAFFAKTSAVYNPVIYIMM,1
1t9v,C,11,25,14,AWVIAIIIMLAGGL,1
1t9v,C,342,357,15,TLVEAIILVFLVMYL,1
1t9v,C,366,382,16,IPTIAVPVVLLGTFAV,1
1t9v,C,398,411,13,VLAIGLLVDDAIV,1
1t9v,C,442,456,14,VGIAMVLSAVFVPM,1
1t9v,C,472,489,17,TIVSAMALSVLVALILT,1
1t9v,C,541,556,15,LVLYLIIVVGMAYLF,1
1t9v,C,877,891,14,AISLIVVFLCLAAL,1
1t9v,C,898,916,18,FSVMLVVPLGVIGALLAA,1
1t9v,C,930,943,13,LLTTIGLSAKNAI,1
1t9v,C,976,992,16,MTSLAFILGVMPLVIS,1
1t9v,C,1004,1021,17,TGVMGGMVTATVLAIFF,1
3iz2,F,19,45,26,IGKIWLTVLFIFRIMILVVAAKEVWG,1
3iz2,F,70,93,23,ISHIRLWALQLIFVSTPALLVAM,1
3iz2,F,135,158,23,YTSSIFFRVIFEAAFMYVFYVMY,1
3iz2,F,187,215,28,KTVFTVFMIAVSGICILLNVTELCYLLI,1
2cps,A,20,41,21,YIGYAWAMVVVIVGATIGIKL,1
1siw,F,5,28,23,MFFFDIYPYIAGAVFLIGSWLRY,1
1siw,F,48,72,24,NLASNLFHIGILGIFVGHFFGMLT,1
1siw,F,87,114,27,KMAMFAGGASGVLCLIGGVLLLKRRLF,1
1siw,F,125,145,20,DILILSLLVIQCALGLLTIP,1
1siw,F,183,204,21,FRLHLVLGMTLFLLFPFSRLI,1
2f93,D,29,39,10,GALTVLFGAI,1
2f93,D,65,79,14,GLIILLGINLGLVA,1
4ene,B,37,60,23,MAAVVGTLVGLAAVAFDKGVAWL,1
4ene,B,84,97,13,CSAVLAMFGYFLV,1
4ene,B,128,142,14,PVKFFGGLGTLGGG,1
4ene,B,144,156,12,LGREGPTVQIGG,1
4ene,B,216,232,16,AVFIGVIMSTIMYRIF,1
4ene,B,253,277,24,LYLILGIIFGIFGPIFNKWVLGMQ,1
4ene,B,290,304,14,WVLMGGAIGGLCGL,1
4ene,B,338,351,13,ARVITTLLCFSSG,1
4ene,B,353,368,15,GGIFAPMLALGTVLG,1
4ene,B,423,439,16,PMIITGLGATLLAQFT,1
1skh,A,7,24,17,SWILVLFVAMWSDVGLC,1
4izm,C,14,31,17,KILIGLILGAIVGLILG,1
4izm,C,39,67,28,HTYVKPFGDLFVRLLKMLVMPIVFASCV,1
4izm,C,79,107,28,RVGVKIVVYYLLTSAFAVTLGIIMARLF,1
4izm,C,128,140,12,PLVHILLDIVPT,1
4izm,C,151,161,10,LPTIFFAIIL,1
4izm,C,198,222,24,NGVMQYAPIGVFALIAYVMAEQGV,1
4izm,C,230,254,24,VTAAVYVGLTLQILLVYFVLLKIY,1
4izm,C,302,321,19,LPLGATINMDGTALYQGVA,1
4izm,C,390,412,22,AILDMGRTMVNVTGDLTGTAIV,1
1m56,D,32,49,17,TWAAVVIVAALIFLALA,1
5svq,C,29,47,18,VQLLIISYFVGWVFLHEK,1
5svq,C,316,343,27,NIIPTIISSVAAFTSVGVGTVLCDIIL,1
5sv0,A,23,49,26,KCVMIGLILASVVTWAIFFSKSVEFF,1
5sv0,A,128,149,21,GNGYLATIGAISPFVGLFGTV,1
5sv0,A,181,201,20,AIGLVAAIPAVVIYNVFARQ,1
2mka,B,104,130,26,PFELFFMINTSILLIFIFIVLLIHFE,1
3p4p,P,13,38,25,WGLFGAGGMWSAIIAPVMILLVGIL,1
3p4p,P,62,86,24,GRVFLFLMIVLPLWCGLHRMHHAM,1
3p4p,P,94,116,22,AGKWVFYGLAAILTVVTLIGVV,1
4pa3,F,132,152,20,SVAALLTVVFYIAAVMATNL,1
4pa3,F,195,218,23,WVFFIPFIMLTTFTVLNLFIGII,1
1jq2,D,97,112,15,AGITSFGLVTAALAT,1
5cgd,A,580,603,23,IAAVVFACLGLLATLFVTVVFII,1
5cgd,A,615,637,22,ELCYIILAGICLGYLCTFCLIA,1
5cgd,A,643,667,24,CYLQRIGIGLSPAMSYSALVTKTY,1
5cgd,A,692,715,23,QLVIAFILICIQLGIIVALFIME,1
5cgd,A,736,760,24,NLGVVAPLGYNGLLILACTFYAFK,1
5cgd,A,772,795,23,YIAFTMYTTCIIWLAFVPIYFGS,1
5cgd,A,799,823,24,ITMCFSVSLSATVALGCMFVPKVY,1
2htg,A,255,273,18,HILVFGESLLNDAVTVVL,1
2mkv,A,30,50,20,FAGLAFIVGLLILLSRRFRS,1
4il6,z,5,25,20,QLALAALVILSFVMVIGVPV,1
4il6,z,40,56,16,FLGSGLWIALVLVVGV,1
3g7f,M,54,71,17,GIAAFAFGSTAILIILF,1
3g7f,M,116,132,16,GLFMTLSLGSWWIRVY,1
3g7f,M,144,161,17,AWNFAAAIFFVLCIGCI,1
3g7f,M,199,218,19,LGFSIGFAYGCGLLFAAHG,1
3g7f,M,266,283,17,GWFFSLMVMVSASVGIL,1
3g6b,B,125,145,20,IMRIARETNILALNATIEAA,1
3g6b,B,152,173,21,GFMIVANEVQNLSNETNEVTK,1
2xq6,E,198,217,19,NIILPMLFILFISWTAFWS,1
2xq6,E,221,240,19,ANVTLVVSTLIAHIAFNIL,1
2xq6,E,255,274,19,AIIFMIYLFYFVAVIEVTV,1
2xq6,E,294,312,18,RIAFPVVFLLANIILAFL,1
4wfg,B,33,50,17,ALLALVLLYLVSGALVF,1
4wfg,B,142,162,20,RLFCIFYALVGIPLFGILLA,1
4wfg,B,203,220,17,IGCLLFVLTPTFVFCYM,1
4wfg,B,255,277,22,AYQPLVWFWILLGLAYFASVLT,1
1mxm,G,40,58,18,GLIIARMISNAVNRLMIS,1
1mxm,G,66,88,22,DFLSALVRYGIIAFTLIAALGR,1
1mxm,G,93,108,15,ASVIAVLGAAGLAVG,1
1ocr,Z,16,34,18,IGLSVTFLSFLLPAGWVL,1
1sqq,K,22,38,16,LWGAVGAVGLVWATDW,1
4rvy,z,8,25,17,LAALVILSFVMVIGVPV,1
4rvy,z,40,55,15,FLGSGLWIALVLVVG,1
3usm,B,14,35,21,ILAMAGNAVGLGNFLRFPVQA,1
3usm,B,42,63,21,FMIPYIIAFLLVGIPLMWIEW,1
3usm,B,89,124,35,AKILGVFGLWIPLVVAIYYVYIESWTLGFAIKFLV,1
3usm,B,167,185,18,AYIVFLITMFINVSILIR,1
3usm,B,191,214,23,ERFAKIAMPTLFILAVFLVIRVF,1
3usm,B,242,265,23,VWIAAVGQIFFTLSLGFGAIITY,1
3usm,B,278,298,20,GLTAATLNEKAEVILGGSIS,1
3usm,B,340,367,27,GFLWFFLLFFAGLTSSIAIMQPMIAFL,1
3usm,B,377,396,19,AVLWTAAIVFFSAHLVMFL,1
3usm,B,400,425,25,DEMDFWAGTIGVVFFGLTELIIFFW,1
3usm,B,445,472,27,RIYYYVMRYITPAFLAVLLVVWAREYI,1
3usm,B,484,502,18,ITRFYIIGLFLFLTFLVF,1
4kyt,B,28,48,20,QCLFINFCAILICLLLICII,1
2ki9,A,9,27,18,LVLAVLLICWFPVLALMA,1
4zwc,A,15,32,17,VATIGSFQFGYNTGVIN,1
4zwc,A,65,83,18,SVAIFSVGGMIGSFSVGL,1
4zwc,A,94,111,17,LIVNLLAVTGGCFMGLC,1
4zwc,A,119,139,20,LILGRLVIGLFCGLCTGFVP,1
4zwc,A,154,173,19,GTLNQLGIVVGILVAQIFG,1
4zwc,A,185,202,17,LLLGFTILPAILQSAAL,1
4zwc,A,271,290,19,ISIVLQLSQQLSGINAVFY,1
4zwc,A,308,326,18,IGAGVVNTIFTVVSLFLV,1
4zwc,A,332,350,18,TLHMIGLGGMAFCSTLMT,1
4zwc,A,367,389,22,GAILVFVAFFEIGPGPIPWFIV,1
4zwc,A,403,420,17,VAGCSNWTSNFLVGLLF,1
4zwc,A,431,450,19,FIIFTGFLITFLAFTFFKV,1
2iqk,C,43,66,23,MFLLIMLGFPINFLTLYVTVQHK,1
2iqk,C,69,94,25,TPLNYILLNLAVADLFMVFGGFTTT,1
2iqk,C,113,136,23,GFFATLGGEIALWSLVVLAIERY,1
2iqk,C,151,173,22,HAIMGVAFTWVMALACAAPPLV,1
2iqk,C,202,224,22,FVIYMFVVHFIIPLIVIFFCYG,1
2iqk,C,252,274,22,MVIIMVIAFLICWLPYAGVAFY,1
2iqk,C,288,310,22,TIPAFFAKTSAVYNPVIYIMMN,1
4hks,F,162,178,16,WTSALLSGFAMVAMVE,1
4hks,F,192,211,19,IAFAICTTLLVAVHMLALM,1
4hks,F,251,268,17,TLLGLILFLLEIAILCW,1
4hks,F,279,298,19,WSATVVLIPVMIIFMAFAI,1
3abk,Z,20,36,16,VTFLSFLLPAGWVLYH,1
4h1w,B,4,22,18,TRELCLNFTVVLITVILI,1
4oaa,A,11,28,17,FGLFFFFYFFIMGAYFP,1
4oaa,A,50,67,17,AISLFSLLFQPLFGLLS,1
4oaa,A,75,88,13,LLWIITGMLVMFA,1
4oaa,A,110,129,19,GIYLGFCFNAGAPAVEAFI,1
4oaa,A,142,156,14,ARMFGCVGWALCAS,1
4oaa,A,172,186,14,GSGCALILAVLLFF,1
4oaa,A,226,241,15,LYVIGVSCTYDVFDQ,1
4oaa,A,264,279,15,TTMGELLNASIMFFA,1
4oaa,A,292,309,17,LLAGTIMSVRIIGSSFA,1
4oaa,A,314,333,19,VVILKTLHMFEVPFLLVGC,1
4oaa,A,349,369,20,YLVCFCFFKQLAMIFMSVLA,1
4oaa,A,382,396,14,LVLGLVALGFTLIS,1
5unf,A,46,68,22,IPILYYIIFVIGFLVNIVVVTL,1
5unf,A,82,105,23,IFNLAVADLLLLATLPLWATYYS,1
5unf,A,111,140,29,FGPVMCKVFGSFLTLNMFASIFFITCMSV,1
5unf,A,163,183,20,VPLVWCMACLSSLPTFYFRD,1
5unf,A,207,233,26,SAGIALMKNILGFIIPLIFIATCYFG,1
5unf,A,256,281,25,MAAAVVLAFIICWLPFHVLTFLDAL,1
5unf,A,300,322,22,PFAILLGFTNSCVNPFLYCFVG,1
4qin,B,230,253,23,HSYIAAFGAVTGLCTLFTLATFV,1
4qin,B,266,287,21,LFYVNACFFVGSIGWLAQFMD,1
4qin,B,313,337,24,CVIIFVIVYYALMAGVVWFVVLTY,1
4qin,B,359,381,22,FHLLTWSLPFVLTVAILAVAQV,1
4qin,B,398,421,23,YRAGFVLAPIGLVLIVGGYFLIR,1
4qin,B,454,475,21,FGFLAFGFVLITFSCHFYDFF,1
4qin,B,515,537,22,LVEKINLFAMFGTGIAMSTWVW,1
2bmn,A,8,36,28,SPLKNLLAGGFGGVCLVFVGHPLDTVKV,1
2bmn,A,72,101,29,RGMAAPIIGVTPMFAVCFFGFGLGKRLQQ,1
2bmn,A,112,136,24,LFTAGMLSGVFTTGIMTPGERIKC,1
2bmn,A,169,194,25,KGTALTLMRDVPASGMYFMTYEWLK,1
2bmn,A,206,231,25,LSVPRVLVAGGFRGIFNWVVAIPPD,1
2bmn,A,263,289,26,SLYKGFNAVMIRAFPANAACFLGFEI,1
4hfc,E,199,218,19,NIILPMLFILFISWTAFWS,1
4hfc,E,222,240,18,ANVTLVVSTLIAHIAANI,1
4hfc,E,256,275,19,AIIFMIYLFYFVAVIEVTV,1
4hfc,E,292,313,21,RASRIAFPVVFLLANIILAFL,1
4x5t,E,225,239,14,QMYIPSLLIVILSW,1
4x5t,E,254,270,16,LGITTVLTMTTQSSGS,1
4x5t,E,284,302,18,IWMAVCLLFVFSALLEYA,1
4x5t,E,392,409,17,IGFPMAFLIFNMFYWII,1
3spg,D,78,104,26,WRYMLLLFSLAFLVSWLLFGLIFWLI,1
3spg,D,156,184,28,LAVFMVVVQSIVGCIIDSFMIGAIMAKM,1
3h1i,W,20,43,23,ALTVVLGAVLFERAFDQGADAIF,1
1pln,E,40,49,9,CLLLICIIV,1
3t51,I,15,33,18,VLMGALFLSIWGTWTIIN,1
3t51,I,339,355,16,GKLLEEFIVVAVVCAL,1
3t51,I,364,384,20,VAIISLPLGLCIAFIVMHFQ,1
3t51,I,393,409,16,GGIAIAVGAMVDAAIV,1
3t51,I,451,466,15,ISLLIITLSFIPIFT,1
3t51,I,477,497,20,LAFTKTYAMAGAALLAIVVI,1
3t51,I,540,555,15,LVAALSVLTVLWPLN,1
3t51,I,873,890,17,LMVPMTLMIIFVLLYLA,1
3t51,I,897,919,22,LLIISSVPFALVGGIWLLWWMG,1
3t51,I,926,943,17,GTGFIALAGVAAEFGVV,1
3t51,I,985,1001,16,MTVAVIIAGLLPILWG,1
3t51,I,1010,1028,18,RIAAPMIGGMITAPLLSL,1
3t45,C,10,29,19,IWLALGTALMGLGTLYFLV,1
3t45,C,46,62,16,TLVPAIAFTMYLSMLL,1
3t45,C,80,94,14,ARYADWLFTTPLLL,1
3t45,C,110,127,17,LVGADGIMIGTGLVGAL,1
3t45,C,134,150,16,FVWWAISTAAMLYILY,1
3t45,C,177,192,15,TVVLWSAYPVVWLIG,1
3t45,C,203,221,18,ETLLFMVLDVSTKVGFGL,1
2ksa,A,34,58,24,WAAAYTVIVVTSVVGNVVVMWIIL,1
2ksa,A,70,93,23,LVNLAFAEASMAAFNTVVNFTYA,1
2ksa,A,104,127,23,CKFHNFFPIAAVFASIYSMTAVA,1
2ksa,A,149,174,25,VICVIWVLALLLAFPQGYYSTTETM,1
2ksa,A,192,217,25,EKVYHICVTVLIYFLPLLVIGYAYT,1
2ksa,A,250,274,24,IVVVCTFAICWLPFHIFFLLPYIN,1
2ksa,A,286,308,22,YLAIMWLAMSSTMYNPIIYCCL,1
2ux4,M,53,72,19,SLGVLSLFSGLMWFFTIGI,1
2ux4,M,118,135,17,SFFMFVAVWSWWGRTYL,1
2ux4,M,145,163,18,TAWAFLSAIWLWMVLGFI,1
2ux4,M,201,221,20,HGLSIAFLYGSALLFAMHGA,1
2ux4,M,267,285,18,WAIWMAVLVTLTGGIGIL,1
3s3a,C,5,25,20,KGALAVILVLTLTILVFWLG,1
4mm6,A,16,35,19,AMAGYAVDLGNFLRFPVQA,1
4mm6,A,39,60,21,GGAFMIPYIIAFLLVGIPLMW,1
4mm6,A,93,120,27,GVFGLWIPLVVASYYVYIESWTLGFAI,1
4mm6,A,168,185,17,YIVFLITMFINVSILIR,1
4mm6,A,191,212,21,ERFAKIAMPTLFILAVFLVIR,1
4mm6,A,239,265,26,DPGVWIAAVGQIFFSLGLGFGVLITF,1
4mm6,A,280,298,18,TAATLNEKASVILGGSIS,1
4mm6,A,343,364,21,WFFLLFFAGLTSSIAGMQGMI,1
4mm6,A,378,396,18,VLWTAAIVFFSAHLVMFL,1
4mm6,A,400,421,21,DEMDFWATGIGVVFFGLTELI,1
4mm6,A,451,473,22,MRYITPAFLAVLLVVWAREYIP,1
4mm6,A,484,500,16,ITRFYIIGLFLFLTFL,1
2gfz,A,39,64,25,VLLAEYLIGIIANGFIMAIHAAEWV,1
2gfz,A,72,95,23,GRILVFLSVSRIALQSLMMLEIT,1
2gfz,A,116,138,22,FIFLNFCSLWFAAWLSFFYFVK,1
2gfz,A,156,176,20,LIPWLLWLSVFISFSHSMFC,1
2gfz,A,208,230,22,LAFFFNLGIVTPLIMFILTATL,1
2gfz,A,259,279,20,AIKAISYFLILYIFNAVALF,1
2gfz,A,293,314,21,NLCQIIMAAYPASHSILLIQD,1
2ik3,_,49,77,28,QVVLILAYCSIILLGVIGNSLVIHVVIK,1
2ik3,_,85,108,23,NFFIANLAVADLLVNTLCLPFTL,1
2ik3,_,125,147,22,VPYAQGLAVQVSTITLTVIALD,1
2ik3,_,164,184,20,SFLIIGLAWGISALLASPLA,1
2ik3,_,219,240,21,SLSSLLILYVLPLGIISFSYT,1
2ik3,_,269,290,21,LVCVVVVFAVSWLPLHAFQLA,1
2ik3,_,308,328,20,VFHIIAMCSTFANPLLYGWM,1
5kpd,A,35,68,33,LTMFRYAGWLDRLYMLVGTLAAIIHGVALPLMM,1
5kpd,A,118,139,21,AGVLIVAYIQVSFWCLAAGRQ,1
5kpd,A,180,204,24,GIGDKIGMFFQAMATFFGGFIIGF,1
5kpd,A,211,231,20,LVILAISPVLGLSAGIWAKI,1
5kpd,A,290,311,21,ANISMGAAFLLIYASYALAFW,1
5kpd,A,331,352,21,FSVLIGAFSVGQASPNIEAFA,1
5kpd,A,706,728,22,FVVGIFCAIINGGLQPAFSVIF,1
5kpd,A,752,773,21,LLFLILGIISFITFFLQGFTF,1
5kpd,A,827,847,20,RLAVIFQNIANLGTGIIISL,1
5kpd,A,855,879,24,LLLAIVPIIAIAGVVEMKMLSGQA,1
5kpd,A,926,949,23,AMKKAHVFGITFSFTQAMMYFSY,1
5kpd,A,973,994,21,FSAIVFGAMAVGQVSSFAPDY,1
4hqj,E,30,47,17,LIFAALAFIVGLIILLS,1
4oyg,C,15,32,17,ILIGLILGAIVGLILGH,1
4oyg,C,36,63,27,HAVHTYVKPFGDLFVRLLKMLVMPIVF,1
4oyg,C,83,108,25,KIVVYYLLTSAFAVTLGIIMARLFN,1
4oyg,C,128,158,30,PLVHILLDIVPTNPFGALANGQVLPTIFFA,1
4oyg,C,202,222,20,QYAPIGVFALIAYVMAEQGV,1
4oyg,C,230,250,20,VTAAVYVGLTLQILLVYFVL,1
4oyg,C,302,321,19,LPLGATINMDGTALYQGVC,1
4oyg,C,339,355,16,TIVLTAVLASIGTAGV,1
4oyg,C,390,408,18,AILDMGATMVNVTGDLTG,1
3j09,B,100,121,21,KLYVAAFAGVLLLFLAHFISL,1
3j09,B,130,150,20,IALPAIFYSGSSIFKAAFSA,1
3j09,B,164,183,19,GVGAAFLASVLSTAGVLPR,1
3j09,B,185,206,21,SFYETSVLLLAFLLLGRTLEA,1
3j09,B,335,357,22,DKVVAYFIPTVLLVAISAFIYW,1
3j09,B,368,387,19,FTTLIAVLVVACPCAFGLA,1
3j09,B,674,695,21,NIFWALIYNVILIPAAAGLLY,1
3j09,B,701,722,21,FRPEFAGLAMAMSSVSVVANS,1
1l0l,K,22,39,17,LWGAVGAVGLVWATDWR,1
1pv6,A,8,32,24,FWMFGLFFFFYFFIMGAYFPFFPI,1
1pv6,A,46,67,21,IIFAAISLFSLLFQPLFGLLS,1
1pv6,A,74,91,17,YLLWIITGMLVMFAPFF,1
1pv6,A,106,130,24,SIVGGIYLGFCFNAGAPAVEAFIE,1
1pv6,A,141,161,20,RARMFGCVGWALGASIVGIM,1
1pv6,A,169,188,19,FWLGSGCALILAVLLFFAK,1
1pv6,A,223,245,22,FLSLYVIGVSCTYDVFDQQFAN,1
1pv6,A,260,279,19,FGYVTTMGELLNASIMFFA,1
1pv6,A,289,309,20,NALLLAGTIMSVRIIGSSFA,1
1pv6,A,314,334,20,VVILKTLHMFEVPFLLVGCF,1
1pv6,A,350,370,20,LVCFCFFKQLAMIFMSVLAG,1
1pv6,A,382,400,18,LVLGLVALGFTLISVFTL,1
3dhl,A,5,23,18,ISTIGDLVKWIIDTVNKF,1
2na6,C,169,188,19,LWLLTILVLLIPLVFIYRK,1
2na7,C,178,193,15,LLLLPIPLIVWVKRK,1
1pv7,A,8,31,23,FWMFGLFFFFYFFIMGAYFPFFP,1
1pv7,A,46,67,21,IIFAAISLFSLLFQPLFGLLS,1
1pv7,A,74,88,14,YLLWIITGMLVMFA,1
1pv7,A,109,129,20,GGIYLGFCFNAGAPAVEAFI,1
1pv7,A,143,159,16,RMFGCVGWALGASIVG,1
1pv7,A,171,188,17,LGSGCALILAVLLFFAK,1
1pv7,A,224,244,20,LSLYVIGVSCTYDVFDQQFA,1
1pv7,A,261,279,18,GYVTTMGELLNASIMFFA,1
1pv7,A,291,309,18,LLLAGTIMSVRIIGSSFA,1
1pv7,A,314,333,19,VVILKTLHMFEVPFLLVGC,1
1pv7,A,351,370,19,VCFCFFKQLAMIFMSVLAG,1
1pv7,A,382,399,17,LVLGLVALGFTLISVFT,1
2y69,Z,17,35,18,GLSVTFLSFLLPAGWVLY,1
4cof,E,226,242,16,MPSILITILSWVSFWI,1
4cof,E,247,265,18,AARVALGITTVLTMTTIN,1
4cof,E,284,303,19,LMGCFVFVFLALLEYAFVN,1
4cof,E,424,445,21,RWSRIVFPFTFSLFNLVYWLY,1
3m7l,C,10,27,17,TGYFGIPLGLAALSLAW,1
3m7l,C,41,64,23,DVLGIVASAVWILFILMYAYKLR,1
3m7l,C,81,97,16,FIALIPITTMLVGDIL,1
3m7l,C,105,128,23,EVLIWIGTIGQLLFSTLRVSELW,1
3m7l,C,140,157,17,SFYLPAVAANFTSASSL,1
3m7l,C,166,186,20,YLFFGAGMIAWIIFEPVLLQ,1
3m7l,C,200,215,15,MGIVLAPAFVCVSAY,1
3m7l,C,227,246,19,KILWGYGFLQLFFLLRLFP,1
3m7l,C,254,271,17,IGLWAFSFGLASMANSA,1
3m7l,C,284,309,25,IFAFVFSNVMIGLLVLMTIYKLTKG,1
1k4c,L,25,50,25,WRAAGAATVLLVIVLLAGSYLAVLA,1
1k4c,L,87,114,27,GRCVAVVVMVAGITSFGLVTAALATWF,1
2n7q,A,5,22,17,ELITLTVGFGILIFSLI,1
3j08,B,102,123,21,YVAAFAGVLLLFLAHFISLPY,1
3j08,B,128,146,18,LLIALPAIFYSGSSIFKA,1
3j08,B,164,182,18,GVGAAFLASVLSTAGVLP,1
3j08,B,188,205,17,ETSVLLLAFLLLGRTLE,1
3j08,B,335,356,21,DKVVAYFIPTVLLVAISAFIY,1
3j08,B,367,391,24,AFTTLIAVLVVACPCAFGLATPTA,1
3j08,B,669,694,25,SKIKQNIFWALIYNVILIPAAAGLL,1
3j08,B,701,729,28,FRPEFAGLAMAMSSVSVVANSLLLRNYV,1
4oyf,C,14,31,17,KILIGLILGAIVGLILG,1
4oyf,C,39,63,24,HTYVKPFGDLFVRLLKMLVMPIVF,1
4oyf,C,83,107,24,KIVVYYLLTSAFAVTLGIIMARLF,1
4oyf,C,131,140,9,HILLDIVPT,1
4oyf,C,151,160,9,LPTIFFAII,1
4oyf,C,202,221,19,QYAPIGVFALIAYVMAEQG,1
4oyf,C,230,250,20,VTAAVYVGLTLQILLVYFVL,1
4oyf,C,302,320,18,LPLGATINMDGTALYQGV,1
4oyf,C,339,352,13,TIVLTAVLASIGT,1
4oyf,C,390,409,19,AILDMGRTMVNVTGDLTGT,1
1r84,A,9,32,23,WIWLALGTALMGLGTLYFLVKGM,1
1r84,A,42,66,24,YAITTLVPAIAFTMYLSMLLGYGL,1
1r84,A,79,99,20,WARYADWLFTTPLLLLDLAL,1
1r84,A,104,127,23,QGTILALVGADGIMIGTGLVGAL,1
1r84,A,134,157,23,FVWWAISTAAMLYILYVLFFGFT,1
1r84,A,172,195,23,VLRNVTVVLWSAYPVVWLIGSEG,1
1r84,A,199,225,26,PLNIETLLFMVLDVSAKVGFGLILLR,1
1wpg,A,58,74,16,DLLVRILLLAACISFV,1
1wpg,A,89,110,21,EPFVILLILIANAIVGVWQER,1
1wpg,A,254,275,21,EFGEQLSKVISLICVAVWLIN,1
1wpg,A,296,318,22,KIAVALAVAAIPEGLPAVITTC,1
1wpg,A,760,781,21,IRYLISSNVGEVVCIFLTAAL,1
1wpg,A,786,809,23,LIPVQLLWVNLVTDGLPATALGF,1
1wpg,A,830,852,22,GWLFFRYMAIGGYVGAATVGAA,1
1wpg,A,898,916,18,MALSVLVTIEMCNALNSL,1
1wpg,A,927,950,23,WVNIWLLGSICLSMSLHFLILYV,1
1wpg,A,965,987,22,QWLMVLKISLPVIGLDEILKFI,1
1e6d,H,16,32,16,IYSFWIFLAGLIYYLQ,1
4xtl,A,29,52,23,HILTLGYAVMLAGLLYFILTIKN,1
4xtl,A,59,81,22,SNILSAVVMVSAFLLLYAQAQN,1
4xtl,A,106,125,19,GYRYLNWLIDVPMLLFQIL,1
4xtl,A,139,160,21,NQFWFSGAMMIITGYIGQFYE,1
4xtl,A,164,189,25,TAFLVWGAISSAFFFHILWVMKKVI,1
4xtl,A,203,228,25,LSNIWILFLISWTLYPGAYLMPYLT,1
4xtl,A,240,265,25,MARQLVYTIADVSSKVIYGVLLGNL,1
1iwg,C,12,27,15,WVIAIIIMLAGGLAI,1
1iwg,C,341,356,15,KTLVEAIILVFLVMY,1
1iwg,C,367,386,19,PTIAVPVVLLGTFAVLAAF,1
1iwg,C,395,410,15,FGMVLAIGLLVDDAI,1
1iwg,C,443,458,15,GIAMVLSAVFVPMAF,1
1iwg,C,469,489,20,FSITIVSAMALSVLVALILT,1
1iwg,C,543,557,14,LYLIIVVGMAYLFV,1
1iwg,C,874,890,16,SLYAISLIVVFLCLAA,1
1iwg,C,899,919,20,SVMLVVPLGVIGALLAATFR,1
1iwg,C,927,943,16,QVGLLTTIGLSAKNAI,1
1iwg,C,976,993,17,MTSLAFILGVMPLVIST,1
1iwg,C,1001,1018,17,AVGTGVMGGMVTATVLA,1
4mm7,A,13,31,18,LILAMAGYAVDLGNFLRF,1
4mm7,A,45,63,18,PYIIAFLLVGIPLMWIEW,1
4mm7,A,93,120,27,GVFGLWIPLVVASYYVYIESWTLGFAI,1
4mm7,A,167,184,17,AYIVFLITMFINVSILI,1
4mm7,A,191,211,20,ERFAKIAMPTLFILAVFLVI,1
4mm7,A,245,265,20,AAVGQIFFSLGLGFGVLITF,1
4mm7,A,277,295,18,SGLTAATLNEKASVILGG,1
4mm7,A,343,364,21,WFFLLFFAGLTSSIAGMQGMI,1
4mm7,A,380,396,16,WTAAIVFFSAHLVMFL,1
4mm7,A,400,425,25,DEMDFWATGIGVVFFGLTELIIFFW,1
4mm7,A,445,469,24,RIYYYVMRYITPAFLAVLLVVWAR,1
4mm7,A,484,499,15,ITRFYIIGLFLFLTF,1
2iil,_,44,68,24,LAYGAVIILGVSGNLALIIIILKQ,1
2iil,_,72,98,26,NVTNILIVNLSFSDLLVAIMCLPFTF,1
2iil,_,115,139,24,NPFVQCVSITVSIFSLVLIAVERH,1
2iil,_,153,174,21,HAYVGIAVIWVLAVASSLPFL,1
2iil,_,211,235,24,TTLLLVLQYFGPLCFIFICYFKIY,1
2iil,_,262,286,24,IMLLSIVVAFAVCWLPLTIFNTVF,1
2iil,_,302,324,22,LLCHLTAMISTCVNPIFYGFLN,1
2ux5,M,55,72,17,GVLSLFSGLMWFFTIGI,1
2ux5,M,117,134,17,ASFFMFVAVWSWWGRTY,1
2ux5,M,147,164,17,WAFLSAIWLWMVLGFIR,1
2ux5,M,200,221,21,FHGLSIAFLYGSALLFAMHGA,1
2ux5,M,269,286,17,IWMAVLVTLTGGIGILL,1
2g1x,A,48,66,18,KVLLVMLLALITLATTLS,1
2g1x,A,91,111,20,AVTDLLVSILVMPISTMYTV,1
2g1x,A,120,142,22,VCDFWLSSDITCCTASILHLCV,1
2g1x,A,171,193,22,LVWVFSISISLPPFFWRQAKAE,1
2g1x,A,205,229,24,ILYTVYSTVGAFYFPTLLLIALYG,1
2g1x,A,318,336,18,ILGAFIVCWLPFFIISLV,1
2g1x,A,352,368,16,FFTWLGYLNSLINPII,1
5iji,B,16,38,22,YIVLLSILSTGIALLTLASSLR,1
5iji,B,143,166,23,ERKMLLVVAISLAGGIGIFTLVF,1
4m8j,C,16,29,13,PPLIIVGILCWLT,1
4m8j,C,47,64,17,TNVWGWAFEWYMVIMFG,1
4m8j,C,97,109,12,SCTSAAVLFWGS,1
4m8j,C,134,150,16,LAYSLFHWGPLPWATY,1
4m8j,C,195,216,21,YLVALILAMGTSLGLATPLVT,1
4m8j,C,233,246,13,IIISCWILLNAIC,1
4m8j,C,259,278,19,DVETYLSFLMLGWVFIVGG,1
4m8j,C,280,293,13,FIVNYFTDSVGTL,1
4m8j,C,295,304,9,YMPRMLFYT,1
4m8j,C,314,328,14,AWTVFYWAWWVIYA,1
4m8j,C,353,369,16,GLTAGTWLIWTILGGN,1
4m8j,C,407,427,20,MWGFFILCFIATVTLINACS,1
4m8j,C,448,464,16,RIGWSVLVGIIGIILL,1
4m8j,C,472,487,15,QTAIIAGGCPLFFVN,1
3s3w,C,50,71,21,FMGSLALLALVCTNRIQYYFL,1
3s3w,C,426,447,21,VAGLLGDIGGQMGLFIGASIL,1
4mma,A,16,35,19,AMAGYAVDLGNFLRFPVQA,1
4mma,A,39,62,23,GGAFMIPYIIAFLLVGIPLMWIE,1
4mma,A,89,120,31,AKILGVFGLWIPLVVASYYVYIESWTLGFAI,1
4mma,A,168,185,17,YIVFLITMFINVSILIR,1
4mma,A,191,215,24,ERFAKIAMPTLFILAVFLVIRVFL,1
4mma,A,242,265,23,VWIAAVGQIFFSLGLGFGVLITF,1
4mma,A,280,298,18,TAATLNEKASVILGGSIS,1
4mma,A,340,367,27,GFLWFFLLFFAGLTSSIAGMQGMIAFL,1
4mma,A,377,394,17,AVLWTAAIVFFSAHLVM,1
4mma,A,401,422,21,EMDFWATGIGVVFFGLTELII,1
4mma,A,451,469,18,MRYITPAFLAVLLVVWAR,1
4mma,A,487,503,16,FYIIGLFLFLTFLVFL,1
5l47,E,199,216,17,NIILPMLFILFISWTAF,1
5l47,E,224,242,18,VTLVVSTLIAHIAFNILV,1
5l47,E,255,274,19,GAIIFMIYLFYFVAVIEVT,1
5l47,E,295,313,18,RIAFPVVFLLANIILAFL,1
2lat,A,6,29,23,LAIFANMLGVSLFLLVVLYHYVA,1
2lck,A,14,35,21,VKFLGAGTAACIADLITFPLD,1
2lck,A,83,111,28,AGLQRQMSFASVRIGLYDSVKQFYTKGS,1
2lck,A,115,139,24,IGSRLLAGSTTGALAVAVAQPTDV,1
2lck,A,179,201,22,SPNVARNAIVNCAELVTYDLIK,1
2lck,A,219,242,23,SAFGAGFCTTVIASPVDVVKTRY,1
2lck,A,271,299,28,GFMPSFLRLGSWNVVMFVTYEQLKRALM,1
4o7g,B,14,35,21,VRVLGFIIAALVLTWTVHYRG,1
4o7g,B,45,66,21,HIFNVHPVMMVIGLILFNGEA,1
4o7g,B,87,107,20,QLTAFILSLIGVWAALKFHI,1
4o7g,B,113,134,21,FYSLHSWLGLACLFLFAFQWA,1
4o7g,B,161,184,23,ISIYALALVTATTGILEKVTFLQ,1
4o7g,B,192,213,21,STEAMLVNTMGVLILILGGFV,1
3h1h,W,19,39,20,FALTVVLGAVLFERAFDQGA,1
1kzu,S,19,37,18,RVFLGLALVAHFLAFSAT,1
4hfb,E,203,218,15,PMLFILFISWTAFWS,1
4hfb,E,222,238,16,ANVTLVVSTLIAHIAA,1
4hfb,E,259,275,16,FMIYLFYFVAVIEVTV,1
4hfb,E,292,310,18,RASRIAFPVVFLLANIIL,1
4he8,C,14,31,17,LKALLVVVGLLTAFAFM,1
4he8,C,88,102,14,SVVFALLAFGLIPF,1
4he8,C,121,135,14,ILYLFAVSELAVYG,1
4he8,C,160,174,14,SYELGLGLALLAPV,1
4he8,C,195,213,18,FLYAFPAFLVYLIASMAE,1
4he8,C,248,267,19,YIHFITASALIPTLFLGGW,1
4he8,C,277,290,13,WMFLKIAFFLFFF,1
4he8,C,310,325,15,GFLFPLALLWFLVTA,1
4he8,C,338,354,16,YLSALSFLVLLGAVLY,1
1yg7,A,30,50,20,AFGSAFQYGYNLSVVNTPHK,1
1yg7,A,89,107,18,SCTVSMFPLGGLLGSLLV,1
1yg7,A,118,137,19,TLLINNIFAIIPAILMGVS,1
1yg7,A,145,164,19,IVFSRVVLGVCAGISYSAL,1
1yg7,A,182,202,20,MTEVFVIVGVFLAQIFSLQA,1
1yg7,A,212,230,18,LLALTGVPALLQLLTLPF,1
1yg7,A,290,313,23,SLRWQLLSIIVLMAGQQLSGINA,1
1yg7,A,330,354,24,HSQYVTVGSGVVNIVMTITSAVLV,1
1yg7,A,362,381,19,LLAGYGICGSACLVLTVVL,1
1yg7,A,390,411,21,SYLGIICVFAYIAGHSIGPSP,1
1yg7,A,428,446,18,AFMVDGAVHWLTNFIIGF,1
1yg7,A,460,480,20,IIFAGICLLTAIYIYVVIPE,1
5ul9,B,23,35,12,IVLADVALFLAL,1
5ul9,B,51,64,13,LAFIAVLWLTEAL,1
5ul9,B,66,77,11,TVTAILVPVMA,1
5ul9,B,89,106,17,NNFANSIIFLFLGGFAL,1
5ul9,B,192,211,19,GIATLVGSPPNAIAAAEVG,1
5ul9,B,212,228,16,SFTDWMKFGLPTAMMM,1
5ul9,B,267,281,14,FGLTVFLWIFSSPI,1
5ul9,B,291,306,15,DTLVALGAILMLSFA,1
5ul9,B,319,333,14,WGVLLLFGGGLCLS,1
5ul9,B,360,376,16,VILVVATFVVFLTEFA,1
5ul9,B,378,389,11,TASAALLIPVF,1
5ul9,B,402,414,12,LSVLIAVAASCA,1
5ul9,B,447,460,13,ACIGLLTAIAMLF,1
5ung,B,45,68,23,AIPILYYIIFVIGFLVNIVVVTL,1
5ung,B,83,105,22,FNLAVADLLLLATLPLWATYYS,1
5ung,B,111,140,29,FGPVMCKVFGSFLTLNMFASIFFITCMSV,1
5ung,B,163,183,20,VPLVWCMACLSSLPTFYFRD,1
5ung,B,207,232,25,SAGIALMKNILGFIIPLIFIATCYF,1
5ung,B,257,281,24,AAAVVLAFIICWLPFHVLTFLDAL,1
5ung,B,296,321,25,DLALPFAILLGFTNSCVNPFLYCFV,1
2l6w,A,10,32,22,ISAILALVVLTIISLIILIMLW,1
1upe,A,9,32,23,ITVELAIAVLAILGNVLVCWAVW,1
1upe,A,44,64,20,VVSLAAADIAVGVLAIPFAI,1
1upe,A,79,99,20,IACFVLVLTQSSIFSLLAIA,1
1upe,A,123,141,18,IIAICWVLSFAIGLTPML,1
1upe,A,176,195,19,MVYFNFFACVLVPLLLMLG,1
1upe,A,235,255,20,AIIVGLFALCWLPLHIINCF,1
1upe,A,270,290,20,YLAIVLSHTNSVVNPFIYAY,1
2gsm,B,61,80,19,LVIIAAITIFVTLLILYAV,1
2gsm,B,100,117,17,EIAWTIVPIVILVAIGA,1
2lnl,A,43,67,24,IAYALVFLLSLLGNSLVMLVILYS,1
2lnl,A,71,97,26,SVTDVYLLNLALADLLFALTLPIWAA,1
2lnl,A,107,133,26,FLCKVVSLLKEVNFYSGILLLACISV,1
2lnl,A,151,178,27,LVKFVCLGCWGLSMNLSLPFFLFRQAY,1
2lnl,A,185,221,36,VCYEVLGNDTAKWRMVLRILPHTFGFIVPLFVMLFC,1
2lnl,A,242,268,26,VIFAVVLIFLLCWLPYNLVLLADTLM,1
2lnl,A,281,303,22,NIGRALDATEILGFLHSCLNPI,1
2b6o,K,14,31,17,AEFFATLFYVFFGLGAS,1
2b6o,K,42,60,18,QVALAFGLALATLVQAVG,1
2b6o,K,87,107,20,CYVVAQLLGAVAGAAVLYSV,1
2b6o,K,128,148,20,QATIVEIFLTLQFVLCIFAT,1
2b6o,K,159,176,17,VALAVGFSLTLGHLFGM,1
2b6o,K,202,219,17,VYWVGPVIGAGLGSLLY,1
4xnu,A,38,54,16,SVIGFAVDLANVWRFP,1
4xnu,A,64,81,17,FLVPYGIMLAVGGIPLF,1
4xnu,A,113,132,19,VLIAFYVDFYYNVIIAWSL,1
4xnu,A,240,255,15,LCLLIVYLICYFSLW,1
4xnu,A,261,278,17,GKVVWFTALFPYAALLI,1
4xnu,A,302,328,26,AIYKAEVWADAATQVFFSLGPGFGVL,1
4xnu,A,346,361,15,LTSFINSATSFIAGF,1
4xnu,A,410,429,19,FMMLATLGLDSSFGGSEAI,1
4xnu,A,448,463,15,AGLFSLYFVVGLASC,1
4xnu,A,471,488,17,HLLDRYAAGYSILVAVF,1
4xnu,A,527,545,18,PIFLLFITVYLLIGYEPL,1
4xnu,A,555,570,15,ANALGWCIAGSSVVM,1
2nwl,C,15,29,14,ILIGLILGAIVGLI,1
2nwl,C,43,63,20,KPFGDLFVRLLKMLVMPIVF,1
2nwl,C,83,103,20,KIVVYYLLTSAFAVTLGIIM,1
2nwl,C,131,140,9,HILLDIVPT,1
2nwl,C,151,158,7,LPTIFFA,1
2nwl,C,202,217,15,QYAPIGVFALIAYVM,1
2nwl,C,234,250,16,VYVGLTLQILLVYFVL,1
2nwl,C,302,317,15,LPLGATINMDGTALY,1
2nwl,C,392,408,16,LDMGRTMVNVTGDLTG,1
2ntw,C,10,32,22,IWLALGTALMGLGTLYFLVKGM,1
2ntw,C,41,62,21,FYAITTLVPAIAFTMYLSMLL,1
2ntw,C,80,99,19,ARYADWLFTTPLLLLDLAL,1
2ntw,C,106,127,21,TILALVGADGIMIGTGLVGAL,1
2ntw,C,134,155,21,FVWWAISTAAMLYILYVLFFG,1
2ntw,C,171,192,21,KVLRNVTVVLWSAYPVVWLIG,1
2ntw,C,203,225,22,ETLLFMVLDVSAKVGFGLILLR,1
4hkr,F,161,176,15,SKTSALLSGFAMVAM,1
4hkr,F,195,212,17,AICTTLLVAVHMLALMI,1
4hkr,F,248,266,18,AFSTLLGLILFLLEIAIL,1
4hkr,F,282,302,20,TVVLIPVMIIFMAFAIHFYR,1
1pb2,A,45,68,23,LLYSLIFLLSVLGNTLVITVLIR,1
1pb2,A,76,97,21,NIFLLSLAVSDLMLCLFCMPF,1
1pb2,A,113,139,26,CKTTTYFMGTSVSVSTFNLVAISLER,1
1pb2,A,159,182,23,KVIAATWCLSFTIMTPYPIYSNL,1
1pb2,A,209,233,24,HTFLLLILFLIPGIVMMVAYGLIS,1
1pb2,A,252,275,23,IRMLIVIVVLFFLCWMPIFSANA,1
1pb2,A,295,315,20,ILLLSYTSSCVNPIIYCFMN,1
2loh,B,18,41,23,IIGLMVGGVVIATVIVITLVMLK,1
4jre,A,40,59,19,SVPCLLLAFCVWMLFSAVA,1
4jre,A,76,92,16,LTALPSVSGALLRVPY,1
4jre,A,105,121,16,AFSTGILIIPCVWLGF,1
4jre,A,132,150,18,FIIISLLCGFAGANFASS,1
4jre,A,170,188,18,GGLGNMGVSVMQLVAPLV,1
4jre,A,214,231,17,ASWIWVPFLAIFTIAAW,1
4jre,A,258,280,22,MSLLYLATFGSFIGFSAGFAML,1
4jre,A,292,309,17,YAFFGPFIGALARSAGG,1
4jre,A,320,337,17,TLVNFILMAIFSGLLFL,1
4jre,A,350,370,20,FFAVFLALFLTAGLGSGSTF,1
4jre,A,409,428,19,ISAIGAIGGFFIPKAFGSS,1
4jre,A,437,455,18,AMKVFLIFYIACVVITWA,1
4zwb,A,12,33,21,AITVATIGSFQFGYNTGVINA,1
4zwb,A,65,85,20,SVAIFSVGGMIGSFSVGLFV,1
4zwb,A,92,111,19,SMLIVNLLAVTGGCFMGLC,1
4zwb,A,119,142,23,LILGRLVIGLFCGLCTGFVPMYI,1
4zwb,A,154,174,20,GTLNQLGIVVGILVAQIFGL,1
4zwb,A,186,203,17,LLGFTILPAILQSAALP,1
4zwb,A,271,292,21,ISIVLQLSQQLSGINAVFYYS,1
4zwb,A,307,326,19,TIGAGVVNTIFTVVSLFLV,1
4zwb,A,332,352,20,TLHMIGLGGMAFCSTLMTVS,1
4zwb,A,365,389,24,CIGAILVFVAFFEIGPGPIPWFIV,1
4zwb,A,401,424,23,MAVAGCSNWTSNFLVGLLFPSAA,1
4zwb,A,430,448,18,VFIIFTGFLITFLAFTFF,1
3v5s,A,8,27,19,FLLGLILLYYGSDWFVLGS,1
3v5s,A,41,58,17,GATVMAIGTSLPEILTS,1
3v5s,A,74,93,19,IGSCICNIGLVLGLSAIIS,1
3v5s,A,105,119,14,LVYLLFVIFAAVIG,1
3v5s,A,127,143,16,GVVLLILFIIYLRWTV,1
3v5s,A,166,183,17,LLIIGLIGVLVGAELFV,1
3v5s,A,207,222,15,GTSLPELMVSLAAAK,1
3v5s,A,229,247,18,LGNVIGSNIADIGGALAV,1
3v5s,A,259,275,16,QMAVLVIMSLLLYLFA,1
3v5s,A,281,297,16,RWQGILFLALYIIAIA,1
4iaq,A,54,72,18,LLALITLATTLSNAFVIA,1
4iaq,A,88,107,19,ASLAVTDLLVSILVMPIST,1
4iaq,A,124,143,19,WLSSDITCCTASIWHLCVI,1
4iaq,A,170,185,15,ALVWVFSISISLPPF,1
4iaq,A,206,226,20,LYTVYSTVGAFYFPTLLLIA,1
4iaq,A,317,336,19,IILGAFIVCWLPFFIISLV,1
4iaq,A,352,371,19,FFTWLGYLNSLINPIIYTM,1
4bpd,C,33,48,15,EGVAVLLCVVIAAWL,1
4bpd,C,53,68,15,TRVLLISSVMLVMIV,1
4bpd,C,102,116,14,IAIIDAVITWAILL,1
3usl,B,14,35,21,ILAMAGNAVGLGNFLRFPVQA,1
3usl,B,42,63,21,FMIPYIIAFLLVGIPLMWIEW,1
3usl,B,89,124,35,AKILGVFGLWIPLVVAIYYVYIESWTLGFAIKFLV,1
3usl,B,167,185,18,AYIVFLITMFINVSILIR,1
3usl,B,191,214,23,ERFAKIAMPTLFILAVFLVIRVF,1
3usl,B,242,265,23,VWIAAVGQIFFTLSLGFGAIITY,1
3usl,B,278,298,20,GLTAATLNEKAEVILGGSIS,1
3usl,B,340,367,27,GFLWFFLLFFAGLTSSIAIMQPMIAFL,1
3usl,B,377,396,19,AVLWTAAIVFFSAHLVMFL,1
3usl,B,400,425,25,DEMDFWAGTIGVVFFGLTELIIFFW,1
3usl,B,445,472,27,RIYYYVMRYITPAFLAVLLVVWAREYI,1
3usl,B,484,502,18,ITRFYIIGLFLFLTFLVF,1
2j4y,A,39,64,25,LAAYMFLLIMLGFPINFLTLYVTVQ,1
2j4y,A,72,98,26,NYILLNLAVADLFMVFGGFTTTLYTS,1
2j4y,A,110,134,24,NLEGFFATLGGEIALWSLVVLAIE,1
2j4y,A,153,176,23,IMGVAFTWVMALACAAPPLVGWS,1
2j4y,A,200,224,24,ESFVIYMFVVHFIIPLIVIFFCYG,1
2j4y,A,253,277,24,VIIMVIAFLICWLPYAGVAFYIFT,1
2j4y,A,287,309,22,MTIPAFFAKTSAVYNPVIYIMM,1
1sqp,K,20,38,18,AGLWGAVGAVGLVWATDW,1
3i4d,H,11,29,18,LASLAIYSFWIFLAGLIY,1
2qts,C,43,67,24,RVVWALCFMGSLALLALVCTNRIQ,1
2qts,C,431,453,22,GDIGGQMGLFIGASILTVLELF,1
4us3,A,19,39,20,LAAMGSAVGLGNIWRFSYVT,1
4us3,A,45,67,22,AFLLVYLGFIALIGIPIVLAEF,1
4us3,A,90,124,34,KVAGLMGVAAGFLILSFYGVIAGWILFYLFNYIT,1
4us3,A,147,166,19,LPLFWQALFMIATIWIVAI,1
4us3,A,172,192,20,ERSNKILMPLLGVLLIALAI,1
4us3,A,218,242,24,GVYLAAISQAFFTLSLGMGALITY,1
4us3,A,254,274,20,AAVSVAGLDTAFAIIAGIMI,1
4us3,A,308,336,28,VGIAFFILLGAAALSSAVSLLEVPVAYF,1
4us3,A,346,365,19,AAITLGVIITLLGIPSSLS,1
4us3,A,379,403,24,IFDSVDFIASSVFLPLGGMIIALF,1
4us3,A,427,448,21,WILSLRFIAPIAILIVFLSAF,1
2xq7,E,198,211,13,NIILPMLFILFIS,1
2xq7,E,228,240,12,STLIAHIAFNIL,1
2xq7,E,254,267,13,GAIIFMIYLFYFV,1
2xq7,E,299,312,13,VVFLLANIILAFL,1
4wff,B,32,50,18,LALLALVLLYLVSGALVF,1
4wff,B,141,162,21,GRLFCIFYALVGIPLFGILLA,1
4wff,B,200,220,20,FLLIGCLLFVLTPTFVFCYM,1
4wff,B,255,276,21,AYQPLVWFWILLGLAYFASVL,1
4wd8,E,26,42,16,RLLLNVLMSIIAIISY,1
4wd8,E,49,64,15,IHLTVAPFSLLGIAI,1
4wd8,E,219,234,15,YLFCTLLPFALVGDL,1
4wd8,E,236,249,13,MTPFVSVFISYTF,1
4njp,A,93,110,17,GPVTWVMMIACVVVFIA,1
4njp,A,148,166,18,MHILFNLLWWWYLGGAVE,1
4njp,A,172,189,17,KLIVITLISALLSGYVQ,1
4njp,A,199,217,18,LSGVVYALMGYVWLRGER,1
4njp,A,225,241,16,QRGLIIFALIWIVAGW,1
4njp,A,252,268,16,AHIAGLAVGLAMAFVD,1
2xqa,E,198,217,19,NIILPMLFILFISWTAFWS,1
2xqa,E,221,240,19,ANVTLVVSTLIAHIAFNIL,1
2xqa,E,255,274,19,AIIFMIYLFYFVAVIEVTV,1
2xqa,E,294,312,18,RIAFPVVFLLANIILAFL,1
2fyn,F,14,32,18,LYYATAGAGAVATGAAVW,1
4lsg,A,43,69,26,WLDRLYMLVGTLAAIIHGVALPLMML,1
4lsg,A,115,137,22,GIGAGVLIVAYIQVSFWCLAAG,1
4lsg,A,182,204,22,GDKIGMFFQAMATFFGGFIIGF,1
4lsg,A,210,230,20,TLVILAISPVLGLSAGIWAK,1
4lsg,A,290,311,21,ANISMGAAFLLIYASYALAFW,1
4lsg,A,330,352,22,FFSVLIGAFSVGQASPNIEAFA,1
4lsg,A,708,729,21,VGIFCAIINGGLQPAFSVIFS,1
4lsg,A,751,773,22,SLLFLILGIISFITFFLQGFTF,1
4lsg,A,827,848,21,RLAVIFQNIANLGTGIIISLI,1
4lsg,A,852,875,23,LTLLLLAIVPIIAIAGVVEMKML,1
4lsg,A,928,952,24,KKAHVFGITFSFTQAMMYFSYAAA,1
4lsg,A,972,991,19,VFSAIVFGAMAVGQVSSFA,1
4g7y,S,114,138,24,HLGMRVFGVFLIFLDIILMIIDLS,1
4g7y,S,149,171,22,YDGMALALSCYFMLDLGLRIFA,1
4g7y,S,181,204,23,WEVADGLIIVVTFVVTIFYTVLD,1
4g7y,S,210,234,24,GADGLGELVVLARLLRVVRLARIF,1
3rze,A,33,50,17,LSTICLVTVGLNLLVLY,1
3rze,A,68,84,16,LSVADLIVGAVVMPMN,1
3rze,A,102,120,18,WLSMDYVASTASIFSVFI,1
3rze,A,149,164,15,GAWFLSFLWVIPILG,1
3rze,A,190,208,18,KVMTAIINFYLPTLLMLW,1
3rze,A,420,436,16,MAAFILCWIPYFIFFM,1
3rze,A,453,467,14,IWLGYINSTLNPLI,1
3p4q,P,13,37,24,WGLFGAGGMWSAIIAPVMILLVGI,1
3p4q,P,62,86,24,GRVFLFLMIVLPLWCGLHRMHHAM,1
3p4q,P,94,116,22,AGKWVFYGLAAILTVVTLIGVV,1
5c3j,D,56,78,22,TLFKIERYFAAAMVPLIPAAYF,1
5c3j,D,84,109,25,DLCLALALTLHVHWGVWGVVNDYGR,1
5c3j,D,114,138,24,DTLAAAVRVGAYIFTACLLAGLLY,1
4ila,E,199,218,19,NIILPMLFILFISWTAFWS,1
4ila,E,222,240,18,ANVTLVVSTLIAHIFFNI,1
4ila,E,256,275,19,AIIFMIYLFYFVAVIEVTV,1
4ila,E,293,313,20,ASRIAFPVVFLLANIILAFL,1
3l1l,A,11,32,21,LIPVTLMVSGAIMGSGVFLLP,1
3l1l,A,43,62,19,YGWLVTIIGALGLSMVYAK,1
3l1l,A,85,112,27,GYQTNVLYWLACWIGNIAMVVIGVGYL,1
3l1l,A,125,144,19,TITCVVVLWIFVLLNIVGP,1
3l1l,A,146,170,24,ITRVQAVATVLALIPIVGIAVFGW,1
3l1l,A,196,213,17,LNVTLWSFIGVESASVA,1
3l1l,A,225,245,20,IATIGGVLIAAVCYVLSTTA,1
3l1l,A,278,302,24,SFCAAAGCLGSLGGWTLLAGQTAK,1
3l1l,A,324,346,22,AGLIIVGILMTIFQLSSISPNA,1
3l1l,A,350,372,22,GLVSSVSVIFTLVPYLYTCAAL,1
3l1l,A,386,407,21,YLAVTTIAFLYCIWAVVGSGA,1
3l1l,A,409,427,18,VMWSFVTLMVITAMYALN,1
1tn5,C,10,34,24,IWLALGTALMGLGTLYFLVKGMGV,1
1tn5,C,41,62,21,FYAITTLVPAIAFTMYLSMLL,1
1tn5,C,79,100,21,WARYADWLFTTPLLLLDLALL,1
1tn5,C,106,127,21,TILALVGADGIMIGTGLVGAL,1
1tn5,C,134,157,23,FVWWAISTAAMLYILYVLFFGFT,1
1tn5,C,171,192,21,KVLRNVTVVLWSAYPVVWLIG,1
1tn5,C,203,226,23,ETLLFMVLDVSAKVGFGLILLRS,1
5xez,A,142,166,24,VMYTVGYSLSLGALLLALAILGGL,1
5xez,A,175,196,21,IHANLFASFVLKASSVLVIDG,1
5xez,A,223,247,24,CRVAAVFMQYGIVANYCWLLVEGL,1
5xez,A,266,289,23,YLGIGWGAPMLFVVPWAVVKCLF,1
5xez,A,295,323,28,TSNDNMGFWWILRFPVFLAILINFFIFV,1
5xez,A,349,371,22,STLTLIPLLGVHEVVFAFVTDE,1
5xez,A,381,404,23,LFFDLFLSSFQGLLVAVLYCFLN,1
5svp,D,27,47,20,RVVQLLIISYFVGWVFLHEK,1
5svp,D,316,339,23,NIIPTIISSVAAFTSVGVGTVLC,1
1m57,D,27,47,20,RMVTWAAVVIVAALIFLALA,1
3ixz,B,41,58,17,LYYVAFYVVMSGIFALC,1
1t9w,C,11,27,16,AWVIAIIIMLAGGLAI,1
1t9w,C,341,357,16,KTLVEAIILVFLVMYL,1
1t9w,C,366,386,20,IPTIAVPVVLLGTFAVLAAF,1
1t9w,C,395,411,16,FGMVLAIGLLVDDAIV,1
1t9w,C,442,458,16,VGIAMVLSAVFVPMAF,1
1t9w,C,470,489,19,SITIVSAMALSVLVALILT,1
1t9w,C,542,557,15,VLYLIIVVGMAYLFV,1
1t9w,C,874,891,17,SLYAISLIVVFLCLAAL,1
1t9w,C,898,919,21,FSVMLVVPLGVIGALLAATFR,1
1t9w,C,927,943,16,QVGLLTTIGLSAKNAI,1
1t9w,C,976,993,17,MTSLAFILGVMPLVIST,1
1t9w,C,1004,1021,17,TGVMGGMVTATVLAIFF,1
5dwy,B,17,33,16,ILWGLVLGAVFGLIAG,1
5dwy,B,38,65,27,GAVKTYIKPFGDLFVRLLKMLVMPIVL,1
5dwy,B,84,109,25,VKIVVYYLATSAMAVFFGLIVGRLF,1
5dwy,B,131,162,31,LVQTLLNIVPTNPFASLAKGEVLPVIFFAII,1
5dwy,B,203,223,20,MQYAPIGVFALIAYVMAEQG,1
5dwy,B,233,253,20,VGAVYTGLFLQIVITYFILL,1
5dwy,B,303,323,20,FTLPLGATINMDGTALYQGV,1
5dwy,B,395,413,18,ILDMGRTMVNVTGDLAGT,1
3pxo,A,40,64,24,AAYMFLLIMLGFPINFLTLYVTVQ,1
3pxo,A,72,96,24,NYILLNLAVADLFMVFGGFTTTLY,1
3pxo,A,113,137,24,GFFATLGGEIALWSLVVLAIERYV,1
3pxo,A,151,173,22,HAIMGVAFTWVMALACAAPPLV,1
3pxo,A,203,227,24,VIYMFVVHFIIPLIVIFFCYGQLV,1
3pxo,A,252,274,22,MVIIMVIAFLICWLPYAGVAFY,1
3pxo,A,289,310,21,IPAFFAKTSAVYNPVIYIMMN,1
4pxf,C,40,63,23,AAYMFLLIMLGFPINFLTLYVTV,1
4pxf,C,75,95,20,LLNLAVADLFMVFGGFTTTL,1
4pxf,C,113,133,20,GFFATLGGEIALWSLVVLAI,1
4pxf,C,154,172,18,MGVAFTWVMALACAAPPL,1
4pxf,C,202,221,19,FVIYMFVVHFIIPLIVIFF,1
4pxf,C,256,277,21,MVIAFLICWLPYAGVAFYIFT,1
4pxf,C,290,309,19,PAFFAKTSAVYNPVIYIMM,1
2h89,D,9,28,19,WTSERAVSALLLGLLPAAY,1
2h89,D,35,55,20,DYSLAAALTLHGHWGLGQVI,1
2h89,D,67,85,18,ANTGLYVLSAITFTGLCY,1
3b29,C,8,25,17,AAVTLLGVLLQAYFSLQ,1
3b29,C,53,71,18,VNCSEYFPLFLATLWVAG,1
3b29,C,79,95,16,ALCGLVYLFARLRYFQ,1
3b29,C,106,124,18,PLYASARALWLLVALAAL,1
1s3e,A,491,501,10,LLRLIGLTTI,1
1t5t,A,61,78,17,VRILLLAACISFVLAWF,1
1t5t,A,86,102,16,AFVEPFVILLILIANA,1
1t5t,A,257,274,17,EQLSKVISLICVAVWLI,1
1t5t,A,296,311,15,KIAVALAVAAIPEGL,1
1t5t,A,760,777,17,IRYLISSNVGEVVCIFL,1
1t5t,A,787,807,20,IPVQLLWVNLVTDGLPATAL,1
1t5t,A,832,851,19,LFFRYMAIGGYVGAATVGA,1
1t5t,A,899,916,17,ALSVLVTIEMCNALNSL,1
1t5t,A,932,951,19,LLGSICLSMSLHFLILYVD,1
1t5t,A,967,988,21,LMVLKISLPVIGLDEILKFIA,1
5v33,M,53,72,19,SLGVLSLFSGLMWFFTIGI,1
5v33,M,118,135,17,SFFMFVAVWSWWGRTYL,1
5v33,M,145,163,18,TAWAFLSAIWLWMVLGFI,1
5v33,M,201,221,20,HGLSIAFLYGSALLFAMHGA,1
5v33,M,266,285,19,RWAIWMAVLVTLTGGIGIL,1
5aex,C,37,54,17,ASAGVWIMVPGIGLLYS,1
5aex,C,66,88,22,WASMMASAVCIFQWFFWGYSLA,1
5aex,C,127,145,18,YQGMFAAVTGALMLGGAC,1
5aex,C,151,172,21,PMMVFLFLWMTIVYCPIACWV,1
5aex,C,187,207,20,AGGLCVHLTSGHGGLVYALI,1
5aex,C,230,249,19,VVLGTVFLWFGWMFFNGGS,1
5aex,C,261,280,19,MSTNLAAACGGLTWMVIDY,1
5aex,C,291,307,16,LCSGIIAGLVGITPAA,1
5aex,C,313,332,19,SAVVIGVVTGAGCNLAVDL,1
5aex,C,342,362,20,DCYSIHGVGGCIGSVLTGIF,1
5aex,C,394,418,24,AGICAALAWTVTVTSILLLTMNAI,1
1s33,D,26,50,24,RAAGAATVLLVIVLLAGSYLAVLA,1
1s33,D,87,111,24,GRCVAVVVMVAGITSFGLVTAALA,1
5a2n,B,32,56,24,SAAMILCIEAVERLTTLGIGVNLV,1
5a2n,B,72,89,17,TVTNFLGTSFMLCLLGG,1
5a2n,B,101,119,18,IAIFAAIQATGVSILTLS,1
5a2n,B,147,171,24,VLYLALYLTALGTGGVKASVSGFG,1
5a2n,B,188,208,20,FFNRFFFCINVGSLLAVTVL,1
5a2n,B,221,239,18,GICAFAIVLALSVFLAGT,1
5a2n,B,344,361,17,IWATCILFWTVHAQLTT,1
5a2n,B,386,410,24,FYVGGLLLTTAVYDRVAIRLCKKL,1
5a2n,B,416,436,20,LRPLQRIGLGLFFGSMAMAV,1
5a2n,B,468,486,18,YLIVGIGEALIYTGQLDF,1
5a2n,B,501,524,23,LLLSTLALGFFFSSVLVTIVEKF,1
5a2n,B,545,564,19,WLVAVLVALNFLIFLVFSK,1
3u32,E,13,31,18,ISTIGLLGAGIGIAIVFA,1
3u32,E,51,71,20,ILGFALSEATGLFCLMVSFL,1
3rce,A,17,30,13,ILILIAFAFSVLC,1
3rce,A,110,123,13,ASLIVVPIILIAR,1
3rce,A,129,141,12,YGFIAALLGSIA,1
3rce,A,159,173,14,LVLPMLILLTFIRL,1
3rce,A,181,195,14,LLLSPIFIMIYLWW,1
3rce,A,200,215,15,SLNFAMIGLFGLYTL,1
3rce,A,225,239,14,LAIALMIIALSMLA,1
3rce,A,241,251,10,YKLALIVLLF,1
3rce,A,267,282,15,ALIFISISILHLSGG,1
3rce,A,333,351,18,SSVLVFILSFIGFILLCK,1
3rce,A,355,367,12,MLLALPMLALGF,1
3rce,A,379,395,16,AVPVMALGFGYFLYAF,1
3rce,A,413,427,14,LLILIAFFSISPAL,1
5aez,C,33,48,15,ASVLVWIMIPGVGLL,1
5aez,C,63,84,21,AALMAACVAAFQWFWWGYSLV,1
5aez,C,121,137,16,YQGMFAAVTAILMAGA,1
5aez,C,148,166,18,VFLFIWLTVVYCPIAYWT,1
5aez,C,181,198,17,AGGGPVHENSGFAALAY,1
5aez,C,227,243,16,GTIFLWFGWYGFNGGS,1
5aez,C,255,272,17,VNTNLAAATGGLTWMLV,1
5aez,C,287,301,14,MGAIAGLVGITPAA,1
5aez,C,307,323,16,TSVIFGIVPAIICNFA,1
5aez,C,338,356,18,WALHGVGGFVGNFMTGLF,1
5aez,C,382,406,24,YQLAGSCAVAAWSFTVTSIILLAM,1
1ov1,A,39,63,24,LAAYMFLLIMLGFPINFLTLYVTV,1
1ov1,A,72,96,24,NYILLNLAVADLFMVFGGFTTTLY,1
1ov1,A,112,135,23,EGFFATLGGEIALWSLVVLAIER,1
1ov1,A,152,172,20,AIMGVAFTWVMALACAAPPL,1
1ov1,A,200,222,22,ESFCIYMFVVHFIIPLIVIFFC,1
1ov1,A,254,279,25,IIMVIAFLICWLPYAGVAFYICTHQ,1
1ov1,A,287,309,22,MTIPAFFAKTSAVYNPVIYIMM,1
4r7c,F,26,42,16,LFVLTILTLISGTIFY,1
4r7c,F,75,95,20,KIFTILYIFIGIGLVFGFIH,1
5vew,A,148,169,21,TVGYALSFSALVIASAILLGF,1
5vew,A,177,196,19,YIHLNLFASFILRALCVFF,1
5vew,A,266,286,20,RLYVAIGWGVPLLFVVPWGI,1
5vew,A,306,329,23,LIIRLPILFACIVNFLIFVRVIC,1
5vew,A,349,370,21,AKSTLTLIPLLCTHEVIFAFV,1
5vew,A,387,406,19,LSFTSFQGLMVAILYCFVN,1
3iz1,F,23,48,25,WLTVLFIFRIMILVVAAKEVWGDEQ,1
3iz1,F,69,90,21,PISHIRLWALQLIFVSTPALL,1
3iz1,F,138,163,25,SIFFRVIFEAAFMYVFYVMYDGFSM,1
3iz1,F,184,211,27,PTEKTVFTVFMIAVSGICILLNVTELC,1
2dw3,A,23,47,24,FQMMKGAGWAGGVFFGTLLLIGFF,1
1t9u,C,11,25,14,AWVIAIIIMLAGGL,1
1t9u,C,342,357,15,TLVEAIILVFLVMYL,1
1t9u,C,366,382,16,IPTIAVPVVLLGTFAV,1
1t9u,C,398,411,13,VLAIGLLVDDAIV,1
1t9u,C,442,456,14,VGIAMVLSAVFVPM,1
1t9u,C,472,489,17,TIVSAMALSVLVALILT,1
1t9u,C,541,556,15,LVLYLIIVVGMAYLF,1
1t9u,C,876,891,15,YAISLIVVFLCLAAL,1
1t9u,C,898,916,18,FSVMLVVPLGVIGALLAA,1
1t9u,C,930,943,13,LLTTIGLSAKNAI,1
1t9u,C,975,992,17,LMTSLAFILGVMPLVIS,1
1t9u,C,1004,1021,17,TGVMGGMVTATVLAIFF,1
3e8h,E,26,45,19,LFVLTILTLISGTIFYSTV,1
3e8h,E,75,96,21,GKIFTILYIFIGIGLVFGFIH,1
1jgj,A,4,27,23,TTLFWLGAIGMLVGTLAFAWAGR,1
1jgj,A,36,60,24,YVTLVGISGIAAVAYAVMALGVGW,1
1jgj,A,69,90,21,VPRYIDWILTTPLIVYFLGLL,1
1jgj,A,96,118,22,EFGIVITLNTVVMLAGFAGAMV,1
1jgj,A,123,146,23,YALFGMGAVAFIGLVYYLVGPMT,1
1jgj,A,160,181,21,VRLRNLTVVLWAIYPFIWLLG,1
1jgj,A,192,215,23,DVALIVYLDLVTKVGFGFIALDA,1
3lde,D,22,41,19,ILLLVLAVIIYGTAGFHFI,1
3lde,D,71,95,24,GMYFTCTLIVLGIGTFAVAVERLL,1
5fmw,V,202,208,6,FKSIIQ,1
5fmw,V,261,266,5,FLSYS,1
5fmw,V,347,353,6,RKGVEL,1
5fmw,V,390,395,5,RAVNI,1
5svr,C,29,47,18,VQLLIISYFVGWVFLHEK,1
5svr,C,316,343,27,NIIPTIISSVAAFTSVGVGTVLCDIIL,1
3kbc,C,13,29,16,QKILIGLILGAIVGLI,1
3kbc,C,43,66,23,KPFGDLFVRLLCMLVMPIVFASL,1
3kbc,C,91,110,19,TSAFAVTLGIIMARLFNPG,1
3kbc,C,131,140,9,HILLDIVPT,1
3kbc,C,150,161,11,VLPTIFFAIIL,1
3kbc,C,201,217,16,MQYAPIGVFALIAYVM,1
3kbc,C,225,242,17,GELAKVTAAVYVGLTLQ,1
3kbc,C,313,326,13,TALYQGVATFFIA,1
3kbc,C,336,352,16,QQLTIVLTAVLASIGT,1
3kbc,C,357,375,18,AGAIMLCMVLHSVGLPLT,1
3kbc,C,380,397,17,AAYAMILGIDAILDMGR,1
2dwe,F,25,50,25,WRAAGAATVLLVIVLLAGSYLAVLA,1
2dwe,F,87,114,27,GRCVAVVVMVAGITSFGLVTAALATWF,1
1c99,A,6,32,26,DLLYMAAAVMMGLAAIGAAIGIGILG,1
1c99,A,51,77,26,QFFIVMGLVDAIPMIAVGLGLYVMFA,1
1jq1,D,94,111,17,VMVAGITSFGLVTAALA,1
4ilc,E,199,218,19,NIILPMLFILFISWTAFWS,1
4ilc,E,222,240,18,ANVTLVVSTLIAHIAFNI,1
4ilc,E,256,275,19,AIIFMIYLFYFVAVIEVTV,1
4ilc,E,293,313,20,ASRIAFPVVFLLANIILAFL,1
1v55,Z,13,37,24,EQAIGLSVTFLSFLLPAGWVLYHL,1
3p4s,P,13,41,28,WGLFGAGGMWSAIIAPVMILLVGILLPL,1
3p4s,P,61,86,25,IGRVFLFLMIVLPLWCGLHRMHHAM,1
3p4s,P,94,117,23,AGKWVFYGLAAILTVVTLIGVVT,1
4wgw,A,71,88,17,LISSLAAMLLQSMTVRL,1
4wgw,A,108,135,27,AIIFWIIAELAIIATDIAEVIGSAIAL,1
4wgw,A,144,157,13,VGALITVFDVFLL,1
4wgw,A,159,180,21,IMRFGFRKIEAIVGTLIFTVL,1
4wgw,A,219,234,15,IIGATIMPHNLYLHS,1
4wgw,A,255,272,17,YATIDSNLQLSIAFVVN,1
4wgw,A,321,342,21,ALLASGQNSTITGTLAGQIVM,1
4wgw,A,353,371,18,LRRLITRSLAVIPVIICL,1
4wgw,A,385,408,23,VFSQVFLSIALPFSLIPLQLATS,1
4wgw,A,414,436,22,PFINKTWVNIISWTLIVILSGL,1
5mkk,B,23,42,19,YLWAVLAGLVSIFFFVLTP,1
5mkk,B,66,84,18,ASAALSGLLSYAMRRLAV,1
5mkk,B,136,156,20,ILMGSRLSFLVLLAFLSMYA,1
5mkk,B,163,184,21,YLTLILPGIFLAMRFLLRLID,1
5mkk,B,237,258,21,LARVEGPLHALLGFLMGFAFL,1
5mkk,B,282,299,17,AYLAQLTWPILGLGWVM,1
2ht2,B,40,61,21,VVGTLVGLAAVAFDKGVAWLQ,1
2ht2,B,84,96,12,CSAVLAMFGYFL,1
2ht2,B,129,142,13,VKFFGGLGTLGGG,1
2ht2,B,144,155,11,LGREGPTVQIG,1
2ht2,B,217,232,15,VFIGVIMSTIMYRIF,1
2ht2,B,253,273,20,LYLILGIIFGIFGPIFNKWV,1
2ht2,B,291,305,14,VLMGGAIGGLCGLL,1
2ht2,B,338,351,13,ARVITTLLCFSSG,1
2ht2,B,353,368,15,GGIFAPMLALGTVLG,1
2ht2,B,422,436,14,LPMIITGLGATLLA,1
2xq5,E,198,215,17,NIILPMLFILFISWTAF,1
2xq5,E,223,239,16,VTLVVSTLIAHIAFNI,1
2xq5,E,255,273,18,AIIFMIYLFYFVAVIEVT,1
2xq5,E,295,312,17,IAFPVVFLLANIILAFL,1
2xqt,P,14,28,14,ALAVGIGSIGPGLG,1
2xqt,P,60,74,14,MEALTIYGLVVALV,1
4ezc,C,69,83,14,PISGILILVGLLVQ,1
4ezc,C,88,105,17,LNGCVGTVVSTLTALLL,1
4ezc,C,116,128,12,QGYNATLVGILM,1
4ezc,C,143,159,16,PVSAMSMTCPVFSSAL,1
4ezc,C,170,182,12,FTLPFNMALSMY,1
4ezc,C,236,249,13,GGIFLGAILLSSP,1
4ezc,C,251,265,14,CLHAAIGSLLGIIA,1
4ezc,C,282,295,13,FNSSLACIAIGGT,1
4ezc,C,304,318,14,LLALACALFTAYLG,1
4ezc,C,333,347,14,TWPFCLATLLFLLL,1
5d58,A,20,36,16,TEMWERFSYYGMRAIL,1
5d58,A,59,74,15,MAIYASMVYLSGTIG,1
5d58,A,88,103,15,FWGGVLIMLGHIVLA,1
5d58,A,111,127,16,FGSIILIIIGTGFLKP,1
5d58,A,152,167,15,FGINLGAFIAPLIVG,1
5d58,A,179,194,15,SLAAIGMFIGLLVYY,1
5d58,A,223,239,16,VSLAVAGFIAIIVVMN,1
5d58,A,249,266,17,INLLTIVAIAIPVFYFA,1
5d58,A,287,307,20,LFIAAVLFWAIEEQGSVVLA,1
5d58,A,323,339,16,FQSLNPLFIMLYTPFF,1
5d58,A,356,371,15,FAVGLMFAGLSFLLM,1
5d58,A,388,404,16,LVGSWALVILGEMLIS,1
5d58,A,426,442,16,WFLSSSVGSALNAQLV,1
5d58,A,455,471,16,YFGLGSVVLGIVLVFL,1
5fuf,C,33,49,16,ASVLVWIMIPGVGLLY,1
5fuf,C,62,84,22,WAALMAACVAAFQWFWWGYSLV,1
5fuf,C,121,138,17,YQGMFAAVTAILMAGAG,1
5fuf,C,146,166,20,MMVFLFIWLTVVYCPIAYWT,1
5fuf,C,181,198,17,AGGGPVHENSGFAALAY,1
5fuf,C,225,243,18,VMGTIFLWFGWYGFNGGS,1
5fuf,C,255,272,17,VNTNLAAATGGLTWMLV,1
5fuf,C,286,301,15,CMGAIAGLVGITPAA,1
5fuf,C,307,324,17,TSVIFGIVPAIICNFAV,1
5fuf,C,336,356,20,DVWALHGVGGFVGNFMTGLF,1
5fuf,C,382,406,24,YQLAGSCAVAAWSFTVTSIILLAM,1
3ne5,I,16,32,16,LMGALFLSIWGTWTII,1
3ne5,I,339,356,17,GKLLEEFIVVAVVCALF,1
3ne5,I,364,384,20,VAIISLPLGLCIAFIVMHFQ,1
3ne5,I,393,409,16,GGIAIAVGAMVDAAIV,1
3ne5,I,450,466,16,FISLLIITLSFIPIFT,1
3ne5,I,478,497,19,AFTKTYAMAGAALLAIVVI,1
3ne5,I,540,555,15,LVAALSVLTVLWPLN,1
3ne5,I,873,890,17,LMVPMTLMIIFVLLYLA,1
3ne5,I,898,918,20,LIISSVPFALVGGIWLLWWM,1
3ne5,I,927,943,16,TGFIALAGVAAEFGVV,1
3ne5,I,985,1001,16,MTVAVIIAGLLPILWG,1
3ne5,I,1010,1028,18,RIAAPMIGGMITAPLLSL,1
4ev6,E,261,281,20,MVTTIFAVPMWITGIYGMNF,1
4ev6,E,292,311,19,FWLVMALMVVIIMIFVYIF,1
2jag,C,36,52,16,VALAGIAILVFVYMGR,1
2jag,C,62,78,16,WGATLMIPLVSISSYL,1
2jag,C,109,124,15,LTWALSTPMILLALG,1
2jag,C,133,149,16,LFTVIAADIGMCVTGL,1
2jag,C,164,180,16,YAISCAFFVVVLSALV,1
2jag,C,199,215,16,RVLVVVLWLGYPIVWA,1
2jag,C,233,251,18,YSVLDVFAKYVFAFILLR,1
2m0b,A,647,668,21,TGMVGALLLLLVVALGIGLFM,1
2mfr,A,21,42,21,GPLIFVFLFSVVIGSIYLFLR,1
3qdc,A,5,27,22,TLFWLGAIGMLVGTLAFAWAGR,1
3qdc,A,35,60,25,YYVTLVGISGIAAVAYVVMALGVGW,1
3qdc,A,69,91,22,APRYIDWILTTPLIVYFLGLLA,1
3qdc,A,96,118,22,EFGIVITLNTVVMLAGFAGAMV,1
3qdc,A,123,146,23,YALFGMGAVAFLGLVYYLVGPMT,1
3qdc,A,160,184,24,VRLRNLTVILWAIYPFIWLLGPPG,1
3qdc,A,192,215,23,DVALIVYLDLVTKVGFGFIALDA,1
2wx5,M,55,72,17,GVLSLFSGLMWFFTIGI,1
2wx5,M,117,134,17,ASFFMFVAVWSWWGRTY,1
2wx5,M,146,164,18,AWAFLSAIWLWMVLGFIR,1
2wx5,M,201,221,20,HGLSIAFLYGSALLFAMHGA,1
2wx5,M,268,286,18,AIWMAVLVTLTGGIGILL,1
1nkz,S,20,37,17,VFLGLALVAHFLAFSAT,1
5kkz,G,14,32,18,LYYATAGAGAVATGAAVW,1
5irz,C,434,455,21,YFNFFVYCLYMIIFTAAAYYR,1
5irz,C,473,497,24,RVTGEILSVSGGVYFFFRGIQYFL,1
5irz,C,511,532,21,SEILFFVQSLFMLVSVVLYFS,1
5irz,C,537,556,19,VASMVFSLAMGWTNMLYYT,1
5irz,C,569,598,29,EKMILRDLCRFMFVYLVFLFGFSTAVVTL,1
5irz,C,656,682,26,AVFIILLLAYVILTYILLLNMLIALM,1
2ntu,C,11,33,22,WLALGTALMGLGTLYFLVKGMG,1
2ntu,C,40,62,22,KFYAITTLVPAIAFTMYLSMLL,1
2ntu,C,80,100,20,ARYADWLFTTPLLLLDLALL,1
2ntu,C,106,127,21,TILALVGADGIMIGTGLVGAL,1
2ntu,C,134,156,22,FVWWAISTAAMLYILYVLFFGF,1
2ntu,C,171,192,21,KVLRNVTVVLWSAYPVVWLIG,1
2ntu,C,204,226,22,TLLFMVLDVSAKVGFGLILLRS,1
4xnw,A,54,79,25,PAVYILVFIIGFLGNSVAIWMFVFH,1
4xnw,A,86,108,22,SVYMFNLALADFLYVLTLPALI,1
4xnw,A,123,150,27,CKLQRFIFHVNLYGSILFLTCISAHRY,1
4xnw,A,168,190,22,ICISVLVWLIVVVAISPILFYS,1
4xnw,A,214,242,28,FIYSMCTTVAMFCVPLVLILGCYGLIVR,1
4xnw,A,258,282,24,IYLVIIVLTVFAVSYIPFHVMKTM,1
4xnw,A,306,328,22,QVTRGLASLNSCVNPILYFLAG,1
1kyl,E,21,37,16,GVIIGAAFGKIVSSLV,1
1kyl,E,78,94,16,IQNVFDFLIVAFAIFM,1
2wu2,L,15,35,20,FILVRATAIVLTLYIIYMVG,1
2wu2,L,57,80,23,KVFTLLALFSILIHAWIGMWQVL,1
2wu2,L,89,110,21,RLMLQLVIVVALVVYVIYGFV,1
4qim,A,230,253,23,HSYIAAFGAVTGLCTLFTLATFV,1
4qim,A,264,290,26,VILFYVNACFFVGSIGWLAQFMDGAR,1
4qim,A,312,340,28,SCVIIFVIVYYALMAGVVWFVVLTYAWH,1
4qim,A,357,383,26,SYFHLLTWSLPFVLTVAILAVAQVDG,1
4qim,A,398,424,26,YRAGFVLAPIGLVLIVGGYFLIRGVM,1
4qim,A,452,474,22,GIFGFLAFGFVLITFSCHFYDF,1
4qim,A,516,538,22,VEKINLFAMFGTGIAMSTWVWT,1
1p8u,C,12,28,16,LALGTALMGLGTLYFL,1
1p8u,C,47,62,15,LAPAIAFTMYLSMLL,1
1p8u,C,80,94,14,ARYADWLFTTPLLL,1
1p8u,C,111,127,16,VGADGIMIGTGLVGAL,1
1p8u,C,134,150,16,FVWWAISTAAMLYILY,1
1p8u,C,178,192,14,VVLWSAYPVVWLIG,1
1p8u,C,204,221,17,TLLFMVLDVSAKVGFGL,1
1ne0,A,31,54,23,LLPPLYSLVFIFGFVGNMLVILI,1
1ne0,A,70,92,22,NLAISDLFFLLTVPFWAHYAAA,1
1ne0,A,103,124,21,LTGLYFIGFFSGIFFIILLTI,1
1ne0,A,151,169,18,TWVVAVFASLPGIIFTRS,1
1ne0,A,193,218,25,QTLKIVILGLVLPLLVMVICYSGIL,1
1ne0,A,240,263,23,MIVYFLFWAPYNIVLLLNTFQEF,1
1ne0,A,277,300,23,AMQVTETLGMTHCCINPIIYAFV,1
1et2,S,194,208,14,YSVSLASLTVAVLI,1
1et2,S,228,241,13,SFMLRAVSIFVKD,1
1et2,S,277,290,13,YAGCRVAVTFFLY,1
1et2,S,323,336,13,FTVFGWGLPAVFV,1
1et2,S,368,381,13,ASIVLNFILFINI,1
1et2,S,413,428,15,MPLFGVHYIVFMATP,1
1et2,S,450,464,14,QGFFVAIIYCFCNG,1
3h1j,W,19,40,21,FALTVVLGAVLFERAFDQGAD,1
5gpj,B,14,28,14,IPVCAVIGIAFALF,1
5gpj,B,93,110,17,KYVGIFMVAFAILIFLF,1
5gpj,B,142,160,18,TVSFLLGGVTSLVSGFLG,1
5gpj,B,192,209,17,MGFLLAANGLLVLYIAI,1
5gpj,B,228,244,16,GYGLGGSSMALFGRVG,1
5gpj,B,290,306,16,MGSDLFGSYAESSCAA,1
5gpj,B,328,344,16,IVSSVGILVCLLTTLF,1
5gpj,B,363,379,16,QLVISTVLMTIGVAVV,1
5gpj,B,406,422,16,CVAVGLWAGLIIGFVT,1
5gpj,B,456,473,17,KSVIIPIFAIAISIFVS,1
5gpj,B,483,500,17,VAALGMLSTIATGLAID,1
5gpj,B,540,556,16,KGFAIGSAALVSLALF,1
5gpj,B,576,593,17,IGLIVGAMLPYWFSAMT,1
5gpj,B,643,659,16,PPGALVMLTPLVVGIL,1
5gpj,B,665,684,19,SGVLAGSLVSGVQIAISAS,1
5gpj,B,734,751,17,PSLNILIKLMAVESLVF,1
4a97,E,211,225,14,LGLIIAASWSVFWL,1
4a97,E,230,245,15,RLQTSFTLMLTVVAY,1
4a97,E,266,282,16,IAGYGSIFAAILLIIF,1
4a97,E,300,315,15,RLAFPLGFLAIGCVL,1
3vou,D,26,45,19,LFVLTFLTLTSGTIFYSTV,1
3vou,D,76,95,19,KVFTILYIFIGIGLVFGFI,1
5nmi,X,22,36,14,LWGAVGAVGLVSAT,1
4d2b,A,20,34,14,TEMWERFSYYGMRA,1
4d2b,A,59,74,15,MAIYASMVYLSGTIG,1
4d2b,A,89,104,15,WGGVLIMLGHIVLAL,1
4d2b,A,111,127,16,FGSIILIIIGTGFLKP,1
4d2b,A,151,166,15,VFGINLGAFIAPLIV,1
4d2b,A,179,193,14,SLAAIGMFIGLLVY,1
4d2b,A,225,240,15,LAVAGFIAIIVVMNL,1
4d2b,A,249,266,17,INLLTIVAIAIPVFYFA,1
4d2b,A,286,304,18,PLFIAAVLFWAIEEQGSV,1
4d2b,A,324,342,18,QSLNPLFIMLYTPFFAWL,1
4d2b,A,354,369,15,TKFAVGLMFAGLSFL,1
4d2b,A,391,407,16,SWALVILGEMLISPVG,1
4d2b,A,427,441,14,FLSSSVGSALNAQL,1
4d2b,A,458,472,14,LGSVVLGIVLVFLS,1
2ksb,A,34,58,24,WAAAYTVIVVTSVVGNVVVMWIIL,1
2ksb,A,70,93,23,LVNLAFAEASMAAFNTVVNFTYA,1
2ksb,A,104,127,23,CKFHNFFPIAAVFASIYSMTAVA,1
2ksb,A,149,174,25,VICVIWVLALLLAFPQGYYSTTETM,1
2ksb,A,192,217,25,EKVYHICVTVLIYFLPLLVIGYAYT,1
2ksb,A,250,274,24,IVVVCTFAICWLPFHIFFLLPYIN,1
2ksb,A,286,308,22,YLAIMWLAMSSTMYNPIIYCCL,1
4mmc,A,13,31,18,LILAMAGYAVDLGNFLRF,1
4mmc,A,45,63,18,PYIIAFLLVGIPLMWIEW,1
4mmc,A,90,121,31,KILGVFGLWIPLVVAIYYVYIESWTLGFAIK,1
4mmc,A,167,184,17,AYIVFLITMFINVSILI,1
4mmc,A,191,211,20,ERFAKIAMPTLFILAVFLVI,1
4mmc,A,245,266,21,AAVGQIFFSLGLGFGAIITFA,1
4mmc,A,277,295,18,SGLTAATLNEKAEVILGG,1
4mmc,A,343,364,21,WFFLLFFAGLTSSIAGMQPMI,1
4mmc,A,380,396,16,WTAAIVFFSAHLVMFL,1
4mmc,A,400,426,26,DEMDFWAGTIGVVFFGLTELIIFFWI,1
4mmc,A,445,468,23,RIYYYVMRYITPAFLAVLLVVWA,1
4mmc,A,484,500,16,ITRFYIIGLFLFLTFL,1
2yoe,E,211,225,14,LGLIIAASWSVFWL,1
2yoe,E,230,245,15,RLQTSFTLMLTVVAY,1
2yoe,E,266,282,16,IAGYGSIFAAILLIIF,1
2yoe,E,300,315,15,RLAFPLGFLAIGCVL,1
2g2a,A,49,67,18,LYYMIFVIGFAVNIVVVS,1
2g2a,A,83,102,19,FNLAVADLLLLATLPLWAT,1
2g2a,A,119,137,18,FGSFLTLNMFASIFFITC,1
2g2a,A,164,183,19,PLVWCMACLSSLPTFYFRD,1
2g2a,A,211,228,17,ALMKNILGFIIPLIFIA,1
2g2a,A,260,278,18,VVLAFIICWLPFHVLTFL,1
2g2a,A,301,320,19,FAILLGFTNSCVNPFLYCF,1
4cbc,H,135,153,18,ALLTVVFYIAAVMATNLY,1
4cbc,H,194,214,20,AWVFFIPFIMLTTFTVLNLF,1
3ddl,A,20,41,21,SFTVATMTASFVFFVLARNNV,1
3ddl,A,46,65,19,ISMMVSALVVFIAGYHYFR,1
3ddl,A,92,112,20,RYVDWLLTVPLLTVELVLVM,1
3ddl,A,121,141,20,LAAKLGFLAALMIVLGYPGE,1
3ddl,A,149,173,24,GTRGLWGFLSTIPFVWILYILFTQ,1
3ddl,A,188,209,21,LGNARLLLLATWGFYPIAYMI,1
3ddl,A,231,252,21,YTIADVLAKAGYGVLIYNIAK,1
4xtn,B,24,47,23,YQFTSHILTLGYAVMLAGLLYFI,1
4xtn,B,62,85,23,LSAVVMVSAFLLLYAQAQNWTSS,1
4xtn,B,105,124,19,NGYRYLNWLIDVPMLLFQI,1
4xtn,B,138,160,22,RNQFWFSGAMMIITGYIGQFYE,1
4xtn,B,165,187,22,AFLVWGAISSAFFFHILWVMKK,1
4xtn,B,206,229,23,IWILFLISWTLYPGAYLMPYLTG,1
4xtn,B,238,261,23,GVMARQLVYTIADVSSKVIYGVL,1
4zlj,C,11,27,16,AWVIAIIIMLAGGLAI,1
4zlj,C,341,357,16,KTLVEAIILVFLVMYL,1
4zlj,C,366,386,20,IPTIAVPVVLLGTFAVLAAF,1
4zlj,C,395,410,15,FGMVLAIGLLVDDAI,1
4zlj,C,443,458,15,GIAMVLSAVFVPMAF,1
4zlj,C,471,489,18,ITIVSAMALSVLVALILT,1
4zlj,C,542,557,15,VLYLIIVVGMAYLFV,1
4zlj,C,874,891,17,SLYAISLIVVFLCLAAL,1
4zlj,C,899,919,20,SVMLVVPLGVIGALLAATFR,1
4zlj,C,927,943,16,QVGLLTTIGLSAKNAI,1
4zlj,C,976,992,16,MTSLAFILGVMPLVIS,1
4zlj,C,1002,1019,17,VGTGVMGGMVTATVLAI,1
4mm5,A,14,32,18,ILAMAGYAVDLGNFLRFP,1
4mm5,A,42,62,20,FMIPYIIAFLLVGIPLMWIE,1
4mm5,A,93,120,27,GVFGLWIPLVVASYYVYIESWTLGFAI,1
4mm5,A,167,184,17,AYIVFLITMFINVSILI,1
4mm5,A,191,212,21,ERFAKIAMPTLFILAVFLVIR,1
4mm5,A,242,265,23,VWIAAVGQIFFSLGLGFGVLITF,1
4mm5,A,280,297,17,TAATLNEKASVILGGSI,1
4mm5,A,343,364,21,WFFLLFFAGLTSSIAGMQGMI,1
4mm5,A,379,396,17,LWTAAIVFFSAHLVMFL,1
4mm5,A,400,421,21,DEMDFWATGIGVVFFGLTELI,1
4mm5,A,451,471,20,MRYITPAFLAVLLVVWAREY,1
4mm5,A,484,500,16,ITRFYIIGLFLFLTFL,1
5lwe,B,51,74,23,PPLYWLVFIVGALGNSLVILVYW,1
5lwe,B,84,108,24,MFLLNLAIADLLFLVTLPFWAIAA,1
5lwe,B,119,143,24,KVVNSMYKMNFYSCVLLIMCICVD,1
5lwe,B,165,185,20,KMVCFTIWVLAAALCIPEIL,1
5lwe,B,214,239,25,LALKVILGFFLPFVVMACCYTIIIH,1
5lwe,B,254,279,25,ATITVLTVFVLSQFPYNCILLVQTI,1
5lwe,B,299,321,22,QVTQAIAFFHSCLNPVLYVFVG,1
1gzm,C,43,66,23,FLLIMLGFPINFLTLYVTVQHKK,1
1gzm,C,69,92,23,PLNYILLNLAVADLFMVFGGFTT,1
1gzm,C,114,136,22,FATLGGEIALWSLVVLAIERYV,1
1gzm,C,151,170,19,AIMGVAFTWVMALACAAPP,1
1gzm,C,203,225,22,IYMFVVHFIIPLIVIFFCYGQL,1
1gzm,C,251,274,23,MVIIMVIAFLICWLPYAGVAFYI,1
1gzm,C,291,310,19,FFAKTSAVYNPVIYIMMNK,1
3s3b,C,5,28,23,KGALAVILVLTLTILVFWLGVYA,1
4tl3,B,8,26,18,WIYVAGMTIGALHFWSLS,1
4tl3,B,38,54,16,VAMFIPIWSGLAYMAM,1
4tl3,B,70,87,17,ARYIDWMVTTPLLLLSL,1
4tl3,B,103,120,17,FLMSTQIVVITSGLIAD,1
4tl3,B,127,146,19,RYLWYICGVCAFLIILWGI,1
4tl3,B,169,186,17,TYFTVLWIGYPIVWIIG,1
4tl3,B,199,218,19,FLFCLLPFFSKVGFSFLEL,1
3m78,C,10,27,17,TGYFDIPLGLAALSLAW,1
3m78,C,41,64,23,DVLGIVASAVWILFILMYAYKLR,1
3m78,C,81,97,16,FIALIPITTMLVGDIL,1
3m78,C,105,128,23,EVLIWIGTIGQLLFSTLRVSELW,1
3m78,C,140,154,14,SFYLPAVAANFTSA,1
3m78,C,166,186,20,YLFFGAGMIAWIIFEPVLLQ,1
3m78,C,200,215,15,MGIVLAPAFVCVSAY,1
3m78,C,227,246,19,KILWGYGFLQLFFLLRLFP,1
3m78,C,254,271,17,IGLWAFSGGLASMANSA,1
3m78,C,284,309,25,IFAFVFSNVMIGLLVLMTIYKLTKG,1
4aw6,B,19,38,19,FGAVLLFSWTVYLWETFLA,1
4aw6,B,80,96,16,SGLYSETEGTLILLFG,1
4aw6,B,118,141,23,EITQSLVFLLLATLFSALAGLPW,1
4aw6,B,169,190,21,KFVVTQCILLPVSSLLLYIIK,1
4aw6,B,196,215,19,FIYAWLFTLVVSLVLVTIY,1
4aw6,B,346,364,18,KNIIISQMNSFLCFFLFA,1
4aw6,B,384,394,10,LIGLLIIFQF,1
4aw6,B,396,411,15,SPYNEVLSFCLTVLS,1
1wpe,A,57,77,20,EDLLVRILLLAACISFVLAW,1
1wpe,A,86,104,18,AFVEPFVILLILIANAIV,1
1wpe,A,257,274,17,EQLSKVISLICVAVWLI,1
1wpe,A,296,311,15,KIAVALAVAAIPEGL,1
1wpe,A,761,780,19,RYLISSNVGEVVCIFLTAA,1
1wpe,A,787,807,20,IPVQLLWVNLVTDGLPATAL,1
1wpe,A,832,851,19,LFFRYMAIGGYVGAATVGA,1
1wpe,A,899,915,16,ALSVLVTIEMCNALNS,1
1wpe,A,932,950,18,LLGSICLSMSLHFLILYV,1
1wpe,A,965,987,22,QWLMVLKISLPVIGLDEILKFI,1
2na5,A,15,32,17,EELNRYYASLRHYLNLV,1
5but,J,19,37,18,LAIGFFLTIIIGAVLLML,1
5but,J,75,95,20,GQTVIMGLIQIGGLGFMTFA,1
5but,J,134,153,19,LFSISIELIAALILSIRLV,1
5but,J,192,209,17,TVNLVITFLFITGGIGF,1
5but,J,232,249,17,TGTLMLNAIAMLTVFIL,1
5but,J,292,308,16,TIVFTLLLMFIGAGSA,1
5but,J,310,324,14,ASGIKLTTFIVILT,1
5but,J,353,372,19,VSVTSLFIVFLGIFALTIT,1
5but,J,404,424,20,GKCIIIVIMFIGRIGPLTFV,1
1l0n,K,22,38,16,LWGAVGAVGLVSATDS,1
3tlm,A,57,78,21,EDLLVRILLLAACISFVLAWF,1
3tlm,A,87,104,17,FVEPFVILLILIANAIV,1
3tlm,A,258,276,18,QLSKVISLICVAVWLINI,1
3tlm,A,293,311,18,YYFKIAVALAVAAIPEGL,1
3tlm,A,759,780,21,IRYLISSNVGEVVCIFLTAAL,1
3tlm,A,786,806,20,IPVQLLWVNLVTDGLPATAL,1
3tlm,A,832,851,19,FFRYMAIGGYVGAATVGAA,1
3tlm,A,898,915,17,ALSVLVTIEMCNALNSL,1
3tlm,A,930,947,17,WLVGSIGLSMSLHFLIL,1
3tlm,A,967,986,19,MVLKISLPVIGLDEILKFV,1
4m58,A,11,28,17,TCAVMGAAMVPVLTVAA,1
4m58,A,44,60,16,IGSAFAFTIMMFNVPI,1
4m58,A,64,76,12,TAHAIGATLLAT,1
4m58,A,81,101,20,AASISLTLALFIQALLFGDG,1
4m58,A,103,128,25,LALGANSFNMAFIAPFVGYGIYRLM,1
4m58,A,137,158,21,SSAIGGYVGINAAALATAIEL,1
4m58,A,184,205,21,AMMFAHLTVAGIVEAVITGLV,1
5er7,F,25,50,25,TVLFIFRIMILVVAAKEVWGDEQAD,1
5er7,F,66,90,24,HYFPISHIRLWALQLIFVSTPALL,1
5er7,F,139,159,20,IFFRVIFEAAFMYVFYVMYD,1
5er7,F,184,208,24,PTEKTVFTVFMIAVSGICILLNVT,1
5i20,A,9,21,12,GFTAILLWSTLA,1
5i20,A,33,53,20,LLTALTFTIGGAVGIAAGLA,1
5i20,A,69,86,17,HGIGGLFGYHFFYFSAL,1
5i20,A,94,107,13,GLVAYLWPLLIVL,1
5i20,A,122,136,14,AGALMGLAGTVVLL,1
5i20,A,151,167,16,GYLAAAACAVIWSVYS,1
5i20,A,180,198,18,VAGFCLATAALSALCHIL,1
5i20,A,213,229,16,VALGIGPVGIAFYTWD,1
5i20,A,240,254,14,GVLSYAAPVLSTLL,1
5i20,A,267,281,14,AIACALIVGGAAVA,1
1lda,D,11,28,17,IAEFLGTGLLIFFGVGC,1
1lda,D,43,60,17,ISVIWGLGVAMAIYLTA,1
1lda,D,86,107,21,IPFIVSQVAGAFCAAALVYGL,1
1lda,D,149,166,17,AVEMVITAILMGLILAL,1
1lda,D,179,195,16,PLLIGLLIAVIGASMG,1
1lda,D,234,255,21,VPLFGPIVGAIVGAFAYRKLI,1
4oye,C,14,30,16,KILIGLILGAIVGLIL,1
4oye,C,40,63,23,TYVKPFGDLFVRLLKMLVMPIVF,1
4oye,C,83,107,24,KIVVYYLLTSAFAVTLGIIMARLF,1
4oye,C,129,140,11,LVHILLDIVPT,1
4oye,C,151,158,7,LPTIFFA,1
4oye,C,202,218,16,QYAPIGVFALIAYVMA,1
4oye,C,232,250,18,AAVYVGLTLQILLVYFVL,1
4oye,C,302,320,18,LPLGATINMDGTALYQGV,1
4oye,C,391,408,17,ILDMGATMVNVTGDLTG,1
5nc5,G,2,22,20,ELLKSLVFAVIMVPVVMAII,1
4m64,B,13,34,21,GAFGKDFAIGIVYMYLMYYYT,1
4m64,B,43,62,19,VGTLFLVARIWDAINDPIM,1
4m64,B,81,101,20,IGTLTNSLVLFLLFSAHLFE,1
4m64,B,106,128,22,VFVCVTYILWGMTYTIMDIPFW,1
4m64,B,150,171,21,FASLAGFVTAGITLPFVSYVG,1
4m64,B,176,195,19,FGFQMFTLVLIAFFIASTI,1
4m64,B,237,258,21,GMALAYNIASNIINGFAIYYF,1
4m64,B,268,286,18,PYYLSYAGAANLLTLIVF,1
4m64,B,300,316,16,GASVMPVLSCAGLFAM,1
4m64,B,326,343,17,IVAAGIFLNIGTALFWV,1
4m64,B,370,387,17,VQTMVVKGGSAFAAFFI,1
4m64,B,409,428,19,MQFIMIVLPVLFFMMTLVL,1
5era,F,25,48,23,TVLFIFRIMILVVAAKEVWGDEQ,1
5era,F,70,87,17,ISHIRLWALQLIFVSTP,1
5era,F,140,159,19,FFRVIFEAAFMYVFYVMYD,1
5era,F,185,208,23,TEKTVFTVFMIAVSGICILLNVT,1
4av3,B,7,21,14,FLIPLVALGFAAAN,1
4av3,B,55,68,13,AIFKVAIVIAILL,1
4av3,B,78,94,16,AFLLGAVMSASAGIVG,1
4av3,B,128,143,15,MGLSVGGFALLGLVL,1
4av3,B,177,192,15,GYALGCSIIAMFDRV,1
4av3,B,239,254,15,LGADLLESFVGAIVS,1
4av3,B,292,308,16,FALVGLGCSMLGILYV,1
4av3,B,323,336,13,SLWTSALLTVVLT,1
4av3,B,365,380,15,AIIGIFSGILIGFWA,1
4av3,B,415,431,16,SVFPPTLTLVLGILFA,1
4av3,B,441,456,15,IAALGMLSFVATSVS,1
4av3,B,499,514,15,GFAIGSAIFAALSLF,1
4av3,B,545,559,14,AGALLGAAITYYFS,1
4av3,B,612,628,16,YPAFIAILTPLVTGFL,1
4av3,B,634,651,17,GGVLIGTVLSGAMLAIL,1
4av3,B,700,716,16,SLDILIKIMSVVSVIA,1
2n7r,A,7,30,23,ITLTVGFGILIFSLIVTYCINAK,1
2n9y,B,692,716,24,ILVVLLSVMGAILLIGLAPLLIWK,1
4mm4,B,14,32,18,ILAMAGYAVDLGNFLRFP,1
4mm4,B,44,63,19,IPYIIAFLLVGIPLMWIEW,1
4mm4,B,90,117,27,KILGVFGLWIPLVVASYYVYIESWTLG,1
4mm4,B,169,185,16,IVFLITMFINVSILIR,1
4mm4,B,191,211,20,ERFAKIAMPTLFILAVFLVI,1
4mm4,B,245,265,20,AAVGQIFFSLGLGFGVLITF,1
4mm4,B,279,297,18,LTAATLNEKASVILGGSI,1
4mm4,B,343,367,24,WFFLLFFAGLTSSIAGMQGMIAFL,1
4mm4,B,378,394,16,VLWTAAIVFFSAHLVM,1
4mm4,B,403,425,22,DFWATGIGVVFFGLTELIIFFW,1
4mm4,B,448,468,20,YYVMRYITPAFLAVLLVVWA,1
4mm4,B,486,502,16,RFYIIGLFLFLTFLVF,1
5uz7,R,145,171,26,YVLYYLAIVGHSLSIFTLVISLGIFV,1
5uz7,R,183,205,22,HKNMFLTYILNSMIIIIHLVEV,1
5uz7,R,218,245,27,CKILHFFHQYMMACNYFWMLCEGIYLH,1
5uz7,R,261,284,23,YYLLGWGFPLVPTTIHAITRAVY,1
5uz7,R,295,321,26,HLLYIIHGPVMAALVVNFFFLLNIVR,1
5uz7,R,343,360,17,ATMILVPLLGIQFVVFP,1
5uz7,R,367,394,27,LGKIYDYVMHSLIHFQGFFVATIYCFC,1
3s3c,C,7,27,20,ALAVILVLTLTILVFWLGVY,1
3tcu,E,25,45,20,VLFVLTILTLISGTIFYSTV,1
3tcu,E,75,99,24,GKIFTILYIFIGIGLVFGFIHKLA,1
3s0x,B,502,520,18,EYIIGALGLIIASVQDFR,1
3s0x,B,525,542,17,DYIWIFLAVFGVLFAIY,1
3s0x,B,557,577,20,SGFVICFILGYMMFLSGIGG,1
3s0x,B,579,591,12,GKMLIGLGALVP,1
3s0x,B,612,635,23,FPIMVFINGIFFMVFLPFVILFR,1
3s0x,B,703,717,14,PLIIPITLSYLVTP,1
3d38,M,54,71,17,GIAAFAFGSTAILIILF,1
3d38,M,115,131,16,AGLFMTLSLGSWWIRV,1
3d38,M,145,162,17,WNFAAAIFFVLCIGCIH,1
3d38,M,198,216,18,WHGFSIGFAYGCGLLFAA,1
3d38,M,267,284,17,WFFSLMVMVSASVGILL,1
3cap,B,40,63,23,AAYMFLLIMLGFPINFLTLYVTV,1
3cap,B,75,95,20,LLNLAVADLFMVFGGFTTTL,1
3cap,B,113,133,20,GFFATLGGEIALWSLVVLAI,1
3cap,B,155,172,17,GVAFTWVMALACAAPPL,1
3cap,B,202,221,19,FVIYMFVVHFIIPLIVIFF,1
3cap,B,256,277,21,MVIAFLICWLPYAGVAFYIFT,1
3cap,B,289,309,20,IPAFFAKTSAVYNPVIYIMM,1
2yn6,E,211,225,14,LGLIIAASWSVFWL,1
2yn6,E,230,245,15,RLQTSFTLMLTVVAY,1
2yn6,E,266,282,16,IAGYGSIFAAILLIIF,1
2yn6,E,298,315,17,RCRLAFPLGFLAIGCVL,1
4xto,B,24,48,24,YQFTSHILTLGYAVMLAGLLYFIL,1
4xto,B,62,85,23,LSAVVMVSAFLLLYAQAQNWTSS,1
4xto,B,105,124,19,NGYRYLNWLIDVPMLLFQI,1
4xto,B,138,160,22,RNQFWFSGAMMIITGYIGQFYE,1
4xto,B,165,187,22,AFLVWGAISSAFFFHILWVMKK,1
4xto,B,207,229,22,WILFLISWTLYPGAYLMPYLTG,1
4xto,B,238,261,23,GVMARQLVYTIADVSSKVIYGVL,1
3t53,I,16,32,16,LMGALFLSIWGTWTII,1
3t53,I,339,356,17,GKLLEEFIVVAVVCALF,1
3t53,I,364,384,20,VAIISLPLGLCIAFIVMHFQ,1
3t53,I,393,409,16,GGIAIAVGAMVDAAIV,1
3t53,I,450,466,16,FISLLIITLSFIPIFT,1
3t53,I,477,497,20,LAFTKTYAMAGAALLAIVVI,1
3t53,I,540,555,15,LVAALSVLTVLWPLN,1
3t53,I,873,890,17,LMVPMTLMIIFVLLYLA,1
3t53,I,895,918,23,EALLIISSVPFALVGGIWLLWWM,1
3t53,I,926,943,17,GTGFIALAGVAAEFGVV,1
3t53,I,985,1000,15,MTVAVIIAGLLPILW,1
3t53,I,1010,1028,18,RIAAPMIGGMITAPLLSL,1
4s0f,B,171,187,16,IFLASLLYTALGIAGS,1
4s0f,B,214,227,13,VIFLLQIFLNYYR,1
4s0f,B,289,302,13,DTIMAVIGGILLY,1
4s0f,B,309,322,13,FISFIIILLYGII,1
4s0f,B,394,407,13,LTGIVAGLGGIVI,1
4s0f,B,430,443,13,LLAYFLTPVKNLI,1
4mmb,A,14,35,21,ILAMAGYAVDLGNFLRFPVQA,1
4mmb,A,42,63,21,FMIPYIIAFLLVGIPLMWIEW,1
4mmb,A,89,124,35,AKILGVFGLWIPLVVAIYYVYIESWTLGFAIKFLV,1
4mmb,A,167,184,17,AYIVFLITMFINVSILI,1
4mmb,A,191,214,23,ERFAKIAMPTLFILAVFLVIRVF,1
4mmb,A,242,265,23,VWIAAVGQIFFSLGLGFGAIITF,1
4mmb,A,279,298,19,LTAATLNEKAEVILGGSIS,1
4mmb,A,340,367,27,GFLWFFLLFFAGLTSSIAGMQPMIAFL,1
4mmb,A,378,396,18,VLWTAAIVFFSAHLVMFL,1
4mmb,A,400,426,26,DEMDFWAGTIGVVFFGLTELIIFFWI,1
4mmb,A,448,469,21,YYVMRYITPAFLAVLLVVWAR,1
4mmb,A,484,502,18,ITRFYIIGLFLFLTFLVF,1
5lv6,B,648,671,23,GMVGALLLLLVVALGIGLFMRRR,1
4d2c,A,20,36,16,TEMWERFSYYGMRAIL,1
4d2c,A,59,74,15,MAIYASMVYLSGTIG,1
4d2c,A,89,103,14,WGGVLIMLGHIVLA,1
4d2c,A,111,126,15,FGSIILIIIGTGFLK,1
4d2c,A,153,167,14,GINLGAFIAPLIVG,1
4d2c,A,179,193,14,SLAAIGMFIGLLVY,1
4d2c,A,225,240,15,LAVAGFIAIIVVMNL,1
4d2c,A,249,263,14,INLLTIVAIAIPVF,1
4d2c,A,287,306,19,LFIAAVLFWAIEEQGSVVL,1
4d2c,A,324,339,15,QSLNPLFIMLYTPFF,1
4d2c,A,356,370,14,FAVGLMFAGLSFLL,1
4d2c,A,390,404,14,GSWALVILGEMLIS,1
4d2c,A,428,442,14,LSSSVGSALNAQLV,1
4d2c,A,455,471,16,YFGLGSVVLGIVLVFL,1
4a96,E,211,225,14,LGLIIAASWSVFWL,1
4a96,E,230,245,15,RLQTSFTLMLTVVAY,1
4a96,E,266,282,16,IAGYGSIFAAILLIIF,1
4a96,E,300,315,15,RLAFPLGFLAIGCVL,1
3h1k,W,20,36,16,ALTVVLGAVLFERAFD,1
4a82,B,17,33,16,ATIIVGIIKFGIPMLI,1
4a82,B,66,81,15,LFIFVIVRPPIEFIR,1
4a82,B,141,154,13,IWLDCITIIIALS,1
4a82,B,164,177,13,LAALFIFPFYILT,1
4a82,B,249,262,13,AINTVTDIGPIIV,1
4a82,B,286,298,12,LELLFGPLRRLV,1
2k1a,A,963,985,22,IPIWWVLVGVLGGLLLLTILVL,1
5eik,C,30,47,17,FDAAHYVLTCLSVRHDL,1
5eik,C,55,77,22,RKHPFSCWLSCMLMSFAGSFLS,1
5eik,C,96,111,15,LGSIVWYLVFYSPFD,1
5eik,C,113,135,22,FRLATWFPVKLGLSVLKEVQRT,1
5eik,C,158,179,21,VGVAKGAGSGVVKIVEQLARG,1
5eik,C,192,204,12,FTTKACVIASIV,1
5eik,C,224,237,13,VVGFFIYFKLASL,1
5ej1,B,698,712,14,GGMLGLAWISAAIA,1
1et3,S,194,207,13,YSVSLASLTVAVL,1
1et3,S,228,242,14,SFMLRAVSIFVKDA,1
1et3,S,278,292,14,AGCRVAVTFFLYFL,1
1et3,S,321,334,13,WGFTVFGWGLPAV,1
1et3,S,371,385,14,VLNFILFINIVRVL,1
1et3,S,412,423,11,LMPLFGVHYIV,1
1et3,S,452,465,13,FFVAIIYCFCNGE,1
3hd6,C,12,28,16,LTCLLLQVIMVILFGV,1
3hd6,C,61,78,17,SFQDVHVMVFVGFGFLM,1
3hd6,C,89,109,20,GFNFLLAAFGIQWALLMQGW,1
3hd6,C,125,142,17,INADFCVASVCVAFGAV,1
3hd6,C,149,169,20,QLLIMTFFQVTLFAVNEFIL,1
3hd6,C,178,196,18,GGSMTIHTFGAYFGLTVT,1
3hd6,C,221,238,17,MIGTLFLWMYWPSFNSA,1
3hd6,C,250,267,17,INTYCSLAACVLTSVAI,1
3hd6,C,282,297,15,QNATLAGGVAVGTAA,1
3hd6,C,304,321,17,GALIIGFVCGIISTLGF,1
3hd6,C,339,358,19,INNLHGIPGIIGGIVGAVT,1
3hd6,C,395,416,21,YGLLVTLAMALMGGIIVGLIL,1
2ei4,C,15,34,19,WLGIGTLLMLIGTFYFIAR,1
2ei4,C,49,66,17,TILVPGIASAAYLAMFF,1
2ei4,C,84,101,17,YARYADWLFTTPLLLLD,1
2ei4,C,115,132,17,LIGVDALMIVTGLIGAL,1
2ei4,C,139,158,19,YTWWLFSTIAFLFVLYYLL,1
2ei4,C,180,197,17,ALVAVLWTAYPILWIVG,1
2ei4,C,209,227,18,TLAFMVLDVTAKVGFGFV,1
5k2d,A,7,29,22,VYITVELAIAVLAILGNVLVCW,1
5k2d,A,45,67,22,VSLAAADIAVGVLAIPFAITIS,1
5k2d,A,76,98,22,CLFIACFVLVLTQSSIFSLLAI,1
5k2d,A,123,144,21,IIAICWVLSFAIGLTPMLGWN,1
5k2d,A,173,195,22,MNYMVYFNFFACVLVPLLLMLG,1
5k2d,A,236,259,23,IIVGLFALCWLPLHIINCFTFFC,1
5k2d,A,266,288,22,LWLMYLAIVLSHTNSVVNPFIY,1
5edl,A,10,31,21,IMSVISIVFAVVYLLFTHFGN,1
5edl,A,40,59,19,AYEPIYGIWFIVSVIAAYM,1
5edl,A,64,84,20,AALVSEIIAALVECLLGNPS,1
5edl,A,86,105,19,MVIVIGIVQGLGAEAVFLA,1
5edl,A,114,135,21,VLMLAGMGSSVASFIYDLFVS,1
5edl,A,143,171,28,YLLIMLVIRLISGALLAGLLGKAVSDSL,1
4qe9,D,21,41,20,RILLLVLAVIIYGTAGFHFI,1
4qe9,D,71,99,28,GMYFTCTLIVLGIGTFAVAVERLLEFLI,1
4xnv,A,57,80,23,YILVFIIGFLGNSVAIWMFVFHM,1
4xnv,A,86,108,22,SVYMFNLALADFLYVLTLPALI,1
4xnv,A,123,150,27,CKLQRFIFHVNLYGSILFLTCISAHRY,1
4xnv,A,168,190,22,ICISVLVWLIVVVAISPILFYS,1
4xnv,A,214,242,28,FIYSMCTTVAMFCVPLVLILGCYGLIVR,1
4xnv,A,256,282,26,KSIYLVIIVLTVFAVSYIPFHVMKTM,1
4xnv,A,309,331,22,RGLASLNSCVNPILYFLAGDTF,1
3zuw,M,53,71,18,SLGVLSLFSGLMWFFTIG,1
3zuw,M,118,135,17,SFFMFVAVWSWWGRTYL,1
3zuw,M,145,163,18,TAWAFLSAIWLWMVLGFI,1
3zuw,M,201,221,20,HGLSIAFLYGSALLFAMHGA,1
3zuw,M,268,285,17,AIWMAVLVTLTGGIGIL,1
3omi,B,61,81,20,LVIIAAITIFVTLLILYAVW,1
3omi,B,99,117,18,LEIAWTIVPIVILVAIGA,1
2nwx,C,15,28,13,ILIGLILGAIVGL,1
2nwx,C,43,60,17,KPFGDLFVRLLKMLVMP,1
2nwx,C,83,100,17,KIVVYYLLTSAFAVTLG,1
2nwx,C,131,140,9,HILLDIVPT,1
2nwx,C,151,158,7,LPTIFFA,1
2nwx,C,202,217,15,QYAPIGVFALIAYVM,1
2nwx,C,236,250,14,VGLTLQILLVYFVL,1
2nwx,C,303,317,14,PLGATINMDGTALY,1
2nwx,C,392,408,16,LDMGRTMVNVTGDLTG,1
3uso,B,14,35,21,ILAMAGNAVGLGNFLRFPVQA,1
3uso,B,42,63,21,FMIPYIIAFLLVGIPLMWIEW,1
3uso,B,89,124,35,AKILGVFGLWIPLVVAIYYVYIESWTLGFAIKFLV,1
3uso,B,167,185,18,AYIVFLITMFINVSILIR,1
3uso,B,191,214,23,ERFAKIAMPTLFILAVFLVIRVF,1
3uso,B,242,265,23,VWIAAVGQIFFTLSLGFGAIITY,1
3uso,B,278,298,20,GLTAATLNEKAEVILGGSIS,1
3uso,B,340,367,27,GFLWFFLLFFAGLTSSIAIMQPMIAFL,1
3uso,B,377,396,19,AVLWTAAIVFFSAHLVMFL,1
3uso,B,400,425,25,DEMDFWAGTIGVVFFGLTELIIFFW,1
3uso,B,445,472,27,RIYYYVMRYITPAFLAVLLVVWAREYI,1
3uso,B,484,502,18,ITRFYIIGLFLFLTFLVF,1
2j7a,F,17,33,16,GGATLGVVALATVAFG,1
5ckr,B,24,41,17,RSFTAVLIAFFLTLVLS,1
5ckr,B,78,93,15,IVILIVVTLSTLLLM,1
5ckr,B,99,116,17,TWVVLLSFLSFGTIGFW,1
5ckr,B,131,148,17,TKFLLQVLSASLISVLI,1
5ckr,B,173,193,20,YLPFAVFVIVGSANAVNLTD,1
5ckr,B,198,214,16,AIGPAMTTATALGVVA,1
5ckr,B,237,253,16,TVFCFALVGAGLGFLW,1
5ckr,B,266,283,17,GSLSIGASLATVALLTK,1
5ckr,B,285,304,19,FIFAVAAGVFVFETISVIL,1
5ckr,B,339,355,16,RMWIISILLAIIAISM,1
4iar,A,52,72,20,VMLLALITLATTLSNAFVIA,1
4iar,A,89,107,18,SLAVTDLLVSILVMPIST,1
4iar,A,121,142,21,CDFWLSSDITCCTASIWHLCV,1
4iar,A,170,186,16,ALVWVFSISISLPPFF,1
4iar,A,206,226,20,LYTVYSTVGAFYFPTLLLIA,1
4iar,A,317,336,19,IILGAFIVCWLPFFIISLV,1
4iar,A,351,371,20,DFFTWLGYLNSLINPIIYTM,1
1o5w,A,495,517,22,PSVPGLLKITGVSTSVALLCFV,1
5are,W,13,26,13,ILGLPLVTLIVLF,1
5are,W,77,89,12,FIGSTNLLGLLP,1
5are,W,96,110,14,QLSMNLGMAIPLWA,1
5are,W,150,169,19,IQPMALAVRLTANITAGHL,1
5are,W,194,212,18,ILILLTILEFAVAMIQAY,1
2jaf,C,33,52,19,WVNVALAGIAILVFVYMGR,1
2jaf,C,62,79,17,WGATLMIPLVSISSYLG,1
2jaf,C,107,124,17,RYLTWALSTPMILLALG,1
2jaf,C,133,151,18,LFTVIAADIGMCVTGLAA,1
2jaf,C,163,180,17,FYAISCAFFVVVLSALV,1
2jaf,C,199,216,17,RVLVVVLWLGYPIVWAV,1
2jaf,C,231,251,20,WAYSVLDVFAKYVFAFILLR,1
3nd0,B,33,57,24,AAIVVGLITGVLGAGFKSAVNNML,1
3nd0,B,77,93,16,TALISGGMVALSFWLM,1
3nd0,B,125,138,13,IKLVGGFLSLGAG,1
3nd0,B,140,152,12,AGFEGPTIQMGG,1
3nd0,B,211,227,16,SLLFGCVMATIILRMI,1
3nd0,B,248,272,24,MFIILGILFGVMGYTFNRGLFKVL,1
3nd0,B,283,297,14,KWKGFLLGSIIGIL,1
3nd0,B,330,343,13,GRFLLTLICYGSG,1
3nd0,B,345,357,12,GGIFAPMLGIAS,1
3nd0,B,415,431,16,PLLVTCLVASVVAEAL,1
4kt0,M,13,29,16,VALLPAFLAFRLSTEL,1
4il4,E,195,217,22,SYIPNIILPMLFILFISWTAFW,1
4il4,E,223,244,21,NVTLVVSTLIAHIAFNILVET,1
4il4,E,252,275,23,TYTGAIIFMIYLFYFVAVIEVTV,1
4il4,E,295,315,20,RIAFPVVFLLANIILAFLFF,1
5hvd,D,13,34,21,FQNVITAIIVLNGAVLGLLTD,1
5hvd,D,41,65,24,QNLLERVDQLCLTIFIVEISLKIY,1
5hvd,D,73,91,18,RSGWNLFDFVIVAIALMP,1
5hvd,D,101,118,17,FRIFRVMRLVSVIPTMR,1
5hvd,D,120,153,33,VQGMLLALPGVGSVAALLTVVFYIAAVMATNLY,1
5hvd,D,195,222,27,WVFFIPFIMLTTFTVLNLFIGICVDAM,1
5te5,A,38,63,25,MLAAYMFLLIMLGFPINFLTLYVTV,1
5te5,A,74,99,25,ILLNLAVADLFMVFGGFTTTLYTSL,1
5te5,A,109,133,24,CNLEGFFATLGGEIALWSLVVLAI,1
5te5,A,154,176,22,MGVAFTWVMALACAAPPLVGWS,1
5te5,A,200,225,25,ESFVIYMFVVHFIIPLIVIFFCYGQ,1
5te5,A,253,277,24,VIIMVIAFLICWLPYAGVAFYIFT,1
5te5,A,287,309,22,MTIPAFFAKTSAVYNPVIYIMM,1
5d59,A,19,36,17,MTEMWERFSYYGMRAIL,1
5d59,A,59,74,15,MAIYASMVYLSGTIG,1
5d59,A,87,103,16,VFWGGVLIMLGHIVLA,1
5d59,A,112,127,15,GSIILIIIGTGFLKP,1
5d59,A,152,167,15,FGINLGAFIAPLIVG,1
5d59,A,179,195,16,SLAAIGMFIGLLVYYF,1
5d59,A,222,238,16,KVSLAVAGFIAIIVVM,1
5d59,A,249,266,17,INLLTIVAIAIPVFYFA,1
5d59,A,287,307,20,LFIAAVLFWAIEEQGSVVLA,1
5d59,A,323,339,16,FQSLNPLFIMLYTPFF,1
5d59,A,356,371,15,FAVGLMFAGLSFLLM,1
5d59,A,388,404,16,LVGSWALVILGEMLIS,1
5d59,A,426,442,16,WFLSSSVGSALNAQLV,1
5d59,A,455,471,16,YFGLGSVVLGIVLVFL,1
1vcr,A,58,81,23,SKNRELEVIHSRWAMLGALGCVF,1
1vcr,A,131,143,12,VILMGAVEGYRI,1
1vcr,A,176,197,21,KVKELKNGRLAMFSMFGFFVQ,1
2ht3,B,37,57,20,MAAVVGTLVGLAAVAFDKGV,1
2ht3,B,84,97,13,CSAVLAMFGYFLV,1
2ht3,B,128,142,14,PVKFFGGLGTLGGG,1
2ht3,B,144,159,15,LGREGPTVQIGGNIG,1
2ht3,B,216,229,13,AVFIGVIMSTIMY,1
2ht3,B,256,277,21,ILGIIFGIFGPIFNKWVLGMQ,1
2ht3,B,290,303,13,WVLMGGAIGGLCG,1
2ht3,B,338,351,13,ARVITTLLCFSSG,1
2ht3,B,353,364,11,GGIFAPMLALG,1
2ht3,B,423,439,16,PMIITGLGATLLAQFT,1
3pcq,X,13,30,17,FWAVLLLAINFLVAAYY,1
4wfe,B,33,51,18,ALLALVLLYLVSGALVFR,1
4wfe,B,141,162,21,GRLFCIFYALVGIPLFGILLA,1
4wfe,B,203,221,18,IGCLLFVLTPTFVFCYME,1
4wfe,B,255,280,25,AYQPLVWFWILLGLAYFASVLTTIG,1
2xqu,P,14,33,19,ALAVGIGSIGPGLGQGQAA,1
2xqu,P,56,74,18,SLAFMEALTIYGLVVALV,1
2xq4,E,198,214,16,NIILPMLFILFISWTA,1
2xq4,E,225,240,15,LVVSTLIAHIAFNIL,1
2xq4,E,255,271,16,AIIFMIYLFYFVAVIE,1
2xq4,E,295,312,17,IAFPVVFLLANIILAFL,1
3p4r,P,12,37,25,FWGLFGAGGMWSAIIAPVMILLVGI,1
3p4r,P,62,86,24,GRVFLFLMIVLPLWCGLHRMHHAM,1
3p4r,P,94,116,22,AGKWVFYGLAAILTVVTLIGVV,1
1v54,Z,17,34,17,GLSVTFLSFLLPAGWVL,1
4ilb,E,202,218,16,LPMLFILFISWTAFWS,1
4ilb,E,222,239,17,ANVTLVVSTLIAHIFFN,1
4ilb,E,258,275,17,IFMIYLFYFVAVIEVTV,1
4ilb,E,293,312,19,ASRIAFPVVFLLANIILAF,1
5cfb,E,224,239,15,IQMYIPSLLIVILSW,1
5cfb,E,256,271,15,ITTVLTMTTQSSGSR,1
5cfb,E,283,299,16,DIWMAVCLLFVFSALL,1
5cfb,E,330,344,14,PLAFLIFNIFYWVI,1
4wgv,A,70,87,17,ILISSLAAMLLQSMTVR,1
4wgv,A,108,132,24,AIIFWIIAELAIIATDIAEVIGSA,1
4wgv,A,146,157,11,ALITVFDVFLL,1
4wgv,A,159,178,19,IMRFGFRKIEAIVGTLIFT,1
4wgv,A,218,234,16,GIIGATIMPHNLYLHS,1
4wgv,A,256,272,16,ATIDSNLQLSIAFVVN,1
4wgv,A,322,342,20,LLASGQNSTITGTLAGQIVM,1
4wgv,A,352,369,17,WLRRLITRSLAVIPVII,1
4wgv,A,386,405,19,FSQVFLSIALPFSLIPLQL,1
4wgv,A,415,436,21,FINKTWVNIISWTLIVILSGL,1
2dwd,F,25,50,25,WRAAGAATVLLVIVLLAGSYLAVLA,1
2dwd,F,87,114,27,GRCVAVVVMVAGITSFGLVTAALATWF,1
5svs,C,29,47,18,VQLLIISYFVGWVFLHEK,1
5svs,C,316,343,27,NIIPTIISSVAAFTSVGVGTVLCDIIL,1
1z65,A,5,25,20,GTWWVAILCMLLASHLSTVK,1
3ldd,D,24,41,17,LLVLAVIIYGTAGFHFI,1
3ldd,D,71,92,21,GMYFTCTLIVLGIGTFAVAVE,1
1t9t,C,13,25,12,VIAIIIMLAGGL,1
1t9t,C,342,354,12,TLVEAIILVFLV,1
1t9t,C,369,382,13,IAVPVVLLGTFAV,1
1t9t,C,398,409,11,VLAIGLLVDDA,1
1t9t,C,444,457,13,IAMVLSAVFVPMA,1
1t9t,C,472,485,13,TIVSAMALSVLVA,1
1t9t,C,544,556,12,YLIIVVGMAYLF,1
1t9t,C,875,888,13,LYAISLIVVFLCL,1
1t9t,C,902,916,14,LVVPLGVIGALLAA,1
1t9t,C,929,941,12,GLLTTIGLSAKN,1
1t9t,C,978,992,14,SLAFILGVMPLVIS,1
1t9t,C,1004,1018,14,TGVMGGMVTATVLA,1
3ud0,E,13,31,18,ISTIGLLGAGIGIAIVFA,1
3ud0,E,52,71,19,LGFALSEATGLFCLMVSFL,1
1vz1,A,24,43,19,QVLFPLLYTVLFFVGLITN,1
1vz1,A,60,83,23,IFLKNTVISDLLMILTFPFKILS,1
1vz1,A,99,123,24,TSVIFYFTMYISISFLGLITIDRY,1
1vz1,A,144,161,17,SVVIWAFMFLLSLPNMI,1
1vz1,A,190,212,22,NYICQVIFWINFLIVIVCYTLI,1
1vz1,A,236,259,23,KVFIIIAVFFICFVPFHFARIPY,1
1vz1,A,273,302,29,NTLFYVKESTLWLTSLNACLDPFIYFFLC,1
1ov0,A,36,60,24,FSMLAAYMFLLIMLGFPINFLTLY,1
1ov0,A,75,99,24,LLNLAVADLFMVFGGFTTTLYTSL,1
1ov0,A,109,133,24,CNLEGFFATLGGEIALWSLVVLAI,1
1ov0,A,152,176,24,AIMGVAFTWVMALACAAPPLVGWS,1
1ov0,A,200,222,22,ESFVIYMFVVHFIIPLIVIFFC,1
1ov0,A,254,279,25,IIMVIAFLICWLPYAGVAFYIFTHQ,1
1ov0,A,287,309,22,MTIPAFFAKTSAVYNPVIYIMM,1
4bgn,E,32,47,15,IVLIVINAIVVGMET,1
4bgn,E,58,75,17,FYLIDRMILWVFTAEII,1
4bgn,E,95,112,17,DFLIVASGHLFVGAQFV,1
4bgn,E,114,129,15,LRVLRVLRLLRAVTV,1
4bgn,E,148,165,17,NIMLLMGLIFYIFGVMG,1
4bgn,E,213,230,17,YFVAFILVGTFVIFNLF,1
5a2o,B,32,56,24,SAAMILCIEAVERLTTLGIGVNLV,1
5a2o,B,69,89,20,AANTVTNFLGTSFMLCLLGG,1
5a2o,B,100,120,20,TIAIFAAIQATGVSILTLST,1
5a2o,B,144,172,28,QLTVLYLALYLTALGTGGVKASVSGFGS,1
5a2o,B,186,209,23,TYFFNRFFFCINVGSLLAVTVLV,1
5a2o,B,218,239,21,WGYGICAFAIVLALSVFLAGT,1
5a2o,B,343,364,21,PIWATCILFWTVHAQLTTLSV,1
5a2o,B,383,411,28,MAVFYVGGLLLTTAVYDRVAIRLCKKLF,1
5a2o,B,416,438,22,LRPLQRIGLGLFFGSMAMAVAA,1
5a2o,B,467,486,19,QYLIVGIGEALIYTGQLDF,1
5a2o,B,501,525,24,LLLSTLALGFFFSSVLVTIVEKFT,1
5a2o,B,544,564,20,YWLVAVLVALNFLIFLVFSK,1
2h8a,C,14,33,19,FTSYATIILAKMMFLSSAT,1
2h8a,C,75,94,19,LNDLENIVPFLGIGLLYSL,1
2h8a,C,103,122,19,IHFRIFVGARIYHTIAYLT,1
2h8a,C,127,146,19,NRGLAFFVGYGVTLSMAYR,1
5sxu,E,207,225,18,FILPLGLIIAASWSVFWL,1
5sxu,E,231,248,17,LQTSFTLMLTVVAYAFY,1
5sxu,E,265,282,17,IIAGYGSIFAAILLIIF,1
5sxu,E,300,316,16,RLAFPLGFLAIGCVLV,1
2q6h,A,16,35,19,AMAGNAVGLGNFLRFPVQA,1
2q6h,A,42,62,20,FMIPYIIAFLLVGIPLMWIE,1
2q6h,A,93,120,27,GVFGLWIPLVVAIYYVYIESWTLGFAI,1
2q6h,A,168,185,17,YIVFLITMFINVSILIR,1
2q6h,A,191,212,21,ERFAKIAMPTLFILAVFLVIR,1
2q6h,A,239,265,26,DPGVWIAAVGQIFFTLSLGFGAIITY,1
2q6h,A,279,297,18,LTAATLNEKAEVILGGSI,1
2q6h,A,343,364,21,WFFLLFFAGLTSSIAIMQPMI,1
2q6h,A,377,396,19,AVLWTAAIVFFSAHLVMFL,1
2q6h,A,400,421,21,DEMDFWAGTIGVVFFGLTELI,1
2q6h,A,451,473,22,MRYITPAFLAVLLVVWAREYIP,1
2q6h,A,484,500,16,ITRFYIIGLFLFLTFL,1
3nsb,C,10,31,21,IWLALGTALMGLGTLYFLVKG,1
3nsb,C,44,62,18,ITTLVPAIAFTMYLSMLL,1
3nsb,C,80,97,17,ARYADWLFTTPLLLLDL,1
3nsb,C,109,127,18,ALVGADGIMIGTGLVGAL,1
3nsb,C,134,153,19,FVWWAISTAAMLYILYVLF,1
3nsb,C,174,192,18,RNVTVVLWSAYPVVWLIG,1
3nsb,C,203,224,21,ETLLFMVLDVSAKVGFGLILL,1
4npp,E,199,218,19,NIILPMLFILFISWTAFWS,1
4npp,E,222,240,18,ANVTLVVSTLIAHIAFNI,1
4npp,E,256,275,19,AIIFMIYLFYFVAVIEVTV,1
4npp,E,292,313,21,RASRIAFPVVFLLANIILAFL,1
5vdh,E,228,244,16,IPSLLIVILSWVSFWI,1
5vdh,E,249,268,19,PARVALGITTVLTMTTQSS,1
5vdh,E,285,305,20,WMAVCLLFVFSALLEYAAVN,1
5vdh,E,323,344,21,TISRACFPLAFLIFNIFYWVI,1
4ea3,A,51,74,23,VTIVGLYLAVCVGGLLGNCLVMY,1
4ea3,A,90,111,21,FNLALADTLVLLTLPFQGTDI,1
4ea3,A,119,143,24,NALCKTVIAIDYYNMFTSTFTLTA,1
4ea3,A,171,190,19,VAIWALASVVGVPVAIMGS,1
4ea3,A,209,232,23,YWGPVFAICIFLFSFIVPVLVIS,1
4ea3,A,267,292,25,VVAVFVGCWTPVQVFVLAQGLGVQP,1
4ea3,A,297,320,23,VAILRFCTALGYVNSCLNPILYA,1
5a3q,A,62,77,15,RILLLAACISFVLAW,1
5a3q,A,88,101,13,VEPFVILLILIAN,1
5a3q,A,260,275,15,SKVISLICVAVWLIN,1
5a3q,A,293,311,18,YYFKIAVALAVAAIPEGL,1
5a3q,A,764,780,16,ISSNVGEVVCIFLTAA,1
5a3q,A,787,804,17,IPVQLLWVNLVTDGLPA,1
5a3q,A,835,851,16,RYMAIGGYVGAATVGA,1
5a3q,A,899,915,16,ALSVLVTIEMCNALNS,1
5a3q,A,932,950,18,LLGSICLSMSLHFLILYV,1
5a3q,A,971,987,16,KISLPVIGLDEILKFI,1
1z8e,A,36,56,20,PVSYGVVCVLGLCLNAVALY,1
1z8e,A,70,92,22,YMFHLAVSDALYAASLPLLVYY,1
1z8e,A,108,129,21,VRFLFYTNLYCSILFLTCISV,1
1z8e,A,152,170,18,VAGAVWVLVLACQAPVLY,1
1z8e,A,199,222,23,SVMLGLLFAVPFAVILVCYVLMA,1
1z8e,A,246,266,20,IAVVLAVFALCFLPFHVTRT,1
1z8e,A,291,309,18,RPLASANSCLDPVLYFLA,1
1ott,B,37,58,21,MAAVVGTLVGLAAVAFDKGVA,1
1ott,B,84,97,13,CSAVLAMFGYFLV,1
1ott,B,129,142,13,VKFFGGLGTLGGG,1
1ott,B,144,156,12,LGRAGPTVQIGG,1
1ott,B,216,231,15,AVFIGVIMSTIMYRI,1
1ott,B,253,274,21,LYLILGIIFGIFGPIFNKWVL,1
1ott,B,290,304,14,WVLMGGAIGGLCGL,1
1ott,B,338,351,13,ARVITTLLCFSSG,1
1ott,B,353,365,12,GGIFAPMLALGT,1
1ott,B,423,439,16,PMIITGLGATLLAQFT,1
1oyd,C,11,27,16,AWVIAIIIMLAGGLAI,1
1oyd,C,341,357,16,KTLVEAIILVFLVMYL,1
1oyd,C,366,386,20,IPTIAVPVVLLGTFAVLAAF,1
1oyd,C,395,411,16,FGMVLAIGLLVDDAIV,1
1oyd,C,443,458,15,GIAMVLSAVFVPMAF,1
1oyd,C,469,489,20,FSITIVSAMALSVLVALILT,1
1oyd,C,542,557,15,VLYLIIVVGMAYLFV,1
1oyd,C,874,891,17,SLYAISLIVVFLCLAAL,1
1oyd,C,899,919,20,SVMLVVPLGVIGALLAATFR,1
1oyd,C,927,943,16,QVGLLTTIGLSAKNAI,1
1oyd,C,976,993,17,MTSLAFILGVMPLVIST,1
1oyd,C,1001,1019,18,AVGTGVMGGMVTATVLAI,1
5tr1,B,47,71,24,EDWYFLTVLGVLMALISFTMSFTV,1
5tr1,B,98,112,14,YPVALVSFSSGFSQ,1
5tr1,B,144,159,15,GAKAVGLTCTLASGS,1
5tr1,B,161,177,16,FLGKVGPFVHLSVMIA,1
5tr1,B,234,253,19,DYWRGFFAATCGAFMFRLL,1
5tr1,B,280,303,23,EIFFFVALGAICGVASCAYLFCQ,1
5tr1,B,324,339,15,PLYSALAALVLASVT,1
5tr1,B,404,420,16,FLVMKFWMLILATTIP,1
5tr1,B,422,437,15,AGYFMPIFIFGAAIG,1
5tr1,B,467,480,13,LAGAAAFSGAVTH,1
5tr1,B,482,492,10,STALLAFELT,1
5tr1,B,498,513,15,LPVLMAVLAANAIAQ,1
4rng,C,12,31,19,IIAGAITTSALIPQALKIY,1
4rng,C,40,59,19,LAMFIFMAIGITLWFFYGV,1
4rng,C,65,85,20,VILANLISLILIFLIIFMKI,1
1t9y,C,11,27,16,AWVIAIIIMLAGGLAI,1
1t9y,C,341,357,16,KTLVEAIILVFLVMYL,1
1t9y,C,366,386,20,IPTIAVPVVLLGTFAVLAAF,1
1t9y,C,395,411,16,FGMVLAIGLLVDDAIV,1
1t9y,C,442,458,16,VGIAMVLSAVFVPMAF,1
1t9y,C,470,489,19,SITIVSAMALSVLVALILT,1
1t9y,C,541,557,16,LVLYLIIVVGMAYLFV,1
1t9y,C,874,891,17,SLYAISLIVVFLCLAAL,1
1t9y,C,898,919,21,FSVMLVVPLGVIGALLAATFR,1
1t9y,C,927,943,16,QVGLLTTIGLSAKNAI,1
1t9y,C,975,993,18,LMTSLAFILGVMPLVIST,1
1t9y,C,1001,1021,20,AVGTGVMGGMVTATVLAIFF,1
2xfq,A,486,498,12,PSVPGLLRLIGL,1
4l35,C,8,30,22,IWLWLGTAGMFLGMLYFIARGW,1
4l35,C,40,60,20,YIATILITAIAFVNYLAMAL,1
4l35,C,78,96,18,ARYSDWLFTTPLLLYDLG,1
4l35,C,106,126,20,SSLVSLDVLMIGTGLVATLS,1
4l35,C,138,158,20,LVWWGISTAFLLVLLYFLFS,1
4l35,C,177,196,19,LRNLVTVVWLVYPVWWLVG,1
4l35,C,207,229,22,ETAGFMVIDLVAKVGFGIILLR,1
2j8c,M,55,72,17,GVLSLFSGLMWFFTIGI,1
2j8c,M,117,134,17,ASFFMFVAVWSWWGRTY,1
2j8c,M,147,164,17,WAFLSAIWLWMVLGFIR,1
2j8c,M,200,221,21,FHGLSIAFLYGSALLFAMHGA,1
2j8c,M,268,286,18,AIWMAVLVTLTGGIGILL,1
5d5b,A,32,57,25,VVGMGIVMSLIVLAIVFGNVLVITA,1
5d5b,A,70,95,25,FITSLACADLVMGLAVVPFGAAHIL,1
5d5b,A,105,130,25,CEFWTSIDVLCVTASIETLCVIAVD,1
5d5b,A,151,174,23,VIILMVWIVSGLTSFLPIQMHWY,1
5d5b,A,196,221,25,QAYAIASSIVSFYVPLVIMVFVYSR,1
5d5b,A,274,298,24,LGIIMGTFTLCWLPFFIVNIVHVI,1
5d5b,A,306,327,21,VYILLNWIGYVNSGFNPLIYC,1
5t1a,A,44,68,24,LPPLYSLVFIFGFVGNMLVVLILI,1
5t1a,A,80,100,20,LLNLAISDLLFLITLPLWAH,1
5t1a,A,112,136,24,CKLFTGLYHIGYFGGIFFIILLTI,1
5t1a,A,159,179,20,TSVITWLVAVFASVPGIIFT,1
5t1a,A,198,222,24,NNFHTIMRNILGLVLPLLIMVICY,1
5t1a,A,245,270,25,FTIMIVYFLFWTPYNIVILLNTFQE,1
5t1a,A,287,308,21,QVTETLGMTHCCINPIIYAFV,1
4il9,E,195,217,22,SYIPNIILPMLFILFISWTAFW,1
4il9,E,223,244,21,NVTLVVSTLIAHIFFNILVET,1
4il9,E,252,275,23,TYTGAIIFMIYLFYFVAVIEVTV,1
4il9,E,295,315,20,RIAFPVVFLLANIILAFLFF,1
2cfq,A,8,31,23,FWMFGLFFFFYFFIMGAYFPFFP,1
2cfq,A,44,64,20,TGIIFAAISLFSLLFQPLFG,1
2cfq,A,75,91,16,LLWIITGMLVMFAPFF,1
2cfq,A,106,129,23,SIVGGIYLGFCFNAGAPAVEAFI,1
2cfq,A,142,160,18,ARMFGCVGWALGASIVGI,1
2cfq,A,170,188,18,WLGSGCALILAVLLFFAK,1
2cfq,A,225,244,19,SLYVIGVSCTYDVFDQQFA,1
2cfq,A,260,279,19,FGYVTTMGELLNASIMFFA,1
2cfq,A,291,309,18,LLLAGTIMSVRIIGSSFA,1
2cfq,A,314,333,19,VVILKTLHMFEVPFLLVGC,1
2cfq,A,352,373,21,CFCFFKQLAMIFMSVLAGNMY,1
2cfq,A,379,399,20,GAYLVLGLVALGFTLISVFT,1
4ryn,A,7,27,20,IIVFFLTYGLFYVSSVLFPI,1
4ryn,A,42,66,24,PGMTIGMIWAVLFGLIALSVAIIY,1
4ryn,A,75,96,21,FWFLFLLNYIFNQAFSYFQFS,1
4ryn,A,101,122,21,LATVDCLLVAITTLLLIMFSS,1
4ryn,A,127,148,21,SAWLLIPYFLWSAFATYLSWT,1
4wfh,B,32,51,19,LALLALVLLYLVSGALVFR,1
4wfh,B,141,165,24,GRLFCIFYALVGIPLFGILLAGVG,1
4wfh,B,200,220,20,FLLIGCLLFVLTPTFVFCYM,1
4wfh,B,255,274,19,AYQPLVWFWILLGLAYFAS,1
2xq9,E,198,215,17,NIILPMLFILFISWTAF,1
2xq9,E,223,240,17,VTLVVSTLIAHIAFNIL,1
2xq9,E,255,273,18,AIIFMIYLFYFVAVIEVT,1
2xq9,E,295,312,17,IAFPVVFLLANIILAFL,1
5doq,C,771,784,13,PMVVVALSVVAAF,1
5arh,W,10,20,10,TPVILGLPLV,1
5arh,W,81,95,14,TNLLGLLPHSFTPT,1
5arh,W,97,106,9,LSMNLGMAI,1
5arh,W,158,179,21,RLTANITAGHLLIHLIGGATL,1
5arh,W,185,204,19,TTTALITFTILILLTILEF,1
5j4i,B,17,32,15,MVSGNIMGSGVFLLP,1
5j4i,B,42,57,15,IYGWLVTIIGALGLS,1
5j4i,B,92,113,21,YWLACWIGNIAMVVIGVGYLS,1
5j4i,B,124,140,16,LTITCVVVLWIFVLLN,1
5j4i,B,148,171,23,RVQAVATVLALIPIVGIAVFGWF,1
5j4i,B,191,209,18,AIQSTLNVTLWSFIGVES,1
5j4i,B,229,246,17,GGVLIAAVCYVLSTTAI,1
5j4i,B,277,297,20,VSFCAAAGCLGSLGGWTLLA,1
5j4i,B,328,342,14,IVGILMTIFQLSSI,1
5j4i,B,347,366,19,KEFGLVSSVSVIFTLVPYL,1
5j4i,B,390,407,17,TTIAFLYCIWAVVGSGA,1
5j4i,B,409,423,14,VMWSFVTLMVITAM,1
4brb,C,34,48,14,GVAVLLCVVIAAWL,1
4brb,C,53,68,15,TRVLLISSVMLVMIV,1
4brb,C,102,117,15,IAIIDAVITWAILLW,1
2m3b,E,31,49,18,FINFCLILICLLLICIIV,1
2vrl,A,486,501,15,PSVPGLLRLIGLTTI,1
4nef,D,13,30,17,FAEFLATLLFVFFGLGS,1
4nef,D,43,60,17,IAMAFGLGIGTLVQALG,1
4nef,D,87,104,17,FYVAAQLLGAVAGAALL,1
4nef,D,131,148,17,TVELFLTLQLVLCIFAS,1
4nef,D,160,175,15,ALSIGFSVALGHLLG,1
4nef,D,202,219,17,VFWIGPLVGAILGSLLY,1
2m20,B,65,89,24,ATGLVGALLLLLVVALGIGLFIRR,1
3kzi,Z,11,26,15,LVILSFVMVIGVPVA,1
3kzi,Z,37,53,16,QLIFLGSGLWIALVLV,1
4pov,A,12,31,19,EIAFMAALAFIISLIPNTV,1
4pov,A,36,49,13,VEIACIPILLLSL,1
4pov,A,54,73,19,AGLVGGLIWGILSMITGHA,1
4pov,A,79,96,17,QAFLEYLVAPVSLGIAG,1
4pov,A,111,130,19,LGTFVAVLLKYFFHFIAGI,1
4pov,A,148,169,21,AVNGISGILTAIAAFVILIIF,1
3tx3,A,36,53,17,NLILFSLAFTWLYGEVD,1
3tx3,A,76,97,21,LAVITIIALFSFIFSTIMHLI,1
3f3a,B,14,32,18,ILAMAGNAVGLGNFLRFP,1
3f3a,B,42,63,21,FMIPYIIAFLLVGIPLMWIEW,1
3f3a,B,89,124,35,AKILGVFGLWIPLVVAIYYVYIESWTLGFAIKFLV,1
3f3a,B,167,184,17,AYIVFLITMFINVSILI,1
3f3a,B,191,212,21,ERFAKIAMPTLFILAVFLVIR,1
3f3a,B,242,265,23,VWIAAVGQIFFTLSLGFGAIITY,1
3f3a,B,278,297,19,GLTAATLNEKAEVILGGSI,1
3f3a,B,340,367,27,GFLWFFLLFFAGLTSSIAIMQPMIAFL,1
3f3a,B,378,396,18,VLWTAAIVFFSAHLVMFL,1
3f3a,B,400,426,26,DEMDFWAGTIGVVFFGLTELIIFFWI,1
3f3a,B,445,469,24,RIYYYVMRYITPAFLAVLLVVWAR,1
3f3a,B,484,502,18,ITRFYIIGLFLFLTFLVF,1
2loq,A,2,37,35,KESGWDSGRAAVAAVVGGVVAVGTVLVALSAMGFT,1
2loq,A,59,91,32,GGVAAGSLVAILQSVGAAGLSVTSKVIGGFAG,1
2iqs,A,50,73,23,FVTLGVISLLENILVIVAIAKNK,1
2iqs,A,79,99,20,YFFICSLAVADMLVSVSNGS,1
2iqs,A,125,149,24,DSVICSSLLASICSLLSIAVDRYF,1
2iqs,A,164,187,23,RVGIIISCIWAACTVSGILFIIY,1
2iqs,A,193,217,24,IICLITMFFTMLALMASLYVHMFL,1
2iqs,A,241,263,22,KGAITLTILIGVFVVCWAPFFL,1
2iqs,A,288,308,20,ILIMCNSIIDPLIYALRSQE,1
2b6v,A,22,45,23,QIIPVLYCMVFIAGILLNGVSGW,1
2b6v,A,60,83,23,KNIVIADFVMSLTFPFKILGDSG,1
2b6v,A,93,114,21,CRVSAVLFYVNMYVSIVFFGL,1
2b6v,A,140,161,21,LSVIVWMLMLLLAVPNIILTN,1
2b6v,A,182,204,22,WHKASNYIFVAIFWIVFLLLIV,1
2b6v,A,238,259,21,VFVFFVCFVPYHIARIPYTKS,1
2b6v,A,276,295,19,KEFTLLLSAANVCLDPIIY,1
3zum,M,55,72,17,GVLSLFSGLMWFFTIGI,1
3zum,M,118,133,15,SFFMFVAVWSWWGRT,1
3zum,M,147,163,16,WAFLSAIWLWMVLGFI,1
3zum,M,201,221,20,HGLSIAFLYGSALLFAMHGA,1
3zum,M,269,285,16,IWMAVLVTLTGGIGIL,1
5wzy,C,39,55,16,ALVIAYVIGYVCVYNK,1
5wzy,C,331,352,21,KFNIIPTLLNIGAGLALLGLV,1
4zud,A,30,55,25,IPTLYSIIFVVGIFGNSLVVIVIYF,1
4zud,A,63,86,23,SVFLLNLALADLCFLLTLPLWAV,1
4zud,A,103,127,24,ASASVSFNLYASVFLLTCLSIDRY,1
4zud,A,143,164,21,VAKVTCIIIWLLAGLASLPAI,1
4zud,A,195,217,22,GLTKNILGFLFPFLIILTSYTL,1
4zud,A,239,262,23,KIIMAIVLFFFFSWIPHQIFTFL,1
4zud,A,284,304,20,PITICIAYFNNCLNPLFYGF,1
5e1j,B,78,94,16,FALLFLNFFEQPLWCE,1
5e1j,B,114,134,20,LTNAESIIYEVITLAILLVH,1
5e1j,B,156,173,17,VACVVILFVDVLVDFLY,1
5e1j,B,185,199,14,IAPYVRVIIFILSI,1
5e1j,B,214,237,23,TYLNILALWMLFLLFASWIAFVM,1
5e1j,B,281,304,23,SVFFVLYVLIGVYFVTNLILAVV,1
5e1j,B,437,454,17,FILIINFIAVVVETTLD,1
5e1j,B,461,479,18,KPWQVAEFVFGWIYVLEM,1
5e1j,B,500,518,18,FLVTWVIVIGETATFITP,1
5e1j,B,525,542,17,NGEWIRYLLLARMLRLI,1
5e1j,B,566,586,20,PYLGTIFCVLCIYCSIGVQV,1
5e1j,B,648,669,21,ITYFVSFYVITILLLLNLVVA,1
5eh4,B,74,96,22,LIIFGVIAGVIGTILLISYGIR,1
1y36,A,54,77,23,PAVYILVFIIGFLGNSVAIWMFV,1
1y36,A,87,109,22,VYMFNLALADFLYVLTLPALIF,1
1y36,A,126,147,21,QRFIFHVNLYGSILFLTCISA,1
1y36,A,169,193,24,CISVLVWLIVVVAISPILFYSGTG,1
1y36,A,216,238,22,YSMCTTVAMFCVPLVLILGCYG,1
1y36,A,261,282,21,VIIVLTVFAVSYIPFHVMKTM,1
1y36,A,307,327,20,VTRGLASLNSCVDPILYFLA,1
1n3m,C,39,63,24,LAAYMFLLIMLGFPINFLTLYVTV,1
1n3m,C,72,99,27,NYILLNLAVADLFMVFGGFTTTLYTSL,1
1n3m,C,109,137,28,CNLEGFFATLGGEIALWSLVVLAIERYV,1
1n3m,C,152,176,24,AIMGVAFTWVMALACAAPPLVGWS,1
1n3m,C,203,228,25,VIYMFVVHFIIPLIVIFFCYGQLVF,1
1n3m,C,251,274,23,RMVIIMVIAFLICWLPYAGVAFY,1
1n3m,C,289,310,21,IPAFFAKTSAVYNPVIYIMMN,1
5uni,D,7,20,13,YFVVAILFIVGLK,1
5uni,D,32,45,13,VWAGWGMVLAVLA,1
5uni,D,60,73,13,ALLLGSVVAWWAA,1
5uni,D,85,100,15,AIYNGMGGGAAATIA,1
5uni,D,118,137,19,ILGGLIGSVAFTGSLIAFA,1
5uni,D,153,169,16,KAVNALVLALTVVIGL,1
5uni,D,183,196,13,FLLALLFGVLMTL,1
5uni,D,210,223,13,NAFTGMAVGFEGF,1
5uni,D,228,242,14,ALMVAGTLVGAAGT,1
3qjs,C,5,25,20,KGALAVILVLTLTILVFWLG,1
5bn2,D,48,66,18,SGEFVGTFLFLWSAFVIA,1
5bn2,D,87,104,17,ISFGFGFGVMVGVFITY,1
5bn2,D,131,148,17,LMAFTQIVAGMAAAGAA,1
5bn2,D,170,189,19,GLFLEAFGTAILCLTVLML,1
5bn2,D,200,216,16,PFVIGIALLIAHLICI,1
5bn2,D,243,260,17,IYWLGPILGAFLAYSIW,1
5ul7,B,22,35,13,LIVLADVALFLAL,1
5ul7,B,51,64,13,LAFIAVLWLTEAL,1
5ul7,B,66,76,10,TVTAILVPVM,1
5ul7,B,92,107,15,ANSIIFLFLGGFALA,1
5ul7,B,191,209,18,GGIATLVGSPPNAIAAAE,1
5ul7,B,213,231,18,FTDWMKFGLPTAMMMLPM,1
5ul7,B,267,278,11,FGLTVFLWIFS,1
5ul7,B,292,306,14,TLVALGAILMLSFA,1
5ul7,B,319,332,13,WGVLLLFGGGLCL,1
5ul7,B,363,376,13,VVATFVVFLTEFA,1
5ul7,B,378,388,10,TASAALLIPV,1
5ul7,B,404,414,10,VLIAVAASCA,1
5ul7,B,444,460,16,LNIACIGLLTAIAMLF,1
1nd8,A,33,55,22,PPLYSLVFIFGFVGNMLVILIL,1
1nd8,A,69,90,21,LNLAISDLFFLLTVPFWAHYA,1
1nd8,A,104,125,21,TGLYFIGFFSGIFFIILLTID,1
1nd8,A,150,168,18,ITWVVAVFASLPGIIFTR,1
1nd8,A,193,218,25,QTLKIVILGLVLPLLVMVICYSGIL,1
1nd8,A,240,263,23,MIVYFLFWAPYNIVLLLNTFQEF,1
1nd8,A,277,300,23,AMQVTETLGMTHCCINPIIYAFV,1
5wtr,C,5,25,20,ELLNIIGIIAFTISGSLKGT,1
5wtr,C,30,52,22,IFGVVTLGVITSYAGGIIADIL,1
5wtr,C,59,80,21,ILKELNYLLLSVGISIFVFYF,1
5wtr,C,92,110,18,IAISDAVGLSTFATLGAS,1
5wtr,C,120,143,23,SVGLIAAIVGTGGGVIRDVLVNE,1
5wtr,C,145,167,22,MVLTKEIYATAALLSGFIYYFT,1
5wtr,C,175,193,18,LFVAFLGSFLLRILSIKY,1
3sph,D,78,104,26,WRYMLLLFSLAFLVSWLLFGLIFWLI,1
3sph,D,156,184,28,LAVFMVVVQSIVGCIIDSFMIGAIMAKM,1
3vmq,A,45,59,14,ILLTILIIIALFIG,1
3aoc,C,11,27,16,AWVIAIIIMLAGGLAI,1
3aoc,C,342,357,15,TLVEAIILVFLVMYL,1
3aoc,C,366,386,20,IPTIAVPVVLLGTFAVLAAF,1
3aoc,C,396,411,15,GMVLAIGLLVDDAIV,1
3aoc,C,443,458,15,GIAMVLSAVFVPMAF,1
3aoc,C,471,489,18,ITIVSAMALSVLVALILT,1
3aoc,C,541,557,16,LVLYLIIVVGMAYLFV,1
3aoc,C,874,891,17,SLYAISLIVVFLCLAAL,1
3aoc,C,899,919,20,SVMLVVPLGVIGALLAATFR,1
3aoc,C,928,943,15,VGLLTTIGLSAKNAI,1
3aoc,C,976,991,15,MTSLAFILGVMPLVI,1
3aoc,C,1004,1019,15,TGVMGGMVTATVLAI,1
4al0,C,14,35,21,AFLLCSTLLVIKMYVVAIITG,1
4al0,C,69,90,21,RAHRNDMETIYPFLFLGFVYS,1
4al0,C,98,119,21,AWMHFLVFLVGRVAHTVAYLG,1
4al0,C,125,149,24,RSVTYTLAQLPCASMALQILWEAA,1
5nx2,A,142,168,26,FLYIIYTVGYALSFSALVIASAILLG,1
5nx2,A,176,199,23,NYIHLNLFASFILRALSVFIKDA,1
5nx2,A,229,253,24,FLFMQYCVAANYYWLLVEGVYLYT,1
5nx2,A,264,286,22,IFRLYVSIGWGVPLLFVVPWGI,1
5nx2,A,305,329,24,WLIIRLPILFAIGVNFLIFVRVIA,1
5nx2,A,347,372,25,RLAKSTLTLIALLATVEVIFAFVMD,1
5nx2,A,379,406,27,RFIKLFTELSFTSFQGLMVAILYCFAN,1
5wua,H,38,51,13,LLFITFPILFIGW,1
5wua,H,72,86,14,LRWILTFILLFVLV,1
5wua,H,114,126,12,MAAITSVVYYHN,1
5wua,H,136,148,12,IALLIYWTLAFI,1
5wua,H,173,188,15,LLVILYGMLLLVEVN,1
5wua,H,304,317,13,FRILADLLGFAGP,1
5wua,H,362,376,14,FLALLLQRTFLQAS,1
5wua,H,440,451,11,MPVQIIVGVIL,1
5wua,H,462,474,12,GAAVIILLAPVQ,1
5wua,H,543,555,12,IFMNTAIPIAAV,1
5wua,H,580,594,14,SLFHILVTPLFLLS,1
5wua,H,1012,1027,15,LSLLVFSQLLKHMVL,1
5wua,H,1072,1085,13,SLGIVLCLVTSVT,1
5wua,H,1142,1158,16,LSRSTLLCVSALTVIS,1
5wua,H,1165,1178,13,VALLPLAVVCYFI,1
5wua,H,1250,1263,13,RMEYIGACVVLIA,1
5wua,H,1287,1299,12,ALMVSNYLNWMV,1
4o6m,B,179,193,14,FSFFLSLVGSALFL,1
4o6m,B,200,214,14,LLAGVIIQLHSIID,1
4o6m,B,238,252,14,DRYSDFIIVFSITY,1
4o6m,B,263,277,14,IGFLAAFASLMIAY,1
4o6m,B,297,317,20,PITRDFRLLIIFACSVVNLP,1
4o6m,B,319,334,15,ALVIIALLGNFEALR,1
2k1l,B,549,572,23,AVIFGLLLGAALLLGILVFRSRR,1
5prc,H,12,30,18,AQLVWYAQWLVIWTVVLL,1
3t6d,M,47,70,23,PIYLGASGIAAFAFGATAILIIG,1
3t6d,M,116,135,19,GLFMTLSLGSWWIRVYSRA,1
3t6d,M,142,162,20,HIAWNFAAAIFFVLCIGCIH,1
3t6d,M,198,222,24,WHGFSIGFAYGCGLLFAAHGATIL,1
3t6d,M,263,284,21,HRWGWFFSLMVMVSASVGILL,1
5g2d,A,17,39,22,IDHLLTMGVGVHFAALIFFLVV,1
5g2d,A,50,73,23,TALSCIVMVSAGLILNSQAVMWT,1
5g2d,A,91,114,23,NGYRYVNWMANIPCLLLQLLIVL,1
5g2d,A,120,143,23,LFSTATWLILAAWGMIITGYVGQ,1
5g2d,A,154,177,23,IWGAVSTAFFVVMNWIVGTKIFK,1
5g2d,A,190,210,20,TKVFWLMMFAWTLYPIAYLV,1
5g2d,A,221,244,23,LRQLLFTIADISSKVIYGLMITY,1
1py6,C,10,33,23,IWLALGTALMGLGTLYFLVKGMG,1
1py6,C,41,62,21,FYAITTLVPAIAFTMYLSMLL,1
1py6,C,80,99,19,ARYADWLFTTPLLLLDLAL,1
1py6,C,106,127,21,TILALVGADGIMIGTGLVGAL,1
1py6,C,134,157,23,FVWWAISTAAMLYILYVLFFGFT,1
1py6,C,171,192,21,KVLRNVTVVLWSAYPVVWLIG,1
1py6,C,203,225,22,ETLLFMVLDVSAKVGFGLILLR,1
3s38,C,5,27,22,KGALAVILVLTLTILVFWLGVY,1
1kme,A,10,33,23,IWLALGTALMGLGTLYFLVKGMG,1
1kme,A,41,66,25,FYAITTLVPAIAFTMYLSMLLGYGL,1
1kme,A,79,100,21,WARYADWLFTTPLLLLDLALL,1
1kme,A,104,127,23,QGTILALVGADGIMIGTGLVGAL,1
1kme,A,134,157,23,FVWWAISTAAMLYILYVLFFGFT,1
1kme,A,171,192,21,KVLRNVTVVLWSAYPVVWLIG,1
1kme,A,203,226,23,ETLLFMVLDVSAKVGFGLILLRS,1
3ayn,A,36,57,21,LGIFIGICGIIGCGGNGIVIY,1
3ayn,A,72,94,22,IINLAFSDFTFSLVNGFPLMTI,1
3ayn,A,110,131,21,YGFIGGIFGFMSIMTMAMISI,1
3ayn,A,153,172,19,IMIIFVWLWSVLWAIGPIF,1
3ayn,A,200,222,22,ILCMFILGFFGPILIIFFCYFN,1
3ayn,A,263,282,19,IVIVSQFLLSWSPYAVVAL,1
3ayn,A,298,317,19,LPVMFAKASAIHNPMIYSV,1
1pxs,C,10,33,23,IWLALGTALMGLGTLYFLVKGMG,1
1pxs,C,41,62,21,FYAITTLVPAIAFTAYLSMLL,1
1pxs,C,79,100,21,WARYADWLFTTPLLLLDLALL,1
1pxs,C,106,127,21,TILALVGADGIMIGTGLVGAL,1
1pxs,C,134,157,23,FVWWAISTAAMLYILYVLFFGFT,1
1pxs,C,171,192,21,KVLRNVTVVLWSAYPVVWLIG,1
1pxs,C,203,226,23,ETLLFMVLDVSAKVGFGLILLRS,1
3m9i,A,11,31,20,AIFAEFFATLFYVFFGLGAS,1
3m9i,A,42,60,18,QVALAFGLALATLVQAVG,1
3m9i,A,84,107,23,RAICYVVAQLLGAVAGAAVLYSV,1
3m9i,A,128,149,21,QATIVEIFLTLQFVLCIFATY,1
3m9i,A,158,176,18,SVALAVGFSLTLGHLFGM,1
3m9i,A,202,220,18,VYWVGPVIGAGLGSLLYD,1
1yq4,D,9,28,19,WTSERAVSALLLGLLPAAY,1
1yq4,D,35,55,20,DYSLAAALTLHGHWGLGQVI,1
1yq4,D,67,87,20,ANTGLYVLSAITFTGLCYFN,1
4mm9,A,14,35,21,ILAMAGYAVDLGNFLRFPVQA,1
4mm9,A,41,63,22,AFMIPYIIAFLLVGIPLMWIEW,1
4mm9,A,89,124,35,AKILGVFGLWIPLVVASYYVYIESWTLGFAIKFLV,1
4mm9,A,167,185,18,AYIVFLITMFINVSILIR,1
4mm9,A,191,214,23,ERFAKIAMPTLFILAVFLVIRVF,1
4mm9,A,242,265,23,VWIAAVGQIFFSLGLGFGVLITF,1
4mm9,A,279,298,19,LTAATLNEKASVILGGSIS,1
4mm9,A,340,367,27,GFLWFFLLFFAGLTSSIAGMQGMIAFL,1
4mm9,A,377,396,19,AVLWTAAIVFFSAHLVMFL,1
4mm9,A,400,426,26,DEMDFWATGIGVVFFGLTELIIFFWI,1
4mm9,A,448,472,24,YYVMRYITPAFLAVLLVVWAREYI,1
4mm9,A,484,502,18,ITRFYIIGLFLFLTFLVF,1
3sfe,D,41,60,19,HWTGERVVSVLLLGLLPAA,1
3sfe,D,69,89,20,YSLAAALTLHGHWGIGQVVT,1
3sfe,D,98,118,20,KAAKAGLLALSAFTFAGLCY,1
3zot,A,94,110,16,PVTWVMMIACVVVFIA,1
3zot,A,148,163,15,MHILFNLLWWWYLGG,1
3zot,A,172,187,15,KLIVITLISALLSGY,1
3zot,A,199,214,15,LSGVVYALMGYVWLR,1
3zot,A,228,241,13,LIIFALIWIVAGW,1
3zot,A,252,267,15,AHIAGLAVGLAMAFV,1
2uxm,M,53,71,18,SLGVLSLFSGLMWFFTIG,1
2uxm,M,118,135,17,SFFMFVAVWSWWGRTYL,1
2uxm,M,145,163,18,TAWAFLSAIWLWMVLGFI,1
2uxm,M,201,221,20,HGLSIAFLYGSALLFAMHGA,1
2uxm,M,267,285,18,WAIWMAVLVTLTGGIGIL,1
4d1b,A,27,40,13,GPFSLAAIWFAMA,1
4d1b,A,69,81,12,TIAVILLFFTQS,1
4d1b,A,104,122,18,IPITLKALLSLFWFGFQT,1
4d1b,A,145,160,15,IVIFGAIQVVTTFYG,1
4d1b,A,162,173,11,FIRWMNVFASP,1
4d1b,A,218,235,17,GWIAVVVSIHDIVKECK,1
4d1b,A,247,261,14,ADARYATAQWLGMV,1
4d1b,A,309,326,17,TWSTNPAANLLSPAYTL,1
4d1b,A,337,352,15,TGVIVSAVVGLLMMP,1
4d1b,A,366,379,13,ASALGPLAGIMIS,1
4d1b,A,412,425,13,AVYAVALAVSFLT,1
4d1b,A,429,442,13,FVTGLIAALLLHI,1
2ksy,A,6,27,21,LFWLGAIGMLVGTLAFAWAGR,1
2ksy,A,36,59,23,YVTLVGISGIAAVAYAVMALGVG,1
2ksy,A,69,89,20,VPRYIDWILTTPLIVYFLGL,1
2ksy,A,96,117,21,EFGIVITLNTVVMLAGFAGAM,1
2ksy,A,124,145,21,ALFGMGAVAFIGLVYYLVGPM,1
2ksy,A,160,181,21,VRLRNLTVVLWAIYPFIWLLG,1
2ksy,A,192,214,22,DVALIVYLDLVTKVGFGFIALD,1
5g36,C,30,49,19,SSLWVNVALAGIAILVFVY,1
5g36,C,66,82,16,LMIPLVSISSYLGLLS,1
5g36,C,106,120,14,GRYLTWALSTPMIL,1
5g36,C,136,154,18,VIAADIGMCVTGLAAAMT,1
5g36,C,160,177,17,RWAFYAISCAFFVVVLS,1
5g36,C,203,221,18,VVLWLGYPIVWAVGVEGL,1
5g36,C,230,247,17,SWAYSVLDVFAKYVFAF,1
3m74,C,12,27,15,YFGIPLGLAALSLAW,1
3m74,C,41,61,20,DVLGIVASAVWILFILMYAY,1
3m74,C,82,97,15,IALIPITTMLVGDIL,1
3m74,C,105,125,20,EVLIWIGTIGQLLFSTLRVS,1
3m74,C,141,154,13,FYLPAVAANFTSA,1
3m74,C,167,185,18,LFFGAGMIAWIIFEPVLL,1
3m74,C,201,215,14,GIVLAPAFVCVSAY,1
3m74,C,227,245,18,KILWGYGFLQLFFLLRLF,1
3m74,C,256,271,15,LWAFSLGLASMANSA,1
3m74,C,284,307,23,IFAFVFSNVMIGLLVLMTIYKLT,1
4zbm,E,26,45,19,LFVLTILTLISGTIFYSTV,1
4zbm,E,74,95,21,GKIFTILYIFIGIGLVFGFIH,1
1ixf,C,10,29,19,IWLALGTALMGLGTLYFLV,1
1ixf,C,45,62,17,TTLVPAIAFTMYLSMLL,1
1ixf,C,79,95,16,WARYADWLFTTPLLLL,1
1ixf,C,110,128,18,LVGADGIMIGTGLVGALT,1
1ixf,C,134,152,18,FVWWAISTAAMLYILYVL,1
1ixf,C,175,192,17,NVTVVLWSAYPVVWLIG,1
1ixf,C,203,222,19,ETLLFMVLDVSAKVGFGLI,1
3tlw,E,203,218,15,PMLFILFISWTAFWS,1
3tlw,E,222,239,17,ANVTLVVSTLIAHIAFN,1
3tlw,E,258,275,17,IFMIYLFYFVAVIEVTV,1
3tlw,E,292,310,18,RASRIAFPVVFLLANIIL,1
4z7f,A,12,31,19,LMGVLIAVVVVFSRFFAYE,1
4z7f,A,36,48,12,ISFTFIPESLIG,1
4z7f,A,54,72,18,WAGIGTAVADVVGMLLFP,1
4z7f,A,77,92,15,PGFTLNAFLAGAIYG,1
4z7f,A,106,125,19,LATLLVTVLINIILTPLWL,1
4z7f,A,140,160,20,PRLIKTVIFFPIQVIATYYL,1
4m5c,A,11,28,17,TCAVMGAAMVPVLTVAA,1
4m5c,A,44,58,14,IGSAFAFTIMMFNV,1
4m5c,A,65,76,11,AHAIGATLLAT,1
4m5c,A,81,101,20,AASISLTLALFIQALLFGDG,1
4m5c,A,103,125,22,LALGANSFNMAFIAPFVGYGIY,1
4m5c,A,137,158,21,SSAIGGYVGINAAALATAIEL,1
4m5c,A,187,206,19,FAHLTVAGIVEAVITGLVV,1
3m7b,C,12,27,15,YFGIPLGLAALSLAW,1
3m7b,C,41,60,19,DVLGIVASAVWILFILMYA,1
3m7b,C,82,97,15,IALIPITTMLVGDIL,1
3m7b,C,105,125,20,EVLIWIGTIGQLLFSTLRVS,1
3m7b,C,141,154,13,FYLPAVAANFTSA,1
3m7b,C,166,182,16,YLFFGAGMIAWIIFEP,1
3m7b,C,201,215,14,GIVLAPAFVCVSAY,1
3m7b,C,227,245,18,KILWGYGFLQLFFLLRLF,1
3m7b,C,258,271,13,AFSFGLASMANSA,1
3m7b,C,284,304,20,IFAFVFSNVMIGLLVLMTIY,1
1gu8,A,6,26,20,LFWLGAIGMLVGTLAFAWAG,1
1gu8,A,36,56,20,YVTLVGISGIAAVAYVVMAL,1
1gu8,A,70,91,21,PRYIDWILTTPLIVYFLGLLA,1
1gu8,A,96,115,19,EFGIVITLNTVVMLAGFAG,1
1gu8,A,126,146,20,FGMGAVAFLGLVYYLVGPMT,1
1gu8,A,160,179,19,VRLRNLTVILWAIYPFIWL,1
1gu8,A,194,214,20,ALIVYLDLVTKVGFGFIALD,1
2uwu,M,55,72,17,GVLSLFSGLMWFFTIGI,1
2uwu,M,117,133,16,ASFFMFVAVWSWWGRT,1
2uwu,M,147,164,17,WAFLSAIWLWMVLGFIR,1
2uwu,M,200,221,21,FHGLSIAFLYGSALLFAMHGA,1
2uwu,M,269,286,17,IWMAVLVTLTGGIGILL,1
2wlj,D,36,70,34,HYHDLLTVSWPVFITLITGLYLVTNALFALAYLA,1
2wlj,D,108,135,27,ANTLVTLEALCGMLGLAVAASLIYARF,1
2na9,A,440,462,22,AMWVLALIVIFLTIAVLLALRF,1
4tnv,E,217,237,20,LQLYIPSCMLVIVSWVSFWF,1
4tnv,E,242,264,22,PARVTLGVTTLLTMTAQSAGIN,1
4tnv,E,276,299,23,DVWIGACMTFIFCALLEFALVNH,1
4tnv,E,315,339,24,DLISRALFPVLFFVFNILYWSRFG,1
2na8,A,437,459,22,SVLPMWVLALIVIFLTIAVLLA,1
2wlk,D,48,71,23,FITLITGLYLVTNALFALAYLAC,1
2wlk,D,108,128,20,ANTLVTLEALCGMLGLAVAA,1
2uwt,M,53,71,18,SLGVLSLFSGLMWFFTIG,1
2uwt,M,118,135,17,SFFMFVAVWSWWGRTYL,1
2uwt,M,145,163,18,TAWAFLSAIWLWMVLGFI,1
2uwt,M,201,221,20,HGLSIAFLYGSALLFAMHGA,1
2uwt,M,266,283,17,RWAIWMAVLVTLTGGIG,1
4tnw,E,217,237,20,LQLYIPSCMLVIVSWVSFWF,1
4tnw,E,242,264,22,PARVTLGVTTLLTMTAQSAGIN,1
4tnw,E,276,299,23,DVWIGACMTFIFCALLEFALVNH,1
4tnw,E,315,338,23,DLISRALFPVLFFVFNILYWSRF,1
2n7i,A,215,237,22,SVAVLSAVICLIIVWAVALKGY,1
4atv,B,14,31,17,GIILIIAAILAMIMANS,1
4atv,B,60,77,17,LWINDALMAVFFLLVGL,1
4atv,B,99,116,17,AAIGGMIVPTLLYLAFN,1
4atv,B,124,140,16,GWAIPAATDIAFALGV,1
4atv,B,158,176,18,LAIIDDLGAIIIIALFYT,1
4atv,B,182,199,17,SLGVAAVAIAVLAVLNL,1
4atv,B,206,222,16,VYILVGVVLWTAVLKS,1
4atv,B,224,237,13,HATLAGVIVGFFI,1
4atv,B,256,276,20,PWVAYLILPLFAFANAGVSL,1
4atv,B,289,307,18,LGIIAGMLIGKPLGISLF,1
4atv,B,330,349,19,VGILCGIGFTMSIFIASLA,1
4atv,B,359,378,19,WAKLGILVGSISSAVIGYS,1
3m7c,C,12,27,15,YFGIPLGLAALSLAW,1
3m7c,C,41,60,19,DVLGIVASAVWILFILMYA,1
3m7c,C,82,97,15,IALIPITTMLVGDIL,1
3m7c,C,105,125,20,EVLIWIGTIGQLLFSTLRVS,1
3m7c,C,141,154,13,FYLPAVAANFTSA,1
3m7c,C,167,182,15,LFFGAGMIAWIIFEP,1
3m7c,C,201,215,14,GIVLAPAFVCVSAY,1
3m7c,C,227,245,18,KILWGYGFLQLFFLLRLF,1
3m7c,C,258,271,13,AFSFGLASMANSA,1
3m7c,C,284,304,20,IFAFVFSNVMIGLLVLMTIY,1
4xyd,B,14,34,20,YGGSLFFILIFVGLSVHSHR,1
1bha,A,13,33,20,ALGTALMGLGTLYFLVKGMG,1
1bha,A,42,61,19,YAITTLVPAIAFTMYLSML,1
2i1x,C,11,28,17,WLALGTALMGLGTLYFL,1
2i1x,C,47,62,15,LVPAIAFTMYLSMLL,1
2i1x,C,80,94,14,ARYADWLFTTPLLL,1
2i1x,C,112,127,15,GADGIMIGTGLVGAL,1
2i1x,C,134,149,15,FVWWAISTAAMLYIL,1
2i1x,C,178,192,14,VVLWSAYPVVWLIG,1
2i1x,C,204,220,16,TLLFMVLDVSAKVGFG,1
4m5b,A,11,28,17,TCAVMGAAMVPVLTVAA,1
4m5b,A,47,59,12,AFAFTIMMFNVP,1
4m5b,A,65,76,11,AHAIGATLLAT,1
4m5b,A,81,101,20,AASISLTLALFIQALLFGDG,1
4m5b,A,103,128,25,LALGANSFNMAFIAPFVGYGIYRLM,1
4m5b,A,137,157,20,SSAIGGYVGINAAALATAIE,1
4m5b,A,187,205,18,FAHLTVAGIVEAVITGLV,1
3dh4,B,58,73,15,SLIAANISAEQFIGM,1
3dh4,B,85,98,13,SYEWMSAITLIIV,1
3dh4,B,130,150,20,AVFWISLYIFVNLTSVLYLG,1
3dh4,B,167,178,11,GLALFALVYSI,1
3dh4,B,186,201,15,WTDVIQVFFLVLGGF,1
3dh4,B,250,268,18,VLIGGLWVANLYYWGFNQ,1
3dh4,B,287,301,14,VFAAFLKLIVPFLV,1
3dh4,B,353,377,24,VFAALAAAIVSSLASMLNSTATIF,1
3dh4,B,400,414,14,TAAVVALIIACLIA,1
3dh4,B,425,441,16,YIQEYTGLVSPGILAV,1
3dh4,B,459,472,13,VVASIPFALFLKF,1
3dh4,B,479,494,15,MDQMLYTLLFTMVVI,1
3dh4,B,527,541,14,AYGIMIVLAVLYTL,1
3m75,C,10,27,17,TGYFGIPLGLAALSLAW,1
3m75,C,41,64,23,DVLGIVASAVWILFILMYAYKLR,1
3m75,C,81,97,16,FIALIPITTMLVGDIL,1
3m75,C,105,126,21,EVLIWIGTIGQLLFSTLRVSE,1
3m75,C,140,154,14,SFYLPAVAANFTSA,1
3m75,C,166,186,20,YLFFGAGMIAWIIFEPVLLQ,1
3m75,C,200,215,15,MGIVLAPAFVCVSAY,1
3m75,C,227,246,19,KILWGYGFLQLFFLLRLFP,1
3m75,C,254,271,17,IGLWAFSVGLASMANSA,1
3m75,C,284,308,24,IFAFVFSNVMIGLLVLMTIYKLTK,1
5lxg,A,136,158,22,NIWTHLLGFVLFLFLGILTMLR,1
5lxg,A,170,192,22,VVFGMFFLGAVLCLSFSWLFHT,1
5lxg,A,204,228,24,SKLDYSGIALLIMGSFVPWLYYSF,1
5lxg,A,235,259,24,LIYLSIVCVLGISAIIVAQWDRFA,1
5lxg,A,265,287,22,TRAGVFLGLGLSGVVPTMHFTI,1
5lxg,A,299,322,23,MGWFFLMAVMYITGAGLYAARIP,1
5lxg,A,334,358,24,QSHQIFHVLVVAAAFVHFYGVSNL,1
3jd8,A,268,283,15,YVIMWITYMAFLLVF,1
3jd8,A,359,372,13,FITACSSGLVFVR,1
3jd8,A,623,637,14,VVISYAIMFLYISL,1
3jd8,A,647,668,21,LLVDSKVSLGIAGILIVLSSV,1
3jd8,A,675,689,14,SYIGLPLTLIVIEV,1
3jd8,A,724,737,13,GRVLGEVAPSMFL,1
3jd8,A,743,758,15,VAFFLGALSVMPAVH,1
3jd8,A,832,846,14,WMRPIVIAIFVGVL,1
3jd8,A,1100,1115,15,NLGVSLGAIFLVTMV,1
3jd8,A,1124,1141,17,VIMCATIAMVLVNMFGV,1
3jd8,A,1156,1169,13,LVMSCGISVEFCS,1
3jd8,A,1199,1215,16,SGITLTKFGGIVVLAF,1
3jd8,A,1227,1247,20,MYLAMVLLGATHGLIFLPVL,1
3cll,D,41,58,17,IAEFIATLLFLYITVAT,1
3cll,D,76,93,17,IAWAFGGMIFVLVYCTA,1
3cll,D,119,137,18,LVYMIAQCLGAICGVGLV,1
3cll,D,163,182,19,ALGAEIIGTFVLVYTVFSA,1
3cll,D,198,214,16,PLPIGFAVFMVHLATI,1
3cll,D,243,260,17,IFWVGPFIGAAVAAAYH,1
3tlv,E,199,218,19,NIILPMLFILFISWTAFWS,1
3tlv,E,222,242,20,ANVTLVVSTLIAHIAFNILV,1
3tlv,E,256,275,19,AIIFMIYLFYFVAVIEVTV,1
3tlv,E,292,313,21,RASRIAFPVVFLLANIILAFL,1
2uxl,M,53,71,18,SLGVLSLFSGLMWFFTIG,1
2uxl,M,118,134,16,SFFMFVAVWSWWGRTY,1
2uxl,M,146,163,17,AWAFLSAIWLWMVLGFI,1
2uxl,M,201,221,20,HGLSIAFLYGSALLFAMHGA,1
2uxl,M,268,285,17,AIWMAVLVTLTGGIGIL,1
5kpj,A,35,68,33,LTMFRYAGWLDRLYMLVGTLAAIIHGVALPLMM,1
5kpj,A,118,139,21,AGVLIVAYIQVSFWCLAAGRQ,1
5kpj,A,180,204,24,GIGDKIGMFFQAMATFFGGFIIGF,1
5kpj,A,211,232,21,LVILAISPVLGLSAGIWAKIL,1
5kpj,A,289,311,22,TANISMGAAFLLIYASYALAFW,1
5kpj,A,331,352,21,FSVLIGAFSVGQASPNIEAFA,1
5kpj,A,705,728,23,YFVVGIFCAIINGGLQPAFSVIF,1
5kpj,A,753,774,21,LFLILGIISFITFFLQGFTFG,1
5kpj,A,826,847,21,SRLAVIFQNIANLGTGIIISL,1
5kpj,A,855,879,24,LLLAIVPIIAIAGVVEMKMLSGQA,1
5kpj,A,925,950,25,NAMKKAHVFGITFSFTQAMMYFSYA,1
5kpj,A,973,992,19,FSAIVFGAMAVGQVSSFAP,1
2ks9,A,34,58,24,WAAAYTVIVVTSVVGNVVVMWIIL,1
2ks9,A,70,93,23,LVNLAFAEASMAAFNTVVNFTYA,1
2ks9,A,104,127,23,CKFHNFFPIAAVFASIYSMTAVA,1
2ks9,A,149,174,25,VICVIWVLALLLAFPQGYYSTTETM,1
2ks9,A,192,217,25,EKVYHICVTVLIYFLPLLVIGYAYT,1
2ks9,A,250,274,24,IVVVCTFAICWLPFHIFFLLPYIN,1
2ks9,A,286,308,22,YLAIMWLAMSSTMYNPIIYCCL,1
4d1c,A,31,46,15,LAAIWFAMAIQVAIF,1
4d1c,A,63,77,14,AIAAGCTIAVILLF,1
4d1c,A,106,130,24,ITLKALLSLFWFGFQTWLGALALD,1
4d1c,A,142,157,15,PLWIVIFGAIQVVTT,1
4d1c,A,164,180,16,RWMNVFASPVLLAMGV,1
4d1c,A,210,227,17,TAIMIFVGGWIAVVVSI,1
4d1c,A,254,268,14,AQWLGMVPASIIFG,1
4d1c,A,304,322,18,FVLLATWSTNPAANLLSP,1
4d1c,A,341,355,14,VSAVVGLLMMPWQF,1
4d1c,A,360,375,15,TFLNLLASALGPLAG,1
1bgy,W,22,36,14,LWGAVGAVGLVSAT,1
3sfd,D,41,60,19,HWTGERVVSVLLLGLLPAA,1
3sfd,D,69,88,19,YSLAAALTLHGHWGIGQVV,1
3sfd,D,100,118,18,AKAGLLALSAFTFAGLCY,1
4mm8,B,14,32,18,ILAMAGYAVDLGNFLRFP,1
4mm8,B,42,63,21,FMIPYIIAFLLVGIPLMWIEW,1
4mm8,B,90,120,30,KILGVFGLWIPLVVASYYVYIESWTLGFAI,1
4mm8,B,167,184,17,AYIVFLITMFINVSILI,1
4mm8,B,191,212,21,ERFAKIAMPTLFILAVFLVIR,1
4mm8,B,245,265,20,AAVGQIFFSLGLGFGVLITF,1
4mm8,B,278,297,19,GLTAATLNEKASVILGGSI,1
4mm8,B,343,366,23,WFFLLFFAGLTSSIAGMQGMIAF,1
4mm8,B,378,394,16,VLWTAAIVFFSAHLVM,1
4mm8,B,400,425,25,DEMDFWATGIGVVFFGLTELIIFFW,1
4mm8,B,448,469,21,YYVMRYITPAFLAVLLVVWAR,1
4mm8,B,485,502,17,TRFYIIGLFLFLTFLVF,1
3zmj,A,94,113,19,PVTWVMMIACVVVFIAMQI,1
3zmj,A,148,163,15,MHILFNLLWWWYLGG,1
3zmj,A,172,191,19,KLIVITLISALLSGYVQQK,1
3zmj,A,198,213,15,GLSGVVYALMGYVWL,1
3zmj,A,228,244,16,LIIFALIWIVAGWFDL,1
3zmj,A,247,267,20,SMANGAHIAGLAVGLAMAFV,1
1pxr,C,10,33,23,IWLALGTALMGLGTLYFLVKGMG,1
1pxr,C,41,62,21,FYAITTLVAAIAFTMYLSMLL,1
1pxr,C,79,100,21,WARYADWLFTTPLLLLDLALL,1
1pxr,C,106,128,22,TILALVGADGIMIGTGLVGALT,1
1pxr,C,134,157,23,FVWWAISTAAMLYILYVLFFGFT,1
1pxr,C,171,195,24,KVLRNVTVVLWSAYPVVWLIGSEG,1
1pxr,C,203,226,23,ETLLFMVLDVSAKVGFGLILLRS,1
4c7r,C,64,76,12,PALVIVLATVVW,1
4c7r,C,99,112,13,GWAFILFGTVFVF,1
4c7r,C,146,158,12,AAGMGIGLMFYG,1
4c7r,C,183,197,14,TTMFHWTLHPWAIY,1
4c7r,C,241,258,17,AIIATVFGTACSLGLGA,1
4c7r,C,281,294,13,IVSVLTLAFIFSA,1
4c7r,C,305,322,17,SNANMVLAALLAIFVFV,1
4c7r,C,367,381,14,IFYWAWWISWSPFV,1
4c7r,C,403,416,13,VPAGVSTVWFSIF,1
4c7r,C,456,473,17,AMILLGTFFITSADSAS,1
4c7r,C,493,506,13,AWGVATAAIGLTL,1
4c7r,C,519,534,15,NVTIVAATPFLFVVI,1
3t4z,E,25,45,20,VLFVLTILTLISGTIFYSTV,1
3t4z,E,75,99,24,GKIFTILYIFIGIGLVFGFIHKLA,1
2ih1,F,26,50,24,RAAGAATVLLVIVLLAGSYLAVLA,1
2ih1,F,87,111,24,GRLVAVVVMVAGITSFGLVTAALA,1
4ov0,C,10,32,22,IWLALGTALMGLGTLYFLVKGM,1
4ov0,C,42,62,20,YAITTLVPAIAFTMYLSMLL,1
4ov0,C,80,98,18,ARYADWLFTTPLLLLDLA,1
4ov0,C,107,127,20,ILALVGADGIMIGTGLVGAL,1
4ov0,C,134,154,20,FVWWAISTAAMLYILYVLFF,1
4ov0,C,173,192,19,LRNVTVVLWSAYPVVWLIG,1
4ov0,C,203,225,22,ETLLFMVLDVSAKVGFGLILLR,1
3t6e,M,50,70,20,LGASGIAAFAFGSTAILIIL,1
3t6e,M,116,134,18,GLFMTLSLGSWWIRVYSR,1
3t6e,M,143,161,18,IAWNFAAAIFFVLCIGCI,1
3t6e,M,199,219,20,HGFSIGFAYGCGLLFAAHGA,1
3t6e,M,264,283,19,RWGWFFSLMVMVSASVGIL,1
3s39,C,10,23,13,VILVLTLTILVFW,1
2ein,Z,14,35,21,QAIGLSVTFLSFLLPAGWVLY,1
1brx,C,10,32,22,WLALGTALMGLGTLYFLVKGMG,1
1brx,C,41,62,21,YAITTLVPAIAFTMYLSMLLG,1
1brx,C,79,100,21,ARYADWLFTTPLLLLDLALLV,1
1brx,C,106,127,21,ILALVGADGIMIGTGLVGALT,1
1brx,C,134,152,18,VWWAISTAAMLYILYVLF,1
1brx,C,171,192,21,VLRNVTVVLWSAYPVVWLIGS,1
1brx,C,203,226,23,TLLFMVLDVSAKVGFGLILLRSR,1
4x5m,C,6,28,22,TGLFAAFFTTFAFAPQSIKTIR,1
4x5m,C,36,55,19,VVMYIMFLTGVISWIAYGI,1
4x5m,C,61,82,21,VLIANIVTLFLAAPVLVITLI,1
4hea,H,14,28,14,LKALLVVVGLLTAF,1
4hea,H,91,103,12,FALLAFGLIPFG,1
4hea,H,121,132,11,ILYLFAVSELA,1
4hea,H,164,176,12,GLGLALLAPVLL,1
4hea,H,194,207,13,LFLYAFPAFLVYL,1
4hea,H,251,272,21,FITASALIPTLFLGGWTMPVL,1
4hea,H,274,287,13,PYLWMFLKIAFFL,1
4hea,H,314,327,13,PLALLWFLVTALV,1
4hea,H,336,348,12,LLYLSALSFLVL,1
2bl2,J,16,35,19,LAMATATIFSGIGSAKGVG,1
2bl2,J,61,78,17,PGTQGLYGFVIAFLIFI,1
2bl2,J,93,110,17,GASLPIAFTGLFSGIAQ,1
2bl2,J,137,154,17,VETYAILGFVISFLLVL,1
3aob,C,11,27,16,AWVIAIIIMLAGGLAI,1
3aob,C,341,357,16,KTLVEAIILVFLVMYL,1
3aob,C,366,386,20,IPTIAVPVVLLGTFAVLAAF,1
3aob,C,395,411,16,FGMVLAIGLLVDDAIV,1
3aob,C,443,458,15,GIAMVLSAVFVPMAF,1
3aob,C,471,489,18,ITIVSAMALSVLVALILT,1
3aob,C,542,558,16,VLYLIIVVGMAYLFVR,1
3aob,C,874,891,17,SLYAISLIVVFLCLAAL,1
3aob,C,899,919,20,SVMLVVPLGVIGALLAATFR,1
3aob,C,927,943,16,QVGLLTTIGLSAKNAI,1
3aob,C,976,992,16,MTSLAFILGVMPLVIS,1
3aob,C,1001,1019,18,AVGTGVMGGMVTATVLAI,1
1nek,L,16,35,19,ILVRATAIVLTLYIIYMVG,1
1nek,L,57,80,23,KVFTLLALFSILIHAWIGMWQVL,1
1nek,L,89,110,21,RLMLQLVIVVALVVYVIYGFV,1
2rh1,A,32,59,27,VVGMGIVMSLIVLAIVFGNVLVITAIA,1
2rh1,A,70,95,25,FITSLACADLVMGLAVVPFGAAHIL,1
2rh1,A,105,129,24,CEFWTSIDVLCVTASIETLCVIAV,1
2rh1,A,151,175,24,VIILMVWIVSGLTSFLPIQMHWYR,1
2rh1,A,194,220,26,TNQAYAIASSIVSFYVPLVIMVFVYS,1
2rh1,A,275,299,24,GIIMGTFTLCWLPFFIVNIVHVIQ,1
2rh1,A,303,327,24,RKEVYILLNWIGYVNSGFNPLIYC,1
4al1,C,16,33,17,LLCSTLLVIKMYVVAII,1
4al1,C,72,89,17,RNDMETIYPFLFLGFVY,1
4al1,C,99,116,17,WMHFLVFLVGRVAHTVA,1
4al1,C,127,146,19,VTYTLAQLPCASMALQILW,1
3spi,D,78,104,26,WRYMLLLFSLAFLVSWLLFGLIFWLI,1
3spi,D,156,184,28,LAVFMVVVQSIVGCIIDSFMIGAIMAKM,1
3tt1,B,14,32,18,ILAMAGNAVGLGNFLRFP,1
3tt1,B,42,63,21,FMIPYIIAFLLVGIPLMWIEW,1
3tt1,B,90,124,34,KILGVFGLWIPLVVAIYFVYIESWTLGFAIKFLV,1
3tt1,B,167,185,18,AYIVFLITMFINVSILIR,1
3tt1,B,191,214,23,ERFAKIAMPTLFILAVFLVIRVF,1
3tt1,B,242,265,23,VWIAAVGQIFFTLSLGFGAIITY,1
3tt1,B,278,298,20,GLTAATLNEAAEVILGGSIS,1
3tt1,B,340,367,27,GFLWFFLLFFAGLTSSIAIMQPMIAFL,1
3tt1,B,377,396,19,AVLWTAAIVFFSAHLVMFL,1
3tt1,B,400,425,25,DEMDFWAGTIGVVFFGLTELIIFFW,1
3tt1,B,448,472,24,YYVMRYITPAFLAVLLVVWAREYI,1
3tt1,B,484,502,18,ITRFYIIGLFLFLTFLVF,1
3aou,J,17,38,21,AMATATIFSGIGSAKGVGMTG,1
3aou,J,60,78,18,LPGTQGLYGFVIAFLIFI,1
3aou,J,94,114,20,ASLPIAFTGLFSGIAQGKVA,1
3aou,J,134,154,20,AAMVQTYAILGFVISFLLVL,1
2l6x,A,30,54,24,VSFWLVTAALLASTVFFFVERDRV,1
2l6x,A,62,85,23,TVSGLVTGIAFWHYMYMRGVWIE,1
2l6x,A,90,111,21,TVFRYIDWLLTVPLLICEFYL,1
2l6x,A,121,142,21,SLFKKLLVGSLVMLVFGYMGE,1
2l6x,A,148,170,22,WPAFIIGCLAWVYMIYELWAGE,1
2l6x,A,184,206,22,AYNTMMYIIIFGWAIYPVGYFT,1
2l6x,A,219,244,25,NLIYNLADFVNKILFGLIIWNVAVK,1
3qjr,C,5,25,20,KGALAVILVLTLTILVFWLG,1
5unh,A,46,68,22,IPILYYIIFVIGFLVNIVVVTL,1
5unh,A,83,104,21,FNLAVADLLLLATLPLWATYY,1
5unh,A,111,140,29,FGPVMCKVFGSFLTLNMFASIFFITCMSV,1
5unh,A,163,183,20,VPLVWCMACLSSLPTFYFRD,1
5unh,A,208,233,25,AGIALMKNILGFIIPLIFIATCYFG,1
5unh,A,256,281,25,MAAAVVLAFIICWLPFHVLTFLDAL,1
5unh,A,300,321,21,PFAILLGFTNSCVNPFLYCFV,1
2l8s,A,18,40,22,GLLLLMLLILALWKIGFFKRPL,1
4o9t,D,6,20,14,AYFVVAILFIVGLK,1
4o9t,D,33,46,13,WAGWGMVLAVLAT,1
4o9t,D,59,73,14,LALLLGSVVAWWAA,1
4o9t,D,85,100,15,AIYNGMGGGAAATIA,1
4o9t,D,118,137,19,ILGGLIGSVAFTGSLIAFA,1
4o9t,D,151,166,15,GQKAVNALVLALTVV,1
4o9t,D,183,196,13,FLLALLFGVLMTL,1
4o9t,D,208,223,15,FYNAFTGMAVGFEGF,1
4o9t,D,228,242,14,ALMVAGTLVGAAGT,1
5u76,D,93,113,20,IRLFNFSLKLLTCLLYIVRV,1
5u76,D,154,175,21,LWAVQVSIALISFLETMLLIY,1
5u76,D,183,207,24,EQIFRISFILEMINTVPFIITIFW,1
5u76,D,214,232,18,IPVFLNCWLAKYALENMI,1
5u76,D,248,271,23,QVLILICTLLCLVFTGTCGIQHL,1
5u76,D,306,328,22,QLLVVIMICVALVVLPLQFEEL,1
5ir6,C,771,784,13,PMVVVALSVVAAF,1
3om3,B,61,80,19,LVIIAAITIFVTLLILYAV,1
3om3,B,99,117,18,LEIAWTIVPIVILVAIGA,1
3fgo,A,61,78,17,VRILLLAACISFVLAWF,1
3fgo,A,87,103,16,FVEPFVILLILIANAI,1
3fgo,A,260,277,17,SKVISLICVAVWLINIG,1
3fgo,A,293,314,21,YYFKIAVALAVAAIPEGLPAV,1
3fgo,A,763,783,20,LISSNVGEVVCIFLTAALGL,1
3fgo,A,786,806,20,LIPVQLLWVNLVTDGLPATA,1
3fgo,A,835,852,17,RYMAIGGYVGAATVGAA,1
3fgo,A,898,916,18,MALSVLVTIEMCNALNSL,1
3fgo,A,931,950,19,WLLGSICLSMSLHFLILYV,1
3fgo,A,968,987,19,MVLKISLPVIGLDEILKFI,1
5b5e,z,8,25,17,LAALVILSFVMVIGVPV,1
5b5e,z,40,54,14,FLGSGLWIALVLVV,1
2lop,A,11,42,31,VTFGSIFGYKRRGGVPSLIAGLFVGCLAGYG,1
2lop,A,54,69,15,VSLFTAFFLATIMGV,1
2lop,A,78,96,18,PAGLVAGLSLMMILRLVL,1
1ry5,H,16,32,16,IYSFWIFLAGLIYYLQ,1
2rdd,F,21,44,23,SLILMLVVFGLIFYFMILRPQQK,1
2iqr,A,50,73,23,FVTLGVISLLENILVIVAIAKNK,1
2iqr,A,79,98,19,YFFICSLAVADMLVSVSNG,1
2iqr,A,125,149,24,DSVICSSLLASICSLLSIAVDRYF,1
2iqr,A,164,185,21,RVGIIISCIWAACTVSGILFI,1
2iqr,A,192,216,24,VIICLITMFFTMLALMASLYVHMF,1
2iqr,A,243,266,23,AITLTILIGVFVVCWAPFFLHLI,1
2iqr,A,287,308,21,LILIMCNSIIDPLIYALRSQE,1
2zfe,C,12,29,17,LALGTALMGLGTLYFLV,1
2zfe,C,45,61,16,TTLVPAIAFTMYLSML,1
2zfe,C,80,95,15,ARYADWLFTTPLLLL,1
2zfe,C,110,126,16,LVGADGIMIGTGLVGA,1
2zfe,C,135,153,18,VWWAISTAAMLYILYVLF,1
2zfe,C,175,192,17,NVTVVLWSAYPVVWLIG,1
2zfe,C,204,222,18,TLLFMVLDVSAKVGFGLI,1
2vrm,A,486,501,15,PSVPGLLRLIGLTTI,1
5mg3,C,363,381,18,IVRGIMYPLTKAQYTSMA,1
5mg3,C,420,434,14,GGCFPLLIQMPIFL,1
5mg3,C,467,483,16,PILMGVTMFFIQKMSP,1
5mg3,C,492,507,15,KIMTFMPVIFTVFFL,1
5mg3,C,518,530,12,VSNLVTIIQQQL,1
4p9p,F,136,153,17,LLTVVFYIAAVMATNLY,1
4p9p,F,194,214,20,AWVFFIPFIMLTTFTVLNLF,1
5hxc,A,7,24,17,YFLLGLILLYYGSDWFV,1
5hxc,A,40,59,19,IGATVMAIGTSLPEILTSA,1
5hxc,A,72,92,20,NAIGSCICNIGLVLGLSAII,1
5hxc,A,104,120,16,ILVYLLFVIFAAVIGI,1
5hxc,A,127,143,16,GVVLLILFIIYLRWTV,1
5hxc,A,166,186,20,LLIIGLIGVLVGAELFVDGA,1
5hxc,A,205,222,17,AFGTSLPELMVSLAAAK,1
5hxc,A,229,248,19,LGNVIGSNIADIGGALAVG,1
5hxc,A,259,275,16,QMAVLVIMSLLLYLFA,1
5hxc,A,281,299,18,RWQGILFLALYIIAIASL,1
4rwd,B,51,77,26,ITALYSAVCAVGLLGNVLVMFGIVRY,1
4rwd,B,81,106,25,TATNIYIFNLALADALATSTLPFQS,1
4rwd,B,124,149,25,LSIDYYNMFTSIFTLTMMSVDRYIA,1
4rwd,B,159,181,22,RTPAKAKLINICIWVLASGVGV,1
4rwd,B,215,237,22,CVFLFAFVVPILIITVCYGLML,1
4rwd,B,260,282,22,RMVLVVVGAFVVCWAPIHIFVI,1
4rwd,B,299,322,23,LHLCIALGYANSSLNPVLYAFLD,1
5ari,W,13,26,13,ILGLPLVTLIVLF,1
5ari,W,77,89,12,FIGSTNLLGLLP,1
5ari,W,96,111,15,QLSMNLGMAIPLWAG,1
5ari,W,144,168,24,ETISLFIQPMALAVRLTANITAGH,1
5ari,W,195,212,17,LILLTILEFAVAMIQAY,1
2hyn,E,25,50,25,QKLQNLFINFCLILICLLLICIIVM,1
5tj6,D,21,37,16,SSLVTFGSGLVVIIIY,1
5tj6,D,102,118,16,VGLVFLLSIASLIIYF,1
5tj6,D,142,157,15,LAFNVFFMIYFFIRF,1
5tj6,D,164,183,19,WFWVELFSFVDYFTIPPSF,1
5tj6,D,195,206,11,RFLRALRLMSI,1
5tj6,D,228,242,14,VSFVSLWLTAAGFL,1
5tj6,D,289,308,19,RTFVVIFIMIFIGLFASFI,1
1q16,F,5,28,23,MFFFDIYPYIAGAVFLIGSWLRY,1
1q16,F,48,73,25,NLASNLFHIGILGIFVGHFFGMLTP,1
1q16,F,87,114,27,KMAMFAGGASGVLCLIGGVLLLKRRLF,1
1q16,F,125,145,20,DILILSLLVIQCALGLLTIP,1
1q16,F,183,204,21,FRLHLVLGMTLFLLFPFSRLI,1
3lsv,E,195,217,22,SYIPNIILPMLFILFISWTAFW,1
3lsv,E,222,244,22,ANVTLVVSTLIAHIFFNILVET,1
3lsv,E,252,275,23,TYTGAIIFMIYLFYFVAVIEVTV,1
3lsv,E,295,315,20,RIAFPVVFLLANIILAFLFF,1
2xq8,E,198,215,17,NIILPMLFILFISWTAF,1
2xq8,E,223,240,17,VTLVVSTLIAHIAFNIL,1
2xq8,E,255,273,18,AIIFMIYLFYFVAVIEVT,1
2xq8,E,295,312,17,IAFPVVFLLANIILAFL,1
4pb1,C,4,17,13,MSCCGMAVLLGIA,1
4pb1,C,34,47,13,AFAIQFSLGAFIL,1
4pb1,C,103,118,15,TLIFFSALISVLYYL,1
4pb1,C,179,192,13,GLASIAGGVLAGY,1
4pb1,C,202,216,14,VAASFMAAPGGLLF,1
4pb1,C,245,274,29,IDAAAGGASAGLQLALNVGAMLIAFIGLI,1
4pb1,C,359,372,13,SFALCGFANLSSI,1
4pb1,C,399,415,16,AGTLSNLMAATIAGFF,1
4ryo,A,9,27,18,VFFLTYGLFYVSSVLFPI,1
4ryo,A,46,65,19,IGMIWAVLFGLIALSVAII,1
4ryo,A,76,96,20,WFLFLLNYIFNQAFSYFQFS,1
4ryo,A,102,122,20,ATVDCLLVAITTLLLIMFSS,1
4ryo,A,127,147,20,SAWLLIPYFLWSAFATYLSW,1
2mk9,A,4,26,22,PFELFFMINTSILLIFIFIVLL,1
2cfp,A,9,31,22,WMFGLFFFFYFFIMGAYFPFFP,1
2cfp,A,47,67,20,IFAAISLFSLLFQPLFGLLS,1
2cfp,A,74,91,17,YLLWIITGMLVMFAPFF,1
2cfp,A,109,129,20,GGIYLGFCFNAGAPAVEAFI,1
2cfp,A,144,160,16,MFGCVGWALGASIVGI,1
2cfp,A,170,188,18,WLGSGCALILAVLLFFAK,1
2cfp,A,223,244,21,FLSLYVIGVSCTYDVFDQQFA,1
2cfp,A,260,279,19,FGYVTTMGELLNASIMFFA,1
2cfp,A,290,309,19,ALLLAGTIMSVRIIGSSFA,1
2cfp,A,314,333,19,VVILKTLHMFEVPFLLVGC,1
2cfp,A,350,370,20,LVCFCFFKQLAMIFMSVLAG,1
2cfp,A,382,400,18,LVLGLVALGFTLISVFTL,1
5cfy,F,14,32,18,KILIGLILGAIVGLILGH,1
5cfy,F,36,63,27,HAVHTYVKPFGDLFVRLLKMLVMPIVF,1
5cfy,F,83,107,24,KIVVYYLLTSAFAVTLGIIMARLF,1
5cfy,F,128,140,12,PLVHILLDIVPT,1
5cfy,F,151,158,7,LPTIFFA,1
5cfy,F,202,221,19,QYAPIGVFALIAYVMAEQG,1
5cfy,F,230,250,20,VTAAVYVGLTLQILLVYFVL,1
5cfy,F,302,321,19,LPLGATINMDGTALYQGVC,1
5cfy,F,390,408,18,AILDMGATMVNVTGDLTG,1
4wd7,E,26,42,16,RLLLNVLMSIIAIISY,1
4wd7,E,49,64,15,IHLTVAPFSLLGIAI,1
4wd7,E,219,234,15,YLFCTLLPFALVGDL,1
4wd7,E,236,249,13,MTPFVSVFISYTF,1
4p6h,C,13,27,14,QKILIGLILGAIVG,1
4p6h,C,44,66,22,PFGDLFVRLLCMLVMPIVFASL,1
4p6h,C,91,107,16,TSAFAVTLGIIMARLF,1
4p6h,C,134,140,6,LDIVPT,1
4p6h,C,151,161,10,LPTIFFAIIL,1
4p6h,C,198,214,16,NGVMQYAPIGVFALIA,1
4p6h,C,226,246,20,ELAKVTAAVYVGLTLQILLV,1
4p6h,C,312,325,13,GTALYQGVATFFI,1
4p6h,C,336,352,16,QQLTIVLTAVLASIGT,1
4p6h,C,357,370,13,AGAIMLCMVLHSV,1
4p6h,C,384,397,13,MILGIDAILDMGR,1
4g7v,S,121,138,17,GVFLIFLDIILMIIDLS,1
4g7v,S,149,167,18,YDGMALALSCYFMLDLGL,1
4g7v,S,183,204,21,VADGLIIVVTFVVTIFYTVLD,1
4g7v,S,210,234,24,GADGLGELVVLARLLRVVRLARIF,1
5mkf,D,219,242,23,VLRELVTYLLFLIVLCILTYGMM,1
5mkf,D,470,497,27,FFLAACEIIFCFFIFYYVVEEILEIRI,1
5mkf,D,503,529,26,RSFWNCLDVVIVVLSVVAIGINIYRT,1
5mkf,D,555,580,25,IQFNNIAAVTVFFVWIKLFKFINFN,1
5mkf,D,594,620,26,KDLFGFAIMFFIIFLAYAQLAYLVFG,1
5mkf,D,654,681,27,VLGPIYFTTFVFFMFFILLNMFLAIIN,1
3e83,E,26,45,19,LFVLTILTLISGTIFYSTV,1
3e83,E,75,96,21,GKIFTILYIFIGIGLVFGFIH,1
2xfp,A,486,498,12,PSVPGLLRLIGL,1
2ahy,D,27,45,18,FVLTILTLISGTIFYSTV,1
2ahy,D,75,94,19,GKIFTILYIFIGIGLVFGF,1
1zcd,C,15,29,14,IILIIAAILAMIMA,1
1zcd,C,61,80,19,WINDALMAVFFLLVGLEVK,1
1zcd,C,98,115,17,IAAIGGMIVPALLYLAF,1
1zcd,C,125,140,15,WAIPAATDIAFALGV,1
1zcd,C,158,174,16,LAIIDDLGAIIIIALF,1
1zcd,C,184,200,16,GVAAVAIAVLAVLNLC,1
1zcd,C,205,220,15,GVYILVGVVLWTAVL,1
1zcd,C,223,237,14,VHATLAGVIVGFFI,1
1zcd,C,256,274,18,PWVAYLILPLFAFANAGV,1
1zcd,C,294,311,17,GLLIGKPLGISLFCWLA,1
1zcd,C,330,348,18,VGILCGIGFTMSIFIASL,1
1zcd,C,362,377,15,LGILVGSISSAVIGY,1
3gwu,B,14,32,18,ILAMAGNAVGLGNFLRFP,1
3gwu,B,44,63,19,IPYIIAFLLVGIPLMWIEW,1
3gwu,B,90,124,34,KILGVFGLWIPLVVAIYYVYIESWTLGFAIKFLV,1
3gwu,B,167,184,17,AYIVFLITMFINVSILI,1
3gwu,B,191,212,21,ERFAKIAMPTLFILAVFLVIR,1
3gwu,B,242,265,23,VWIAAVGQIFFTLSLGFGAIITY,1
3gwu,B,278,298,20,GLTAATLNEKAEVILGGSIS,1
3gwu,B,340,366,26,GFLWFFLLFFAGLTSSIAIMQPMIAF,1
3gwu,B,378,396,18,VLWTAAIVFFSAHLVMFL,1
3gwu,B,400,425,25,DEMDFWAGTIGVVFFGLTELIIFFW,1
3gwu,B,445,469,24,RIYYYVMRYITPAFLAVLLVVWAR,1
3gwu,B,484,502,18,ITRFYIIGLFLFLTFLVF,1
1oye,C,11,27,16,AWVIAIIIMLAGGLAI,1
1oye,C,341,357,16,KTLVEAIILVFLVMYL,1
1oye,C,366,386,20,IPTIAVPVVLLGTFAVLAAF,1
1oye,C,395,411,16,FGMVLAIGLLVDDAIV,1
1oye,C,442,458,16,VGIAMVLSAVFVPMAF,1
1oye,C,469,489,20,FSITIVSAMALSVLVALILT,1
1oye,C,542,557,15,VLYLIIVVGMAYLFV,1
1oye,C,874,891,17,SLYAISLIVVFLCLAAL,1
1oye,C,898,919,21,FSVMLVVPLGVIGALLAATFR,1
1oye,C,927,943,16,QVGLLTTIGLSAKNAI,1
1oye,C,976,993,17,MTSLAFILGVMPLVIST,1
1oye,C,1004,1019,15,TGVMGGMVTATVLAI,1
1t9x,C,11,27,16,AWVIAIIIMLAGGLAI,1
1t9x,C,341,357,16,KTLVEAIILVFLVMYL,1
1t9x,C,366,386,20,IPTIAVPVVLLGTFAVLAAF,1
1t9x,C,395,411,16,FGMVLAIGLLVDDAIV,1
1t9x,C,442,458,16,VGIAMVLSAVFVPMAF,1
1t9x,C,472,489,17,TIVSAMALSVLVALILT,1
1t9x,C,541,557,16,LVLYLIIVVGMAYLFV,1
1t9x,C,874,891,17,SLYAISLIVVFLCLAAL,1
1t9x,C,898,919,21,FSVMLVVPLGVIGALLAATFR,1
1t9x,C,927,943,16,QVGLLTTIGLSAKNAI,1
1t9x,C,975,993,18,LMTSLAFILGVMPLVIST,1
1t9x,C,1001,1021,20,AVGTGVMGGMVTATVLAIFF,1
3bhs,C,19,36,17,SINILAMLLVGFGFLMV,1
3bhs,C,45,63,18,TTGTYLVVATGLPLYILL,1
3bhs,C,82,99,17,YAEFAVATGLIAMGAVL,1
3bhs,C,105,122,17,QYALLALFIVPVYLLNE,1
3bhs,C,141,159,18,SIAIHAFGAYFGLGVSIA,1
3bhs,C,179,195,16,SMLGSMVLWLFWPSFA,1
3bhs,C,209,226,17,NTLLALCGATLATYFLS,1
3bhs,C,238,254,16,MANAALAGGVAIGSVC,1
3bhs,C,260,277,17,GAFVIGLLGGAISVVGF,1
3bhs,C,293,313,20,CGVHNLHGLPGLLGGFSAIL,1
3bhs,C,323,347,24,TGIGITLALALIGGVIAGALIKLT,1
3r65,D,24,41,17,LLVLAVIIYGTAGFHFI,1
3r65,D,71,92,21,GMYFTCTLIVLGIGTFAVAVQ,1
1ddd,7,296,316,20,TRGLASLNSCVDPILYFLAG,1
4gx2,F,21,41,20,VLLLYCAFLLVMLLAYASIF,1
4gx2,F,81,105,24,YLFASIVTVSGVIFLDIILPFGFV,1
2agv,A,57,76,19,EDLLVRILLLAACISFVLA,1
2agv,A,89,104,15,EPFVILLILIANAIV,1
2agv,A,258,276,18,QLSKVISLICVAVWLINI,1
2agv,A,296,314,18,KIAVALAVAAIPEGLPAV,1
2agv,A,761,781,20,RYLISSNVGEVVCIFLTAAL,1
2agv,A,786,807,21,LIPVQLLWVNLVTDGLPATAL,1
2agv,A,835,851,16,RYMAIGGYVGAATVGA,1
2agv,A,900,916,16,LSVLVTIEMCNALNSL,1
2agv,A,927,948,21,WVNIWLLGSICLSMSLHFLIL,1
2agv,A,971,987,16,KISLPVIGLDEILKFI,1
1otu,B,37,58,21,MAAVVGTLVGLAAVAFDKGVA,1
1otu,B,84,97,13,CSAVLAMFGYFLV,1
1otu,B,129,142,13,VKFFGGLGTLGGG,1
1otu,B,144,156,12,LGRQGPTVQIGG,1
1otu,B,216,231,15,AVFIGVIMSTIMYRI,1
1otu,B,253,274,21,LYLILGIIFGIFGPIFNKWVL,1
1otu,B,290,304,14,WVLMGGAIGGLCGL,1
1otu,B,338,351,13,ARVITTLLCFSSG,1
1otu,B,353,365,12,GGIFAPMLALGT,1
1otu,B,423,439,16,PMIITGLGATLLAQFT,1
1s00,H,16,32,16,IYSFWIFLAGLIYYLQ,1
4rai,E,25,45,20,VLFVLTILTLISGTIFYSTV,1
4rai,E,74,101,27,GKIFTILYIFIGIGLVFGFIHKLAVNV,1
5jtb,A,5,28,23,SSVYITVELAIAVLAILGNVLVC,1
5jtb,A,45,68,23,VSLAAADIAVGVLAIPFAITIST,1
5jtb,A,75,97,22,GCLFIACFVLVLTQSSIFSLLA,1
5jtb,A,124,144,20,IAICWVLSFAIGLTPMLGWN,1
5jtb,A,172,195,23,PMNYMVYFNFFACVLVPLLLMLG,1
5jtb,A,237,259,22,IVGLFALCWLPLHIINCFTFFC,1
5jtb,A,265,287,22,PLWLMYLAIVLSHTNSVVNPFI,1
5jwy,A,5,27,22,RRTAVGAALLLVMPVAVWISGW,1
5jwy,A,38,68,30,KAAFWVTETVTQPWGVITHLILFGWFLWCL,1
5jwy,A,76,100,24,VLFAILAAAILVGQGVKSWIKDKV,1
5jwy,A,159,179,20,PSGHTMFAASWALLAVGLLW,1
5jwy,A,183,203,20,TLTIAILLVWATGVMGSRLL,1
5jwy,A,207,230,23,WPRDLVVATLISWALVAVATWLA,1
2q7m,C,12,34,22,AIVTLISVVQNGFFAHKVEHES,1
2q7m,C,54,75,21,TANQNCVDAYPTFLAVLWSAG,1
2q7m,C,83,103,20,AFAGLMYLFVRQKYFVGYLG,1
2q7m,C,109,128,19,PGYIFGKRIILFLFLMSVA,1
4r50,E,25,45,20,VLFVLTILTLISGTIFYSTV,1
4r50,E,74,98,24,GKIFTILYIFIGIGLVFGFIHKLA,1
5vdi,E,225,244,19,QMYIPSLLIVILSWVSFWI,1
5vdi,E,249,269,20,PARVALGITTVLTMTTQSSG,1
5vdi,E,284,305,21,IWMAVCLLFVFSALLEYAAVN,1
5vdi,E,323,344,21,TISRACFPLAFLIFNIFYWVI,1
1s2y,A,491,501,10,LLRLIGLTTI,1
3eam,E,199,218,19,NIILPMLFILFISWTAFWS,1
3eam,E,222,240,18,ANVTLVVSTLIAHIAFNI,1
3eam,E,256,275,19,AIIFMIYLFYFVAVIEVTV,1
3eam,E,292,313,21,RASRIAFPVVFLLANIILAFL,1
5hld,A,76,93,17,AVLIAIYGVYLDQKIRS,1
5sxv,E,211,225,14,LGLIIAASWSVFWL,1
5sxv,E,230,245,15,RLQTSFTLMLTVVAY,1
5sxv,E,266,282,16,IAGYGSIFAAILLIIF,1
5sxv,E,300,315,15,RLAFPLGFLAIGCVL,1
4u2q,D,526,543,17,MAIVFAYIGVSVVLFLV,1
4u2q,D,595,614,19,LSARIVAGVWWFFTLIIIS,1
4u2q,D,793,812,19,GVFYILVGGLGLAMLVALI,1
2a06,W,19,39,20,FALTIVVGALFFERAFDQGA,1
4iu8,A,38,54,16,SVSCLLLAFCVWMLFS,1
4iu8,A,77,91,14,LPSVSGALLRVPYS,1
4iu8,A,103,118,15,VFSTAILIIPCVWLG,1
4iu8,A,133,149,16,IALLCGFAGANFASSM,1
4iu8,A,167,183,16,NGGLGNLGVSVMQLVA,1
4iu8,A,213,228,15,AWIWVPLLAIATIAA,1
4iu8,A,255,274,19,LLSLLYLATFGSFIGFSAG,1
4iu8,A,293,310,17,FGPFIGAIARSVGGAIS,1
4iu8,A,314,331,17,GVRVTLINFIFMAIFSA,1
4iu8,A,351,370,19,FMGLFLTAGLGSGSTFQMI,1
4iu8,A,405,420,15,FISAIGAVGGFFIPQ,1
4iu8,A,439,454,15,LIFYIVCVLLTWLVY,1
4gx0,F,21,41,20,VLLLYCAFLLVMLLAYASIF,1
4gx0,F,83,105,22,FASIVTVSGVIFLDIILPFGFV,1
4knf,E,33,50,17,WLVTAGMLAATVFFFVE,1
4knf,E,61,77,16,LTVSGLITGIAFWHYL,1
4knf,E,94,110,16,YINWLLTVPLLVVEFY,1
4knf,E,123,139,16,FKKLLAGSLVMLGAGF,1
4knf,E,151,169,18,FIIGMAGWLYMIYELYMG,1
4knf,E,189,206,17,MMIIVVGWAIYPAGYAA,1
4knf,E,221,240,19,LIYNLADFVNKILFGLIIW,1
4pxk,C,9,31,22,WLWLGTAGMFLGMLYFIARGWG,1
4pxk,C,39,60,21,FYIATILITAIAFVNYLAMAL,1
4pxk,C,77,98,21,WARYTDWLFTTPLLLYNLGLL,1
4pxk,C,104,126,22,TIYSLVSLDVLMIGTGVVATLS,1
4pxk,C,138,160,22,LVWWGISTAFLLVLLYFLFSSL,1
4pxk,C,175,196,21,KTLRNLVTVVWLVYPVWWLVG,1
4pxk,C,208,229,21,TAGFMVIDLVAKVGFGIILLR,1
5a3r,A,51,77,26,LVIEQFEDLLVRILLLAACISFVLAW,1
5a3r,A,86,106,20,AFVEPFVILLILIANAIVGV,1
5a3r,A,254,274,20,EFGEQLSKVISLICVAVWLI,1
5a3r,A,297,317,20,IAVALAVAAIPEGLPAVITT,1
5a3r,A,759,778,19,FIRYLISSNVGEVVCIFLT,1
5a3r,A,787,807,20,IPVQLLWVNLVTDGLPATAL,1
5a3r,A,830,852,22,GWLFFRYMAIGGYVGAATVGAA,1
5a3r,A,898,916,18,MALSVLVTIEMCNALNSL,1
5a3r,A,932,954,22,LLGSICLSMSLHFLILYVDPLP,1
5a3r,A,962,987,25,DLTQWLMVLKISLPVIGLDEILKFI,1
5vex,A,146,169,23,IYTVGYALSFSALVIASAILLGF,1
5vex,A,176,199,23,NYIHLNLFASFILRALCVFFKDA,1
5vex,A,265,287,22,FRLYVAIGWGVPLLFVVPWGIV,1
5vex,A,305,332,27,WLIIRLPILFACIVNFLIFVRVICIVV,1
5vex,A,347,370,23,RLAKSTLTLIPLLCTHEVIFAFV,1
5vex,A,387,407,20,LSFTSFQGLMVAILYCFVNN,1
3gww,B,13,32,19,LILAMAGNAVGLGNFLRFP,1
3gww,B,44,63,19,IPYIIAFLLVGIPLMWIEW,1
3gww,B,90,124,34,KILGVFGLWIPLVVAIYYVYIESWTLGFAIKFLV,1
3gww,B,167,185,18,AYIVFLITMFINVSILIR,1
3gww,B,191,212,21,ERFAKIAMPTLFILAVFLVIR,1
3gww,B,242,265,23,VWIAAVGQIFFTLSLGFGAIITY,1
3gww,B,278,297,19,GLTAATLNEKAEVILGGSI,1
3gww,B,340,366,26,GFLWFFLLFFAGLTSSIAIMQPMIAF,1
3gww,B,378,396,18,VLWTAAIVFFSAHLVMFL,1
3gww,B,400,425,25,DEMDFWAGTIGVVFFGLTELIIFFW,1
3gww,B,445,469,24,RIYYYVMRYITPAFLAVLLVVWAR,1
3gww,B,484,502,18,ITRFYIIGLFLFLTFLVF,1
5ah3,C,33,50,17,ASVLVWIMIPGVGLLYS,1
5ah3,C,62,84,22,WAALMAACVAAFQWFWWGYSLV,1
5ah3,C,121,139,18,YQGMFAAVTAILMAGAGC,1
5ah3,C,145,166,21,PMMVFLFIWLTVVYCPIAYWT,1
5ah3,C,181,201,20,AGGGPVHENSGFAALAYSLW,1
5ah3,C,224,242,18,IVMGTIFLWFGWYGFNGG,1
5ah3,C,255,275,20,VNTNLAAATGGLTWMLVDWF,1
5ah3,C,284,301,17,GLCMGAIAGLVGITPAA,1
5ah3,C,307,324,17,TSVIFGIVPAIICNFAV,1
5ah3,C,336,356,20,DVWALHGVGGFVGNFMTGLF,1
5ah3,C,382,409,27,YQLAGSCAVAAWSFTVTSIILLAMDRI,1
5fn5,C,11,26,15,VAFGPAFALFLITVA,1
5fn5,C,33,52,19,ILVAGAFFWLVSLLLASVV,1
5fn5,C,77,91,14,VSVLLQEVFRFAYY,1
5fn5,C,120,134,14,SGLSFGIISGVFSV,1
5fn5,C,162,178,16,LTAAIILLHTFWGVVF,1
5fn5,C,188,202,14,ALGLVVGSHLLTSG,1
5fn5,C,216,229,13,IYAVTVSMGLWAF,1
5svj,C,28,47,19,VVQLLIISYFVGWVFLHEK,1
5svj,C,316,343,27,NIIPTIISSVAAFTSVGVGTVLCDIIL,1
3e8g,E,26,45,19,LFVLTILTLISGTIFYSTV,1
3e8g,E,75,96,21,GKIFTILYIFIGIGLVFGFIH,1
4lep,B,19,33,14,IELWERFGYYGMQA,1
4lep,B,55,69,14,ACAALIYVSPAIGG,1
4lep,B,82,96,14,LLGAGILSVGYALM,1
4lep,B,109,122,13,LGVIVVGNGLFKP,1
4lep,B,147,161,14,MAVNVGSTFSMLLT,1
4lep,B,183,198,15,VCCVGILVGLGNYAL,1
4lep,B,221,238,17,IVLALAALSVVASAIIL,1
4lep,B,244,261,17,RVFVYAAGVAVLGIFFH,1
4lep,B,278,295,17,ILTVQTVFFFIFYQQMS,1
4lep,B,325,340,15,QALNPIWIMVLSPVL,1
4lep,B,359,373,14,FALGFAVVAIGFFI,1
4lep,B,393,408,15,GYASYSLGELLVSGL,1
4lep,B,428,441,13,YFVASGISQYLGG,1
4lep,B,471,484,13,VAAVVCTIIALAV,1
3eml,A,8,30,22,YITVELAIAVLAILGNVLVCWA,1
3eml,A,42,66,24,YFVVSLAAADIAVGVLAIPFAITI,1
3eml,A,79,103,24,IACFVLVLTQSSIFSLLAIAIDRY,1
3eml,A,121,143,22,KGIIAICWVLSFAIGLTPMLGW,1
3eml,A,176,202,26,MVYFNFFACVLVPLLLMLGVYLRIFL,1
3eml,A,233,254,21,SLAIIVGLFALCWLPLHIINC,1
3eml,A,270,291,21,YLAIVLSHTNSVVNPFIYAYR,1
1c8s,C,12,28,16,LALGTALMGLGTLYFL,1
1c8s,C,48,62,14,VPAIAFTMYLSMLL,1
1c8s,C,80,93,13,ARYADWLFTTPLL,1
1c8s,C,112,127,15,GADGIMIGTGLVGAL,1
1c8s,C,134,149,15,FVWWAISTAAMLYIL,1
1c8s,C,178,192,14,VVLWSAYPVVWLIG,1
1c8s,C,204,220,16,TLLFMVLDVSAKVGFG,1
4r8c,E,28,45,17,VLTILTLISGTIFYSTV,1
4r8c,E,74,94,20,GKIFTILYIFIGIGLVFGFI,1
1at9,C,10,32,22,WLALGTALMGLGTLYFLVKGMG,1
1at9,C,42,66,24,AITTLVPAIAFTMYLSMLLGYGLT,1
1at9,C,79,98,19,ARYADWLFTTPLLLLDLAL,1
1at9,C,106,128,22,ILALVGADGIMIGTGLVGALTK,1
1at9,C,134,156,22,VWWAISTAAMLYILYVLFFGFT,1
1at9,C,172,193,21,LRNVTVVLWSAYPVVWLIGSE,1
1at9,C,203,225,22,TLLFMVLDVSAKVGFGLILLRS,1
5hwy,A,7,27,20,YFLLGLILLYYGSDWFVLGS,1
5hwy,A,40,58,18,IGATVMAIGTSLPEILTS,1
5hwy,A,74,93,19,IGSCICNIGLVLGLSAIIS,1
5hwy,A,103,120,17,NILVYLLFVIFAAVIGI,1
5hwy,A,127,144,17,GVVLLILFIIYLRWTVK,1
5hwy,A,163,183,20,SLVLLIIGLIGVLVGAELFV,1
5hwy,A,206,222,16,FGTSLPELMVSLAAAK,1
5hwy,A,227,247,20,MVLGNVIGSNIADIGGALAV,1
5hwy,A,259,275,16,QMAVLVIMSLLLYLFA,1
5hwy,A,281,299,18,RWQGILFLALYIIAIASL,1
2zjs,E,32,52,20,AILLFTLAFMVILGLYDTVF,1
4p6j,B,5,22,17,AHALFSALFALSELYIA,1
4yk5,C,16,32,16,LLCSTLLVIKMYVVAI,1
4yk5,C,73,90,17,NDMETIYPFLFLGFVYS,1
4yk5,C,98,115,17,AWMHFLVFLVGRVAHTV,1
4yk5,C,129,146,17,YTLAQLPCASMALQILW,1
2jlo,A,31,45,14,LAAIWFAMAIQVAI,1
2jlo,A,63,76,13,AIAAGCTIAVILL,1
2jlo,A,109,130,21,KALLSLFWFGFQTWLGALALD,1
2jlo,A,143,157,14,LWIVIFGAIQVVTT,1
2jlo,A,164,179,15,RWMNVFASPVLLAMG,1
2jlo,A,211,227,16,AIMIFVGGWIAVVVSI,1
2jlo,A,254,268,14,AQWLGMVPASIIFG,1
2jlo,A,305,322,17,VLLATWSTNPAANLLSP,1
2jlo,A,341,356,15,VSAVVGLLMMPWQFA,1
2jlo,A,362,375,13,LNLLASALGPLAG,1
2htk,B,40,61,21,VVGTLVGLAAVAFDKGVAWLQ,1
2htk,B,83,97,14,LCSAVLAMFGYFLV,1
2htk,B,129,142,13,VKFFGGLGTLGGG,1
2htk,B,144,155,11,LGREGPTVQIG,1
2htk,B,216,232,16,AVFIGVIMSTIMYRIF,1
2htk,B,253,273,20,LYLILGIIFGIFGPIFNKWV,1
2htk,B,291,305,14,VLMGGAIGGLCGLL,1
2htk,B,337,351,14,VARVITTLLCFSSG,1
2htk,B,353,368,15,GGIFAPMLALGTVLG,1
2htk,B,423,439,16,PMIITGLGATLLAQFT,1
3gb7,F,26,50,24,RAAGAATVLLVIVLLAGSYLAVLA,1
3gb7,F,87,111,24,GRCVAVVVMVAGITSFGLVTAALA,1
5d5a,A,32,56,24,VVGMGIVMSLIVLAIVFGNVLVIT,1
5d5a,A,71,95,24,ITSLACADLVMGLAVVPFGAAHIL,1
5d5a,A,105,129,24,CEFWTSIDVLCVTASIETLCVIAV,1
5d5a,A,152,175,23,IILMVWIVSGLTSFLPIQMHWYR,1
5d5a,A,196,220,24,QAYAIASSIVSFYVPLVIMVFVYS,1
5d5a,A,275,299,24,GIIMGTFTLCWLPFFIVNIVHVIQ,1
5d5a,A,306,327,21,VYILLNWIGYVNSGFNPLIYC,1
3pbl,A,35,52,17,YCALILAIVFGNGLVCM,1
3pbl,A,68,84,16,VSLAVADLLVATLVMP,1
3pbl,A,109,123,14,DVMMCTASIWNLCA,1
3pbl,A,152,166,14,MITAVWVLAFAVSC,1
3pbl,A,191,206,15,SSVVSFYLPFGVTVL,1
3pbl,A,334,347,13,LGAFIVCWLPFFL,1
3pbl,A,368,382,14,TWLGYVNSALNPVI,1
3wfb,C,10,26,16,RNIYFGGSVFFILLFL,1
3g5u,A,45,68,23,DRLYMLVGTLAAIIHGVALPLMM,1
3g5u,A,114,132,18,TGIGAGVLIVAYIQVSFW,1
3g5u,A,184,203,19,KIGMFFQAMATFFGGFIIG,1
3g5u,A,215,234,19,AISPVLGLSAGIWAKILSS,1
3g5u,A,291,310,19,NISMGAAFLLIYASYALAF,1
3g5u,A,332,349,17,SVLIGAFSVGQASPNIE,1
3g5u,A,708,728,20,VGIFCAIINGGLQPAFSVIF,1
3g5u,A,753,773,20,LFLILGIISFITFFLQGFTF,1
3g5u,A,829,847,18,AVIFQNIANLGTGIIISL,1
3g5u,A,852,872,20,LTLLLLAIVPIIAIAGVVEM,1
3g5u,A,933,953,20,FGITFSFTQAMMYFSYAAAF,1
3g5u,A,973,990,17,FSAIVFGAMAVGQVSSF,1
5c2t,D,56,79,23,TLFKIERYFAAAMVPLIPAAYFI,1
5c2t,D,84,110,26,DLCLALALTLHVHWGVWGVVNDYGRP,1
5c2t,D,113,137,24,GDTLAAAVRVGAYIFTACLLAGLL,1
5d57,C,34,48,14,GVAVLLCVVIAAWL,1
5d57,C,53,67,14,TRVLLISSVMLVMI,1
5d57,C,103,117,14,AIIDAVITWAILLW,1
4rym,A,9,27,18,VFFLTYGLFYVSSVLFPI,1
4rym,A,45,65,20,TIGMIWAVLFGLIALSVAII,1
4rym,A,75,96,21,FWFLFLLNYIFNQAFSYFQFS,1
4rym,A,102,122,20,ATVDCLLVAITTLLLIMFSS,1
4rym,A,127,147,20,SAWLLIPYFLWSAFATYLSW,1
1qhj,C,13,30,17,ALGTALMGLGTLYFLVK,1
1qhj,C,45,60,15,TTLVPAIAFTMYLSM,1
1qhj,C,81,96,15,RYADWLFTTPLLLLD,1
1qhj,C,110,125,15,LVGADGIMIGTGLVG,1
1qhj,C,136,152,16,WWAISTAAMLYILYVL,1
1qhj,C,175,191,16,NVTVVLWSAYPVVWLI,1
1qhj,C,205,222,17,LLFMVLDVSAKVGFGLI,1
5vpn,H,13,33,20,WGLFGAGGMWSAIIAPVMIL,1
5vpn,H,65,86,21,FLFLMIVLPLWCGLHRMHHAM,1
5vpn,H,94,116,22,AGKWVFYGLAAILTVVTLIGVV,1
5tin,E,225,244,19,QMYIPSLLIVILSWVSFWI,1
5tin,E,249,269,20,PARVALGITTVLTMTTQSSG,1
5tin,E,284,305,21,IWMAVCLLFVFSALLEYAAVN,1
5tin,E,323,344,21,TISRACFPLAFLIFNIFYWVI,1
4wis,B,196,215,19,RFLVIPSAFGFGAWLLLGQ,1
4wis,B,217,233,16,YLYALLCGLWSVVFFE,1
4wis,B,287,318,31,QLLQIPFALACVVALGALIVTCNSLEVFINE,1
4wis,B,325,354,29,QYLGFLPTIFLVIGTPTISGVLMGAAEKL,1
4wis,B,371,397,26,QKQFVLNFMTSYMALFFTAFVYIPFG,1
4wis,B,430,455,25,ARISNQMFYFTVTAQIVNFATEVVV,1
4wis,B,506,521,15,MVMQFGYVAMFSVAW,1
4wis,B,523,535,12,AACCFLVNNWVE,1
4wis,B,562,585,23,TALSFLSWLGSITSSAIVYLCSN,1
4wis,B,597,621,24,KAWGLLLSILFAEHFYLVVQLAVR,1
2zd9,D,16,28,12,LAAPGLLAVAAL,1
2zd9,D,41,54,13,AALLAVIWGAYLL,1
2zd9,D,80,92,12,AVLVPLAAFLLD,1
2zd9,D,98,108,10,LYCAVWLLKP,1
2zd9,D,134,149,15,LFGVVLFAVALAAYV,1
2zd9,D,188,203,15,RVLAGAVMMSGIGIF,1
2mgy,A,9,28,19,GLTLVPSLGGFMGAYFVRG,1
2mgy,A,41,61,20,WHPPRWTLAPIWGTLYSAMG,1
2mgy,A,82,102,20,GLYTGQLALNWAWPPIFFGA,1
2mgy,A,107,128,21,ALADLLLVSGVATATTLAWHR,1
2mgy,A,134,153,19,RLLYPYLAWLAFATVLNYY,1
2b6u,A,26,49,23,PALYTVVFLTGILLNTLALWVFV,1
2b6u,A,60,80,20,LKNTLVADLIMTLMLPFKIL,1
2b6u,A,95,118,23,RFSSVIFYETMYVGIVLLGLIAF,1
2b6u,A,141,164,23,VSIFIWFFLFFISLPNMILSNKE,1
2b6u,A,184,208,24,HQMVNNICQFIFWTVFILMLVFYV,1
2b6u,A,236,256,20,FVVVAVFFVCFAPFHFARVP,1
2b6u,A,279,299,20,TTLFLAATNICMDPLIYIFL,1
2iqp,A,51,73,22,VTLGVISLLENILVIVAIAKNK,1
2iqp,A,79,98,19,YFFICSLAVADMLVSVSNG,1
2iqp,A,125,149,24,DSVICSSLLASICSLLSIAVDRYF,1
2iqp,A,164,187,23,RVGIIISCIWAACTVSGILFIIY,1
2iqp,A,193,217,24,IICLITMFFTMLALMASLYVHMFL,1
2iqp,A,241,263,22,KGAITLTILIGVFVVCWAPFFL,1
2iqp,A,288,310,22,ILIMCNSIIDPLIYALRSQELR,1
1p7b,D,61,85,24,VFFASLAALFVVNNTLFALLYQLG,1
1p7b,D,122,145,23,AHAIATLEIFVGMSGIALSTGLV,1
5uar,A,85,103,18,GFLLYIGEATKTVQPQLL,1
5uar,A,126,142,16,GLGLLFTARFLLLQPA,1
5uar,A,201,217,16,IWISPLQCILCTGLIW,1
5uar,A,223,238,15,SFCALAAISLLGVLQ,1
5uar,A,307,323,16,SSAYFFSAIFVIVAAV,1
5uar,A,339,355,16,TLSYCMVLRMTVTRQL,1
5uar,A,860,876,16,LIFILFIAAIEIAGSV,1
5uar,A,927,943,16,VATSESLLAMGFFRGL,1
5uar,A,1002,1021,19,VQLTVVVVGCILVVSIVRP,1
5uar,A,1023,1037,14,FLAATPLAIIFIVM,1
5uar,A,1109,1125,16,RADILFVFFFTLAAWI,1
5uar,A,1140,1155,15,ICLAMLILGTFQWCV,1
3zuy,A,8,26,18,SFIGKTFSLWAALFAAAA,1
3zuy,A,40,55,15,PWLLGIIMFGMGLTL,1
3zuy,A,71,88,17,IGVIAQFAIMPATAWLL,1
3zuy,A,103,118,15,LVGCCPGGTASNVMT,1
3zuy,A,129,147,18,AVTSVSTLISPLLTPAIF,1
3zuy,A,163,181,18,MSIVKMVLLPIVLGLIVH,1
3zuy,A,192,209,17,DALPLVSVAAIVLIIGA,1
3zuy,A,227,247,20,VVVLHNGIGYLLGFFAAKWT,1
3zuy,A,255,272,17,TLTIEVGMQNSGLAAAL,1
3zuy,A,287,304,17,ALFSVWHNISGSLLATY,1
2lor,A,41,54,13,TGMAFGLQMFIQR,1
2lor,A,60,78,18,QWSLLVAVVAGSVVSYGV,1
5khn,A,22,39,17,LSLLIAAFSGVYVARHF,1
5khn,A,279,295,16,NGVVTLLVVFVILWLA,1
5khn,A,303,325,22,SVLVTLFVGLVVTAALGLAMVG,1
5khn,A,332,347,15,AFMVLFVGLGVDFSI,1
5khn,A,382,395,13,TAVAASFFSFIPT,1
5khn,A,401,418,17,ELGLIAGVGMFVALLTT,1
5khn,A,458,473,15,IGTLAVVIGALPLLA,1
5khn,A,719,734,15,FLHAALWSIISITIL,1
5khn,A,750,766,16,PLLVSGIVTLEMCVVL,1
5khn,A,775,789,14,IALPLMLGVGVAFK,1
5khn,A,813,828,15,FSAATTATAFGSLWL,1
5khn,A,838,854,16,KLLALALTCTLIGAVV,1
5is0,E,440,453,13,YCLYMIIFTAAAY,1
5is0,E,474,490,16,VTGEILSVSGGVYFFF,1
5is0,E,516,531,15,FVQSLFMLVSVVLYF,1
5is0,E,537,552,15,VASMVFSLAMGWTNM,1
5is0,E,582,598,16,VYLVFLFGFSTAVVTL,1
5is0,E,658,676,18,FIILLLAYVILTYILLLN,1
4zw9,A,13,33,20,ITVATIGSFQFGYNTGVINA,1
4zw9,A,65,85,20,SVAIFSVGGMIGSFSVGLFV,1
4zw9,A,92,110,18,SMLIVNLLAVTGGCFMGL,1
4zw9,A,119,140,21,LILGRLVIGLFCGLCTGFVPM,1
4zw9,A,154,174,20,GTLNQLGIVVGILVAQIFGL,1
4zw9,A,186,203,17,LLGFTILPAILQSAALP,1
4zw9,A,271,292,21,ISIVLQLSQQLSGINAVFYYS,1
4zw9,A,307,326,19,TIGAGVVNTIFTVVSLFLV,1
4zw9,A,332,352,20,TLHMIGLGGMAFCSTLMTVS,1
4zw9,A,365,389,24,CIGAILVFVAFFEIGPGPIPWFIV,1
4zw9,A,401,424,23,MAVAGCSNWTSNFLVGLLFPSAA,1
4zw9,A,430,448,18,VFIIFTGFLITFLAFTFF,1
4xnx,A,38,57,19,SVIGFAVDLANVWRFPYLC,1
4xnx,A,63,81,18,AFLVPYGIMLAVGGIPLF,1
4xnx,A,113,133,20,VLIAFYVDFYYNVIIAWSLR,1
4xnx,A,238,255,17,MALCLLIVYLICYFSLW,1
4xnx,A,261,280,19,GKVVWFTALFPYAVLLILL,1
4xnx,A,304,328,24,YKAEVWVDAATQVFFSLGPGFGVL,1
4xnx,A,346,362,16,LTSFINSATSFIAGFV,1
4xnx,A,410,429,19,FMMLATLGLDSSFGGSEAI,1
4xnx,A,449,464,15,GLFSLYFVVGLASCT,1
4xnx,A,468,488,20,YFFHLLDRYAAGYSILVAVF,1
4xnx,A,527,545,18,PIFLLFITVYGLIGYEPL,1
4xnx,A,554,569,15,WANALGWCIAGSSVV,1
2l9u,A,645,667,22,LTVIAGLVVIFMMLGGTFLYWR,1
1rzz,H,13,32,19,SLAIYSFWIFLAGLIYYLQ,1
4qe7,D,24,41,17,LLVLAVIIYGTAGFHFI,1
4qe7,D,71,92,21,GMYFTCTLIVLGIGTFAVAVE,1
3vmr,A,45,59,14,ILLTILIIIALFIG,1
4o6y,B,14,35,21,VRVLGFIIAALVLTWTVHYRG,1
4o6y,B,45,66,21,HIFNVHPVMMVIGLILFNGEA,1
4o6y,B,87,108,21,QLTAFILSLIGVWAALKFHID,1
4o6y,B,113,134,21,FYSLHSWLGLACLFLFAFQWA,1
4o6y,B,161,184,23,ISIYALALVTATTGILEKVTFLQ,1
4o6y,B,190,214,24,RYSTEAMLVNTMGVLILILGGFVI,1
3tt3,B,16,35,19,AMAGNAVGLGNFLRFPVQA,1
3tt3,B,44,59,15,IPYIIAFLLVGIPLM,1
3tt3,B,96,124,28,GLWIPLVVAIYYVYIESWTLGFAIKFLV,1
3tt3,B,167,181,14,AYIVFLITMFINVS,1
3tt3,B,195,212,17,KIAMPTLFILAVFLVIR,1
3tt3,B,242,259,17,VWIAAVGQIFFTLSLGF,1
3tt3,B,283,298,15,TLNEAAEVILGGSIS,1
3tt3,B,337,360,23,TFLGFLWFFLLFFAGLVASIAIM,1
3tt3,B,382,396,14,AAIVFFSAHLVMFL,1
3tt3,B,400,418,18,DEMDFWAGTIGVVFFGLT,1
3tt3,B,455,472,17,TPAFLAVLLVVWAREYI,1
3tt3,B,484,498,14,ITRFYIIGLFLFLT,1
4o6n,B,179,193,14,FSFFLSLVGSALFL,1
4o6n,B,199,214,15,TLLAGVIIQLHSIID,1
4o6n,B,238,252,14,DRYSDFIIVFSITY,1
4o6n,B,262,277,15,IIGFLAAFASLMIAY,1
4o6n,B,297,316,19,PITRDFRLLIIFACSVVNL,1
4o6n,B,318,334,16,LALVIIALLGNFEALR,1
2eil,Z,13,35,22,EQAIGLSVTFLSFLLPAGWVLY,1
3dqb,C,40,63,23,AAYMFLLIMLGFPINFLTLYVTV,1
3dqb,C,75,95,20,LLNLAVADLFMVFGGFTTTL,1
3dqb,C,113,133,20,GFFATLGGEIALWSLVVLAI,1
3dqb,C,155,173,18,GVAFTWVMALACAAPPLV,1
3dqb,C,202,221,19,FVIYMFVVHFIIPLIVIFF,1
3dqb,C,255,277,22,IMVIAFLICWLPYAGVAFYIFT,1
3dqb,C,289,309,20,IPAFFAKTSAVYNPVIYIMM,1
4a98,E,211,225,14,LGLIIAASWSVFWL,1
4a98,E,230,245,15,RLQTSFTLMLTVVAY,1
4a98,E,266,282,16,IAGYGSIFAAILLIIF,1
4a98,E,298,315,17,RCRLAFPLGFLAIGCVL,1
2ih3,F,27,50,23,AAGAATVLLVIVLLAGSYLAVLA,1
2ih3,F,87,110,23,GRLVAVVVMVAGITSFGLVTAAL,1
5ksd,A,56,65,9,KLLKFLGFM,1
5ksd,A,67,83,16,PLSWVMEMAAIMAIAL,1
5ksd,A,93,114,21,QDFVGIICLLVINSTISFIEE,1
5ksd,A,241,263,22,AIGNFCICSIAIGMVIEIIVMY,1
5ksd,A,275,292,17,NLLVLLIGGIPIAMPTV,1
5ksd,A,645,666,21,TIYAVSITIRIVFGFMLIALI,1
5ksd,A,672,690,18,AFMVLIIAILNDGTIMTI,1
5ksd,A,710,730,20,ATGVVLGGYQAIMTVIFFWA,1
5ksd,A,755,774,19,AVYLQVSIISQALIFVTRS,1
5ksd,A,783,803,20,GALLMIAFLIAQLIATLIAV,1
5ksd,A,818,841,23,WAGVIWLYSIVTYFPLDVFKFAI,1
3aym,A,36,57,21,LGIFIGICGIIGCGGNGIVIY,1
3aym,A,72,94,22,IINLAFSDFTFSLVNGFPLMTI,1
3aym,A,110,131,21,YGFIGGIFGFMSIMTMAMISI,1
3aym,A,153,172,19,IMIIFVWLWSVLWAIGPIF,1
3aym,A,200,221,21,ILCMFILGFFGPILIIFFCYF,1
3aym,A,263,282,19,IVIVSQFLLSWSPYAVVAL,1
3aym,A,298,317,19,LPVMFAKASAIHNPMIYSV,1
2nop,C,15,32,17,CTALVLFMTIPGIALFY,1
2nop,C,46,64,18,QVTVTFALVCILWVVYGY,1
2nop,C,103,118,15,QGSFACITVGLIVGA,1
2nop,C,127,147,20,VLIFVVVWLTLSYIPIAHMV,1
2nop,C,161,178,17,AGGTVVHINAAIAGLVG,1
2nop,C,202,219,17,TGTAILYIGWFGFNAGS,1
2nop,C,231,248,17,VNTVVATAAAILGWIFG,1
2nop,C,261,276,15,CSGAIAGLVGVTPAC,1
2nop,C,282,299,17,GALIIGVVAGLAGLWGV,1
2nop,C,314,332,18,FGVHGVCGIVGCIMTGIF,1
2nop,C,353,377,24,VQLESIAITIVWSGVVAFIGYKLA,1
4d1a,A,31,45,14,LAAIWFAMAIQVAI,1
4d1a,A,63,77,14,AIAAGCTIAVILLF,1
4d1a,A,107,130,23,TLKALLSLFWFGFQTWLGALALD,1
4d1a,A,142,157,15,PLWIVIFGAIQVVTT,1
4d1a,A,164,180,16,RWMNVFASPVLLAMGV,1
4d1a,A,210,227,17,TAIMIFVGGWIAVVVSI,1
4d1a,A,254,268,14,AQWLGMVPASIIFG,1
4d1a,A,304,322,18,FVLLATWSTNPAANLLSP,1
4d1a,A,341,355,14,VSAVVGLLMMPWQF,1
4d1a,A,360,375,15,TFLNLLASALGPLAG,1
3zo6,M,6,18,12,AIAAGLAAVGGA,1
3zo6,M,55,66,11,VPIIAIVISLL,1
3zmh,A,94,109,15,PVTWVMMIACVVVFI,1
3zmh,A,149,166,17,HILFNLLWWWYLGGAVE,1
3zmh,A,172,188,16,KLIVITLISALLSGYV,1
3zmh,A,199,213,14,LSGVVYALMGYVWL,1
3zmh,A,226,242,16,RGLIIFALIWIVAGWF,1
3zmh,A,252,267,15,AHIAGLAVGLAMAFV,1
5bzb,F,132,153,21,SVAALLTVVFYIAAVMATNLY,1
5bzb,F,194,218,24,AWVFFIPFIMLTTFTVLNLFIGII,1
3fps,A,55,74,19,QFEDLLVRILLLAACISFV,1
3fps,A,90,109,19,PFVILLILIANAIVGVWQE,1
3fps,A,254,276,22,EFGEQLSKVISLICVAVWLINI,1
3fps,A,296,318,22,KIAVALAVAAIPEGLPAVITTC,1
3fps,A,760,781,21,IRYLISSNVGEVVCIFLTAAL,1
3fps,A,786,809,23,LIPVQLLWVNLVTDGLPATALGF,1
3fps,A,833,852,19,FFRYMAIGGYVGAATVGAA,1
3fps,A,898,917,19,MALSVLVTIEMCNALNSLS,1
3fps,A,926,948,22,PWVNIWLLGSICLSMSLHFLIL,1
3fps,A,967,987,20,LMVLKISLPVIGLDEILKFI,1
3zcc,B,329,351,22,ADDGTLLMAGVSHDLRTPLTRI,1
3zcc,B,372,387,15,IEECNAIIEQFIDYL,1
3vvo,A,24,41,17,IPMMIGMSVQTLYNLAD,1
3vvo,A,60,79,19,PVFMGIIALAAGLGVGTSS,1
3vvo,A,98,118,20,HSLILSLILGVTITITMLPA,1
3vvo,A,141,162,21,VLLAGAFIIVFNNVGNGILRG,1
3vvo,A,166,187,21,NRAMLAMVLGSGLNIVLDPIF,1
3vvo,A,199,219,20,YATLLSMVVTSLFIAYWLFV,1
3vvo,A,240,264,24,DILRVGLPSSLSQLSMSIAMFFLN,1
3vvo,A,280,301,21,SAWRITMLGIVPILGMAAATT,1
3vvo,A,324,346,22,KIAFMIELAVVAFIMLFAPQVA,1
3vvo,A,363,387,24,SALRTLPVFLVLTPFGMMTSAMFQ,1
3vvo,A,391,414,23,GEKSLILTIFRTLVMQVGFAYIF,1
3vvo,A,424,444,20,VWIGIVIGNMVAAIVGFLWG,1
3tlt,E,199,218,19,NIILPMLFILFISWTAFWS,1
3tlt,E,222,242,20,ANVTLVVSTLIAFIAFNILV,1
3tlt,E,256,276,20,AIIFMIYLFYFVAVIEVTVQ,1
3tlt,E,292,313,21,RASRIAFPVVFLLANIILAFL,1
3m77,C,12,26,14,YFDIPLGLAALSLA,1
3m77,C,41,61,20,DVLGIVASAVWILFILMYAY,1
3m77,C,82,97,15,IALIPITTMLVGDIL,1
3m77,C,105,125,20,EVLIWIGTIGQLLFSTLRVS,1
3m77,C,141,154,13,FYLPAVAANFTSA,1
3m77,C,167,182,15,LFFGAGMIAWIIFEP,1
3m77,C,201,215,14,GIVLAPAFVCVSAY,1
3m77,C,227,245,18,KILWGYGFLQLFFLLRLF,1
3m77,C,256,271,15,LWAFSAGLASMANSA,1
3m77,C,284,307,23,IFAFVFSNVMIGLLVLMTIYKLT,1
2y5y,A,11,33,22,FGLFFFFYFFIMGAYFPFFPIW,1
2y5y,A,46,64,18,IIFAAISLFSLLFQPLFG,1
2y5y,A,76,96,20,LWIITGMLVMFAPFFIFIFG,1
2y5y,A,105,126,21,GSIVGGIYLGFSFNAGCPAVE,1
2y5y,A,144,162,18,MFGAVGWALVASIVGIMF,1
2y5y,A,167,186,19,FVFWLGSGMALILAVLLFF,1
2y5y,A,224,245,21,LSLYVIGVSSTYDVFDQQFAN,1
2y5y,A,259,279,20,VFGYVTTMGELLNASIMFFA,1
2y5y,A,290,309,19,ALLLAGTIMSVRIIGSSFA,1
2y5y,A,314,333,19,VVILKTLHMFEVPFLLVGS,1
2y5y,A,351,372,21,VAFAFFKQLAMIFMSVLAGNM,1
2y5y,A,382,400,18,LVLGLVALGFTLISVFTL,1
3m6e,C,33,46,13,GLLFFAGIFYNST,1
3m6e,C,48,62,14,GVCAVLGTAASTLT,1
3m6e,C,79,91,12,ANGTLAGIALPF,1
3m6e,C,99,114,15,LGYVALNGAFTTIIM,1
3m6e,C,129,143,14,TAPFVLATWLLMFG,1
3m6e,C,194,206,12,VTGVIFVVAILV,1
3m6e,C,210,226,16,SALFAVIGSLVGLCTA,1
3m6e,C,240,253,13,YGFNSVLCGIAMG,1
3m6e,C,265,282,17,YALGCMVLGAIATGAFS,1
3m6e,C,292,304,12,LTWPFIVVTWLF,1
2uwv,M,55,72,17,GVLSLFSGLMWFFTIGI,1
2uwv,M,117,134,17,ASFFMFVAVWSWWGRTY,1
2uwv,M,147,164,17,WAFLSAIWLWMVLGFIR,1
2uwv,M,200,221,21,FHGLSIAFLYGSALLFAMHGA,1
2uwv,M,269,286,17,IWMAVLVTLTGGIGILL,1
2wli,E,48,71,23,FITLITGLYLVTNALFALAYLAC,1
2wli,E,108,128,20,ANTLVTLEALCGMLGLAVAA,1
2uui,C,5,28,23,ALLAAVTLLGVLLQAYFSLQVIS,1
2uui,C,52,74,22,QVNCSEYFPLFLATLWVAGIFF,1
2uui,C,76,97,21,GAAALCGLVYLFARLRYFQGY,1
2uui,C,104,131,27,LAPLYASARALWLLVALAALGLLAHFL,1
2uuh,C,9,22,13,AVTLLGVLLQAYF,1
2uuh,C,57,71,14,EYFPLFLATLWVAG,1
2uuh,C,79,92,13,ALCGLVYLFARLR,1
2uuh,C,108,124,16,YASARALWLLVALAAL,1
4j2t,A,55,73,18,QFEDLLVRILLLAACISF,1
4j2t,A,90,110,20,PFVILLILIANAIVGVWQER,1
4j2t,A,254,276,22,EFGEQLSKVISLICVAVWLINI,1
4j2t,A,296,318,22,KIAVALAVAAIPEGLPAVITTC,1
4j2t,A,760,781,21,IRYLISSNVGEVVCIFLTAAL,1
4j2t,A,786,808,22,LIPVQLLWVNLVTDGLPATALG,1
4j2t,A,833,852,19,FFRYMAIGGYVGAATVGAA,1
4j2t,A,898,916,18,MALSVLVTIEMCNALNSL,1
4j2t,A,927,950,23,WVNIWLLGSICLSMSLHFLILYV,1
4j2t,A,968,987,19,MVLKISLPVIGLDEILKFI,1
1bhb,A,10,31,21,IWLALGTALMGLGTLYFLVKG,1
1bhb,A,40,63,23,KFYAITTLVPAIAFTMYLSMLLG,1
2wlh,D,48,71,23,FITLITGLYLVTNALFALAYLAC,1
2wlh,D,108,128,20,ANTLVTLEALCGMLGLAVAA,1
2uww,M,55,72,17,GVLSLFSGLMWFFTIGI,1
2uww,M,117,133,16,ASFFMFVAVWSWWGRT,1
2uww,M,147,164,17,WAFLSAIWLWMVLGFIR,1
2uww,M,200,221,21,FHGLSIAFLYGSALLFAMHGA,1
2uww,M,269,286,17,IWMAVLVTLTGGIGILL,1
3tlu,E,203,218,15,PMLFILFISWTAFWS,1
3tlu,E,222,239,17,ANVTLVVSTLIAHIAFN,1
3tlu,E,259,276,17,FMIYLFYFVAVIEVTVQ,1
3tlu,E,292,310,18,RASRIAFPVVFLLANIIL,1
1l0v,P,13,38,25,WGLFGAGGMWSAIIAPVMILLVGIL,1
1l0v,P,62,86,24,GRVFLFLMIVLPLWCGLHRMHHAM,1
1l0v,P,94,116,22,AGKWVFYGLAAILTVVTLIGVV,1
3m76,C,12,27,15,YFDIPLGLAALSLAW,1
3m76,C,41,61,20,DVLGIVASAVWILFILMYAY,1
3m76,C,82,97,15,IALIPITTMLVGDIL,1
3m76,C,105,125,20,EVLIWIGTIGQLLFSTLRVS,1
3m76,C,141,154,13,FYLPAVAANFTSA,1
3m76,C,167,182,15,LFFGAGMIAWIIFEP,1
3m76,C,201,217,16,GIVLAPAFVCVSAYLS,1
3m76,C,227,245,18,KILWGYGFLQLFFLLRLF,1
3m76,C,256,271,15,LWAFSFGLASMANSA,1
3m76,C,284,307,23,IFAFVFSNVMIGLLVLMTIYKLT,1
3vvn,A,24,44,20,IPMMIGMSVQTLYNLADGIW,1
3vvn,A,57,79,22,LFFPVFMGIIALAAGLGVGTSS,1
3vvn,A,100,120,20,LILSLILGVTITITMLPAID,1
3vvn,A,138,161,23,YARVLLAGAFIIVFNNVGNGILR,1
3vvn,A,167,188,21,RAMLAMVLGSGLNIVLDPIFI,1
3vvn,A,197,218,21,AAYATLLSMVVTSLFIAYWLF,1
3vvn,A,243,264,21,RVGLPSSLSQLSMSIAMFFLN,1
3vvn,A,280,301,21,SAWRITMLGIVPILGMAAATT,1
3vvn,A,324,346,22,KIAFMIELAVVAFIMLFAPQVA,1
3vvn,A,364,388,24,ALRTLPVFLVLTPFGMMTSAMFQG,1
3vvn,A,392,415,23,EKSLILTIFRTLVMQVGFAYIFV,1
3vvn,A,424,444,20,VWIGIVIGNMVAAIVGFLWG,1
1kad,A,45,69,24,PPLYSLVFIFGFVGNMLVVLILIN,1
1kad,A,77,100,23,DIYLLNLAISDLLFLITLPLWAH,1
1kad,A,112,136,24,CKLFTGLYHIGYFGGIFFIILLTI,1
1kad,A,158,179,21,VTSVITWLVAVFASVPGIIFT,1
1kad,A,200,223,23,FHTIMRNILGLVLPLLIMVICYS,1
1kad,A,245,269,24,FTIMIVYFLFWTPYNIVILLNTFQ,1
1kad,A,294,317,23,MTHCCINPIIYAFVGEKFRRYLS,1
2lz3,B,8,29,21,IGLMVGGVVIATVIVITLVML,1
3zmi,A,94,113,19,PVTWVMMIACVVVFIAMQI,1
3zmi,A,144,166,22,HFSLMHILFNLLWWWYLGGAVE,1
3zmi,A,172,190,18,KLIVITLISALLSGYVQQ,1
3zmi,A,198,214,16,GLSGVVYALMGYVWLR,1
3zmi,A,226,244,18,RGLIIFALIWIVAGWFDL,1
3zmi,A,251,268,17,GAHIAGLAVGLAMAFVD,1
1ufd,D,42,57,15,EAVGTYFLIFAGCAS,1
1ufd,D,72,85,13,IAIVWGLVLTVLV,1
1ufd,D,116,137,21,AYVVAQLLGSILASGTLRLLF,1
1ufd,D,156,172,16,FVFEFIMTFFLMFVIC,1
1ufd,D,186,200,14,IAIGSTLLLNVIIG,1
1ufd,D,226,244,18,WIYLLAPVVGAIAGAWVY,1
2yn9,B,38,55,17,WISLYYVAFYVVMSGIF,1
5kpi,A,35,68,33,LTMFRYAGWLDRLYMLVGTLAAIIHGVALPLMM,1
5kpi,A,118,139,21,AGVLIVAYIQVSFWCLAAGRQ,1
5kpi,A,180,204,24,GIGDKIGMFFQAMATFFGGFIIGF,1
5kpi,A,211,231,20,LVILAISPVLGLSAGIWAKI,1
5kpi,A,290,311,21,ANISMGAAFLLIYASYALAFW,1
5kpi,A,331,352,21,FSVLIGAFSVGQASPNIEAFA,1
5kpi,A,706,728,22,FVVGIFCAIINGGLQPAFSVIF,1
5kpi,A,752,773,21,LLFLILGIISFITFFLQGFTF,1
5kpi,A,827,847,20,RLAVIFQNIANLGTGIIISL,1
5kpi,A,855,879,24,LLLAIVPIIAIAGVVEMKMLSGQA,1
5kpi,A,925,949,24,NAMKKAHVFGITFSFTQAMMYFSY,1
5kpi,A,973,994,21,FSAIVFGAMAVGQVSSFAPDY,1
2nlj,F,26,50,24,RAAGAATVLLVIVLLAGSYLAVLA,1
2nlj,F,87,112,25,GRCVAVVVVVAGITSFGLVTAALAT,1
1be3,K,18,36,18,PTAQLWGAVGAVGLVSAT,1
3aoa,C,11,25,14,AWVIAIIIMLAGGL,1
3aoa,C,343,357,14,LVEAIILVFLVMYL,1
3aoa,C,366,383,17,IPTIAVPVVLLGTFAVL,1
3aoa,C,397,410,13,MVLAIGLLVDDAI,1
3aoa,C,443,456,13,GIAMVLSAVFVPM,1
3aoa,C,471,489,18,ITIVSAMALSVLVALILT,1
3aoa,C,543,556,13,LYLIIVVGMAYLF,1
3aoa,C,875,890,15,LYAISLIVVFLCLAA,1
3aoa,C,899,916,17,SVMLVVPLGVIGALLAA,1
3aoa,C,928,943,15,VGLLTTIGLSAKNAI,1
3aoa,C,976,990,14,MTSLAFILGVMPLV,1
3aoa,C,1004,1019,15,TGVMGGMVTATVLAI,1
4qh1,E,199,218,19,NIILPMLFILFISWTAFWS,1
4qh1,E,222,240,18,ANVTLVVSTLIAHIAFNI,1
4qh1,E,256,275,19,AIIFMIYLFYFVAVIEVTV,1
4qh1,E,293,313,20,ASRIAFPVVFLLANIILAFL,1
4x5n,B,6,28,22,TGLFAAFFTTFAFAPQSIKTIR,1
4x5n,B,36,55,19,VVMYIMFLTGVISWIAYGI,1
4x5n,B,61,82,21,VLIANIVTLFLAAPVLVITLI,1
4h33,D,15,34,19,LNRFLMIFVLLVIIIPVPM,1
4h33,D,69,93,24,GRILASIMMLFGIAFIGMITSTIT,1
2eim,Z,17,35,18,GLSVTFLSFLLPAGWVLY,1
3hgc,C,51,75,24,MGSLALLALVCTNRIQYYFLYPHV,1
3hgc,C,423,448,25,AYEVAGLLGDIGGQMGLFIGASILT,1
4myh,B,114,132,18,LGLLISAKILNVQVPFFF,1
4myh,B,159,175,16,CYGVARFGSVLFGELR,1
4myh,B,238,252,14,ISFEISVVCGILTY,1
4myh,B,257,272,15,FAAITFSTMLLYSIF,1
4myh,B,344,358,14,GQNLIFTTALTAMM,1
4myh,B,377,390,13,INQLVFQLSVPLN,1
3fi1,B,15,28,13,IILIIAAILAMIM,1
3fi1,B,63,80,17,NDALMAVFFLLVGLEVK,1
3fi1,B,98,115,17,IAAIGGMIVPALLYLAF,1
3fi1,B,126,140,14,AIPAATDIAFALGV,1
3fi1,B,157,174,17,ALAIIDDLGAIIIIALF,1
3fi1,B,185,200,15,VAAVAIAVLAVLNLC,1
3fi1,B,205,220,15,GVYILVGVVLWTAVL,1
3fi1,B,224,237,13,HATLAGVIVGFFI,1
3fi1,B,256,274,18,PWVAYLILPLFAFANAGV,1
3fi1,B,294,311,17,GLLIGKPLGISLFCWLA,1
3fi1,B,330,348,18,VGILCGIGFTMSIFIASL,1
3fi1,B,362,378,16,LGILVGSISSAVIGYS,1
4zyr,A,10,30,20,MFGLFFFFYFFIMGAYFPFF,1
4zyr,A,49,67,18,AAISLFSLLFQPLFGLLS,1
4zyr,A,75,91,16,LLWIITGMLVMFAPFF,1
4zyr,A,109,130,21,GGIYLGFCFNAGAPAVEAFIE,1
4zyr,A,141,158,17,RARMFGCVGWALCASIV,1
4zyr,A,170,187,17,WLGSGCALILAVLLFFA,1
4zyr,A,224,243,19,LSLYVIGVSCTYDVFDQQF,1
4zyr,A,263,280,17,VTTMGELLNASIMFFAP,1
4zyr,A,291,309,18,LLLAGTIMSVRIIGSSFA,1
4zyr,A,314,334,20,VVILKTLHMFEVPFLLVGCF,1
4zyr,A,348,369,21,IYLVCFCFFKQLAMIFMSVLA,1
4zyr,A,380,397,17,AYLVLGLVALGFTLISV,1
3qjq,C,5,27,22,KGALAVILVLTLTILVFWLGVY,1
5eh6,A,74,96,22,LIIFGVIAGVIGTILLISYGIR,1
3vms,A,48,61,13,TILIIIALFIGIM,1
3spj,D,78,104,26,WRYMLLLFSLAFLVSWLLFGLIFWLI,1
3spj,D,156,181,25,LAVFMVVVQSIVGCIIDSFMIGAIM,1
1p49,A,181,205,24,FKRLVFLPLQIVGVTLLTLAALNC,1
1p49,A,212,233,21,LGVFFSLLFLAALILTLFLGF,1
2los,A,6,29,23,VVPLHWFGFGYAALVASGGIIGY,1
2los,A,37,54,17,LAAGLLFGSLAGLGAYQ,1
2los,A,87,102,15,PAGLIAGASLLMVAK,1
3f3c,B,13,32,19,LILAMAGNAVGLGNFLRFP,1
3f3c,B,44,63,19,IPYIIAFLLVGIPLMWIEW,1
3f3c,B,90,124,34,KILGVFGLWIPLVVAIYYVYIESWTLGFAIKFLV,1
3f3c,B,167,185,18,AYIVFLITMFINVSILIR,1
3f3c,B,191,212,21,ERFAKIAMPTLFILAVFLVIR,1
3f3c,B,244,265,21,IAAVGQIFFTLSLGFGAIITY,1
3f3c,B,278,297,19,GLTAATLNEKAEVILGGSI,1
3f3c,B,340,367,27,GFLWFFLLFFAGLTSSIAIMQPMIAFL,1
3f3c,B,378,396,18,VLWTAAIVFFSAHLVMFL,1
3f3c,B,400,426,26,DEMDFWAGTIGVVFFGLTELIIFFWI,1
3f3c,B,445,469,24,RIYYYVMRYITPAFLAVLLVVWAR,1
3f3c,B,484,502,18,ITRFYIIGLFLFLTFLVF,1
2nww,C,13,31,18,QKILIGLILGAIVGLILG,1
2nww,C,39,63,24,HTYVKPFGDLFVRLLKMLVMPIVF,1
2nww,C,82,107,25,VKIVVYYLLTSAFAVTLGIIMARLF,1
2nww,C,128,140,12,PLVHILLDIVPT,1
2nww,C,151,160,9,LPTIFFAII,1
2nww,C,201,221,20,MQYAPIGVFALIAYVMAEQG,1
2nww,C,230,251,21,VTAAVYVGLTLQILLVYFVLL,1
2nww,C,301,321,20,TLPLGATINMDGTALYQGVC,1
2nww,C,390,409,19,AILDMGRTMVNVTGDLTGT,1
3zux,A,8,27,19,SFIGKTFSLWAALFAAAAF,1
3zux,A,36,55,19,GPYIPWLLGIIMFGMGLTL,1
3zux,A,68,88,20,VVIIGVIAQFAIMPATAWCL,1
3zux,A,103,118,15,LVGCCPGGTASNVMT,1
3zux,A,128,147,19,VAVTSVSTLTSPLLTPAIF,1
3zux,A,163,181,18,MSIVKMVLLPIVLGLIVH,1
3zux,A,192,211,19,DALPLVSVAAIVLIIGAVV,1
3zux,A,226,248,22,AVVVLHNGIGYLLGFFAAKWTG,1
3zux,A,255,272,17,ALTIEVGMQNSGLAAAL,1
3zux,A,285,304,19,PGALFSVWHNISGSLLATY,1
1ezv,S,17,33,16,VGTIFAGAFVFQTVFD,1
1ds8,H,16,32,16,IYSFWIFLAGLIYYLQ,1
5tio,E,225,246,21,QMYIPSLLIVILSWVSFWINM,1
5tio,E,249,269,20,PARVALGITTVLTMTTQSSG,1
5tio,E,284,306,22,IWMAVCLLFVFSALLEYAAVNF,1
5tio,E,323,344,21,TISRACFPLAFLIFNIFYWVI,1
1sr1,A,9,26,17,GGAVALIVGVAFVWLLY,1
1sr1,A,40,56,16,LAIIPVFAGLSYVGMA,1
1sr1,A,71,87,16,LRYIDWLVTTPILVGY,1
1sr1,A,98,114,16,IIGVMVADALMIAVGA,1
1sr1,A,128,142,14,GVSSIFHLSLFAYL,1
1sr1,A,163,179,16,KNHIGLLWLAYPLVWL,1
1sr1,A,194,211,17,LTYVFLDVLAKVPYVYF,1
1qkp,A,10,31,21,IWLALGTALMGLGTLYFLVKG,1
1qkp,A,42,66,24,YAITTLVPAIAFTMYLSMLLGYGL,1
1qkp,A,79,100,21,WARYADWLFTTPLLLLDLALL,1
1qkp,A,104,127,23,QGTILALVGADGIMIGTGLVGAL,1
1qkp,A,135,158,23,VWWAISTAAMLYILYVLFFGFTS,1
1qkp,A,171,192,21,KVLRNVTVVLWSAYPVVWLIG,1
1qkp,A,202,225,23,IETLLFMVLDVSAKVGFGLILLR,1
2asg,E,105,121,16,LCISVLLALTFFLLLI,1
4i7z,P,5,23,18,VFYIVFIALFFGIAVGII,1
5d6l,A,32,59,27,VVGMGIVMSLIVLAIVFGNVLVITAIA,1
5d6l,A,70,95,25,FITSLACADLVMGLAVVPFGAAHIL,1
5d6l,A,105,129,24,CEFWTSIDVLCVTASIETLCVIAV,1
5d6l,A,151,175,24,VIILMVWIVSGLTSFLPIQMHWYR,1
5d6l,A,196,220,24,QAYAIASSIVSFYVPLVIMVFVYS,1
5d6l,A,275,299,24,GIIMGTFTLCWLPFFIVNIVHVIQ,1
5d6l,A,303,327,24,RKEVYILLNWIGYVNSGFNPLIYC,1
5d56,C,34,48,14,GVAVLLCVVIAAWL,1
5d56,C,53,67,14,TRVLLISSVMLVMI,1
5d56,C,102,117,15,IAIIDAVITWAILLW,1
1xnu,E,25,50,25,RQNLQNLFINFCLILICLLLICIIV,1
1zv0,B,34,55,21,YSIIFVVGIFGNSLVVIVIYF,1
1zv0,B,64,83,19,VFLLNLALADLCFLLTLPL,1
1zv0,B,104,124,20,SASVSFNLYASVFLLTCLSI,1
1zv0,B,146,163,17,VTCIIIWLLAGLASLPA,1
1zv0,B,194,216,22,LGLTKNILGFLFPFLIILTSYT,1
1zv0,B,242,265,23,MAIVLFFFFSWIPHQIFTFLDVL,1
1zv0,B,284,304,20,PITICIAYFNNCLNPLFYGF,1
4p79,A,5,29,24,ETFGFFMSALGLLMLGLTLSNSYW,1
4p79,A,78,100,22,RALMITAILLGFLGLFLGMVGL,1
4p79,A,113,139,26,AKLLAIAGTLHILAGACGMVAISWYA,1
4p79,A,160,184,24,ALYLGWSASLLSILGGICVFSTAA,1
4pb2,C,5,21,16,SCCGMAVLLGIAVLLS,1
4pb2,C,30,46,16,TVGGAFAIQFSLGAFI,1
4pb2,C,103,118,15,TLIFFSALISVLYYL,1
4pb2,C,176,192,16,MCGGLASIAGGVLAGY,1
4pb2,C,202,220,18,VAASFMAAPGGLLFAKLM,1
4pb2,C,242,274,32,ANVIDAAAGGASAGLQLALNVGAMLIAFIGLI,1
4pb2,C,361,379,18,ALCGFANLSSIAILLGGL,1
4pb2,C,395,412,17,KAVIAGTLSNLMAATIA,1
3p5n,A,18,33,15,SMLSAIAFVLTFIKF,1
3p5n,A,43,56,13,LDFSDVPSLLATF,1
3p5n,A,61,79,18,AGIIVALVKNLLNYLFSM,1
3p5n,A,83,103,20,GPFANFLAGASFLLTAYAIY,1
3p5n,A,111,131,20,LITGLIIATIVMTIVLSILN,1
3p5n,A,162,181,19,FNIIKGIVISIVFILLYRR,1
3wfc,C,6,26,20,KGMARNIYFGGSVFFILLFL,1
2fyu,K,23,38,15,WGAVGAVGLVWATDW,1
5mke,D,219,242,23,VLRELVTYLLFLIVLCILTYGMM,1
5mke,D,472,496,24,LAACEIIFCFFIFYYVVEEILEIR,1
5mke,D,507,527,20,NCLDVVIVVLSVVAIGINIY,1
5mke,D,557,579,22,FNNIAAVTVFFVWIKLFKFINF,1
5mke,D,595,620,25,DLFGFAIMFFIIFLAYAQLAYLVFG,1
5mke,D,655,681,26,LGPIYFTTFVFFMFFILLNMFLAIIN,1
5hwx,A,8,28,20,FLLGLILLYYGSDWFVLGSE,1
5hwx,A,40,56,16,IGATVMAIGTSLPEIL,1
5hwx,A,74,92,18,IGSCICNIGLVLGLSAII,1
5hwx,A,104,120,16,ILVYLLFVIFAAVIGI,1
5hwx,A,127,144,17,GVVLLILFIIYLRWTVK,1
5hwx,A,163,183,20,SLVLLIIGLIGVLVGAELFV,1
5hwx,A,207,222,15,GTSLPELMVSLAAAK,1
5hwx,A,227,247,20,MVLGNVIGSNIADIGGALAV,1
5hwx,A,259,275,16,QMAVLVIMSLLLYLFA,1
5hwx,A,281,299,18,RWQGILFLALYIIAIASL,1
2jln,A,31,52,21,LAAIWFAMAIQVAIFIAAGQM,1
2jln,A,60,76,16,VIVAIAAGCTIAVILL,1
2jln,A,110,134,24,ALLSLFWFGFQTWLGALALDEITR,1
2jln,A,140,157,17,NLPLWIVIFGAIQVVTT,1
2jln,A,164,181,17,RWMNVFASPVLLAMGVY,1
2jln,A,208,225,17,FSTAIMIFVGGWIAVVV,1
2jln,A,254,271,17,AQWLGMVPASIIFGFIG,1
2jln,A,301,320,19,FQVFVLLATWSTNPAANLL,1
2jln,A,342,357,15,SAVVGLLMMPWQFAG,1
2jln,A,359,372,13,NTFLNLLASALGP,1
4p6k,B,4,23,19,IAHALFSALFALSELYIAV,1
3leo,C,8,25,17,AAVTLLGVLLQAYFSLQ,1
3leo,C,53,71,18,VNCSEYFPLFLATLWVAG,1
3leo,C,79,95,16,ALCGLVYLFARLRYFQ,1
3leo,C,106,124,18,PLYASARALWLLVALAAL,1
1aty,A,10,26,16,MAAAVMMGLAAIGAAI,1
1aty,A,58,77,19,LVDAIPMICVGLGLYVMFA,1
5hcj,E,199,218,19,NIILPMLFILFISWTAFWS,1
5hcj,E,222,242,20,ANVTLVVSTLIAHIAFNILV,1
5hcj,E,256,276,20,AIIFMIYLFYFVAVIEVTVQ,1
5hcj,E,292,313,21,RASRIAFPVVFLLANIILAFL,1
1c8r,C,10,28,18,IWLALGTALMGLGTLYFL,1
1c8r,C,47,62,15,LVPAIAFTMYLSMLL,1
1c8r,C,80,94,14,ARYADWLFTTPLLL,1
1c8r,C,111,127,16,VGADGIMIGTGLVGAL,1
1c8r,C,134,150,16,FVWWAISTAAMLYILY,1
1c8r,C,178,192,14,VVLWSAYPVVWLIG,1
1c8r,C,203,220,17,ETLLFMVLDVSAKVGFG,1
3e8f,E,26,45,19,LFVLTILTLISGTIFYSTV,1
3e8f,E,75,96,21,GKIFTILYIFIGIGLVFGFIH,1
1vvk,X,32,45,13,VLVLYFIMGCIDV,1
1vvk,X,59,84,25,QTITASRIGTLITLGIGPIVTAGII,1
1vvk,X,115,127,12,IIMCFVEAVLFV,1
1vvk,X,142,158,16,VIIQIAFGSIILIYLD,1
1vvk,X,171,188,17,LFIAAGVSQTIFVGALG,1
1vvk,X,212,224,12,IIGTIIVFLMVV,1
1vvk,X,259,273,14,ILAAALFANIQLWG,1
1vvk,X,314,328,14,HAIVYMIAMIITCV,1
1vvk,X,383,396,13,FVGFLATIANFIG,1
1vvk,X,398,411,13,GGGTGVLLTVSIV,1
3gwv,B,13,31,18,LILAMAGNAVGLGNFLRF,1
3gwv,B,45,63,18,PYIIAFLLVGIPLMWIEW,1
3gwv,B,90,120,30,KILGVFGLWIPLVVAIYYVYIESWTLGFAI,1
3gwv,B,168,184,16,YIVFLITMFINVSILI,1
3gwv,B,191,211,20,ERFAKIAMPTLFILAVFLVI,1
3gwv,B,245,265,20,AAVGQIFFTLSLGFGAIITY,1
3gwv,B,278,296,18,GLTAATLNEKAEVILGGS,1
3gwv,B,343,366,23,WFFLLFFAGLTSSIAIMQPMIAF,1
3gwv,B,378,394,16,VLWTAAIVFFSAHLVM,1
3gwv,B,400,425,25,DEMDFWAGTIGVVFFGLTELIIFFW,1
3gwv,B,445,468,23,RIYYYVMRYITPAFLAVLLVVWA,1
3gwv,B,485,502,17,TRFYIIGLFLFLTFLVF,1
5svk,D,26,47,21,NRVVQLLIISYFVGWVFLHEK,1
5svk,D,316,339,23,NIIPTIISSVAAFTSVGVGTVLC,1
3wqj,C,15,32,17,WLGIGTLLMLIGTFYFI,1
3wqj,C,51,66,15,LVPGIASAAYLAMFF,1
3wqj,C,84,99,15,YARYADWLFTTPLLL,1
3wqj,C,117,133,16,GVDALMIVTGLIGALS,1
3wqj,C,138,155,17,RYTWWLFSTIAFLFVLY,1
3wqj,C,182,197,15,VAVLWTAYPILWIVG,1
3wqj,C,209,226,17,TLAFMVLDVTAKVGFGF,1
2ahz,D,26,45,19,LFVLTILTLISGTIFYSTV,1
2ahz,D,75,94,19,GKIFTILYIFIGIGLVFGF,1
5a3s,A,50,76,26,ELVIEQFEDLLVRILLLAACISFVLA,1
5a3s,A,88,106,18,VEPFVILLILIANAIVGV,1
5a3s,A,254,274,20,EFGEQLSKVISLICVAVWLI,1
5a3s,A,296,317,21,KIAVALAVAAIPEGLPAVITT,1
5a3s,A,760,780,20,IRYLISSNVGEVVCIFLTAA,1
5a3s,A,787,807,20,IPVQLLWVNLVTDGLPATAL,1
5a3s,A,832,851,19,LFFRYMAIGGYVGAATVGA,1
5a3s,A,898,916,18,MALSVLVTIEMCNALNSL,1
5a3s,A,931,950,19,WLLGSICLSMSLHFLILYV,1
5a3s,A,968,987,19,MVLKISLPVIGLDEILKFI,1
4gx1,F,21,41,20,VLLLYCAFLLVMLLAYASIF,1
4gx1,F,83,105,22,FASIVTVSGVIFLDIILPFGFV,1
4iu9,B,41,60,19,CLLLAFCVWMLFSAVTVNL,1
4iu9,B,70,87,17,QLFLLTALPSVSGALLR,1
4iu9,B,106,123,17,TAILIIPCVWLGIAVQN,1
4iu9,B,127,145,18,FGIFIVIALLCGFAGANF,1
4iu9,B,170,189,19,LGNLGVSVMQLVAPLVIFV,1
4iu9,B,210,227,17,ANAAWIWVPLLAIATIA,1
4iu9,B,257,279,22,SLLYLATFGSFIGFSAGFAMLA,1
4iu9,B,289,307,18,RLAFFGPFIGAIARSVGG,1
4iu9,B,318,336,18,TLINFIFMAIFSALLFLT,1
4iu9,B,347,366,19,FYAVFMGLFLTAGLGSGST,1
4iu9,B,408,428,20,AIGAVGGFFIPQAFGMSLNM,1
4iu9,B,433,452,19,GAMKVFLIFYIVCVLLTWL,1
4u2p,C,528,540,12,IVFAYIGVSVVL,1
4u2p,C,598,613,15,RIVAGVWWFFTLIII,1
4u2p,C,797,809,12,ILVGGLGLAMLV,1
4gyc,D,24,39,15,VFIFVGALTVLFGAI,1
4gyc,D,65,83,18,GLIILLGINLGLVAATLG,1
2hn2,E,5294,5313,19,TIIATIFMPLTFIAGIYGM,1
2hn2,E,5327,5346,19,PVVLAVMGVIAVIMVVYFK,1
5f5b,A,94,109,15,PVTWVMMIACVVVFI,1
5f5b,A,148,163,15,MHILFNLLWWWYLGG,1
5f5b,A,172,189,17,KLIVITLISALLSGYVQ,1
5f5b,A,199,213,14,LSGVVYALMGYVWL,1
5f5b,A,229,245,16,IIFALIWIVAGWFDLF,1
5f5b,A,250,267,17,NGAHIAGLAVGLAMAFV,1
3u2y,E,13,31,18,ISTIGLLGAGIGIAIVFA,1
3u2y,E,50,70,20,AILGFALSEATGLFCLMVSF,1
5xjy,A,23,40,17,QLLLEVAWPLFIFLILI,1
5xjy,A,641,659,18,LFMTLAWIYSVAVIIKGI,1
5xjy,A,683,704,21,SWFISSLIPLLVSAGLLVVIL,1
5xjy,A,716,740,24,VVFVFLSVFAVVTILQCFLISTLF,1
5xjy,A,745,763,18,AAACGGIIYFTLYLPYVL,1
5xjy,A,823,843,20,SVSMMLFDTFLYGVMTWYIE,1
5xjy,A,1345,1363,18,GFFAQIVLPAVFVCIALV,1
5xjy,A,1656,1673,17,VSICVIFAMSFVPASFV,1
5xjy,A,1704,1724,20,WDMCNYVVPATLVIIIFICF,1
5xjy,A,1733,1754,21,NLPVLALLLLLYGWSITPLMY,1
5xjy,A,1766,1785,19,YVVLTSVNLFIGINGSVAT,1
5xjy,A,1846,1865,19,DLVGRNLFAMAVEGVVFFL,1
2f75,A,37,49,12,IFGVLGNILVIL,1
2f75,A,65,87,22,VNLAVADLLLTSTVLPFSAIFE,1
2f75,A,98,120,22,CNIWAAVDVLCCTASIMGLCII,1
2f75,A,145,169,24,ALLCVWVLSLVISIGPLFGWRQPA,1
2f75,A,183,202,19,YVLFSALGSFYVPLAIILV,1
2f75,A,274,293,19,GIVVGCFVLCWLPFFLVMP,1
2f75,A,306,326,20,VFKIVFWLGYLNSCINPIIY,1
4gx5,F,21,41,20,VLLLYCAFLLVMLLAYASIF,1
4gx5,F,81,108,27,YLFASIVTVSGVIFLLIILPFGFVSMF,1
4r6z,E,29,45,16,LTILTLISGTIFYSTV,1
4r6z,E,74,91,17,GKIFTILYIFIGIGLVF,1
2dys,Z,17,36,19,GLSVTFLSFLLPAGWVLYH,1
1zll,E,25,49,24,QKLQNLFINFCLILICLLLICIIV,1
4bem,J,29,40,11,LGIGLAMVAGV,1
4bem,J,82,97,15,IFSLVIALILLFANP,1
4bem,J,112,123,11,MASGIAMIAGI,1
4bem,J,165,180,15,IYALIVALILMYANP,1
4u1x,D,519,542,23,PLAYEIWMAIVFAYILVSVVLFL,1
4u1x,D,597,621,24,ARIVAGVWWFFTLIIISSYTANLA,1
4u1x,D,788,810,22,LSNVAGVFYILVGGLGLAMLVA,1
2q68,D,27,45,18,FVLTILTLISGTIFYSTV,1
2q68,D,75,92,17,GKIFTILYIFIGIGLVF,1
2h8p,J,87,114,27,GRLVAVVVMVAGITSFGLVTAALATWF,1
5hla,A,70,84,14,KLAIVFAVLIAIYG,1
4bez,B,40,63,23,AAYMFLLIMLGFPINFLTLYVTV,1
4bez,B,75,95,20,LLNLAVADLFMVFGDFTTTL,1
4bez,B,113,133,20,GFFATLGGEIALWSLVVLAI,1
4bez,B,154,172,18,MGVAFTWVMALACAAPPL,1
4bez,B,202,222,20,FVIYMFVVHFIIPLIVIFFC,1
4bez,B,255,277,22,IMVIAFLICWLPYAGVAFYIFT,1
4bez,B,290,309,19,PAFFAKTSAVYNPVIYIMM,1
5sv9,B,43,65,22,NYRVIPSTVDTYFNNLLPAIAF,1
5sv9,B,83,100,17,LSSAMAGIVFGVLAGQP,1
5sv9,B,102,113,11,IVGVTGPISIF,1
5sv9,B,136,152,16,LWSMIFHLLLAFTNVV,1
5sv9,B,163,179,16,DIFGLFINVVYIQKGI,1
5sv9,B,204,219,15,ALVMTAFGLFFKSFH,1
5sv9,B,229,246,17,TFISDYSTALSVLFWSS,1
5sv9,B,297,317,20,FGIILTILFYFDHNVSSLMA,1
5sv9,B,332,346,14,DFALLGLTTCISGV,1
5sv9,B,351,366,15,PNGLIPQAPLHTETL,1
5sv9,B,382,396,14,LTNTFQGLMILGTM,1
5sv9,B,412,427,15,SGLFFIMGINGLMTN,1
5sv9,B,462,478,16,FSLAGFTGEFAITNTI,1
5sv9,B,480,492,12,IGFPLVLLLSVI,1
5vhz,F,11,29,18,VALNLLALLFATTAFLTT,1
5vhz,F,123,144,21,LWLSVVSEVLYILLLVVGFSL,1
5vhz,F,165,184,19,AVFTVLSGLLGMVAHMMYT,1
5vhz,F,206,224,18,WSFCLAWGSFTCCMAASV,1
5aid,C,34,50,16,SVLVWIMIPGVGLLYS,1
5aid,C,62,84,22,WAALMAACVAAFQWFWWGYSLV,1
5aid,C,121,139,18,YQGMFAAVTAILMAGAGC,1
5aid,C,145,166,21,PMMVFLFIWLTVVYCPIAYWT,1
5aid,C,181,201,20,AGGGPVHENSGFAALAYSLW,1
5aid,C,224,242,18,IVMGTIFLWFGWYGFNGG,1
5aid,C,255,275,20,VNTNLAAATGGLTWMLVDWF,1
5aid,C,284,301,17,GLCMGAIAGLVGITPAA,1
5aid,C,307,326,19,TSVIFGIVPAIICNFAVDL,1
5aid,C,336,356,20,DVWALHGVGGFVGNFMTGLF,1
5aid,C,382,409,27,YQLAGSCAVAAWSFTVTSIILLAMDRI,1
1jgw,H,12,29,17,ASLAIYSFWIFLAGLIY,1
3pwh,A,12,29,17,ELAIAVLAILGNVLVCW,1
3pwh,A,44,63,19,VVSLAAADILVGVLAIPFA,1
3pwh,A,83,99,16,VLVLAQSSIFSLLAIA,1
3pwh,A,122,138,16,GIIAICWVLSFAIGLT,1
3pwh,A,178,197,19,YFNFFACVLVPLLLMLGVY,1
3pwh,A,236,252,16,IIAGLFALCWLPLHII,1
3pwh,A,273,287,14,IVLAHTNSVVNPFI,1
3e8b,E,26,45,19,LFVLTILTLISGTIFYSTV,1
3e8b,E,75,96,21,GKIFTILYIFIGIGLVFGFIH,1
4in7,M,55,72,17,GVLSLFSGLMWFFTIGI,1
4in7,M,117,133,16,ASFFMFVAVWSWWGRT,1
4in7,M,147,164,17,WAFLSAIWLWMVLGFIR,1
4in7,M,201,221,20,HGLSIAFLYGSANLFAMHGA,1
4in7,M,269,286,17,IWMAVLVTLTGGIGILL,1
5jlc,A,30,45,15,RVSIMVALPFVYTIT,1
3wdo,A,12,33,21,ATWGLGTVFSLRMLGMFMVLP,1
3wdo,A,53,72,19,IGIYGLTQAVFQIPFGLLS,1
3wdo,A,79,98,19,LIVGGLAVFAAGSVIAALS,1
3wdo,A,103,122,19,IILGRALQGSGAIAAAVMA,1
3wdo,A,134,155,21,KAMAFIGVSFGITFAIAMVLG,1
3wdo,A,163,185,22,LHALFWMIAILATTGIALTIWV,1
3wdo,A,210,232,22,EPRLLKLNFGIMCLHMLLMSTF,1
3wdo,A,251,272,21,VYLATMLIAFGSVVPFIIYAE,1
3wdo,A,277,296,19,KQVFVFCVGLIVVAEIVLW,1
3wdo,A,307,328,21,GVQLFFVAFNLMEALLPSLIS,1
3wdo,A,338,358,20,AMGVYSTSQFLGVAIGGSLG,1
3wdo,A,371,388,17,LAGAMLAAVWLAVASTM,1
5hv9,C,8,28,20,AAVTLLGVLLQAYFSLQVIS,1
5hv9,C,50,71,21,RAQVNCSEYFPLFLATLWVAG,1
5hv9,C,79,98,19,ALCGLVYLFARLRYFQGYA,1
5hv9,C,104,124,20,LAPLYASARALWLLVALAAL,1
4gbz,A,15,35,20,VATLGGLLFGYDTAVISGTV,1
4gbz,A,56,75,19,LGFCVASALIGCIIGGALG,1
4gbz,A,88,105,17,KIAAVLFFISGVGSAWP,1
4gbz,A,125,148,23,VPEFVIYRIIGGIGVGLASMLSP,1
4gbz,A,162,185,23,LVSFNQFAIIFGQLLVYCVNYFI,1
4gbz,A,199,218,19,RYMFASECIPALLFLMLLY,1
4gbz,A,280,302,22,GVMLSIFQQFVGINVVLYYAPE,1
4gbz,A,316,336,20,QTIIVGVINLTFTVLAIMTV,1
4gbz,A,342,364,22,PLQIIGALGMAIGMFSLGTAFY,1
4gbz,A,372,395,23,LLSMLFYVAAFAMSWGPVCWVLL,1
4gbz,A,410,431,21,AVAAQWLANYFVSWTFPMMDK,1
4gbz,A,442,460,18,FSYWIYGCMGVLAALFMW,1
3lrb,B,15,31,16,TLMVSGNIMGSGVFLL,1
3lrb,B,44,58,14,GWLVTIIGALGLSM,1
3lrb,B,89,112,23,NVLYWLACWIGNIAMVVIGVGYL,1
3lrb,B,125,140,15,TITCVVVLWIFVLLN,1
3lrb,B,147,171,24,TRVQAVATVLALIPIVGIAVFGWF,1
3lrb,B,194,209,15,STLNVTLWSFIGVES,1
3lrb,B,229,244,15,GGVLIAAVCYVLSTT,1
3lrb,B,278,298,20,SFCAAAGCLGSLGGWTLLAG,1
3lrb,B,328,342,14,IVGILMTIFQLSSI,1
3lrb,B,349,367,18,FGLVSSVSVIFTLVPYLY,1
3lrb,B,390,407,17,TTIAFLYCIWAVVGSGA,1
3lrb,B,409,423,14,VMWSFVTLMVITAM,1
5fxk,D,558,575,17,WVMMFVMLLIVSAVAVF,1
5fxk,D,625,643,18,TTSKIMVSVWAFFAVIFL,1
5fxk,D,822,839,17,YMLGAAMALSLITFISE,1
5hvx,D,13,32,19,FQNVITAIIVLNGAVLGLL,1
5hvx,D,45,65,20,ERVDQLCLTIFIVEISLKIY,1
5hvx,D,73,91,18,RSGWNLFDFVIVAIALMP,1
5hvx,D,101,118,17,FRIFRVMRLVSVIPTMR,1
5hvx,D,120,149,29,VQGMLLALPGVGSVAALLTVVFYIAAVMA,1
5hvx,D,197,222,25,FFIPFIMLTTFTVLNLFIGIIVDAM,1
4g70,C,7,24,17,ALAVILVLTLTILVFWL,1
4g7q,C,7,24,17,ALAVILVLTLTILVFWL,1
5hxs,A,5,24,19,VGYFLLGLILLYYGSDWFV,1
5hxs,A,40,58,18,IGATVMAIGTSLPEILTS,1
5hxs,A,72,92,20,NAIGSCICNIGLVLGLSAII,1
5hxs,A,104,120,16,ILVYLLFVIFAAVIGI,1
5hxs,A,127,143,16,GVVLLILFIIYLRWTV,1
5hxs,A,166,186,20,LLIIGLIGVLVGAELFVDGA,1
5hxs,A,205,222,17,AFGTSLPELMVSLAAAK,1
5hxs,A,229,247,18,LGNVIGSNIADIGGALAV,1
5hxs,A,259,275,16,QMAVLVIMSLLLYLFA,1
5hxs,A,281,298,17,RWQGILFLALYIIAIAS,1
4pop,A,12,31,19,EIAFMAALAFIISLIPNTV,1
4pop,A,36,49,13,VEIACIPILLLSL,1
4pop,A,54,73,19,AGLVGGLIWGILSMITGHA,1
4pop,A,80,97,17,AFLEYLVAPVSLGIAGL,1
4pop,A,111,128,17,LGTFVAVLLKYFFHFIA,1
4pop,A,149,169,20,VNGISGILTAIAAFVILIIF,1
1a91,A,14,38,24,VMMGLAAIGAAIGIGILGGKFLEG,1
1a91,A,49,71,22,RTQFFIVMGLVDAIPMIAVGLG,1
1sqx,J,18,43,25,TFALTIVVGALFFERAFDQGADAIY,1
5d91,A,34,51,17,GTLGVMAGALIFYPMGQ,1
5d91,A,53,66,13,WGTVVITVFVFSD,1
5d91,A,91,108,17,RVGDSSVFTGIVIWFFL,1
5d91,A,114,129,15,IAILALICLVLSSLV,1
5d91,A,148,166,18,ERSERLVVVLVATGLVGL,1
5d91,A,171,187,16,VLLVVLIVLAIASVVT,1
3rvy,D,2015,2033,18,KFIIYLIVLNGITMGLET,1
3rvy,D,2045,2064,19,TLFNQIVITIFTIEIILRI,1
3rvy,D,2076,2091,15,SLFDFFVVAISLVPT,1
3rvy,D,2098,2113,15,RVLRVLRLFRLVTAV,1
3rvy,D,2131,2148,17,SVIALMTLFFYIFAIMA,1
3rvy,D,2195,2214,19,VFFIPFIFVVTFVMINLVV,1
5ch4,G,11,25,14,YLGVAGLLVYLVLV,1
5ch4,G,53,67,14,RLTVILGVVFAALA,1
4y28,3,106,122,16,RFAMLGAVGAIAPEYL,1
4y28,3,155,167,12,TLFVLEMALMGF,1
4y28,3,234,246,12,MLAILGYFIQGL,1
2met,C,205,232,27,EIIILEGTAVIAMFFWLLLVIILRTVK,1
4ib4,A,54,76,22,HWAALLILMVIIPTIGGNTLVI,1
4ib4,A,94,116,22,SLAVADLLVGLFVMPIALLTIM,1
4ib4,A,122,148,26,LPLVLCPAWLFLDVLFSTASIWHLCA,1
4ib4,A,177,195,18,VVWLISIGIAIPVPIKGI,1
4ib4,A,208,235,27,LTKERFGDFMLFGSLAAFFTPLAIMIV,1
4ib4,A,328,350,22,VFFLFLLMWCPFFITNITLVLC,1
4ib4,A,359,380,21,MLLEIFVWIGYVSSGVNPLVY,1
1zza,A,6,25,19,DHSPTTGVVTVIVILIAIA,1
4q2g,B,24,45,21,KTRVITASVVAPFVVLCFVSY,1
4q2g,B,47,64,17,LIGLVSAILILAGYELI,1
4q2g,B,75,92,17,FYVILLALYPVLYGLVF,1
4q2g,B,94,112,18,PTQPLSILFITGVVFSLI,1
4q2g,B,125,145,20,AFSIALIYVTFFLSFFLPIY,1
4q2g,B,153,175,22,LLVLTSTWVFDSFAYFTGLKFG,1
4q2g,B,188,206,18,LEGVIGGFLGVVIYTFLY,1
4q2g,B,224,242,18,LPFAATVAIMDTFGDIFE,1
4q2g,B,258,284,26,PGHGGMLDRIDGLLFVAPVCYIVFKI,1
4jrz,C,8,22,14,AAVTLLGVLLQAYF,1
4jrz,C,57,71,14,EYFPLFLATLWVAG,1
4jrz,C,79,92,13,ALCGLVYLFARLR,1
4jrz,C,108,124,16,YASARALFLLVALAAL,1
2l91,A,689,711,22,GPDILVVLLSVMGAILLIGLAP,1
4zwj,A,40,65,25,AAYMFLLIVLGFPINFLTLYVTVQH,1
4zwj,A,69,95,26,TPLNYILLNLAVADLFMVLGGFTSTL,1
4zwj,A,113,137,24,GFFATLGGEIALWSLVVLAIERYV,1
4zwj,A,151,173,22,HAIMGVAFTWVMALACAAPPLA,1
4zwj,A,203,228,25,VIYMFVVHFTIPMIIIFFCYGQLVF,1
4zwj,A,251,274,23,RMVIIYVIAFLICWVPYASVAFY,1
4zwj,A,290,314,24,PAFFAKSAAIYNPVIYIMMNKQFR,1
4cz9,B,4,24,20,SLAEALFLILFTGVISMLIS,1
4cz9,B,30,46,16,YVPIFILTGLVIGPLL,1
4cz9,B,54,75,21,HEIFDFVRVFGLVIILFTEGH,1
4cz9,B,88,108,20,IVTLDTIGLILTALIAGFIF,1
4cz9,B,120,134,14,LFGAIIGATDPATL,1
4cz9,B,152,169,17,TESIFNDPLGIVLTLIA,1
4cz9,B,193,217,24,GGVIYFLYNVSVSISLGIFLGILG,1
4cz9,B,231,250,19,IEAFSLSLAFLGFFIGERL,1
4cz9,B,252,264,12,SGYLVATVTGIV,1
4cz9,B,294,313,19,DTLAALATIFIFVLLGAEM,1
4cz9,B,323,346,23,KGLLVALGVMILARPLATLPLLK,1
4cz9,B,354,372,18,FIALEGPRGVVPSALASL,1
4cz9,B,394,411,17,ATVVITVLTSVIVETLW,1
2b6p,D,11,31,20,AICAEFFASLFYVFFGLGAS,1
2b6p,D,43,60,17,VALAFGLALATLVQAVG,1
2b6p,D,84,107,23,RAICYMVAQLLGAVAGAAVLYSV,1
2b6p,D,129,149,20,ATIVEIFLTLQFVLCIFATY,1
2b6p,D,158,176,18,SVALAVGFSLTLGHLFGM,1
2b6p,D,202,223,21,VYWVGPVIGAGLGSLLYDFLL,1
5b6y,C,12,28,16,LALGTALMGLGTLYFL,1
5b6y,C,47,61,14,LVPAIAFTMYLSML,1
5b6y,C,80,94,14,ARYADWLFTTPLLL,1
5b6y,C,111,126,15,VGADGIMIGTGLVGA,1
5b6y,C,135,150,15,VWWAISTAAMLYILY,1
5b6y,C,178,192,14,VVLWSAYPVVWLIG,1
5b6y,C,204,220,16,TLLFMVLDVSAKVGFG,1
3txt,C,96,110,14,TWVMMIACVVVFIA,1
3txt,C,148,165,17,MHILFNLLWWWYLGGAV,1
3txt,C,173,189,16,LIVITLISALLSGYVQ,1
3txt,C,199,214,15,LSGVVYALMGYVWLR,1
3txt,C,226,241,15,RGLIIFALIWIVAGW,1
3txt,C,252,267,15,AHIAGLAVGLAMAFV,1
2low,A,24,48,24,KSSGALIPAIYMLVFLLGTTGNGL,1
1rzh,H,13,29,16,SLAIYSFWIFLAGLIY,1
2iq4,_,13,28,15,VVATSLLKSTEGFTR,1
2iq4,_,33,49,16,GCLVGYGIAFALLALS,1
2iq4,_,67,82,15,TAAIVLVAVLFLGSP,1
2iq4,_,87,104,17,VVGVGLIVVGVVTLNLA,1
2iqu,A,48,68,20,EVFVTLGVISLLENILVIVA,1
2iqu,A,83,101,18,CSLAVADMLVSVSNGSET,1
2iqu,A,122,142,20,NVIDSVICSSLLASICSLLS,1
2iqu,A,171,190,19,CIWAACTVSGILFIIYSDS,1
2iqu,A,192,209,17,VIICLITMFFTMLALMA,1
2iqu,A,246,274,28,LTILIGVFVVCWAPFFLHLIFYISCPQN,1
2iqu,A,285,305,20,LYLILIMCNSIIDPLIYALR,1
4xnj,A,17,37,20,LFMTEMWERFSYYGMRAILL,1
4xnj,A,58,78,20,IMAIYASMVYLSGTIGGFVA,1
4xnj,A,85,104,19,PAVFWGGVLIMLGHIVLAL,1
4xnj,A,111,130,19,FGSIILIIIGTGFLKPNVS,1
4xnj,A,149,169,20,IFVFGINLGAFIAPLIVGAA,1
4xnj,A,178,197,19,FSLAAIGMFIGLLVYYFGG,1
4xnj,A,220,240,20,LVKVSLAVAGFIAIIVVMNL,1
4xnj,A,248,270,22,YINLLTIVAIAIPVFYFAWMIS,1
4xnj,A,284,307,23,YIPLFIAAVLFWAIEEQGSVVLA,1
4xnj,A,323,342,19,FQSLNPLFIMLYTPFFAWL,1
4xnj,A,354,372,18,TKFAVGLMFAGLSFLLMA,1
4xnj,A,387,408,21,WLVGSWALVILGEMLISPVGL,1
4xnj,A,423,442,19,MSMWFLSSSVGSALNAQLV,1
4xnj,A,454,472,18,SYFGLGSVVLGIVLVFLS,1
4h37,D,18,34,16,FLMIFVLLVIIIPVPM,1
4h37,D,69,89,20,GRILASIMMLFGIAFIGMIT,1
2lbg,A,7,24,17,AAGAVVGGLGGYMLGSA,1
4qh5,E,195,217,22,SYIPNIILPMLFILFISWTAFW,1
4qh5,E,222,244,22,ANVTLVVSTLIAHIAFNILVET,1
4qh5,E,252,275,23,TYTGAIIFMIYLFYFVAVIEVTV,1
4qh5,E,295,315,20,RIAFPVVFLLANIILAFLFF,1
4qi1,C,18,37,19,WLALGTIGMLLGMLYFIAD,1
4qi1,C,51,69,18,ITILIPAIAAASYLSMFF,1
4qi1,C,88,104,16,ARYADWLFTTPLLLLD,1
4qi1,C,118,136,18,LVGIDAFMIVTGLVATLT,1
4qi1,C,141,160,19,RYAFWTISTISMVFLLYYL,1
4qi1,C,183,200,17,NIILVTWAIYPVAWLVG,1
4qi1,C,212,230,18,TLLFMVLDLVAKVGFGFI,1
1p8h,C,10,32,22,IWLALGTALMGLGTLYFLVKGM,1
1p8h,C,43,62,19,AITTLVPAIAFTMYLSMLL,1
1p8h,C,79,98,19,WARYADWLFTTPLLLLDLA,1
1p8h,C,107,128,21,ILALVGADGIMIGTGLVGALT,1
1p8h,C,134,155,21,FVWWAISTAAMLYILYVLFFG,1
1p8h,C,174,192,18,RNVTVVLWSAYPVVWLIG,1
1p8h,C,203,224,21,ETLLFMVLDVSAKVGFGLILL,1
4o79,B,14,35,21,VRVLGFIIAALVLTWTVHYRG,1
4o79,B,45,66,21,HIFNVHPVMMVIGLILFNGEA,1
4o79,B,87,107,20,QLTAFILSLIGVWAALKFHI,1
4o79,B,113,134,21,FYSLHSWLGLACLFLFAFQWA,1
4o79,B,161,184,23,ISIYALALVTATTGILEKVTFLQ,1
4o79,B,192,214,22,STEAMLVNTMGVLILILGGFVI,1
2yxq,C,33,48,15,IGVTVAFVIIEAILT,1
3qju,C,6,27,21,GALAVILVLTLTILVFWLGVY,1
3o7q,A,30,49,19,LCSLFFLWAVANNLNDILL,1
3o7q,A,66,85,19,QSAFYFGYFIIPIPAGILM,1
3o7q,A,91,110,19,AGIITGLFLYALGAALFWP,1
3o7q,A,120,142,22,LVGLFIIAAGLGCLETAANPFV,1
3o7q,A,154,174,20,LNLAQTFNSFGAIIAVVFGQ,1
3o7q,A,210,228,18,PYMIIVAIVLLVALLIML,1
3o7q,A,261,281,20,WAVLAQFCYVGAQTACWSYL,1
3o7q,A,301,319,18,TGTMVCFFIGRFTGTWLI,1
3o7q,A,325,345,20,KVLAAYALIAMALCLISAFA,1
3o7q,A,350,372,22,LIALTLCSAFMSIQYPTIFSLG,1
3o7q,A,382,401,19,GSSFIVMTIIGGGIVTPVM,1
3o7q,A,413,431,18,AELIPALCFAVIFIFARF,1
4c48,I,2,26,24,ELLKSLVFAVIMVPVVMAIILGLI,1
2uxk,M,51,72,21,LGSLGVLSLFSGLMWFFTIGI,1
2uxk,M,118,137,19,SFFMFVAVWSWWGRTYLRA,1
2uxk,M,144,163,19,HTAWAFLSAIWLWMVLGFI,1
2uxk,M,201,222,21,HGLSIAFLYGSALLFAMHGAT,1
2uxk,M,265,285,20,HRWAIWMAVLVTLTGGIGIL,1
4d1d,A,31,52,21,LAAIWFAMAIQVAIFIAAGQM,1
4d1d,A,59,76,17,QVIVAIAAGCTIAVILL,1
4d1d,A,110,134,24,ALLSLFWFGFQTWLGALALDEITR,1
4d1d,A,140,157,17,NLPLWIVIFGAIQVVTT,1
4d1d,A,164,183,19,RWMNVFASPVLLAMGVYMV,1
4d1d,A,207,225,18,PFSTAIMIFVGGWIAVVV,1
4d1d,A,254,272,18,AQWLGMVPASIIFGFIGA,1
4d1d,A,301,320,19,FQVFVLLATWSTNPAANLL,1
4d1d,A,342,357,15,SAVVGLLMMPWQFAG,1
4d1d,A,359,372,13,NTFLNLLASALGP,1
1iwo,A,60,76,16,LVRILLLAACISFVLA,1
1iwo,A,89,103,14,EPFVILLILIANAI,1
1iwo,A,260,276,16,SKVISLICVAVWLINI,1
1iwo,A,296,314,18,KIAVALAVAAIPEGLPAV,1
1iwo,A,761,780,19,RYLISSNVGEVVCIFLTAA,1
1iwo,A,786,807,21,LIPVQLLWVNLVTDGLPATAL,1
1iwo,A,834,851,17,FRYMAIGGYVGAATVGA,1
1iwo,A,901,916,15,SVLVTIEMCNALNSL,1
1iwo,A,931,948,17,WLLGSICLSMSLHFLIL,1
1iwo,A,971,987,16,KISLPVIGLDEILKFI,1
3ous,D,24,41,17,LLVLAVIIYGTAGFHFI,1
3ous,D,71,92,21,GMYFTCTLIVLGIGTFAVAVE,1
2by4,A,54,73,19,EQFEDLLVRILLLAACISF,1
2by4,A,90,110,20,PFVILLILIANAIVGVWQER,1
2by4,A,254,274,20,EFGEQLSKVISLICVAVWLI,1
2by4,A,296,318,22,KIAVALAVAAIPEGLPAVITTC,1
2by4,A,760,781,21,IRYLISSNVGEVVCIFLTAAL,1
2by4,A,786,808,22,LIPVQLLWVNLVTDGLPATALG,1
2by4,A,833,852,19,FFRYMAIGGYVGAATVGAA,1
2by4,A,898,916,18,MALSVLVTIEMCNALNSL,1
2by4,A,931,950,19,WLLGSICLSMSLHFLILYV,1
2by4,A,967,987,20,LMVLKISLPVIGLDEILKFI,1
4xu6,C,9,26,17,VLFLLGAVAALIGDHSH,1
4xu6,C,41,61,20,VWSSPFWFPILVGAATASLA,1
4xu6,C,80,97,17,GGVAAVVGTYVTTALVH,1
4xu6,C,102,118,16,PVTALVAAAAAITWCV,1
4xu6,C,125,143,18,AAGVVIAVIGPAVEIALV,1
4xu6,C,161,176,15,PFLAPLYFAFGVVAA,1
1iw9,C,10,29,19,IWLALGTALMGLGTLYFLV,1
1iw9,C,45,62,17,TTLVPAIAFTMYLSMLL,1
1iw9,C,79,95,16,WARYADWLFTTPLLLL,1
1iw9,C,110,128,18,LVGADGIMIGTGLVGALT,1
1iw9,C,134,153,19,FVWWAISTAAMLYILYVLF,1
1iw9,C,175,192,17,NVTVVLWSAYPVVWLIG,1
1iw9,C,203,222,19,ETLLFMVLDVSAKVGFGLI,1
2wll,D,59,85,26,WPVFFASLAALFVVNNTLFALLYQLG,1
2wll,D,122,146,24,AHAIATLEIFVGMSGIALSTGLVF,1
2uws,M,55,72,17,GVLSLFSGLMWFFTIGI,1
2uws,M,117,133,16,ASFFMFVAVWSWWGRT,1
2uws,M,147,164,17,WAFLSAIWLWMVLGFIR,1
2uws,M,200,221,21,FHGLSIAFLYGSALLFAMHGA,1
2uws,M,269,286,17,IWMAVLVTLTGGIGILL,1
1wrg,A,16,38,22,KEFHKIFTSSILVFFGVAAFAH,1
4cl4,B,32,56,24,SAAMILCIEAVERLTTLGIGVNLV,1
4cl4,B,70,89,19,ANTVTNFLGTSFMLCLLGG,1
4cl4,B,101,119,18,IAIFAAIQATGVSILTLS,1
4cl4,B,147,171,24,VLYLALYLTALGTGGVKASVSGFG,1
4cl4,B,188,208,20,FFNRFFFCINVGSLLAVTVL,1
4cl4,B,221,239,18,GICAFAIVLALSVFLAGT,1
4cl4,B,344,361,17,IWATCILFWTVHAQLTT,1
4cl4,B,386,410,24,FYVGGLLLTTAVYDRVAIRLCKKL,1
4cl4,B,416,436,20,LRPLQRIGLGLFFGSMAMAV,1
4cl4,B,468,486,18,YLIVGIGEALIYTGQLDF,1
4cl4,B,501,524,23,LLLSTLALGFFFSSVLVTIVEKF,1
4cl4,B,543,562,19,FYWLVAVLVALNFLIFLVF,1
2i36,B,36,64,28,SMLAAYMFLLIMLGFPINFLTLYVTVQH,1
2i36,B,72,95,23,YILLNLAVADLFMVFGGFTTTLY,1
2i36,B,113,134,21,FFATLGGEIALWSLVVLAIER,1
2i36,B,151,170,19,AIMGVAFTWVMALACAAPP,1
2i36,B,204,225,21,YMFVVHFIIPLIVIFFCYGQL,1
2i36,B,254,277,23,IMVIAFLICWLPYAGVAFYIFTH,1
2i36,B,287,308,21,TIPAFFAKTSAVYNPVIYIMM,1
1kch,E,39,49,10,IALLLIAIIV,1
3cn5,D,41,58,17,IAEFIATLLFLYITVAT,1
3cn5,D,76,93,17,IAWAFGGMIFVLVYCTA,1
3cn5,D,119,137,18,LVYMIAQCLGAICGVGLV,1
3cn5,D,163,182,19,ALGAEIIGTFVLVYTVFSA,1
3cn5,D,198,214,16,PLPIGFAVFMVHLATI,1
3cn5,D,243,260,17,IFWVGPFIGAAVAAAYH,1
3qs6,B,14,32,18,ILAMAGNAVGLGNFLRFP,1
3qs6,B,44,63,19,IPYIIAFLLVGIPLMWIEW,1
3qs6,B,90,124,34,KILGVFGLWIPLVVAIYYVYIESWTLGFAIKFLV,1
3qs6,B,167,184,17,AYIVFLITMFINVSILI,1
3qs6,B,191,212,21,ERFAKIAMPTLFILAVFLVIR,1
3qs6,B,244,265,21,IAAVGQIFFTLSLGVGAIITY,1
3qs6,B,278,297,19,GLTAATLNEKAEVILGGSI,1
3qs6,B,340,366,26,GFLWFFLLFFAGLTSSIAQMQPMIAF,1
3qs6,B,378,396,18,VLWTAAIVFFSAHLVMFL,1
3qs6,B,400,425,25,DEMDFWAGTIGVVFFGLTELIIFFW,1
3qs6,B,445,469,24,RIYYYVMRYITPAFLAVLLVVWAR,1
3qs6,B,484,502,18,ITRFYIIGLFLFLTFLVF,1
3m72,C,12,27,15,YFGIPLGLAALSLAW,1
3m72,C,41,60,19,DVLGIVASAVWILFILMYA,1
3m72,C,82,97,15,IALIPITTMLVGDIL,1
3m72,C,105,125,20,EVLIWIGTIGQLLFSTLRVS,1
3m72,C,141,154,13,FYLPAVAANFTSA,1
3m72,C,166,182,16,YLFFGAGMIAWIIFEP,1
3m72,C,201,217,16,GIVLAPPFVCVSAYLS,1
3m72,C,227,245,18,KILWGYGFLQLFFLLRLF,1
3m72,C,258,271,13,AFSFPLASMANSA,1
3m72,C,284,307,23,IFAFVFSNVMIGLLVLMTIYKLT,1
5uvi,A,6,28,22,SVYITVELAIAVLAILGNVLVC,1
5uvi,A,45,67,22,VSLAAADIAVGVLAIPFAITIS,1
5uvi,A,76,97,21,CLFIACFVLVLTQSSIFSLLA,1
5uvi,A,124,144,20,IAICWVLSFAIGLTPMLGWN,1
5uvi,A,172,195,23,PMNYMVYFNFFACVLVPLLLMLG,1
5uvi,A,237,259,22,IVGLFALCWLPLHIINCFTFFC,1
5uvi,A,266,287,21,LWLMYLAIVLSHTNSVVNPFI,1
3m73,C,12,27,15,YFGIPLGLAALSLAW,1
3m73,C,41,61,20,DVLGIVASAVWILFILMYAY,1
3m73,C,82,97,15,IALIPITTMLVGDIL,1
3m73,C,105,125,20,EVLIWIGTIGQLLFSTLRVS,1
3m73,C,141,154,13,FYLPAVAANFTSA,1
3m73,C,167,182,15,LFFGAGMIAWIIFEP,1
3m73,C,201,215,14,GIVLAPAFVCVSAY,1
3m73,C,227,245,18,KILWGYGFLQLFFLLRLF,1
3m73,C,256,271,15,LWAFSAGLASMANSA,1
3m73,C,284,307,23,IFAFVFSNVMIGLLVLMTIYKLT,1
5lxa,A,146,169,23,GNIWTHLLGCVFFLCLGIFYMFR,1
5lxa,A,179,203,24,EKVVFGLFFLGAILCLSFSWLFHT,1
5lxa,A,216,238,22,KLDYSGIALLIMGSFVPWLYYS,1
5lxa,A,245,266,21,CFIYLIVICVLGIAAIIVSQW,1
5lxa,A,275,296,21,GVRAGVFLGLGLSGIIPTLHY,1
5lxa,A,310,334,24,IGWLMLMASLYITGAALYAARIPE,1
5lxa,A,345,369,24,HSHQLFHIFVVAGAFVHFHGVSNL,1
4c9h,A,28,49,21,MGGVSAAVAKTAASPIERVKL,1
4c9h,A,87,108,21,RGNTANVIRYFPTQALNFAFK,1
4c9h,A,132,153,21,SGGAAGALSLLFVYSLDYART,1
4c9h,A,190,207,17,RGFLPSVVGIVVYRGLY,1
4c9h,A,235,253,18,VVTTGASTCSYPLDTVRR,1
4c9h,A,285,306,21,KGCGANILRGVAGAGVISMYD,1
3vvk,C,37,57,20,LYINIALAGLSILLFVFMTR,1
3vvk,C,66,87,21,IAVSTILVPVVSIASYTGLAS,1
3vvk,C,121,142,21,GRYLTWALSTPMILLALGLLA,1
3vvk,C,147,168,21,KLFTAITFDIAMCVTGLAAAL,1
3vvk,C,175,199,24,RWFWYAISCACFIVVLYILLVEWA,1
3vvk,C,211,232,21,STLKLLTVVMWLGYPIVWALG,1
3vvk,C,244,268,24,SWAYSALDIVAKYIFAFLLLNYLT,1
4cl5,B,32,55,23,SAAMILCIEAVERLTTLGIGVNL,1
4cl5,B,72,89,17,TVTNFLGTSFMLCLLGG,1
4cl5,B,100,119,19,TIAIFAAIQATGVSILTLS,1
4cl5,B,147,171,24,VLYLALYLTALGTGGVKASVSGFG,1
4cl5,B,188,208,20,FFNRFFFCINVGSLLAVTVL,1
4cl5,B,221,239,18,GICAFAIVLALSVFLAGT,1
4cl5,B,344,361,17,IWATCILFWTVHAQLTT,1
4cl5,B,386,410,24,FYVGGLLLTTAVYDRVAIRLCKKL,1
4cl5,B,416,436,20,LRPLQRIGLGLFFGSMAMAV,1
4cl5,B,468,486,18,YLIVGIGEALIYTGQLDF,1
4cl5,B,501,524,23,LLLSTLALGFFFSSVLVTIVEKF,1
4cl5,B,543,562,19,FYWLVAVLVALNFLIFLVF,1
3m7e,C,12,27,15,YFGIPLGLAALSLAW,1
3m7e,C,41,61,20,DVLGIVASAVWILFILMYAY,1
3m7e,C,82,97,15,IALIPITTMLVGDIL,1
3m7e,C,105,125,20,EVLIWIGTIGQLLFSTLRVS,1
3m7e,C,141,154,13,FYLPAVAANFTSA,1
3m7e,C,167,182,15,LFFGAGMIAWIIFEP,1
3m7e,C,201,216,15,GIVLAPAFVCVSAYL,1
3m7e,C,227,245,18,KILWGYGFLQLFFLLRLF,1
3m7e,C,256,271,15,LWAFSFGLASMANSA,1
3m7e,C,284,307,23,IFAFVFSNVMIGLLVLMTIYKLT,1
2ycz,A,43,64,21,MSLLMALVVLLIVAGNVLVIA,1
2ycz,A,80,103,23,TSLACADLVVGLLVVPFGATLVV,1
2ycz,A,113,134,21,CELWTSLDVLCVTASIETLCV,1
2ycz,A,163,183,20,TVWAISALVSFLPIMMHWWR,1
2ycz,A,201,225,24,VTNRAYAIASSIISFYIPLLIMIF,1
2ycz,A,294,316,22,IMGVFTLCWLPFFLVNIVNVFN,1
2ycz,A,324,343,19,FVAFNWLGYANSAMNPIIY,1
2i37,B,36,64,28,SMLAAYMFLLIMLGFPINFLTLYVTVQH,1
2i37,B,72,96,24,YILLNLAVADLFMVFGGFTTTLYT,1
2i37,B,113,134,21,FFATLGGEIALWSLVVLAIER,1
2i37,B,151,170,19,AIMGVAFTWVMALACAAPP,1
2i37,B,204,224,20,YMFVVHFIIPLIVIFFCYGQ,1
2i37,B,254,277,23,IMVIAFLICWLPYAGVAFYIFTH,1
2i37,B,287,308,21,TIPAFFAKTSAVYNPVIYIMM,1
5eqg,A,14,35,21,AVGGAVLGSLQFGYNTGVINA,1
5eqg,A,64,83,19,WSLSVAIFSVGGMIGSFSV,1
5eqg,A,95,113,18,MLMMNLLAFVSAVLMGFS,1
5eqg,A,120,141,21,MLILGRFIIGVYCGLTTGFVP,1
5eqg,A,159,175,16,HQLGIVVGILIAQVFG,1
5eqg,A,188,206,18,LLSIIFIPALLQCIVLPF,1
5eqg,A,274,295,21,AVVLQLSQQLSGINAVFYYST,1
5eqg,A,309,328,19,TIGSGIVNTAFTVVSLFVV,1
5eqg,A,335,353,18,LHLIGLAGMAGCAILMTI,1
5eqg,A,368,388,20,IVAIFGFVAFFEVGPGPIPW,1
5eqg,A,406,426,20,AGFSNWTSNFIVGMCFQYVE,1
5eqg,A,433,450,17,FIIFTVLLVLFFIFTYF,1
2wlm,D,46,71,25,PVFITLITGLYLVTNALFALAYLAC,1
2wlm,D,108,132,24,ANTLVTLEALCGMLGLAVAASLIY,1
4au5,B,14,31,17,GIILIIAAILAMIMANS,1
4au5,B,60,79,19,LWINDALMAVFFLLVGLEV,1
4au5,B,99,116,17,AAIGGMIVPALLYLAFN,1
4au5,B,124,140,16,GWAIPAATDIAFALGV,1
4au5,B,158,176,18,LAIIDDLGAIIIIALFYT,1
4au5,B,182,199,17,SLGVAAVAIAVLAVLNL,1
4au5,B,206,222,16,VYILVGVVLWTAVLKS,1
4au5,B,224,237,13,HATLAGVIVGFFI,1
4au5,B,256,276,20,PWVAYLILPLFAFANAGVSL,1
4au5,B,288,307,19,PLGIIAGLLIGKPLGISLF,1
4au5,B,330,349,19,VGILCGIGFTMSIFIASLA,1
4au5,B,359,378,19,WAKLGILVGSISSAVIGYS,1
3det,B,37,61,24,MAAVVGTLVGLAAVAFDKGVAWLQ,1
3det,B,84,97,13,CSAVLAMFGYFLV,1
3det,B,129,142,13,VKFFGGLGTLGGG,1
3det,B,144,156,12,LGRAGPTVQIGG,1
3det,B,216,232,16,AVFIGVIMSTIMYRIF,1
3det,B,253,273,20,LYLILGIIFGIFGPIFNKWV,1
3det,B,290,305,15,WVLMGGAIGGLCGLL,1
3det,B,338,351,13,ARVITTLLCFSSG,1
3det,B,353,368,15,GGIFAPMLALGTVLG,1
3det,B,423,439,16,PMIITGLGATLLAQFT,1
5g2c,A,17,40,23,IDHLLTMGVGVHFAALIFFLVVS,1
5g2c,A,50,73,23,TALSCIVMVSAGLILNSQAVMWT,1
5g2c,A,91,114,23,NGYRYVNWMADIPCLLLQLLIVL,1
5g2c,A,121,143,22,FSTATWLILAAWGMIITGYVGQ,1
5g2c,A,155,178,23,WGAVSTAFFVVMNWIVGTKIFKN,1
5g2c,A,189,210,21,ITKVFWLMMFAWTLYPIAYLV,1
5g2c,A,222,245,23,RQLLFTIADISSKVIYGLMITYI,1
5lwy,A,146,169,23,GNIWTHLLGCVFFLCLGIFYMFR,1
5lwy,A,179,203,24,EKVVFGLFFLGAILCLSFSWLFHT,1
5lwy,A,216,239,23,KLDYSGIALLIMGSFVPWLYYSF,1
5lwy,A,245,266,21,CFIYLIVICVLGIAAIIVSQW,1
5lwy,A,275,297,22,GVRAGVFLGLGLSGIIPTLHYV,1
5lwy,A,310,334,24,IGWLMLMASLYITGAALYAARIPE,1
5lwy,A,345,368,23,HSHQLFHIFVVAGAFVHFHGVSN,1
2yl4,B,168,189,21,RRLAAAVGFLTMSSVISMSAP,1
2yl4,B,219,239,20,AVFLCGAAANAIRVYLMQTS,1
2yl4,B,285,308,23,VTENLSDGLRAGAQASVGISMMF,1
2yl4,B,316,337,21,FVLSVVPPVSIIAVIYGRYLR,1
2yl4,B,391,413,22,AFARAGFFGATGLSGNLIVLSV,1
2yl4,B,435,455,20,MYAFWVGISIGGLSSFYSEL,1
2ped,A,40,65,25,AYMFLLIMLGFPINFLTLYVTVQHK,1
2ped,A,69,95,26,PLNYILLNLAVADLFMVFGGFTTTLY,1
2ped,A,112,137,25,GFFATLGGEIALWSLVVLAIERYVV,1
2ped,A,151,173,22,AIMGVAFTWVMALACAAPPLVG,1
2ped,A,203,227,24,IYMFVVHFIIPLIVIFFCYGQLVF,1
2ped,A,251,274,23,MVIIMVIAFLICWLPYAGVAFYI,1
2ped,A,289,310,21,PAFFAKTSAVYNPVIYIMMNK,1
4mnd,B,326,340,14,ISFLVGAFSALASF,1
4mnd,B,344,357,13,LAGLLYQFSSILD,1
4mnd,B,379,395,16,ILDRFVDFLFLAIIAL,1
4mnd,B,402,417,15,VAMFAIFGSVMVSYT,1
4mnd,B,439,456,17,PGKRDERIFLIMIFCLL,1
4mnd,B,465,484,19,WMFLFVAAISLTRVVVTLL,1
1yq3,D,9,29,20,WTSERAVSALLLGLLPAAYL,1
1yq3,D,35,55,20,DYSLAAALTLHGHWGLGQVI,1
1yq3,D,67,87,20,ANTGLYVLSAITFTGLCYFN,1
4d0a,A,4,24,20,MAIGYLGLALVLGSLVAKIA,1
4d0a,A,30,46,16,DIPLLLLLGLIIGPFL,1
4d0a,A,58,76,18,EYAGPIGLIFILLGGAFT,1
4d0a,A,89,108,19,VRLDTITFLITLLISGFIF,1
4d0a,A,123,140,17,FGAITAATDPATLIPVF,1
4d0a,A,153,171,18,EAESIFNDPLGIVSTSVI,1
4d0a,A,185,206,21,DLITLAGGAIVVGLLLAKIYE,1
4d0a,A,218,237,19,APLVLGGAMLLLYVGDDLL,1
4d0a,A,244,259,15,FSGYMAVAIMGLYLG,1
4d0a,A,277,296,19,DDLSLLARVFIFVFLGACI,1
4d0a,A,306,329,23,PGLLVALGSIFLARPLGVFLGLI,1
4d0a,A,339,356,17,YFALEGPRGVVPAALAV,1
4d0a,A,387,404,17,IGTFMTILLSVILEASW,1
2uxj,M,56,72,16,VLSLFSGLMWFFTIGI,1
2uxj,M,115,132,17,LIASFFMFVAVWSWWGR,1
2uxj,M,147,167,20,WAFLSAIWLWMVLGFIRPIL,1
2uxj,M,200,221,21,FHGLSIAFLYGSALLFAMHGA,1
2uxj,M,269,286,17,IWMAVLVTLTGGIGILL,1
2kpe,B,74,96,22,LIIFGVMAGVIGTILLISYGIR,1
4cas,D,16,32,16,WYAQWLVIWTVVLLYL,1
4ayw,B,169,195,26,RLAAAVGFLTMSSVISMSAPFFLGKI,1
4ayw,B,215,237,22,LGLSAVFLCGAAANAIRVYLMQ,1
4ayw,B,288,312,24,NLSDGLRAGAQASVGISMMFFVSP,1
4ayw,B,314,336,22,ATFVLSVVPPVSIIAVIYGRYL,1
4ayw,B,393,417,24,ARAGFFGATGLSGNLIVLSVLYKG,1
4ayw,B,430,453,23,LSSFLMYAFWVGISIGGLSSFYS,1
3hqk,B,14,27,13,VTLMVSGNIMGSG,1
3hqk,B,47,60,13,VTIIGALALSMVY,1
3hqk,B,89,105,16,NVLYWLACWIGNIAMV,1
3hqk,B,129,141,12,VAVLWIFVLLNI,1
3hqk,B,147,162,15,TRVQAVATVLALVPI,1
3hqk,B,201,211,10,WSFIGVESAS,1
3hqk,B,228,241,13,IGGVLIAAVCYVL,1
3hqk,B,285,298,13,CLGSLGGWTLLAG,1
3hqk,B,327,339,12,LIVGVLMTIFQF,1
3hqk,B,354,369,15,SVSVIFTLVPYLYTC,1
3hqk,B,390,405,15,TFVAFVYCIWAVIGS,1
3hqk,B,410,423,13,MWSFVTLMVITAL,1
1rvj,H,16,32,16,IYSFWIFLAGLIYYLQ,1
3o7p,A,30,49,19,LCSLFFLWAVANNLNDILL,1
3o7p,A,67,85,18,SAFYFGYFIIPIPAGILM,1
3o7p,A,91,109,18,AGIITGLFLYALGAALFW,1
3o7p,A,120,142,22,LVGLFIIAAGLGCLETAANPFV,1
3o7p,A,156,174,18,LAQTFASFGAIIAVVFGQ,1
3o7p,A,210,228,18,PYMIIVAIVLLVALLIML,1
3o7p,A,261,281,20,WAVLAQFCYVGAQTACWSYL,1
3o7p,A,301,319,18,TGTMVCFFIGRFTGTWLI,1
3o7p,A,326,345,19,VLAAYALIAMALCLISAFA,1
3o7p,A,350,372,22,LIALTLCSAFMSIQYPTIFSLG,1
3o7p,A,382,401,19,GSSFIVMTIIGGGIVTPVM,1
3o7p,A,413,431,18,AELIPALCFAVIFIFARF,1
4twd,E,211,225,14,LGLIIAASWSVFWL,1
4twd,E,230,245,15,RLQTSFTLMLTVVAY,1
4twd,E,266,282,16,IAGYGSIFAAILLIIF,1
4twd,E,300,315,15,RLAFPLGFLAIGCVL,1
3qjt,C,7,23,16,ALAVILVLTLTILVFW,1
5ul0,A,9,22,13,EALEYVNIGLSHF,1
5ul0,A,30,48,18,ISLIIIIPFIYNIVWQLL,1
5l4h,E,203,218,15,PMLFILFISWTAFWS,1
5l4h,E,222,239,17,ANVTLVVSTLIAHIAFN,1
5l4h,E,259,276,17,FMIYLFYFVAVIEVTVQ,1
5l4h,E,292,310,18,RASRIAFPVVFLLANIIL,1
3aod,C,11,27,16,AWVIAIIIMLAGGLAI,1
3aod,C,341,357,16,KTLVEAIILVFLVMYL,1
3aod,C,366,386,20,IPTIAVPVVLLGTFAVLAAF,1
3aod,C,395,410,15,FGMVLAIGLLVDDAI,1
3aod,C,443,458,15,GIAMVLSAVFVPMAF,1
3aod,C,471,489,18,ITIVSAMALSVLVALILT,1
3aod,C,543,558,15,LYLIIVVGMAYLFVR,1
3aod,C,874,890,16,SLYAISLIVVFLCLAA,1
3aod,C,899,919,20,SVMLVVPLGVIGALLAATFR,1
3aod,C,927,943,16,QVGLLTTIGLSAKNAI,1
3aod,C,976,991,15,MTSLAFILGVMPLVI,1
3aod,C,1004,1019,15,TGVMGGMVTATVLAI,1
4qiq,A,16,39,23,ATLGGLLFGYDTAVISGTVESLN,1
4qiq,A,52,75,23,ANSLLGFCVASALIGCIIGGALG,1
4qiq,A,87,106,19,LKIAAVLFFISGVGSAWPE,1
4qiq,A,123,145,22,GYVPEFVIYRIIGGIGVGLASM,1
4qiq,A,166,187,21,NQFAIIFGQLLVYCVNYFIAR,1
4qiq,A,198,218,20,WRYMFASECIPALLFLMLLY,1
4qiq,A,280,305,25,GVMLSIFQQFVGINVVLYYAPEVFK,1
4qiq,A,312,336,24,IALLQTIIVGVINLTFTVLAIMTV,1
4qiq,A,343,364,21,LQIIGALGMAIGMFSLGTAFY,1
4qiq,A,370,392,22,VALLSMLFYVAAFAMSWGPVCW,1
4qiq,A,411,432,21,VAAQWLANYFVSWTFPMMDKN,1
4qiq,A,442,462,20,FSYWIYGCMGVLAALFMWKF,1
1yew,K,53,67,14,ALAIYTVFYLWVRW,1
1yew,K,93,108,15,YTEIVLEIVTASILW,1
1yew,K,139,155,16,AYAWAIYWGASYFTEQ,1
1yew,K,175,190,15,EFYLSYPIYIITGFA,1
1p8i,C,12,30,18,LALGTALMGLGTLYFLVK,1
1p8i,C,44,61,17,ITTLVPAIAFTMYLSML,1
1p8i,C,80,97,17,ARYADWLFTTPLLLLDL,1
1p8i,C,109,126,17,ALVGADGIMIGTGLVGA,1
1p8i,C,135,153,18,VWWAISTAAMLYILYVLF,1
1p8i,C,175,192,17,NVTVVLWSAYPVVWLIG,1
1p8i,C,204,222,18,TLLFMVLDVSAKVGLGLI,1
4h0l,P,9,23,14,LLSFGLIFVGWGLG,1
3dsy,H,12,32,20,ASLAIYSFWIFLAGLIYYLQ,1
4qh4,E,199,218,19,NIILPMLFILFISWTAFWS,1
4qh4,E,222,240,18,ANVTLVVSTLIAHIAFNI,1
4qh4,E,256,275,19,AIIFMIYLFYFVAVIEVTV,1
4qh4,E,295,313,18,RIAFPVVFLLANIILAFL,1
3vma,A,73,86,13,IVFAVLIAIYGVY,1
2k21,A,50,72,22,LGFFGFFTLGIMLSYIRSKKLE,1
2k1k,B,548,569,21,VAVIFGLLLGAALLLGILVFR,1
5l7d,A,234,251,17,AAFGAVTGLCTLFTLAT,1
5l7d,A,267,283,16,FYVNACFFVGSIGWLA,1
5l7d,A,316,336,20,IFVIVYYALMAGFVWFVVLT,1
5l7d,A,362,378,16,LTWSLPFVLTVAILAV,1
5l7d,A,400,420,20,AGFVLAPIGLVLIVGGYFLI,1
5l7d,A,455,472,17,GFLAFGFVLITFSCHFY,1
5l7d,A,518,537,19,KINLFAMFGTGIAMSTWVW,1
2llm,A,18,40,22,IIGLMVGGVVIATVIVITLVML,1
4f05,C,7,24,17,ALAVILVLTLTILVFWL,1
2b6q,A,35,62,27,ILLPVSYAVVFVLGLGLNAPTLWLFIF,1
2b6q,A,70,97,27,ATYMFHLALSDTLYVLSLPTLIYYYAA,1
2b6q,A,107,133,26,CKFVRFLFYWNLYCSVLFLTCISVHR,1
2b6q,A,151,175,24,AGLLCLAVWLVVAGCLVPNLFFVT,1
2b6q,A,199,222,23,FSSAVMGLLFGVPCLVTLVCYGL,1
2b6q,A,246,270,24,IAVVLTVFAVCFVPFHITRTIYYL,1
2b6q,A,287,309,22,YKVTRPLASANSCLDPVLYLLT,1
4cz8,B,7,24,17,EALFLILFTGVISMLIS,1
4cz8,B,30,43,13,YVPIFILTGLVIG,1
4cz8,B,58,74,16,DFVRVFGLVIILFTEG,1
4cz8,B,90,108,18,TLDTIGLILTALIAGFIF,1
4cz8,B,121,133,12,FGAIIGATDPAT,1
4cz8,B,155,168,13,IFNDPLGIVLTLI,1
4cz8,B,196,214,18,IYFLYNVSVSISLGIFLG,1
4cz8,B,234,250,16,FSLSLAFLGFFIGERL,1
4cz8,B,252,262,10,SGYLVATVTG,1
4cz8,B,294,313,19,DTLAALATIFIFVLLGAEM,1
4cz8,B,323,344,21,KGLLVALGVMILARPLATLPL,1
4cz8,B,358,371,13,EGPRGVVPSALAS,1
4cz8,B,395,411,16,TVVITVLTSVIVETLW,1
4jq6,F,14,31,17,FWLAAAIMLASTVFFFV,1
4jq6,F,45,62,17,VAGLVTGVAFWHYLYMR,1
4jq6,F,75,91,16,RYIDWLITVPLQIIEF,1
4jq6,F,106,122,16,WKLLIASLVMLIGGFI,1
4jq6,F,132,148,16,WWIVGMIAWLYIIYEI,1
4jq6,F,173,189,16,WIVTVGWAIYPIGYAW,1
4jq6,F,201,219,18,NIVYNLADLINKAAFGLA,1
4a4m,C,43,63,20,MFLLIMLGFPINFLTLYVTV,1
4a4m,C,75,92,17,LLNLAVADLFMVFGGFT,1
4a4m,C,114,133,19,FFATLGGEIALWSLVVLAI,1
4a4m,C,154,170,16,MGVAFTWVMALACAAP,1
4a4m,C,203,221,18,VIYMFVVHFIIPLIVIFF,1
4a4m,C,255,274,19,IYVIAFLICWLPYAGVAFY,1
4a4m,C,291,309,18,AFFAKTSAVYNPVIYIMM,1
5b6x,C,12,28,16,LALGTALMGLGTLYFL,1
5b6x,C,47,61,14,LVPAIAFTMYLSML,1
5b6x,C,80,94,14,ARYADWLFTTPLLL,1
5b6x,C,111,126,15,VGADGIMIGTGLVGA,1
5b6x,C,135,150,15,VWWAISTAAMLYILY,1
5b6x,C,178,192,14,VVLWSAYPVVWLIG,1
5b6x,C,204,220,16,TLLFMVLDVSAKVGFG,1
5u70,D,91,113,22,LRIRLFNFSLKLLTCLLYIVRV,1
5u70,D,155,178,23,WAVQVSIALISFLETMLLIYLSY,1
5u70,D,182,207,25,WEQIFRISFILEMINTVPFIITIFW,1
5u70,D,214,232,18,IPVFLNCWLAKYALENMI,1
5u70,D,248,271,23,QVLILICTLLCLVFTGTCGIQHL,1
5u70,D,306,333,27,QLLVVIMICVALVVLPLQFEELVYLWM,1
4cy4,E,266,279,13,FAVPMWITGIYGM,1
4cy4,E,293,306,13,WLVMALMVVIIMI,1
4o93,D,4,19,15,QAAYFVVAILFIVGL,1
4o93,D,34,48,14,AGWGMVLAVLATFF,1
4o93,D,57,72,15,ILLALLLGSVVAWWA,1
4o93,D,87,101,14,YNGMGGGAAATIAA,1
4o93,D,117,134,17,AILGGLIGSVAFTGSLI,1
4o93,D,153,169,16,KAVNALVLALTVVIGL,1
4o93,D,181,195,14,LFFLLALLFGVLMT,1
4o93,D,210,226,16,NAFTGMAVGFEGFAVG,1
4o93,D,228,242,14,ALMVAGTLVGAAGT,1
4o9r,A,234,253,19,AAFGAVTGLCTLFTLATFV,1
4o9r,A,267,283,16,FYVNACFFVGSIGWLA,1
4o9r,A,316,337,21,IFVIVYYALMAGVVWFVVLTY,1
4o9r,A,361,377,16,LLTWSLPFVLTVAILA,1
4o9r,A,400,420,20,AGFVLAPIGLVLIVGGYFLI,1
4o9r,A,454,472,18,FGFLAFGFVLITFSCHFY,1
4o9r,A,518,537,19,KINLFAMFGTGIAMSTWVW,1
4a7a,A,488,501,13,VPGLLRLIGLTTI,1
4fg6,B,37,60,23,MAAVVGTLVGLAAVAFDKGVAWL,1
4fg6,B,84,97,13,CSAVLAMFGYFLV,1
4fg6,B,128,142,14,PVKFFGGLGTLGGG,1
4fg6,B,144,156,12,LGRAGPTVQIGG,1
4fg6,B,216,232,16,AVFIGVIMSTIMYRIF,1
4fg6,B,253,277,24,LYLILGIIFGIFGPIFNKWVLGMQ,1
4fg6,B,290,305,15,WVLMGGAIGGLCGLL,1
4fg6,B,338,351,13,ARVITTLLCFSSG,1
4fg6,B,353,365,12,GGIFAPMLALGT,1
4fg6,B,423,439,16,PMIITGLGATLLAQFT,1
1fjk,A,31,49,18,FINFCLILIFLLLICIIV,1
5hya,A,7,24,17,YFLLGLILLYYGSDWFV,1
5hya,A,40,59,19,IGATVMAIGTSLPEILTSA,1
5hya,A,72,92,20,NAIGSCICNIGLVLGLSAII,1
5hya,A,104,120,16,ILVYLLFVIFAAVIGI,1
5hya,A,127,143,16,GVVLLILFIIYLRWTV,1
5hya,A,166,186,20,LLIIGLIGVLVGAELFVDGA,1
5hya,A,205,222,17,AFGTSLPELMVSLAAAK,1
5hya,A,229,248,19,LGNVIGSNIADIGGALAVG,1
5hya,A,259,275,16,QMAVLVIMSLLLYLFA,1
5hya,A,281,299,18,RWQGILFLALYIIAIASL,1
5do7,B,414,431,17,PTLLIHGAEACLMSMTI,1
5do7,B,455,469,14,GALIPFNVILDVIS,1
5do7,B,497,513,16,LGELPEHCAYIIIYGM,1
5do7,B,533,550,17,LVWLVVFCCRIMALAAA,1
5do7,B,559,574,15,SFFSNALYNSFYLAG,1
5do7,B,644,659,15,LIVIGLSGGFMVLYY,1
5jae,B,14,32,18,ILAMAGNAVGLGNFLRFP,1
5jae,B,42,63,21,FMIPYIIAFLLVGIPLMWIEW,1
5jae,B,90,120,30,KILGVFGLWIPLVVAIYYVYIESWTLGFAI,1
5jae,B,167,184,17,AYIVFLITMFINVSILI,1
5jae,B,191,212,21,ERFAKIAMPTLFILAVFLVIR,1
5jae,B,244,265,21,IAAVGQIFFTLSLGFGAIITY,1
5jae,B,279,297,18,LTAATLNEKAEVILGGSI,1
5jae,B,343,366,23,WFFLLFFAGLTSSIAIMQPMIAF,1
5jae,B,378,394,16,VLWTAAIVFFSAHLVM,1
5jae,B,400,425,25,DEMDFWAGTIGVVFFGLTELIIFFW,1
5jae,B,448,469,21,YYVMRYITPAFLAVLLVVWAR,1
5jae,B,485,501,16,TRFYIIGLFLFLTFLV,1
5j4n,B,17,32,15,MVSGNIMGSGVFLLP,1
5j4n,B,41,57,16,AIYGWLVTIIGALGLS,1
5j4n,B,92,113,21,YWLACWIGNIAMVVIGVGYLS,1
5j4n,B,123,140,17,VLTITCVVVLWIFVLLN,1
5j4n,B,148,171,23,RVQAVATVLALIPIVGIAVFGWF,1
5j4n,B,190,209,19,GAIQSTLNVTLWSFIGVES,1
5j4n,B,229,246,17,GGVLIAAVCYVLSTTAI,1
5j4n,B,277,297,20,VSFCAAAGCLGSLGGWTLLA,1
5j4n,B,328,342,14,IVGILMTIFQLSSI,1
5j4n,B,347,366,19,KEFGLVSSVSVIFTLVPYL,1
5j4n,B,390,407,17,TTIAFLYCIWAVVGSGA,1
5j4n,B,409,423,14,VMWSFVTLMVITAM,1
5mdx,8,102,119,17,LIHGRWAMAAVLGIFVG,1
5mdx,8,145,158,13,LGTQLLLMGWVES,1
5mdx,8,228,243,15,IKHSRLAMVAMLIFY,1
1ocz,Z,16,35,19,IGLSVTFLSFLLPAGWVLY,1
2m3e,A,1063,1083,20,MLYLYVLSGIGGLLLLLLIF,1
5hxe,A,5,27,22,VGYFLLGLILLYYGSDWFVLGS,1
5hxe,A,40,59,19,IGATVMAIGTSLPEILTSA,1
5hxe,A,72,92,20,NAIGSCICNIGLVLGLSAII,1
5hxe,A,103,120,17,NILVYLLFVIFAAVIGI,1
5hxe,A,127,143,16,GVVLLILFIIYLRWTV,1
5hxe,A,166,186,20,LLIIGLIGVLVGAELFVDGA,1
5hxe,A,205,222,17,AFGTSLPELMVSLAAAK,1
5hxe,A,229,248,19,LGNVIGSNIADIGGALAVG,1
5hxe,A,259,275,16,QMAVLVIMSLLLYLFA,1
5hxe,A,281,299,18,RWQGILFLALYIIAIASL,1
2meu,B,112,136,24,TAVIAMEFWLLLVIILRTVKRANG,1
4up6,C,33,47,14,EGVAVLLAVVIACW,1
4up6,C,54,68,14,RVLLISSVMLVMIV,1
4up6,C,102,116,14,IAIIVAVITWCILL,1
4bpm,C,14,32,18,AFLLCSTLLVIKMYVVAI,1
4bpm,C,73,90,17,NDMETIYPFLFLGFVYS,1
4bpm,C,98,115,17,AWMHFLVFLVGRVAHTV,1
4bpm,C,129,149,20,YTLAQLPCASMALQILWEAA,1
4brr,C,34,48,14,GVAVLLCVVIAAWL,1
4brr,C,53,68,15,TRVLLISSVMLVMIV,1
4brr,C,102,117,15,IAIIDAVITWAILLW,1
5hxr,A,8,27,19,FLLGLILLYYGSDWFVLGS,1
5hxr,A,40,56,16,IGATVMAIGTSLPEIL,1
5hxr,A,74,92,18,IGSCICNIGLVLGLSAII,1
5hxr,A,105,120,15,LVYLLFVIFAAVIGI,1
5hxr,A,127,143,16,GVVLLILFIIYLRWTV,1
5hxr,A,163,182,19,SLVLLIIGLIGVLVGAELF,1
5hxr,A,207,222,15,GTSLPELMVSLAAAK,1
5hxr,A,229,247,18,LGNVIGSNIADIGGALAV,1
5hxr,A,259,275,16,QMAVLVIMSLLLYLFA,1
5hxr,A,281,297,16,RWQGILFLALYIIAIA,1
5fxj,D,556,573,17,CVWVMMFVMLLIVSAVA,1
5fxj,D,627,647,20,SKIMVSVWAFFAVIFLASYT,1
5fxj,D,818,837,19,AGVFYMLGAAMALSLITFI,1
3lrc,B,13,31,18,PVTLMVSGNIMGSGVFLL,1
3lrc,B,44,61,17,GWLVTIIGALGLSMVYA,1
3lrc,B,85,112,27,GYQTNVLYWLACWIGNIAMVVIGVGYL,1
3lrc,B,126,144,18,ITCVVVLWIFVLLNIVGP,1
3lrc,B,146,171,25,ITRVQAVATVLALIPIVGIAVFGWF,1
3lrc,B,197,213,16,NVTLWSFIGVESASVA,1
3lrc,B,225,244,19,IATIGGVLIAAVCYVLSTT,1
3lrc,B,278,301,23,SFCAAAGCLGSLGGWTLLAGQTA,1
3lrc,B,324,342,18,AGLIIVGILMTIFQLSSI,1
3lrc,B,350,370,20,GLVSSVSVIFTLVPYLYTCA,1
3lrc,B,386,407,21,YLAVTTIAFLYCIWAVVGSGA,1
3lrc,B,409,426,17,VMWSFVTLMVITAMYAL,1
2j8d,M,53,72,19,SLGVLSLFSGLMWFFTIGI,1
2j8d,M,118,134,16,SFFMFVAVWSWWGRTY,1
2j8d,M,145,163,18,TAWAFLSAIWLWMVLGFI,1
2j8d,M,201,221,20,HGLSIAFLYGSALLFAMHGA,1
2j8d,M,268,285,17,AIWMAVLVTLTGGIGIL,1
3wgu,E,29,46,17,GLIFAALAFIVGLIIIL,1
4njn,A,93,110,17,GPVTWVMMIACVVVFIA,1
4njn,A,148,166,18,MHILFNLLWWWYLGGAVE,1
4njn,A,172,189,17,KLIVITLISALLSGYVQ,1
4njn,A,199,216,17,LSGVVYALMGYVWLRGE,1
4njn,A,225,241,16,QRGLIIFALIWIVAGW,1
4njn,A,252,268,16,AHIAGLAVGLAMAFVD,1
4g71,C,7,24,17,ALAVILVLTLTILVFWL,1
2jo1,A,14,37,23,SLQIGGLVIAGILFILGILIVLS,1
4in6,H,12,31,19,ASLAIYSFWIFLAGLIYYL,1
3nkc,E,5,22,17,AAECFGTFWLVFGGCGS,1
3nkc,E,38,55,17,VALAWGLTVLTMAFAVG,1
3nkc,E,82,99,17,GYVIAQVVGGIVAAALL,1
3nkc,E,135,152,17,VVELVLSAGFLLVIHGA,1
3nkc,E,162,178,16,PIAIGLALTLIGLISI,1
3nkc,E,206,223,17,FFWVVPIVGGIIGGLIY,1
4ryi,B,10,27,17,FFLTYGLFYVSSVLFPI,1
4ryi,B,43,63,20,GMTIGMIWAVLFGLIALSVA,1
4ryi,B,75,96,21,FWFLFLLNYIFNQAFSYFQFS,1
4ryi,B,103,122,19,TVDCLLVAITTLLLIMFSS,1
4ryi,B,127,146,19,SAWLLIPYFLWSAFATYLS,1
5t04,A,63,90,27,KVLVTAIYLALFVVGTVGNSVTLFTLA,1
5t04,A,105,130,25,LGSLALSDLLILLLAMPVELYNFIW,1
5t04,A,140,164,24,GCRGYYFLRDACTYATALNVASLS,1
5t04,A,189,209,20,ISAIWLASALLAIPMLFTMG,1
5t04,A,232,256,24,TVKVVIQVNTFMSFLFPMLVISIL,1
5t04,A,309,334,25,LRAVVIAFVVCWLPYHVRRLMFCYI,1
5t04,A,347,370,23,HYFYMLTNALAYASSAINPILYN,1
5d6i,C,34,47,13,GVAVLLAVVIACW,1
5d6i,C,53,67,14,TRVLLISSVMLVMI,1
5d6i,C,103,116,13,AIIDAVITWCILL,1
3nk5,A,5,22,17,AAECFGTFWLVFGGCGS,1
3nk5,A,38,55,17,VALAWGLTVLTMAFAVG,1
3nk5,A,81,99,18,VGYVIAQVVGGIVAAALL,1
3nk5,A,135,152,17,VVELVLSAGFLLVIHGA,1
3nk5,A,162,178,16,PIAIGLALTLIHLISI,1
3nk5,A,206,223,17,FFWVVPIVGGIIGGLIY,1
5aji,G,35,59,24,AIIIVGLIIARMISNAVNRLMISR,1
5aji,G,67,87,20,FLSALVRYGIIAFTLIAALG,1
5aji,G,92,108,16,TASVIAVLGAAGLAVG,1
5duo,B,4,26,22,WALFLTFLAACGAPATTGALLK,1
5duo,B,38,65,27,WNPPRWVFPLAWTSLYFLMSLAAMRVA,1
5duo,B,72,92,20,ALAFYAAQLAFNTLWTPVFF,1
5duo,B,98,119,21,TALAVVMVMWLFVAATMWAFF,1
5duo,B,125,145,20,GVLFVPYLIWATATTGLNFE,1
1jdm,A,5,26,21,RELFLNFTIVLITVILMWLLV,1
4ro2,F,25,45,20,VLFVLTILTLISGTIFYSTV,1
4ro2,F,74,99,25,GKIFTILYIFIGIGLVFGFIHKLAV,1
5f5g,A,93,109,16,GPVTWVMMIACVVVFI,1
5f5g,A,148,166,18,MHILFNLLWWWYLGGAVE,1
5f5g,A,171,189,18,GKLIVITLISALLSGYVQ,1
5f5g,A,199,214,15,LSGVVFALMGYVWLR,1
5f5g,A,226,245,19,RGLIIFALIWIVAGWFDLF,1
5f5g,A,250,268,18,NGAHIAGLAVGLAMAFVD,1
2a0d,A,60,87,27,IITAVYSVVFVVGLVGNSLVMFVIIRY,1
2a0d,A,91,118,27,TATNIYIFNLALADALVTTTMPFQSTV,1
2a0d,A,133,158,25,VISIDYYNMFTSIFTLTMMSVDRYI,1
2a0d,A,173,195,22,KAKIINICIWLLSSSVGISAIV,1
2a0d,A,226,250,24,KICVFIFAFVIPVLIIIVCYTLMI,1
2a0d,A,273,294,21,RLVLVVVAVFVVCWTPIHIFI,1
2a0d,A,308,334,26,LSSYYFCIALGYTNSSLNPILYAFLD,1
2q69,D,25,45,20,VLFVLTILTLISGTIFYSTV,1
2q69,D,75,95,20,GKIFTILYIFIGIGLVFGFI,1
4u1y,D,524,542,18,IWMAIVFAYILVSVVLFL,1
4u1y,D,597,617,20,ARIVAGVWWFFTLIIISSYT,1
4u1y,D,793,812,19,GVFYILVGGLGLAMLVALI,1
4u3f,W,20,36,16,ALTVVLGAVLFERAFD,1
2dyr,Z,13,34,21,EQAIGLSVTFLSFLLPAGWVL,1
2jwa,B,155,179,24,SAVVGILLVVVLGVVFGILIKRRQ,1
1ots,B,37,60,23,MAAVVGTLVGLAAVAFDKGVAWL,1
1ots,B,84,97,13,CSAVLAMFGYFLV,1
1ots,B,129,142,13,VKFFGGLGTLGGG,1
1ots,B,144,156,12,LGREGPTVQIGG,1
1ots,B,216,231,15,AVFIGVIMSTIMYRI,1
1ots,B,253,273,20,LYLILGIIFGIFGPIFNKWV,1
1ots,B,290,304,14,WVLMGGAIGGLCGL,1
1ots,B,338,351,13,ARVITTLLCFSSG,1
1ots,B,353,365,12,GGIFAPMLALGT,1
1ots,B,423,439,16,PMIITGLGATLLAQFT,1
2qb4,B,13,32,19,LILAMAGNAVGLGNFLRFP,1
2qb4,B,44,63,19,IPYIIAFLLVGIPLMWIEW,1
2qb4,B,90,124,34,KILGVFGLWIPLVVAIYYVYIESWTLGFAIKFLV,1
2qb4,B,167,185,18,AYIVFLITMFINVSILIR,1
2qb4,B,191,212,21,ERFAKIAMPTLFILAVFLVIR,1
2qb4,B,242,265,23,VWIAAVGQIFFTLSLGFGAIITY,1
2qb4,B,277,297,20,SGLTAATLNEKAEVILGGSI,1
2qb4,B,340,367,27,GFLWFFLLFFAGLTSSIAIMQPMIAFL,1
2qb4,B,378,396,18,VLWTAAIVFFSAHLVMFL,1
2qb4,B,400,426,26,DEMDFWAGTIGVVFFGLTELIIFFWI,1
2qb4,B,445,469,24,RIYYYVMRYITPAFLAVLLVVWAR,1
2qb4,B,484,502,18,ITRFYIIGLFLFLTFLVF,1
5mrw,D,6,21,15,TGVLLVFLLLGYLVY,1
4rcr,H,13,30,17,SLAIYSFWIFLAGLIYY,1
4bey,A,40,65,25,AYMFLLIMLGFPINFLTLYVTVQHK,1
4bey,A,69,96,27,PLNYILLNLAVADLFMVFGDFTTTLYT,1
4bey,A,113,137,24,FFATLGGEIALWSLVVLAIERYVV,1
4bey,A,151,173,22,AIMGVAFTWVMALACAAPPLVG,1
4bey,A,203,227,24,IYMFVVHFIIPLIVIFFCYGQLVF,1
4bey,A,250,274,24,RMVIIMVIAFLICWLPYAGVAFYI,1
4bey,A,290,311,21,AFFAKTSAVYNPVIYIMMNKQ,1
4pxz,A,24,48,24,QVLFPLLYTVLFFVGLITNGLAMR,1
4pxz,A,63,85,22,KNTVISDLLMILTFPFKILSDA,1
4pxz,A,93,119,26,TFVCQVTSVIFYFTMYISISFLGLIT,1
4pxz,A,143,164,21,LSVVIWAFMFLLSLPNMILTN,1
4pxz,A,183,210,27,LVWHEIVNYICQVIFWINFLIVIVCYT,1
4pxz,A,238,264,26,FIIIAVFFICFVPFHFARIPYTLSQT,1
4pxz,A,276,299,23,FYVKESTLWLTSLNACLNPFIYF,1
5syt,A,21,39,18,AVLLFSWTVYLWETFLAQ,1
5syt,A,78,96,18,FWSGLYSETEGTLILLFG,1
5syt,A,121,143,22,QSLVFLLLATLFSALTGLPWSL,1
5syt,A,168,189,21,KKFVVTQCILLPVSSLLLYII,1
5syt,A,196,215,19,FIYAWLFTLVVSLVLVTIY,1
5syt,A,347,364,17,NIIISQMNSFLCFFLFA,1
5syt,A,385,410,25,IGLLIIFQFIFSPYNEVLSFCLTVL,1
5hlb,A,70,86,16,KLAIVFAVLIAIYGVY,1
5f8u,A,43,67,24,MSLLMALVVLLIVAGNVLVIAAIG,1
5f8u,A,77,100,23,LFITSLACADLVVGLLVVPFGAT,1
5f8u,A,117,140,23,TSLDVLCVTASIETLCVIAIDRY,1
5f8u,A,157,178,21,AKVIICTVWAISALVSFLPIM,1
5f8u,A,208,232,24,IASSIISFYIPLLIMIFVALRVYR,1
5f8u,A,290,312,22,TLGIIMGVFTLCWLPFFLVNIV,1
5f8u,A,325,345,20,VAFNWLGYANSAMNPIIYCR,1
5vhy,F,11,31,20,VALNLLALLFATTAFLTTYW,1
5vhy,F,123,143,20,LWLSVVSEVLYILLLVVGFS,1
5vhy,F,166,185,19,VFTVLSGLLGMVAHMMYTQ,1
5vhy,F,206,224,18,WSFCLAWGSFTCCMAASV,1
1jfp,A,44,67,23,FLLIMLGFPINFLTLYVTVQHKK,1
1jfp,A,70,96,26,PLNYILLNLAVADLFMVFGGFTTTLY,1
1jfp,A,112,136,24,EGFFATLGGEIALWSLVVLAIERY,1
1jfp,A,153,174,21,IMGVAFTWVMALACAAPPLVG,1
1jfp,A,203,224,21,VIYMFVVHFIIPLIVIFFCYG,1
1jfp,A,250,273,23,TRMVIIMVIAFLICWLPYAGVAF,1
1jfp,A,291,309,18,AFFAKTSAVYNPVIYIMM,1
5hcm,E,199,218,19,NIILPMLFILFISWTAFWS,1
5hcm,E,222,242,20,ANVTLVVSTLIAHIAFNILV,1
5hcm,E,255,276,21,GAIIFMIYLFYFVAVIEVTVQ,1
5hcm,E,292,313,21,RASRIAFPVVFLLANIILAFL,1
5x0m,A,142,159,17,SYFIMITILIHCIFMIM,1
5x0m,A,168,185,17,ELVFLSIYTIEVVVKVL,1
5x0m,A,197,217,20,RDPWNWLDFLVTLIGYITLV,1
5x0m,A,226,242,16,RAFRVLRSWRTVTIVP,1
5x0m,A,255,279,24,TSLKDLVLLLLFSLFVFAVLGLQI,1
5x0m,A,391,415,24,HILFFIIVVFYGTFCFLNFILAVV,1
5x0m,A,522,539,17,LFIAVIIVLNITFMALD,1
5x0m,A,551,570,19,RTGNYIFTSIYIVEAVLKI,1
5x0m,A,584,602,18,VFDFIIVVFAILELGLEG,1
5x0m,A,608,624,16,FRSFRLLRVFRLAKFW,1
5x0m,A,639,660,21,AFVNVMYVMFLLLFIFAIIGM,1
5x0m,A,717,740,23,IPFFVAVFFVGNLVILNLLIALL,1
5x0m,A,861,876,15,VTAVLVITSVLLALE,1
5x0m,A,889,906,17,TLYVDYVLTAFFVIEMI,1
5x0m,A,922,945,23,YWLDFIVVVAYLLNFVLMCAGIE,1
5x0m,A,947,963,16,QTLRLLRVFRLFRPLS,1
5x0m,A,979,1002,23,PHIFNVILVGIFFWLVFAIMGVQ,1
5x0m,A,1088,1111,23,YLYFIFFIVFGSFFILKLFVCIL,1
5x0m,A,1173,1190,17,YTMMILIILNVAVMAID,1
5x0m,A,1202,1222,20,DYLNLIFIIIFFVECVIKVS,1
5x0m,A,1233,1251,18,NIIDFLYVVLAIAGLMLS,1
5x0m,A,1258,1276,18,ISPTLLRILRILRVGRLL,1
5x0m,A,1297,1320,23,TLFNVSFLLFVIMFVYAVFGMEF,1
5x0m,A,1386,1410,24,GIAYLVSYLIITCLVVINMYAAVI,1
5svl,D,24,47,23,IINRVVQLLIISYFVGWVFLHEK,1
5svl,D,316,343,27,NIIPTIISSVAAFTSVGVGTVLCDIIL,1
5d6k,A,17,37,20,LFMTEMWERFSYYGMRAILL,1
5d6k,A,56,74,18,ASIMAIYASMVYLSGTIG,1
5d6k,A,87,104,17,VFWGGVLIMLGHIVLAL,1
5d6k,A,110,130,20,LFGSIILIIIGTGFLKPNVS,1
5d6k,A,150,169,19,FVFGINLGAFIAPLIVGAA,1
5d6k,A,178,196,18,FSLAAIGMFIGLLVYYFG,1
5d6k,A,225,244,19,LAVAGFIAIIVVMNLVGWN,1
5d6k,A,246,266,20,PAYINLLTIVAIAIPVFYFA,1
5d6k,A,287,307,20,LFIAAVLFWAIEEQGSVVLA,1
5d6k,A,323,342,19,FQSLNPLFIMLYTPFFAWL,1
5d6k,A,355,371,16,KFAVGLMFAGLSFLLM,1
5d6k,A,388,405,17,LVGSWALVILGEMLISP,1
5d6k,A,425,444,19,MWFLSSSVGSALNAQLVTL,1
5d6k,A,454,472,18,SYFGLGSVVLGIVLVFLS,1
1jsq,B,25,46,21,GLIVAGVALILNAASDTFMLS,1
1jsq,B,66,80,14,MPLVVIGLMILRGI,1
1jsq,B,151,162,11,SIIGLFIMMFY,1
1jsq,B,173,186,13,LAPIVSIAIRVVS,1
1jsq,B,260,273,13,LALAFVLYAASFP,1
1jsq,B,281,295,14,GTITVVFSSMIALM,1
2ziy,A,36,57,21,LGIFIGICGIIGCGGNGIVIY,1
2ziy,A,72,94,22,IINLAFSDFTFSLVNGFPLMTI,1
2ziy,A,110,131,21,YGFIGGIFGFMSIMTMAMISI,1
2ziy,A,153,171,18,IMIIFVWLWSVLWAIGPI,1
2ziy,A,200,221,21,ILCMFILGFFGPILIIFFCYF,1
2ziy,A,264,283,19,VIVSQFLLSWSPYAVVALL,1
2ziy,A,298,316,18,LPVMFAKASAIHNPMIYS,1
3wfd,C,11,27,16,NIYFGGSVFFILLFLA,1
2mic,B,113,133,20,CSILAAVVVGLVAYIAFKRW,1
1zti,A,36,60,24,SAFIVILCCAIVVENLLVLIAVAR,1
1zti,A,68,91,23,YLFLGNLAASDLLAGVAFVANTL,1
1zti,A,107,131,24,REGSAFITLSASVFSLLAIAIERH,1
1zti,A,147,168,21,MLLLIGASWLISLVLGGLPIL,1
1zti,A,189,213,24,YVLCVVTIFSIILLAIVALYVRIY,1
1zti,A,232,255,23,KTVTIVLGVFIVCWLPAFSILLL,1
1zti,A,270,292,22,HYFFAVSTLNSLLNPVIYTWRS,1
4g7r,C,7,24,17,ALAVILVLTLTILVFWL,1
4pa9,F,135,152,17,ALLTVVFYIAAVMATNL,1
4pa9,F,195,214,19,WVFFIPFIMLTTFTVLNLF,1
4gby,A,12,32,20,ITLVATLGGLLFGYDTAVIS,1
4gby,A,59,79,20,CVASALIGCIIGGALGGYCS,1
4gby,A,85,106,21,DSLKIAAVLFFISGVGSAWPE,1
4gby,A,128,151,23,FVIYRIIGGIGVGLASMLSPMYI,1
4gby,A,162,182,20,LVSFNQFAIIFGQLLVYCVN,1
4gby,A,202,220,18,FASECIPALLFLMLLYTV,1
4gby,A,280,301,21,GVMLSIFQQFVGINVVLYYAP,1
4gby,A,318,336,18,IIVGVINLTFTVLAIMTV,1
4gby,A,342,362,20,PLQIIGALGMAIGMFSLGTA,1
4gby,A,372,396,24,LLSMLFYVAAFAMSWGPVCWVLLS,1
4gby,A,409,430,21,IAVAAQWLANYFVSWTFPMMD,1
4gby,A,443,460,17,SYWIYGCMGVLAALFMW,1
5fxh,D,557,572,15,VWVMMFVMLLIVSAV,1
5fxh,D,629,646,17,IMVSVWAFFAVIFLASY,1
5fxh,D,821,838,17,FYMLGAAMALSLITFIS,1
3nka,E,5,22,17,AAECFGTFWLVFGGCGS,1
3nka,E,38,55,17,VALAFGLTVLTMAFAVG,1
3nka,E,81,99,18,VGYVIAQVVGGIVAAALL,1
3nka,E,135,152,17,VVELVLSAGFLLVIHGA,1
3nka,E,162,177,15,PIAIGLALTLIGLIS,1
3nka,E,206,223,17,FFWVVPIVGGIIGGLIY,1
2mjo,A,10,31,21,PVYASILAAVVVGLVAYIAFK,1
4p6l,B,4,24,20,IAHALFSALFALSELYIAVR,1
4nh2,F,16,32,16,TALVLFMTIPGIALFY,1
4nh2,F,46,64,18,QVTVTFALVCILWVVYGY,1
4nh2,F,103,118,15,QGSFACITVGLIVGA,1
4nh2,F,127,144,17,VLIFVVVWLTLSYIPIA,1
4nh2,F,161,178,17,AGGTVVHINAAIAGLVG,1
4nh2,F,202,217,15,TGTAILYIGWFGFNA,1
4nh2,F,231,248,17,VNTVVATAAAILGWIFG,1
4nh2,F,261,276,15,CSGAIAGLVGVTPAC,1
4nh2,F,282,299,17,GALIIGVVAGLAGLWGV,1
4nh2,F,314,331,17,FGVHGVCGIVGCIMTGI,1
4nh2,F,356,377,21,ESIAITIVWSGVVAFIGYKLA,1
5d92,A,31,48,17,TVVGTLGVMAGALIFYP,1
5d92,A,53,66,13,WGTVVITVFVFSD,1
5d92,A,90,105,15,DRVGDSSVFTGIVIW,1
5d92,A,116,131,15,ILALICLVLSSLVSY,1
5d92,A,148,164,16,ERSERLVVVLVATGLV,1
5d92,A,173,189,16,LVVLIVLAIASVVTIF,1
2qto,D,26,48,22,RAAGAATVLLVIVLLAGSYLAV,1
2qto,D,87,111,24,GRCVAVVVMVAGITSFGLVTAALA,1
3rvz,D,2015,2033,18,KFIIYLIVLNGITMGLET,1
3rvz,D,2044,2064,20,TTLFNQIVITIFTIEIILRI,1
3rvz,D,2076,2094,18,SLFDFFVVAISLVPTSSG,1
3rvz,D,2096,2113,17,ILRVLRVLRLFRLVTAV,1
3rvz,D,2131,2151,20,SVIALMTLFFYIFAIMATQL,1
3rvz,D,2194,2214,20,WVFFIPFIFVVTFVMINLVV,1
3usg,B,14,35,21,ILAMAGNAVGLGNFLRFPVQA,1
3usg,B,42,63,21,FMIPYIIAFLLVGIPLMWIEW,1
3usg,B,89,124,35,AKILGVFGLWIPLVVAIYYVYIESWTLGFAIKFLV,1
3usg,B,167,185,18,AYIVFLITMFINVSILIR,1
3usg,B,191,214,23,ERFAKIAMPTLFILAVFLVIRVF,1
3usg,B,242,265,23,VWIAAVGQIFFTLSLGFGAIITY,1
3usg,B,278,298,20,GLTAATLNEKAEVILGGSIS,1
3usg,B,340,367,27,GFLWFFLLFFAGLTSSIAIMQPMIAFL,1
3usg,B,377,396,19,AVLWTAAIVFFSAHLVMFL,1
3usg,B,400,425,25,DEMDFWAGTIGVVFFGLTELIIFFW,1
3usg,B,445,472,27,RIYYYVMRYITPAFLAVLLVVWAREYI,1
3usg,B,484,502,18,ITRFYIIGLFLFLTFLVF,1
1oco,Z,16,36,20,IGLSVTFLSFLLPAGWVLYH,1
4uqq,D,521,535,14,FSFLNPLSPDIWMY,1
4uqq,D,612,629,17,TLIIISSYTANLAAFLT,1
4uqq,D,787,794,7,NIGGIFI,1
7prc,H,13,30,17,QLVWYAQWLVIWTVVLL,1
5jag,A,14,35,21,ILAMAGNAVGLGNFLRFPVQA,1
5jag,A,39,63,24,GGAFMIPYIIAFLLVGIPLMWIEW,1
5jag,A,89,120,31,AKILGVFGLWIPLVVAIYYVYIESWTLGFAI,1
5jag,A,168,185,17,YIVFLITMFINVSILIR,1
5jag,A,191,214,23,ERFAKIAMPTLFILAVFLVIRVF,1
5jag,A,239,257,18,DPGVWIAAVGQIFFTLSL,1
5jag,A,280,298,18,TAATLNEKAEVILGGSIS,1
5jag,A,340,367,27,GFLWFFLLFFAGLHSSIAIMQPMIAFL,1
5jag,A,377,394,17,AVLWTAAIVFFSAHLVM,1
5jag,A,400,425,25,DEMDFWAGTIGVVFFGLTELIIFFW,1
5jag,A,448,469,21,YYVMRYITPAFLAVLLVVWAR,1
5jag,A,485,503,18,TRFYIIGLFLFLTFLVFL,1
3usp,B,13,31,18,LILAMAGNAVGLGNFLRF,1
3usp,B,45,63,18,PYIIAFLLVGIPLMWIEW,1
3usp,B,89,120,31,AKILGVFGLWIPLVVAIYYVYIESWTLGFAI,1
3usp,B,168,185,17,YIVFLITMFINVSILIR,1
3usp,B,191,211,20,ERFAKIAMPTLFILAVFLVI,1
3usp,B,245,266,21,AAVGQIFFTLSLGFGAIITYA,1
3usp,B,277,296,19,SGLTAATLNEKAEVILGGS,1
3usp,B,343,367,24,WFFLLFFAGLTSSIAIMQPMIAFL,1
3usp,B,378,394,16,VLWTAAIVFFSAHLVM,1
3usp,B,403,426,23,DFWAGTIGVVFFGLTELIIFFWI,1
3usp,B,445,468,23,RIYYYVMRYITPAFLAVLLVVWA,1
3usp,B,485,502,17,TRFYIIGLFLFLTFLVF,1
2m3g,C,7,26,19,HWIYVAGMTIGALHFWSLS,1
2m3g,C,38,55,17,VAMFIPIWSGLAYMAMA,1
2m3g,C,70,87,17,ARYIDWMVTTPLLLLSL,1
2m3g,C,104,122,18,LMSTQIVVITSGLIADLS,1
2m3g,C,128,147,19,YLWYICGVCAFLIILWGIW,1
2m3g,C,169,189,20,TYFTVLWIGYPIVWIIGPSG,1
2m3g,C,198,217,19,TFLFCLLPFFSKVGFSFLD,1
4wib,B,278,303,25,VALWLARVRWLVILILTGMVTSSIL,1
4wib,B,318,338,20,YVPVLLGTGGNTGNQSATLI,1
4wib,B,353,381,28,RVFLKEMGVGLLLGLTLSFLLVGKVYWD,1
4wib,B,388,412,24,VVGVSLVLIVFFANLVGAMLPFLL,1
4wib,B,420,442,22,LVSNPLVATLSDVTGLLIYLSV,1
3q17,B,33,54,21,AAIVVGLITGVLGAGFKSAVN,1
3q17,B,77,92,15,TALISGGMVALSFWL,1
3q17,B,125,138,13,IKLVGGFLSLGAG,1
3q17,B,140,152,12,AGFEGPTIQMGG,1
3q17,B,211,227,16,SLLFGCVMATIILRMI,1
3q17,B,248,268,20,MFIILGILFGVMGYTFNRGL,1
3q17,B,285,297,12,KGFLLGSIIGIL,1
3q17,B,330,343,13,GRFLLTLICYGSG,1
3q17,B,345,357,12,GGIFAPMLGIAS,1
3q17,B,415,431,16,PLLVTCLVASVVAEAL,1
4o9p,B,4,20,16,QAAYFVVAILFIVGLK,1
4o9p,B,33,47,14,WAGWGMVLAVLATF,1
4o9p,B,58,73,15,LLALLLGSVVAWWAA,1
4o9p,B,86,101,15,IYNGMGGGAAATIAA,1
4o9p,B,117,137,20,AILGGLIGSVAFTGSLIAFA,1
4o9p,B,151,169,18,GQKAVNALVLALTVVIGL,1
4o9p,B,182,196,14,FFLLALLFGVLMTL,1
4o9p,B,210,224,14,NAFTGMAVGFEGFA,1
4o9p,B,228,242,14,ALMVAGTLVGAAGT,1
5kk2,H,11,29,18,LTTVGAFAAFSLMTIAVG,1
5kk2,H,101,121,20,RASSIFPILSVILLFMGGLC,1
5kk2,H,137,155,18,AGIFFVSAGLSNIIGIIV,1
5kk2,H,178,196,18,SFYFGALSFIIAEMVGVL,1
4jr8,C,9,31,22,WLWLGTAGMFLGMLYFIARGWG,1
4jr8,C,39,60,21,FYIATILITAIAFVNYLAMAL,1
4jr8,C,78,98,20,ARYSDWLFTTPLLLYDLGLL,1
4jr8,C,104,126,22,TISSLVSLDVLMIGTGLVATLS,1
4jr8,C,138,160,22,LVWWGISTAFLLVLLYFLFSSL,1
4jr8,C,175,196,21,KTLRNLVTVVWLVYPVWWLVG,1
4jr8,C,208,229,21,TAGFMVIDLVAKVGFGIILLR,1
2b76,P,13,38,25,WGLFGAGGMWSAIIAPVMILLVGIL,1
2b76,P,62,86,24,GRVFLFLMIVLPLWCGLHRMHHAM,1
2b76,P,94,116,22,AGKWVFYGLAAILTVVTLIGVV,1
4xni,A,16,37,21,TLFMTEMWERFSYYGMRAILL,1
4xni,A,56,75,19,ASIMAIYASMVYLSGTIGG,1
4xni,A,86,104,18,AVFWGGVLIMLGHIVLAL,1
4xni,A,110,130,20,LFGSIILIIIGTGFLKPNVS,1
4xni,A,149,167,18,IFVFGINLGAFIAPLIVG,1
4xni,A,178,198,20,FSLAAIGMFIGLLVYYFGGK,1
4xni,A,224,244,20,SLAVAGFIAIIVVMNLVGWN,1
4xni,A,246,265,19,PAYINLLTIVAIAIPVFYF,1
4xni,A,286,307,21,PLFIAAVLFWAIEEQGSVVLA,1
4xni,A,323,343,20,FQSLNPLFIMLYTPFFAWLW,1
4xni,A,354,372,18,TKFAVGLMFAGLSFLLMA,1
4xni,A,388,408,20,LVGSWALVILGEMLISPVGL,1
4xni,A,425,445,20,MWFLSSSVGSALNAQLVTLY,1
4xni,A,453,472,19,FSYFGLGSVVLGIVLVFLS,1
3qf4,B,33,57,24,PHTFTLIMVFVFVTVSSILGVLSP,1
3qf4,B,85,107,22,IYALTSLLFWLQGKIMLTLSQD,1
3qf4,B,150,173,23,LGNSIIQFFSGIVTLAGAVIMMF,1
3qf4,B,178,201,23,LSLVTLSIVPLTVLITQIVSSQT,1
3qf4,B,258,278,20,FSGVLPPLMNMVNNLGFALI,1
3qf4,B,299,320,21,IGYSRQFTRPLNELSNQFNMI,1
4x88,F,132,153,21,SVAALLTVVFYIAAVMATNLY,1
4x88,F,194,218,24,AWVFFIPFIMLTTFTVLNLFIGII,1
3f3d,B,13,32,19,LILAMAGNAVGLGNFLRFP,1
3f3d,B,44,63,19,IPYIIAFLLVGIPLMWIEW,1
3f3d,B,89,124,35,AKILGVFGLWIPLVVAIYYVYIESWTLGFAIKFLV,1
3f3d,B,167,185,18,AYIVFLITMFINVSILIR,1
3f3d,B,191,212,21,ERFAKIAMPTLFILAVFLVIR,1
3f3d,B,244,266,22,IAAVGQIFFTLSLGFGAIITYA,1
3f3d,B,277,297,20,SGLTAATLNEKAEVILGGSI,1
3f3d,B,340,367,27,GFLWFFLLFFAGLTSSIAIMQPMIAFL,1
3f3d,B,378,396,18,VLWTAAIVFFSAHLVMFL,1
3f3d,B,400,426,26,DEMDFWAGTIGVVFFGLTELIIFFWI,1
3f3d,B,445,469,24,RIYYYVMRYITPAFLAVLLVVWAR,1
3f3d,B,484,502,18,ITRFYIIGLFLFLTFLVF,1
2lot,A,33,56,23,IYMLVFLLGTTGNGLVLWTVFRK,1
3oma,B,61,81,20,LVIIAAITIFVTLLILYAVW,1
3oma,B,99,117,18,LEIAWTIVPIVILVAIGA,1
5b6z,C,12,28,16,LALGTALMGLGTLYFL,1
5b6z,C,47,61,14,LVPAIAFTMYLSML,1
5b6z,C,80,94,14,ARYADWLFTTPLLL,1
5b6z,C,111,126,15,VGADGIMIGTGLVGA,1
5b6z,C,135,150,15,VWWAISTAAMLYILY,1
5b6z,C,178,192,14,VVLWSAYPVVWLIG,1
5b6z,C,204,220,16,TLLFMVLDVSAKVGFG,1
3abv,D,41,61,20,HWTGERVVSVLLLGLLPAAY,1
3abv,D,69,92,23,YSLAAALTLHGHWGIGQVVTDYV,1
3abv,D,97,118,21,QKAAKAGLLALSAFTFAGLCY,1
2b6s,A,36,63,27,DFLWPILVVEFLVAVASNGLALYRFSI,1
2b6s,A,75,99,24,SVQLAVSDLLCALTLPPLAAYLYP,1
2b6s,A,108,132,24,ACRLERFLFTCNLLGSVIFITCIS,1
2b6s,A,156,177,21,VSAAGWVLAALLAMPTLSFSH,1
2b6s,A,208,234,26,AYRAYSLVLAGLGCGLPLLLTLAAYG,1
2b6s,A,258,282,24,ASGVALYASSYVPYHIMRVLNVDA,1
2b6s,A,308,331,23,VGYQVMRGLMPLAFCVHPLLYMA,1
5wud,C,9,25,16,DIFNYIGIVAFAISGA,1
5wud,C,36,57,21,GVLVLGFSTALGGGIISNLLL,1
5wud,C,63,83,20,NLIYYPYPITAFLASLATFV,1
5wud,C,97,114,17,ADAIGLGAFASSGASLA,1
5wud,C,122,142,20,LVVIVGAITAVGGGVIRDIL,1
5wud,C,154,169,15,YATTAVIGSFVYFIA,1
5wud,C,178,193,15,ALIVSFLITLILRIL,1
3cwb,W,19,40,21,FALTVVLGAVLFERAFDQGAD,1
5uld,B,19,35,16,RNSLIVLADVALFLAL,1
5uld,B,51,64,13,LAFIAVLWLTEAL,1
5uld,B,66,76,10,TVTAILVPVM,1
5uld,B,90,110,20,NFANSIIFLFLGGFALAAAM,1
5uld,B,188,209,21,ASIGGIATLVGTGPNAIAAAE,1
5uld,B,213,235,22,FTDWMKFGLPTAMMMLPMAIAI,1
5uld,B,261,278,17,VVTLGIFGLTVFLWIFS,1
5uld,B,291,309,18,DTLVALGAILMLSFARVV,1
5uld,B,311,332,21,KEIQKTADWGILLLFGGGLCL,1
5uld,B,360,376,16,VILVVATFVVFLTEFT,1
5uld,B,378,389,11,VATTTLLIPVF,1
5uld,B,403,417,14,SVLIAVAASCAFML,1
5uld,B,440,460,20,VGLYLNIACIGLLTAIAMLF,1
2eij,Z,13,34,21,EQAIGLSVTFLSFLLPAGWVL,1
4twf,E,211,225,14,LGLIIAASWSVFWL,1
4twf,E,230,245,15,RLQTSFTLMLTVVAY,1
4twf,E,266,282,16,IAGYGSIFAAILLIIF,1
4twf,E,298,315,17,RCRLAFPLGFLAIGCVL,1
3qjv,C,7,27,20,ALAVILVLTLTILVFWLGVY,1
2yxr,C,33,50,17,IGVTVAFVIIEAILTYG,1
4qid,A,17,39,22,IWLALGTIGMLLGMLYFIADGL,1
4qid,A,49,73,24,YVITILIPAIAAASYLSMFFGFGL,1
4qid,A,87,109,22,WARYADWLFTTPLLLLDIGLLA,1
4qid,A,114,136,22,DIGALVGIDAFMIVTGLVATLT,1
4qid,A,142,165,23,YAFWTISTISMVFLLYYLVAVFG,1
4qid,A,178,200,22,FNALRNIILVTWAIYPVAWLVG,1
4qid,A,211,233,22,ETLLFMVLDLVAKVGFGFILLR,1
3vmt,A,45,59,14,ILLTILIIIALFIG,1
4hfi,E,199,218,19,NIILPMLFILFISWTAFWS,1
4hfi,E,222,240,18,ANVTLVVSTLIAHIAFNI,1
4hfi,E,256,275,19,AIIFMIYLFYFVAVIEVTV,1
4hfi,E,293,313,20,ASRIAFPVVFLLANIILAFL,1
2n90,B,112,134,22,AVGLAVFACLFLSTLLLVLNKA,1
5nl2,B,335,350,15,GAYTQMLIPASIVGV,1
5nl2,B,413,427,14,VFMALWAATFMEHW,1
5nl2,B,487,504,17,PAYFTNLVSIIFMIAVT,1
5nl2,B,547,564,17,VVIILLDEVYGCIARWL,1
5nl2,B,579,594,15,LTFKAFLLKFVNSYT,1
5nl2,B,639,657,18,IIMLGKQLIQNNLFEIGI,1
5nl2,B,701,717,16,EYMEMIIQFGFVTLFV,1
5nl2,B,721,735,14,LAPLFALLNNIIEI,1
5nl2,B,759,773,14,WYNILRGVGKLAVI,1
5nl2,B,875,885,10,MFMSDFVDWV,1
4cbj,M,5,18,13,AAIAAGLAAVAGA,1
4cbj,M,55,68,13,VPIIAIVISLLIL,1
2gfp,A,12,32,20,LVLLVAVGQMAQTIYIPAIA,1
2gfp,A,43,59,16,AVQSVMGAYLLTYGVS,1
2gfp,A,72,88,16,RPVILVGMSIFMLATL,1
2gfp,A,99,115,16,IAASAMQGMGTGVGGV,1
2gfp,A,137,153,16,NMGILVSPLLAPLIGG,1
2gfp,A,158,177,19,WNWRACYLFLLVLCAGVTF,1
2gfp,A,215,231,16,LIGGLAGIAAFEACSG,1
2gfp,A,238,255,17,GLSSMTVSILFILPIPA,1
2gfp,A,272,288,16,LMWQSVICCLLAGLLM,1
2gfp,A,290,304,14,PDWFGVMNVWTLLV,1
2gfp,A,332,349,17,GTAGALVGGLQNIGSGV,1
2gfp,A,355,370,15,MLPQTGQGSLGLLMT,1
4xu5,C,9,26,17,VLFLLGAVAALIGDHSH,1
4xu5,C,41,61,20,VWSSPFWFPILVGAATASLA,1
4xu5,C,80,97,17,GGVAAVVGTYVTTALVH,1
4xu5,C,102,118,16,PVTALVCAAAAITWCV,1
4xu5,C,125,142,17,ACGVVIAVIGPAVEIAL,1
4xu5,C,161,176,15,PFLAPLYFAFGVVAA,1
5bz2,B,7,27,20,LEIFYLLLAAQVMAFIFKRL,1
5bz2,B,29,42,13,PCVIGEVLAGVLV,1
5bz2,B,59,75,16,AELGAVFLLFMVGLET,1
5bz2,B,85,102,17,EAFLVAVLGVALPFLGG,1
5bz2,B,121,134,13,ALVATSVGCTARV,1
5bz2,B,149,165,16,LGAAVIDDVLGLIVLA,1
5bz2,B,185,202,17,VLSVVFVGLAVFLSTLI,1
5bz2,B,210,233,23,PVGSPLGFALALGVGMAALAASI,1
5bz2,B,236,249,13,PIVGAFLGGMLLS,1
5bz2,B,258,277,19,EPIFAIESFLAPIFFAMVG,1
5bz2,B,295,314,19,VVTVIAILGKVLGGFLGAL,1
5bz2,B,322,340,18,TVGVGMAPRGEVGLIVAA,1
5bz2,B,357,372,15,FMVVFTTLFAPFALK,1
5g2a,A,16,38,22,FIDHLLTMGVGVHFAALIFFLV,1
5g2a,A,51,74,23,ALSCIVMVSAGLILNSQAVMWTD,1
5g2a,A,91,111,20,NGYRYVNWMATIPCLLLQLL,1
5g2a,A,123,146,23,TATWLILAAWGMIITGYVGQLYE,1
5g2a,A,153,176,23,MIWGAVSTAFFVVMNWIVGTKIF,1
5g2a,A,190,213,23,TKVFWLMMFAWTLYPIAYLVPAF,1
5g2a,A,220,243,23,VLRQLLFTIADISSKVIYGLMIT,1
4xwk,A,35,68,33,LTMFRYAGWLDRLYMLVGTLAAIIHGVALPLMM,1
4xwk,A,118,140,22,AGVLIVAYIQVSFWCLAAGRQI,1
4xwk,A,180,204,24,GIGDKIGMFFQAMATFFGGFIIGF,1
4xwk,A,209,229,20,LTLVILAISPVLGLSAGIWA,1
4xwk,A,290,313,23,ANISMGAAFLLIYASYALAFWYG,1
4xwk,A,329,352,23,VFFSVLIGAFSVGQASPNIEAFA,1
4xwk,A,706,729,23,FVVGIFCAIINGGLQPAFSVIFS,1
4xwk,A,751,773,22,SLLFLILGIISFITFFLQGFTF,1
4xwk,A,828,848,20,LAVIFQNIANLGTGIIISLI,1
4xwk,A,854,879,25,LLLLAIVPIIAIAGVVEMKMLSGQA,1
4xwk,A,925,952,27,NAMKKAHVFGITFSFTQAMMYFSYAAC,1
4xwk,A,972,991,19,VFSAIVFGAMAVGQVSSFA,1
2i35,A,40,64,24,AYMFLLIMLGFPINFLTLYVTVQH,1
2i35,A,72,96,24,YILLNLAVADLFMVFGGFTTTLYT,1
2i35,A,112,136,24,GFFATLGGEIALWSLVVLAIERYV,1
2i35,A,152,176,24,IMGVAFTWVMALACAAPPLVGWSR,1
2i35,A,203,228,25,IYMFVVHFIIPLIVIFFCYGQLVFT,1
2i35,A,251,274,23,MVIIMVIAFLICWLPYAGVAFYI,1
2i35,A,289,310,21,PAFFAKTSAVYNPVIYIMMNK,1
2ycx,A,42,63,21,GMSLLMALVVLLIVAGNVLVI,1
2ycx,A,81,103,22,SLACADLVVGLLVVPFGATLVV,1
2ycx,A,108,136,28,WGSFLCELWTSLDVLCVTASIETLCVIA,1
2ycx,A,163,183,20,TVWAISALVSFLPIMMHWWR,1
2ycx,A,200,228,28,FVTNRAYAIASSIISFYIPLLIMIFVAL,1
2ycx,A,292,315,23,GIIMGVFTLCWLPFFLVNIVNVF,1
2ycx,A,324,345,21,FVAFNWLGYANSAMNPIIYCR,1
3t9n,G,17,47,30,VKFLLDVLKILIIAFIGIKFADFLIYRFYK,1
3t9n,G,69,88,19,NAVRYIIYFLAGASILKLF,1
3t9n,G,90,101,11,DMTSLLAVAGI,1
4tll,D,552,568,16,VMMFVMLLIVSAVAVF,1
4tll,D,612,630,18,IMVSVWAFFAVIFLASYT,1
4tll,D,806,825,19,MLAAAMALSLITFIMEHLF,1
3fpb,A,58,73,15,DLLVRILLLAACISF,1
3fpb,A,89,107,18,EPFVILLILIANAIVGVW,1
3fpb,A,254,274,20,EFGEQLSKVISLICVAVWLI,1
3fpb,A,296,317,21,KIAVALAVAAIPEGLPAVITT,1
3fpb,A,760,780,20,IRYLISSNVGEVVCIFLTAA,1
3fpb,A,787,807,20,IPVQLLWVNLVTDGLPATAL,1
3fpb,A,832,852,20,LFFRYMAIGGYVGAATVGAA,1
3fpb,A,898,916,18,MALSVLVTIEMCNALNSL,1
3fpb,A,931,950,19,WLLGSICLSMSLHFLILYV,1
3fpb,A,965,987,22,QWLMVLKISLPVIGLDEILKFI,1
1ldi,D,11,28,17,IAEFLGTGLLIFFGVGC,1
1ldi,D,43,60,17,ISVIWGLGVAMAIYLTA,1
1ldi,D,86,104,18,IPFIVSQVAGAFCAAALV,1
1ldi,D,149,167,18,AVEMVITAILMGLILALT,1
1ldi,D,179,195,16,PLLIGLLIAVIGASMG,1
1ldi,D,234,255,21,VPLFGPIVGAIVGAFAYRKLI,1
2wlo,B,48,70,22,FITLITGLYLVTNALFALAYLA,1
2wlo,B,109,129,20,NTLVTLEALCGMLGLAVAAS,1
2i21,C,11,28,17,WLALGTALMGLGTLYFL,1
2i21,C,47,62,15,LVPAIAFTMYLSMLL,1
2i21,C,80,94,14,ARYADWLFTTPLLL,1
2i21,C,111,127,16,VGADGIMIGTGLVGAL,1
2i21,C,134,150,16,FVWWAISTAAMLYILY,1
2i21,C,178,192,14,VVLWSAYPVVWLIG,1
2i21,C,203,220,17,ETLLFMVLDVSAKVGFG,1
4qry,C,37,57,20,LYINIALAGLSILLFVFMTR,1
4qry,C,66,86,20,IAVSTILVPVVSIASYTGLA,1
4qry,C,121,141,20,GRYLTWALSTPMILLALGLL,1
4qry,C,147,168,21,KLFTAITFDIAMCVTGLAAAL,1
4qry,C,176,199,23,WFWYAISCACFIVVLYILLVEWA,1
4qry,C,211,232,21,STLKLLTVVMWLGYPIVWALG,1
4qry,C,244,268,24,SWAYSALDIVAKYIFAFLLLNYLT,1
4c9j,A,14,34,20,NFLMGGVSAAIAKTAASPIE,1
4c9j,A,79,97,18,TANVIRYFPTQALNFAFK,1
4c9j,A,120,142,22,ASGGAAGALSLLFVYSLDFART,1
4c9j,A,179,200,21,RGFMPSVVGIVVYRGLYFGMF,1
4c9j,A,221,242,21,LGWVVTTGASTCSYPLDTVRR,1
4c9j,A,277,302,25,GANILRSVAGAGVISMYDQLQMILF,1
3m71,C,12,27,15,YFGIPLGLAALSLAW,1
3m71,C,41,61,20,DVLGIVASAVWILFILMYAY,1
3m71,C,82,97,15,IALIPITTMLVGDIL,1
3m71,C,105,125,20,EVLIWIGTIGQLLFSTLRVS,1
3m71,C,141,154,13,FYLPAVAANFTSA,1
3m71,C,167,185,18,LFFGAGMIAWIIFEPVLL,1
3m71,C,201,215,14,GIVLAPAFVCVSAY,1
3m71,C,227,245,18,KILWGYGFLQLFFLLRLF,1
3m71,C,256,271,15,LWAFSFGLASMANSA,1
3m71,C,284,307,23,IFAFVFSNVMIGLLVLMTIYKLT,1
3qs5,B,13,32,19,LILAMAGNAVGLGNFLRFP,1
3qs5,B,44,63,19,IPYIIAFLLVGIPLMWIEW,1
3qs5,B,89,124,35,AKILGVFGLWIPLVVAIYYVYIESWTLGFAIKFLV,1
3qs5,B,167,185,18,AYIVFLITMFINVSILIR,1
3qs5,B,191,212,21,ERFAKIAMPTLFILAVFLVIR,1
3qs5,B,242,266,24,VWIAAVGQIFFTLSLGFGAIITYA,1
3qs5,B,277,298,21,SGLTAATLNEKAEVILGGSIS,1
3qs5,B,340,367,27,GFLWFFLLFFAGLTSSIAQMQPMIAFL,1
3qs5,B,377,396,19,AVLWTAAIVFFSAHLVMFL,1
3qs5,B,400,426,26,DEMDFWAGTIGVVFFGLTELIIFFWI,1
3qs5,B,445,469,24,RIYYYVMRYITPAFLAVLLVVWAR,1
3qs5,B,484,502,18,ITRFYIIGLFLFLTFLVF,1
3cn6,E,41,58,17,IAEFIATLLFLYITVAT,1
3cn6,E,76,93,17,IAWAFGGMIFVLVYCTA,1
3cn6,E,119,137,18,LVYMIAQCLGAICGVGLV,1
3cn6,E,163,182,19,ALGAEIIGTFVLVYTVFSA,1
3cn6,E,198,214,16,PLPIGFAVFMVHLATI,1
3cn6,E,243,260,17,IFWVGPFIGAAVAAAYH,1
2lz4,B,8,30,22,IGLMVGGVVIATMIVITLVMLK,1
1kb9,I,17,32,15,VGTIFAGAFVFQTVF,1
3qs4,B,13,32,19,LILAMAGNAVGLGNFLRFP,1
3qs4,B,42,63,21,FMIPYIIAFLLVGIPLMWIEW,1
3qs4,B,89,124,35,AKILGVFGLWIPLVVAIYYVYIESWTLGFAIKFLV,1
3qs4,B,167,184,17,AYIVFLITMFINVSILI,1
3qs4,B,191,212,21,ERFAKIAMPTLFILAVFLVIR,1
3qs4,B,244,265,21,IAAVGQIFFTLSLGVGAIITY,1
3qs4,B,278,297,19,GLTAATLNEKAEVILGGSI,1
3qs4,B,340,366,26,GFLWFFLLFFAGLTSSIAIMQPMIAF,1
3qs4,B,378,396,18,VLWTAAIVFFSAHLVMFL,1
3qs4,B,400,426,26,DEMDFWAGTIGVVFFGLTELIIFFWI,1
3qs4,B,445,469,24,RIYYYVMRYITPAFLAVLLVVWAR,1
3qs4,B,484,502,18,ITRFYIIGLFLFLTFLVF,1
1kby,H,15,32,17,AIYSFWIFLAGLIYYLQ,1
3tls,E,199,218,19,NIILPMLFILFISWTAFWS,1
3tls,E,222,241,19,ANVTLVVSTLIAHIAFNIL,1
3tls,E,256,275,19,AIIFMIYLFYFVAVIEVTV,1
3tls,E,292,313,21,RASRIAFPVVFLLANIILAFL,1
4mbs,A,33,57,24,PPLYSLVFIFGFVGNMLVILILIN,1
4mbs,A,65,88,23,DIYLLNLAISDLFFLLTVPFWAH,1
4mbs,A,100,127,27,CQLLTGLYFIGFFSGIFFIILLTIDRY,1
4mbs,A,143,165,22,FGVVTSVITWVVAVFASLPNII,1
4mbs,A,193,216,23,QTLKIVILGLVLPLLVMVICYSG,1
4mbs,A,235,261,26,LIFTIMIVYFLFWAPYNIVLLLNTFQ,1
4mbs,A,279,301,22,QVTETLGMTHCCINPIIYAFVG,1
2i20,C,11,34,23,WLALGTALMGLGTLYFLVKGMGV,1
2i20,C,41,62,21,FYAITTLVPAIAFTMYLSMLL,1
2i20,C,80,100,20,ARYADWLFTTPLLLLALALL,1
2i20,C,106,127,21,TILALVGADGIMIGTGLVGAL,1
2i20,C,134,156,22,FVWWAISTAAMLYILYVLFFGF,1
2i20,C,171,192,21,KVLRNVTVVLWSAYPVVWLIG,1
2i20,C,204,226,22,TLLFMVLDVSAKVGFGLILLRS,1
2wln,D,46,71,25,PVFITLITGLYLVTNALFALAYLAC,1
2wln,D,108,132,24,ANTLVTLEALCGMLGLAVAASLIY,1
2ycy,A,41,63,22,AGMSLLMALVVLLIVAGNVLVI,1
2ycy,A,82,103,21,LACADLVVGLLVVPFGATLVV,1
2ycy,A,113,133,20,CELWTSLDVLCVTASIETLC,1
2ycy,A,164,183,19,VWAISALVSFLPIMMHWWR,1
2ycy,A,200,224,24,FVTNRAYAIASSIISFYIPLLIMI,1
2ycy,A,295,317,22,MGVFTLCWLPFFLVNIVNVFNR,1
2ycy,A,320,342,22,PDWLFVAFNWLGYANSAMNPII,1
2n5s,A,44,66,22,SIATGMVGALLLLLVVALGIGL,1
4tlm,D,552,568,16,VMMFVMLLIVSAVAVF,1
4tlm,D,611,627,16,KIMVSVWAFFAVIFLA,1
4tlm,D,806,825,19,MLAAAMALSLITFIMEHLF,1
2w8a,C,61,76,15,VIVPALVIVLATVVW,1
2w8a,C,99,116,17,GWAFILFGTVFVFFIVV,1
2w8a,C,143,158,15,MMFAAGMGIGLMFYG,1
2w8a,C,183,201,18,TTMFHWTLHPWAIYAIVG,1
2w8a,C,237,258,21,IDILAIIATVFGTACSLGLGA,1
2w8a,C,284,299,15,VLTLAFIFSAISGVG,1
2w8a,C,301,322,21,IQYLSNANMVLAALLAIFVFV,1
2w8a,C,368,385,17,FYWAWWISWSPFVGMFL,1
2w8a,C,399,416,17,GVLLVPAGVSTVWFSIF,1
2w8a,C,456,477,21,AMILLGTFFITSADSASTVMG,1
2w8a,C,490,506,16,VTAAWGVATAAIGLTL,1
2w8a,C,519,538,19,NVTIVAATPFLFVVIGLMF,1
3ouf,E,25,45,20,VLFVLTILTLISGTIFYSTV,1
3ouf,E,75,99,24,GKIFTILYIFIGIGLVFGFIHKLA,1
2now,C,15,32,17,CTALVLFMTIPGIALFY,1
2now,C,46,64,18,QVTVTFALVCILWVVYGY,1
2now,C,102,118,16,FQGSFACITVGLIVGA,1
2now,C,127,147,20,VLIFVVVWLTLSYIPIAHMV,1
2now,C,161,178,17,AGGTVVEINAAIAGLVG,1
2now,C,202,219,17,TGTAILYIGWFGFNAGS,1
2now,C,231,248,17,VNTVVATAAAILGWIFG,1
2now,C,261,276,15,CSGAIAGLVGVTPAC,1
2now,C,282,299,17,GALIIGVVAGLAGLWGV,1
2now,C,314,332,18,FGVHGVCGIVGCIMTGIF,1
2now,C,353,377,24,VQLESIAITIVWSGVVAFIGYKLA,1
5bz3,B,4,24,20,EHLLEIFYLLLAAQVCAFIF,1
5bz3,B,30,46,16,VVIGEVLAGVLVGPAL,1
5bz3,B,48,72,24,LVHEGEILEFLAELGAVFLLFMVG,1
5bz3,B,85,106,21,EAFLVAVLGVALPFLGGYLYG,1
5bz3,B,118,134,16,LGTALVATSVGITARV,1
5bz3,B,149,167,18,LGAAVIDDVLGLIVLACV,1
5bz3,B,179,198,19,AITRLIVLSVVFVGLAVFL,1
5bz3,B,218,233,15,ALALGVGMAALAASI,1
5bz3,B,235,245,10,APIVGAFLGG,1
5bz3,B,265,285,20,SFLAPIFFAMVGVRLELSAL,1
5bz3,B,291,313,22,VAGTVVTVIAILGKVLGGFLGA,1
5bz3,B,322,339,17,TVGCGMAPRGEVGLIVA,1
5bz3,B,355,372,17,VLFMVVFTTLFAPFALK,1
1k9n,E,40,49,9,CLLLICIIV,1
4xu4,C,9,26,17,VLFLLGAVAALIGDHSH,1
4xu4,C,41,61,20,VWSSPFWFPILVGAATASLA,1
4xu4,C,80,97,17,GGVAAVVGTYVTTALVH,1
4xu4,C,102,118,16,PVTALVCAAAAITWCV,1
4xu4,C,125,142,17,ACGVVIAVIGPAVEIAL,1
4xu4,C,161,176,15,PFLAPLYFAFGVVAA,1
2kpf,A,73,95,22,TLIIFGVMAGVIGTILLISYGI,1
4ayt,B,168,189,21,RRLAAAVGFLTMSSVISMSAP,1
4ayt,B,219,239,20,AVFLCGAAANAIRVYLMQTS,1
4ayt,B,286,308,22,TENLSDGLRAGAQASVGISMMF,1
4ayt,B,316,337,21,FVLSVVPPVSIIAVIYGRYLR,1
4ayt,B,392,413,21,FARAGFFGATGLSGNLIVLSV,1
4ayt,B,435,455,20,MYAFWVGISIGGLSSFYSEL,1
4cbk,M,5,17,12,AAIAAGLAAVAG,1
4cbk,M,55,68,13,VPIIAIVISLLIL,1
3d31,D,17,39,22,FSFLLLVLFLFIFLTLSNMIFE,1
3d31,D,62,83,21,LSLYAGFLATLLALLLGAPTG,1
3d31,D,96,116,20,VESIIDVPVVVPHTVAGIAL,1
3d31,D,141,159,18,GIVVAMLFVSMPYLANSA,1
3d31,D,198,215,17,IGSVMTWARAISEFGAV,1
3d31,D,246,260,14,LLILVTLSIFLVIR,1
3hpl,F,30,50,20,AATVLLVIVLLAGSYLAVLA,1
3hpl,F,87,107,20,GRCVAVVVMVAGITSAGLVT,1
2boz,M,53,72,19,SLGVLSLFSGLMWFFTIGI,1
2boz,M,118,134,16,SFFMFVAVWSWWGRTY,1
2boz,M,145,163,18,TAWAFLSAIWLWMVLGFI,1
2boz,M,201,221,20,HLLSIAFLYGSALLFAMHGA,1
2boz,M,268,285,17,AIWMAVLVTLTGGIGIL,1
4hfh,E,199,218,19,NIILPMLFILFISWTAFWS,1
4hfh,E,222,240,18,ANVTLVVSTLIAHIAFNI,1
4hfh,E,256,275,19,AIIFMIYLFYFVAVIEVTV,1
4hfh,E,293,313,20,ASRIAFPVVFLLANIILAFL,1
3tu0,B,13,32,19,LILAMAGNAVGLGNFLRFP,1
3tu0,B,44,63,19,IPYIIAFLLVGIPLMWIEW,1
3tu0,B,89,124,35,AKILGVFGLWIPLVVAIYYVYIESWTLGFAIKFLV,1
3tu0,B,167,184,17,AYIVFLITMFINVSILI,1
3tu0,B,191,212,21,ERFAKIAMPTLFILAVFLVIR,1
3tu0,B,244,265,21,IAAVGQIFFTLSLGFGAIITY,1
3tu0,B,278,297,19,GLTAATLNEAAEVILGGSI,1
3tu0,B,340,367,27,GFLWFFLLFFAGLVASIAIMQPMIAFL,1
3tu0,B,378,396,18,VLWTAAIVFFSAHLVMFL,1
3tu0,B,400,426,26,DEMDFWAGTIGVVFFGLTELIIFFWI,1
3tu0,B,445,469,24,RIYYYVMRYITPAFLAVLLVVWAR,1
3tu0,B,484,502,18,ITRFYIIGLFLFLTFLVF,1
2eik,Z,21,35,14,TFLSFLLPAGWVLY,1
2kdc,C,34,51,17,GVAVLLAVVIACWLDVD,1
2kdc,C,53,66,13,TRVLLISSVMLVM,1
2kdc,C,100,119,19,VLIAIIVAVITWCILLWSH,1
5ule,B,22,35,13,LIVLADVALFLAL,1
5ule,B,51,64,13,LAFIAVLWLTEAL,1
5ule,B,66,76,10,TVTAILVPVM,1
5ule,B,90,106,16,NFANSIIFLFLGGFAL,1
5ule,B,191,209,18,GGIATLVGTGPNAIAAAE,1
5ule,B,213,229,16,FTDWMKFGLPTAMMML,1
5ule,B,267,278,11,FGLTVFLWIFS,1
5ule,B,291,306,15,DTLVALGAILMLSFA,1
5ule,B,319,332,13,WGILLLFGGGLCL,1
5ule,B,360,376,16,VILVVATFVVFLTEFT,1
5ule,B,378,389,11,VATTTLLIPVF,1
5ule,B,403,414,11,SVLIAVAASCA,1
5ule,B,446,460,14,IACIGLLTAIAMLF,1
1nen,L,16,35,19,ILVRATAIVLTLYIIYMVG,1
1nen,L,57,80,23,KVFTLLALFSILIHAWIGMWQVL,1
1nen,L,89,110,21,RLMLQLVIVVALVVYVIYGFV,1
5wue,C,9,25,16,DIFNYIGIVAFAISGA,1
5wue,C,36,57,21,GVLVLGFSTALGGGIISNLLL,1
5wue,C,63,83,20,NLIYYPYPITAFLASLATFV,1
5wue,C,95,112,17,LYADAIGLGAFASSGAS,1
5wue,C,122,142,20,LVVIVGAITAVGGGVIRDIL,1
5wue,C,155,169,14,ATTAVIGSFVYFIA,1
5wue,C,180,195,15,IVSFLITLILRILAM,1
3abw,D,37,55,18,LYINIALAGLSILLFVFM,1
3abw,D,69,87,18,STILVPVVSIASYTGLAS,1
3abw,D,121,138,17,GRYLTWALSTPMILLAL,1
3abw,D,150,168,18,TAITFDIAMCVTGLAAAL,1
3abw,D,175,195,20,RWFWYAISCACFIVVLYILL,1
3abw,D,214,232,18,KLLTVVMWLGYPIVWALG,1
3abw,D,244,264,20,SWAYSALDIVAKYIFAFLLL,1
5ee7,A,148,167,19,YSLSLAALLLALAILGGLS,1
5ee7,A,173,190,17,NAIHANLFLSFVLKASA,1
5ee7,A,231,248,17,QYGIVANYCWLLVEGLY,1
5ee7,A,263,281,18,FSLYLGIGWGAPALFVVP,1
5ee7,A,307,323,16,RFPVFLAILINFFIFV,1
5ee7,A,350,368,18,TLTLIPLLGVHFVVFAFV,1
5ee7,A,385,404,19,LALSSFQGLLVAVLYCFLN,1
2b6r,A,29,53,24,PPVYSAVLAAGLPLNICVITQICT,1
2b6r,A,64,84,20,TLNLALADLLYACSLPLLIY,1
2b6r,A,101,119,18,VRFLFYANLHGSILFLTC,1
2b6r,A,146,169,23,VCVAVWLAVTTQCLPTAIFAATG,1
2b6r,A,190,209,19,PYGMALTVIGFLLPFAALL,1
2b6r,A,244,264,20,AAAFAISFLPFHITKTAYLA,1
2b6r,A,283,303,20,KGTRPFASANSVLDPILFYF,1
5egi,C,25,43,18,MYPYFDVAHYLLMIIEVR,1
5egi,C,55,82,27,KHPLSCWLSSMLMCFADAFLANFLLGE,1
5egi,C,84,110,26,IAPFKRHDDIILATIIWYLVFYAPFD,1
5egi,C,112,141,29,YKIAKITPVKCVLAVMKEVKRAYKVSHGV,1
5egi,C,153,178,25,VQVLVGTAKGAGSGIVRTLEQLVRG,1
5egi,C,188,205,17,RPSFATKACVVAASVLA,1
5egi,C,220,237,17,YLVIVGFFVYFKLSAVI,1
2lou,A,31,52,21,PAIYMLVFLLGTTGNGLVLWT,1
3f3e,B,13,35,22,LILAMAGNAVGLGNFLRFPVQA,1
3f3e,B,44,63,19,IPYIIAFLLVGIPLMWIEW,1
3f3e,B,89,124,35,AKILGVFGLWIPLVVAIYYVYIESWTLGFAIKFLV,1
3f3e,B,167,185,18,AYIVFLITMFINVSILIR,1
3f3e,B,191,212,21,ERFAKIAMPTLFILAVFLVIR,1
3f3e,B,242,266,24,VWIAAVGQIFFTLSLGFGAIITYA,1
3f3e,B,277,298,21,SGLTAATLNEKAEVILGGSIS,1
3f3e,B,340,367,27,GFLWFFLLFFAGLTSSIAIMQPMIAFL,1
3f3e,B,378,396,18,VLWTAAIVFFSAHLVMFL,1
3f3e,B,400,426,26,DEMDFWAGTIGVVFFGLTELIIFFWI,1
3f3e,B,445,469,24,RIYYYVMRYITPAFLAVLLVVWAR,1
3f3e,B,484,502,18,ITRFYIIGLFLFLTFLVF,1
4x89,F,136,153,17,LLTVVFYIAAVMATNLY,1
4x89,F,194,211,17,AWVFFIPFIMLTTFTVL,1
4jr9,A,41,57,16,VPCLLLAFCVWMLFSA,1
4jr9,A,77,93,16,TALPSVSGALLRVPYS,1
4jr9,A,105,120,15,AFSTGILIIPCVWLG,1
4jr9,A,135,150,15,ISLLCGFAGANFASS,1
4jr9,A,170,188,18,GGLGNMGVSVMQLVAPLV,1
4jr9,A,215,231,16,SWIWVPFLAIFTIAAW,1
4jr9,A,258,277,19,MSLLYLATFGSFIGFSAGF,1
4jr9,A,293,309,16,AFFGPFIGALARSAGG,1
4jr9,A,319,335,16,VTLVNFILMAIFSGLL,1
4jr9,A,353,370,17,VFLALFLTAGLGSGSTF,1
4jr9,A,409,424,15,ISAIGAIGGFFIPKA,1
4jr9,A,439,456,17,KVFLIFYIACVVITWAV,1
2yvx,B,282,305,23,LARVRWLVILILTGMVTSSILQG,1
2yvx,B,318,336,18,YVPVLLGTGGNTGNQSAT,1
2yvx,B,356,381,25,LKEMGVGLLLGLTLSFLLVGKVYWD,1
2yvx,B,388,409,21,VVGVSLVLIVFFANLVGAMLP,1
2yvx,B,423,443,20,NPLVATLSDVTGLLIYLSVA,1
4q2e,B,25,45,20,TRVITASVVAPFVVLCFVSY,1
4q2e,B,47,67,20,LIGLVSAILILAGYELITLE,1
4q2e,B,72,92,20,ARFFYVILLALYPVLYGLVF,1
4q2e,B,94,114,20,PTQPLSILFITGVVFSLITD,1
4q2e,B,121,145,24,KTVAAFSIALIYVTFFLSFFLPIY,1
4q2e,B,151,177,26,NALLVLTSTWVFDSFAYFTGLKFGRT,1
4q2e,B,185,206,21,RKSLEGVIGGFLGVVIYTFLY,1
4q2e,B,224,246,22,LPFAATVAIMDTFGDIFECALK,1
4q2e,B,261,284,23,GGMLDRIDGLLFVAPVSYIVFKI,1
3a7k,D,37,54,17,LYINIALAGLSILLFVF,1
3a7k,D,70,87,17,TILVPVVSIASYTGLAS,1
3a7k,D,121,136,15,GRYLTWALSTPMILL,1
3a7k,D,152,168,16,ITFDIAMCVTGLAAAL,1
3a7k,D,175,192,17,RWFWYAISCACFIVVLY,1
3a7k,D,217,232,15,TVVMWLGYPIVWALG,1
3a7k,D,244,261,17,SWAYSALDIVAKYIFAF,1
4aa3,B,169,193,24,RLAAAVGFLTMSSVISMSAPFFLG,1
4aa3,B,215,237,22,LGLSAVFLCGAAANAIRVYLMQ,1
4aa3,B,288,312,24,NLSDGLRAGAQASVGISMMFFVSP,1
4aa3,B,314,336,22,ATFVLSVVPPVSIIAVIYGRYL,1
4aa3,B,393,417,24,ARAGFFGATGLSGNLIVLSVLYKG,1
4aa3,B,431,453,22,SSFLMYAFWVGISIGGLSSFYS,1
2bbj,F,293,313,20,LTIIATIFMPLTFIAGIYGM,1
2bbj,F,327,347,20,PVVLAVMGVIAVIMVVYFKK,1
2lly,A,12,32,20,NLIIPCLLISCLTVLVFYLP,1
2lly,A,38,57,19,ITLCISVLLSLTVFLLLIT,1
2lly,A,71,91,20,EYLLFTMIFVTLSIVITVFV,1
2lly,A,109,129,20,DRIFLWMFIIVCLLGTVGLF,1
4rwa,B,47,68,21,LAIAITALYSAVCAVGLLGNV,1
4rwa,B,90,110,20,LALADALATSTLPFQSAKYL,1
4rwa,B,115,141,26,FGELLCKAVLSIDYYNMFTSIFTLTM,1
4rwa,B,168,187,19,NICIWVLASGVGVPIMVMA,1
4rwa,B,212,232,20,TKICVFLFAFVVPILIITVC,1
4rwa,B,266,284,18,VGAFVVCWAPIHIFVIVW,1
4rwa,B,296,316,20,VAALHLCIALGYANSSLNPV,1
1cwq,E,13,30,17,ALGTALMGLGTLYFLVK,1
1cwq,E,44,60,16,ITTLVPAIAFTMYLSM,1
1cwq,E,81,97,16,RYADWLFTTPLLLLDL,1
1cwq,E,109,125,16,ALVGADGIMIGTGLVG,1
1cwq,E,136,153,17,WWAISTAAMLYILYVLF,1
1cwq,E,175,190,15,NVTVVLWSAYPVVWL,1
1cwq,E,205,223,18,LLFMVLDVSAKVGFGLIL,1
5jaf,A,13,31,18,LILAMAGNAVGLGNFLRF,1
5jaf,A,44,63,19,IPYIIAFLLVGIPLMWIEW,1
5jaf,A,93,117,24,GVFGLWIPLVVAIYYVYIESWTLG,1
5jaf,A,168,184,16,YIVFLITMFINVSILI,1
5jaf,A,191,211,20,ERFAKIAMPTLFILAVFLVI,1
5jaf,A,244,265,21,IAAVGQIFFTLSLGFGAIITY,1
5jaf,A,279,296,17,LTAATLNEKAEVILGGS,1
5jaf,A,343,364,21,WFFLLFFAGLTSSIAIMQPMI,1
5jaf,A,379,394,15,LWTAAIVFFSAHLVM,1
5jaf,A,400,422,22,DEMDFWAGTIGVVFFGLTELII,1
5jaf,A,448,469,21,YYVMRYITPAFLAVLLVVWAR,1
5jaf,A,485,500,15,TRFYIIGLFLFLTFL,1
2vpw,G,16,36,20,NALHFVLVGLAGGVALLAAL,1
2vpw,G,49,66,17,LYALMLIALDLFILWAE,1
2vpw,G,90,105,15,GAWGLGLGFLTGGLL,1
2vpw,G,115,131,16,AWALLVFSLVALSYPG,1
2vpw,G,147,163,16,AGLFPLTALVLALGLA,1
2vpw,G,174,189,15,LRVLAGASLLLALLY,1
2vpw,G,207,221,14,WYGLFLLLGLGTFW,1
2vpw,G,226,240,14,PWAGLLAAAGLRAL,1
4wit,B,196,215,19,RFLVIPSAFGFGAWLLLGQ,1
4wit,B,217,233,16,YLYALLCGLWSVVFFE,1
4wit,B,287,318,31,QLLQIPFALACVVALGALIVTCNSLEVFINE,1
4wit,B,325,354,29,QYLGFLPTIFLVIGTPTISGVLMGAAEKL,1
4wit,B,371,397,26,QKQFVLNFMTSYMALFFTAFVYIPFG,1
4wit,B,430,455,25,ARISNQMFYFTVTAQIVNFATEVVV,1
4wit,B,506,521,15,MVMQFGYVAMFSVAW,1
4wit,B,523,535,12,AACCFLVNNWVE,1
4wit,B,562,585,23,TALSFLSWLGSITSSAIVYLCSN,1
4wit,B,597,621,24,KAWGLLLSILFAEHFYLVVQLAVR,1
5j7a,C,10,32,22,IWLALGTALMGLGTLYFLVKGM,1
5j7a,C,41,62,21,FYAITTLVPAIAFTMYLSMLL,1
5j7a,C,80,99,19,ARYADWLFTTPLLLLDLAL,1
5j7a,C,106,127,21,TILALVGADGIMIGTGLVGAL,1
5j7a,C,134,154,20,FVWWAISTAAMLYILYVLFF,1
5j7a,C,172,192,20,VLRNVTVVLWSAYPVVWLIG,1
5j7a,C,203,225,22,ETLLFMVLDVSAKVGFGLILLR,1
4in5,H,15,32,17,AIYSFWIFLAGLIYYLQ,1
2htl,B,37,58,21,MAAVVGTLVGLAAVAFDKGVA,1
2htl,B,84,97,13,CSAVLAMFGYFLV,1
2htl,B,129,142,13,VKFFGGLGTLGGG,1
2htl,B,144,156,12,LGREGPTVQIGG,1
2htl,B,216,231,15,AVFIGVIMSTIMYRI,1
2htl,B,253,274,21,LYLILGIIFGIFGPIFNKWVL,1
2htl,B,290,303,13,WVLMGGAIGGLCG,1
2htl,B,338,351,13,ARVITTLLCFSSG,1
2htl,B,353,365,12,GGIFAPMLALGT,1
2htl,B,423,439,16,PMIITGLGATLLAQFT,1
4g7s,C,7,24,17,ALAVILVLTLTILVFWL,1
4g72,C,7,24,17,ALAVILVLTLTILVFWL,1
3wg7,Z,17,37,20,GLSVTFLSFLLPAGWVLYHL,1
3wgv,E,30,46,16,LIFAALAFIVGLIIIL,1
3wfe,C,11,32,21,NIYFGGSVFFILLFLALTYHT,1
4i9w,B,32,50,18,LALLALVLLYLVSGALVF,1
4i9w,B,141,165,24,GRLFCIFYALVGIPLFGILLAGVG,1
4i9w,B,200,220,20,FLLIGCLLFVLTPTFVFCYM,1
4i9w,B,255,276,21,AYQPLVWFWILLGLAYFASVL,1
4ryj,B,10,27,17,FFLTYGLFYVSSVLFPI,1
4ryj,B,43,63,20,GMTIGMIWAVLFGLIALSVA,1
4ryj,B,75,96,21,FWFLFLLNYIFNQAFSYFQFS,1
4ryj,B,103,122,19,TVDCLLVAITTLLLIMFSS,1
4ryj,B,127,146,19,SAWLLIPYFLWSAFATYLS,1
4pbu,z,8,24,16,LAALVILSFVMVIGVP,1
4pbu,z,40,55,15,FLGSGLWIALVLVVG,1
4lds,A,14,31,17,GGLLYGYDNGVISGALL,1
4lds,A,43,61,18,EGIVVSSMLIGAIVGAGS,1
4lds,A,77,91,14,IAIVFIIGALILAA,1
4lds,A,97,113,16,LIIGRLIIGLAVGGSM,1
4lds,A,138,154,16,MITIGILAAYLVNYAF,1
4lds,A,161,177,16,WMLGLAVVPSVILLVG,1
4lds,A,248,266,18,FQQFIGINAVIFYSSSIF,1
4lds,A,276,293,17,ILGSVGIGTINVLVTIV,1
4lds,A,310,326,16,NIGMIASLLIMAILIW,1
4lds,A,334,353,19,WIIIVCLSLFIVFFGISWG,1
4lds,A,379,395,16,LNIGTLIVSLFFPILS,1
4lds,A,401,416,15,WVFLIFAFIGVLAMI,1
5svm,D,27,47,20,RVVQLLIISYFVGWVFLHEK,1
5svm,D,316,339,23,NIIPTIISSVAAFTSVGVGTVLC,1
2xfu,A,486,498,12,PSVPGLLRLIGL,1
5fn2,C,8,26,18,CTFVAFGPAFALFLITVA,1
5fn2,C,33,53,20,ILVAGAFFWLVSLLLASVVW,1
5fn2,C,75,90,15,AAVSVLLQEVFRFAY,1
5fn2,C,119,135,16,VSGLSFGIISGVFSVI,1
5fn2,C,162,179,17,LTAAIILLHTFWGVVFF,1
5fn2,C,188,203,15,ALGLVVGSHLLTSGL,1
5fn2,C,215,230,15,PIYAVTVSMGLWAFI,1
1fqu,A,61,74,13,VRILLLAACISFV,1
1fqu,A,87,100,13,FVEPFVILLILIA,1
1fqu,A,262,276,14,VISLICVAVWLINI,1
1fqu,A,293,309,16,YYFKIAVALAVAAIPE,1
1fqu,A,766,780,14,SNVGEVVCIFLTAA,1
1fqu,A,786,801,15,LIPVQLLWVNLVTDG,1
1fqu,A,835,851,16,RYMAIGGYVGAATVGA,1
1fqu,A,900,915,15,LSVLVTIEMCNALNS,1
1fqu,A,934,950,16,GSICLSMSLHFLILYV,1
1fqu,A,968,985,17,MVLKISLPVIGLDEILK,1
3rlb,A,12,31,19,EIAFMAALAFIISLIPNTV,1
3rlb,A,36,49,13,VEIACIPILLLSL,1
3rlb,A,54,74,20,AGLVGGLIWGILSMITGHAY,1
3rlb,A,79,97,18,QAFLEYLVAPVSLGIAGL,1
3rlb,A,111,128,17,LGTFVAVLLKYFFHFIA,1
3rlb,A,149,169,20,VNGISGILTAIAAFVILIIF,1
5vhx,E,10,26,16,AVALNLLALLFATTAF,1
5vhx,E,129,146,17,SEVLYILLLVVGFSLMC,1
5vhx,E,165,180,15,AVFTVLSGLLGMVAH,1
5vhx,E,210,225,15,LAWGSFTCCMAASVT,1
1zc7,A,19,40,21,VLAVLLMCMISGVQYSWTLYA,1
1zc7,A,53,73,20,VQTAFTLSQVIQAGSQPGGG,1
1zc7,A,80,100,20,PRIPLMFGGAMVLAGWTFMG,1
1zc7,A,111,130,19,YTLAGAGVGIVYGIAMNTA,1
1zc7,A,149,168,19,GLGVLPFLPLISSVLKVEG,1
1zc7,A,180,197,17,GILIILIAFVIRFPGQQ,1
1zc7,A,220,240,20,FWVLWTAFFSVNFGGLLLVA,1
1zc7,A,256,275,19,TIGVSIQNLFNGGCRPFWG,1
1zc7,A,287,305,18,SVVFGINAVVLALFPTIA,1
1zc7,A,310,330,20,AFIAMLAIAFFTWGGSYALF,1
1zc7,A,348,368,20,FFWAAKATASIFGGGLGAAI,1
1zc7,A,376,394,18,AFLITAITSFIAFALATF,1
4pv1,P,10,27,17,LSFGLIFVGWGLGVLLL,1
3e86,E,26,45,19,LFVLTILTLISGTIFYSTV,1
3e86,E,75,96,21,GKIFTILYIFIGIGLVFGFIH,1
4uhr,A,9,29,20,ITVELAIAVLAILGNVLVCW,1
4uhr,A,45,65,20,VSAAAADILVGVLAIPFAIA,1
4uhr,A,80,101,21,ACFVLVLTASSIFSLLAIAID,1
4uhr,A,123,141,18,IIAICWVLSFAIGLTPML,1
4uhr,A,177,202,25,VYFNFFACVLVPLLLMLGVYLRIFL,1
4uhr,A,233,251,18,SLAIIVGLFALCWLPLHI,1
4uhr,A,272,291,19,AIVLSHTNSVVNPFIYAYR,1
1oy6,C,11,27,16,AWVIAIIIMLAGGLAI,1
1oy6,C,341,357,16,KTLVEAIILVFLVMYL,1
1oy6,C,366,386,20,IPTIAVPVVLLGTFAVLAAF,1
1oy6,C,395,411,16,FGMVLAIGLLVDDAIV,1
1oy6,C,442,458,16,VGIAMVLSAVFVPMAF,1
1oy6,C,469,489,20,FSITIVSAMALSVLVALILT,1
1oy6,C,541,557,16,LVLYLIIVVGMAYLFV,1
1oy6,C,874,892,18,SLYAISLIVVFLCLAALY,1
1oy6,C,898,919,21,FSVMLVVPLGVIGALLAATFR,1
1oy6,C,927,943,16,QVGLLTTIGLSAKNAI,1
1oy6,C,975,993,18,LMTSLAFILGVMPLVIST,1
1oy6,C,1004,1021,17,TGVMGGMVTATVLAIFF,1
5jtg,E,294,310,16,TIIATIFMPLTFIAGI,1
5jtg,E,331,346,15,AVMGVIAVIMVVYFK,1
5f5d,A,94,113,19,PVTWVMMIACVVVFIAMQI,1
5f5d,A,144,166,22,HFSLMHILFNLLWWWYLGGAVE,1
5f5d,A,171,190,19,GKLIVITLISALLSGYVQQ,1
5f5d,A,198,216,18,GLSGVVFALMGYVWLRGE,1
5f5d,A,225,244,19,QRGLIIFALIWIVAGWFDL,1
5f5d,A,254,270,16,IAGLAVGLAMAFVDSL,1
3ns0,C,10,31,21,IWLALGTALMGLGTLYFLVKG,1
3ns0,C,44,62,18,ITTLVPAIAFTMYLSMLL,1
3ns0,C,80,97,17,ARYADWLFTTPLLLLDL,1
3ns0,C,109,127,18,ALVGADGIMIGTGLVGAL,1
3ns0,C,134,153,19,FVWWAISTAAMLYILYVLF,1
3ns0,C,174,192,18,RNVTVVLWSAYPVVWLIG,1
3ns0,C,203,224,21,ETLLFMVLDVSAKVGFGLILL,1
2zuq,A,13,31,18,AWLLMAFTALALELTALW,1
2zuq,A,48,63,15,VALFGVLGAALIGAI,1
2zuq,A,70,86,16,YVAMVIWLYSAFRGVQ,1
2zuq,A,146,162,16,LGIFIAYLIVAVLVVI,1
4llh,C,61,76,15,VIVPALVIVLATVVW,1
4llh,C,99,116,17,GWAFILFGTVFVFFIVV,1
4llh,C,143,158,15,MMFAAGMGIDLMFYG,1
4llh,C,184,201,17,TMFHWTLHPWAIYAIVG,1
4llh,C,237,258,21,IDILAIIATVFGTACSLGLGA,1
4llh,C,283,296,13,SVLTLAFIFSAIS,1
4llh,C,302,322,20,QYLSNANMVLAALLAIFVFV,1
4llh,C,368,385,17,FYWAWWISWSPFVGMFL,1
4llh,C,399,415,16,GVLLVPAGVSTVWFSI,1
4llh,C,457,477,20,MILLGTFFITSADSASTVMG,1
4llh,C,490,505,15,VTAAWGVATAAIGLT,1
4llh,C,522,537,15,IVAATPFLFVVIGLM,1
5va1,D,411,430,19,WLILLLVIYTAVFTPYSAA,1
5va1,D,450,469,19,PLAVVDLIVDIMFIVDILI,1
5va1,D,498,510,12,LIDMVAAIPFDL,1
5va1,D,522,537,15,LLKTARLLRLVRVAR,1
5va1,D,548,568,20,VLFLLMCTFALIAHWLACIW,1
5va1,D,639,660,21,FSICVMLIGSLMYASIFGNVS,1
4lml,E,194,216,22,SYIPNIILPMLFILFISWTAFW,1
4lml,E,221,243,22,ANVTLVVSTLAAHIAFNILVET,1
4lml,E,252,274,22,YTGAIIFMIYLFYFVAVIEVTV,1
4lml,E,294,316,22,RIAFPVVFLLANIILAFLFFGF,1
2hi7,B,15,31,16,LLMAFTALALELTALW,1
2hi7,B,48,65,17,VALFGVLGAALIGAIAP,1
2hi7,B,70,85,15,YVAMVIWLYSAFRGV,1
2hi7,B,146,162,16,LGIFIAYLIVAVLVVI,1
4nv2,A,20,38,18,LILAILAGLGSLLTAYLT,1
4nv2,A,71,90,19,TAAVGLLGFLGVLALAVLP,1
4nv2,A,100,124,24,WPALFGLVSAMTAFEMYMLYLMVA,1
4nv2,A,130,150,20,MYCTTAIILVAGLGLVTVLG,1
4nv2,A,160,180,20,FSYILVAFLTLVTTIGVYAN,1
2f1u,G,291,305,14,HLTAMISTCVNPIF,1
5hk6,D,154,165,11,LLLLVIFYVFA,1
5hk6,D,217,236,19,FVSFILVSSFTVLNLFIGI,1
4u4f,D,519,539,20,PLAYEIWMCIVFAYIGVSVV,1
4u4f,D,600,621,21,VGGVWWFFTLIIISSYTANLA,1
4u4f,D,788,808,20,LSNVAGVFYILVGGLGLAML,1
3rgb,G,54,66,12,LAIYTVFYLWVR,1
3rgb,G,93,106,13,YTEIVLEIVTASI,1
3rgb,G,141,154,13,AWAIYWGASYFTE,1
3rgb,G,175,189,14,EFYLSYPIYIITGF,1
3rgb,G,213,222,9,VVGPFMILP,1
3ir5,F,5,28,23,MFFFDIYPYIAGAVFLIGSWLRY,1
3ir5,F,48,72,24,NLASNLFHIGILGIFVGHFFGMLT,1
3ir5,F,87,114,27,KMAMFAGGASGVLCLIGGVLLLKRRLF,1
3ir5,F,125,145,20,DILILSLLVIQCALGLLTIP,1
3ir5,F,183,204,21,FRLHLVLGMTLFLLFPFSRLI,1
3b44,A,94,113,19,PVTWVMMIACVVVFIAMQI,1
3b44,A,144,166,22,HFSLMHILFNLLWWWYLGGAVE,1
3b44,A,172,190,18,KLIVITLISALLSGYVQQ,1
3b44,A,198,214,16,GLSGVVYALMGYVWLR,1
3b44,A,228,245,17,LIIFALIWIVAGWFDLF,1
3b44,A,247,268,21,SMANGAHIAGLAVGLAMAFVD,1
1s5h,L,26,50,24,RAAGAATVLLVIVLLAGSYLAVLA,1
1s5h,L,87,112,25,GRLVAVVVMVAGITSFGLVTAALAT,1
4uc3,B,6,23,17,LFLTFLAACGAPATTGA,1
4uc3,B,45,62,17,FPLAWTSLYFLMSLAAM,1
4uc3,B,72,89,17,ALAFYAAQLAFNTLWTP,1
4uc3,B,100,119,19,LAVVMVMWLFVAATMWAFF,1
4uc3,B,125,144,19,GVLFVPYLIWATAATGLNF,1
4ret,G,27,46,19,NGGLIFAALAFIVGLIIIL,1
5jrw,E,295,315,20,IIATIFMPLTFIAGIYGMNF,1
5jrw,E,326,344,18,YPVVLAVMGVIAVIMVVY,1
1z2r,B,26,47,21,LIVAGIALILNAASDTFMLSL,1
1z2r,B,67,85,18,PLVVIGLMILRGITSYIS,1
1z2r,B,147,164,17,REGASIIGLFIMMFYYS,1
1z2r,B,168,188,20,IILVVLAPIVSIAIRVVSKR,1
1z2r,B,254,273,19,IQLIASLALAFVLYAASFP,1
1z2r,B,280,297,17,AGTITVVFSSMIALMRP,1
1j4n,D,12,32,20,AVVAEFLAMILFIFISIGSA,1
1j4n,D,52,70,18,KVSLAFGLSIATLAQSVG,1
1j4n,D,94,114,20,RAIMYIIAQCVGAIVATAIL,1
1j4n,D,142,159,17,IEIIGTLQLVLCVLATT,1
1j4n,D,169,186,17,GPLAIGFSVALGHLLAI,1
1j4n,D,212,233,21,IFWVGPFIGAALAVLIYDFIL,1
5h2h,C,12,28,16,LALGTALMGLGTLYFL,1
5h2h,C,47,61,14,LVPAIAFTMYLSML,1
5h2h,C,80,94,14,ARYADWLFTTPLLL,1
5h2h,C,111,126,15,VGADGIMIGTGLVGA,1
5h2h,C,135,150,15,VWWAISTAAMLYILY,1
5h2h,C,178,192,14,VVLWSAYPVVWLIG,1
5h2h,C,204,220,16,TLLFMVLDVSAKVGFG,1
4nyk,C,47,72,25,ALCFMGSLALLALVCTNRIQYYFLY,1
4nyk,C,425,444,19,EVAGLLGDIGGQMGLFIGA,1
2x6b,D,48,71,23,FITLITGLYLVTNALFALAYLAC,1
2x6b,D,108,128,20,ANTLVTLEALCGMLGLAVAA,1
4k0j,C,17,31,14,LVFAMVALYGWYAW,1
4k0j,C,336,351,15,TLMEGMFLVSLVLLL,1
4k0j,C,360,380,20,IVAVTIPLSLLMAFILMHHF,1
4k0j,C,390,402,12,AIDFGIIVDGAI,1
4k0j,C,438,451,13,GMIVIITAYLPLF,1
4k0j,C,465,479,14,FAVGFALFGALLVA,1
4k0j,C,526,540,14,IAVATLVGVMILGA,1
4k0j,C,861,875,14,ILPMVLALMFVLLF,1
4k0j,C,885,905,20,LILMAVPLATLGGLVALHLR,1
4k0j,C,914,928,14,VGFIALFGVAVLNA,1
4k0j,C,963,977,14,TATVAALGLIPAAL,1
4k0j,C,989,1004,15,ATVVVGGLITATALT,1
3b9r,A,55,74,19,QFEDLLVRILLLAACISFV,1
3b9r,A,89,107,18,EPFVILLILIANAIVGVW,1
3b9r,A,254,275,21,EFGEQLSKVISLICVAVWLIN,1
3b9r,A,296,317,21,KIAVALAVAAIPEGLPAVITT,1
3b9r,A,760,781,21,IRYLISSNVGEVVCIFLTAAL,1
3b9r,A,786,807,21,LIPVQLLWVNLVTDGLPATAL,1
3b9r,A,832,852,20,LFFRYMAIGGYVGAATVGAA,1
3b9r,A,898,916,18,MALSVLVTIEMCNALNSL,1
3b9r,A,927,951,24,WVNIWLLGSICLSMSLHFLILYVD,1
3b9r,A,967,987,20,LMVLKISLPVIGLDEILKFI,1
4yl1,C,14,36,22,AFLLCSTLLVIKMYVVAIITGQ,1
4yl1,C,69,90,21,RAHRNDMETIYPFLFLGFVYS,1
4yl1,C,98,119,21,AWMHFLVFLVGRVAHTVAYLG,1
4yl1,C,125,149,24,RSVTYTLAQLPCASMALQILWEAA,1
2c64,A,486,501,15,PSVPGLLRLIGLTTI,1
1vfp,A,58,77,19,DLLVRILLLAACISFVLAW,1
1vfp,A,86,103,17,AFVEPFVILLILIANAI,1
1vfp,A,257,273,16,EQLSKVISLICVAVWL,1
1vfp,A,296,311,15,KIAVALAVAAIPEGL,1
1vfp,A,760,777,17,IRYLISSNVGEVVCIFL,1
1vfp,A,788,807,19,PVQLLWVNLVTDGLPATAL,1
1vfp,A,832,851,19,LFFRYMAIGGYVGAATVGA,1
1vfp,A,899,916,17,ALSVLVTIEMCNALNSL,1
1vfp,A,934,954,20,GSICLSMSLHFLILYVDPLP,1
1vfp,A,965,988,23,QWLMVLKISLPVIGLDEILKFIA,1
2mn7,A,2,18,16,GISIWQLLIIAVIVVL,1
2mn7,A,25,45,20,GSIGSDLGASIKGFKKAMSD,1
2c70,A,490,501,11,GLLRLIGLTTI,1
4ymt,B,16,44,28,SGLIMTLKLTFLAVTIGVLMGLFIALMK,1
4ymt,B,49,74,25,PIKLVASSYIEVIRGTPLLVQLLLI,1
4ymt,B,89,107,18,AGVSALAINSSAYVAEII,1
4ymt,B,147,164,17,ALGNEFIVMLKESAIVS,1
4ymt,B,190,207,17,IIAAIYFVMTLTFSKLL,1
4p30,F,135,153,18,ALLTVVFYIAAVMATNLY,1
4p30,F,194,214,20,AWVFFIPFIMLTAFTVLNLA,1
4uxx,C,33,48,15,EGVAVLLAVVIACWL,1
4uxx,C,53,67,14,TRVLLISSVMLVMI,1
4uxx,C,102,117,15,IAIIDAVITWCILLW,1
1q5j,C,10,32,22,IWLALGTALMGLGTLYFLVKGM,1
1q5j,C,43,62,19,AITTLVPAIAFTMYLSMLL,1
1q5j,C,80,98,18,ARYADWLFTTALLLLDLA,1
1q5j,C,108,127,19,LALVGADGIMIGTGLVGAL,1
1q5j,C,134,154,20,FVWWAISTAAMLYILYVLFF,1
1q5j,C,174,192,18,RNVTVVLWSAYPVVWLIG,1
1q5j,C,203,224,21,ETLLFMVLDVSAKVGFGLILL,1
4pdr,H,22,45,23,EFQVLFVLTILTLISGTIFYSTV,1
4pdr,H,75,102,27,GKIFTILYIFIGIGLVFGFIHKLAVNV,1
3lut,H,164,181,17,IAIVSVMVILISIVSFC,1
3lut,H,222,241,19,FIVETLCIIWFSFEFLVRF,1
3lut,H,254,271,17,MNIIDIVAIIPYFITLG,1
3lut,H,295,312,17,IRLVRVFRIFKLSRHSK,1
3lut,H,326,349,23,ELGLLIFFLFIGVILFSSAVYFA,1
3lut,H,387,406,19,KIVGSLCAIAGVLTIALPV,1
5dgy,A,40,65,25,AAYMFLLIVLGFPINFLTLYVTVQH,1
5dgy,A,69,96,27,TPLNYILLNLAVADLFMVLGGFTSTLY,1
5dgy,A,113,138,25,GFFATLGGEIALWSLVVLAIERYVV,1
5dgy,A,149,171,22,ENHAIMGVAFTWVMALACAAPP,1
5dgy,A,204,228,24,IYMFVVHFTIPMIIIFFCYGQLVF,1
5dgy,A,251,274,23,RMVIIYVIAFLICWVPYASVAFY,1
5dgy,A,290,314,24,PAFFAKSAAIYNPVIYIMMNKQFR,1
2hqg,C,12,25,13,WVIAIIIMLAGGL,1
2hqg,C,342,357,15,TLVEAIILVFLVMYL,1
2hqg,C,366,382,16,IPTIAVPVVLLGTFAV,1
2hqg,C,398,410,12,VLAIGLLVDDAI,1
2hqg,C,442,456,14,VGIAMVLSAVFVPM,1
2hqg,C,472,489,17,TIVSAMALSVLVALILT,1
2hqg,C,542,556,14,VLYLIIVVGMAYLF,1
2hqg,C,877,890,13,AISLIVVFLCLAA,1
2hqg,C,898,915,17,FSVMLVVPLGVIGALLA,1
2hqg,C,930,943,13,LLTTIGLSAKNAI,1
2hqg,C,976,990,14,MASLAFILGVMPLV,1
2hqg,C,1005,1019,14,GVMGGMVTATVLAI,1
2c9m,A,54,71,17,EQFEDLLVRILLLAACI,1
2c9m,A,90,108,18,PFVILLILIANAIVGVWQ,1
2c9m,A,257,274,17,EQLSKVISLICVAVWLI,1
2c9m,A,294,311,17,YFKIAVALAVAAIPEGL,1
2c9m,A,761,780,19,RYLISSNVGEVVCIFLTAA,1
2c9m,A,787,807,20,IPVQLLWVNLVTDGLPATAL,1
2c9m,A,832,851,19,LFFRYMAIGGYVGAATVGA,1
2c9m,A,899,916,17,ALSVLVTIEMCNALNSL,1
2c9m,A,932,950,18,LLGSICLSMSLHFLILYV,1
2c9m,A,965,987,22,QWLMVLKISLPVIGLDEILKFI,1
3n5k,A,58,74,16,DLLVRILLLAACISFV,1
3n5k,A,89,108,19,EPFVILLILIANAIVGVWQ,1
3n5k,A,254,276,22,EFGEQLSKVISLICVAVWLINI,1
3n5k,A,296,318,22,KIAVALAVAAIPEGLPAVITTC,1
3n5k,A,760,781,21,IRYLISSNVGEVVCIFLTAAL,1
3n5k,A,786,808,22,LIPVQLLWVNLVTDGLPATALG,1
3n5k,A,833,853,20,FFRYMAIGGYVGAATVGAAA,1
3n5k,A,898,916,18,MALSVLVTIEMCNALNSL,1
3n5k,A,927,950,23,WVNIWLLGSICLSMSLHFLILYV,1
3n5k,A,965,987,22,QWLMVLKISLPVIGLDEILKFI,1
4nc3,A,55,77,22,WAALLILMVIIPTIGGNTLVIL,1
4nc3,A,94,115,21,SLAVADLLVGLFVMPIALLTI,1
4nc3,A,124,148,24,LVLCPAWLFLDVLFSTASIWHLCA,1
4nc3,A,177,195,18,VVWLISIGIAIPVPIKGI,1
4nc3,A,214,235,21,GDFMLFGSLAAFFTPLAIMIV,1
4nc3,A,329,350,21,FFLFLLMWCPFFITNITLVLC,1
4nc3,A,359,380,21,MLLEIFVWIGYVSSGVNPLVY,1
5aw1,G,25,40,15,VAAVLCVIGIIILLA,1
5dir,A,13,27,14,WITVLVFVLDQVSK,1
5dir,A,72,86,14,FALIAIVVSASLVV,1
5dir,A,101,117,16,LALVLGGALGNLYDRM,1
5dir,A,140,155,15,LADSAITVGAVMLAL,1
5m5h,A,356,370,14,SIIIITFIVRGIMY,1
5m5h,A,427,440,13,IQMPIFLALYYML,1
5m5h,A,465,476,11,ILPILMGVTMF,1
5m5h,A,498,511,13,PVIFTVFFLWFPS,1
5m5h,A,513,523,10,VLYYIVSNLV,1
1su4,A,54,71,17,EQFEDLLVRILLLAACI,1
1su4,A,90,106,16,PFVILLILIANAIVGV,1
1su4,A,258,274,16,QLSKVISLICVAVWLI,1
1su4,A,294,310,16,YFKIAVALAVAAIPEG,1
1su4,A,762,780,18,YLISSNVGEVVCIFLTAA,1
1su4,A,787,806,19,IPVQLLWVNLVTDGLPATA,1
1su4,A,832,851,19,LFFRYMAIGGYVGAATVGA,1
1su4,A,899,915,16,ALSVLVTIEMCNALNS,1
1su4,A,932,950,18,LLGSICLSMSLHFLILYV,1
1su4,A,968,987,19,MVLKISLPVIGLDEILKFI,1
1fnp,H,12,31,19,ASLAIYSFWIFLAGLIYYL,1
5avt,G,22,38,16,GLIVAAVLCVIGIIIL,1
4bwz,A,4,24,20,EHLLEIFYLLLAAQVCAFIF,1
4bwz,A,30,46,16,VVIGEVLAGVLVGPAL,1
4bwz,A,48,72,24,LVHEGEILEFLAELGAVFLLFMVG,1
4bwz,A,85,105,20,EAFLVAVLGVALPFLGGYLY,1
4bwz,A,120,134,14,TALVATSVGITARV,1
4bwz,A,149,165,16,LGAAVIDDVLGLIVLA,1
4bwz,A,182,198,16,RLIVLSVVFVGLAVFL,1
4bwz,A,218,233,15,ALALGVGMAALAASI,1
4bwz,A,235,247,12,APIVGAFLGGML,1
4bwz,A,265,282,17,SFLAPIFFAMVGVRLEL,1
4bwz,A,292,313,21,AGTVVTVIAILGKVLGGFLGA,1
4bwz,A,322,339,17,TVGCGMAPRGEVGLIVA,1
4bwz,A,356,371,15,LFMVVFTTLFAPFAL,1
1ogv,M,55,72,17,GVLSLFSGLMWFFTIGI,1
1ogv,M,118,133,15,SFFMFVAVWSWWGRT,1
1ogv,M,146,163,17,AWAFLSAIWLWMVLGFI,1
1ogv,M,202,221,19,GLSIAFLYGSALLFAMHGA,1
1ogv,M,268,283,15,AIWMAVLVTLTGGIG,1
1qlb,F,29,50,21,QSATGLFLGLFMIGHMFFVST,1
1qlb,F,77,101,24,VVSFLAAFVFAVFIAHAFLAMRKF,1
1qlb,F,125,151,26,WWIQAMTGFAMFFLGSVHLYIMMTQP,1
1qlb,F,167,192,25,MWPLYLVLLFAVELHGSVGLYRLAV,1
1qlb,F,206,232,26,ANLKKLKTLMSAFLIVLGLLTFGAYV,1
5jdm,A,4,24,20,GVGYFLLGLILLYYGSDWFV,1
5jdm,A,41,57,16,GATVMAIGTSLPEILT,1
5jdm,A,74,91,17,IGSCICNIGLVLGLSAI,1
5jdm,A,103,117,14,NILVYLLFVIFAAV,1
5jdm,A,129,143,14,VLLILFIIYLRWTV,1
5jdm,A,169,186,17,IGLIGVLVGAELFVDGA,1
5jdm,A,205,219,14,AFGTSLPELMVSLA,1
5jdm,A,230,247,17,GNVIGSNIADIGGALAV,1
5jdm,A,261,275,14,AVLVIMSLLLYLFA,1
5jdm,A,283,297,14,QGILFLALYIIAIA,1
3wme,B,118,140,22,TMIVIGFIASILEGATLPAFAI,1
3wme,B,167,188,21,VGIGVFEFIVAGSRTALFGIA,1
3wme,B,236,257,21,KLGAVLFNLAQCVVGIIVAFI,1
3wme,B,264,284,20,VLIALSPLVVLAGAAQMIEM,1
3wme,B,339,361,22,YISDGLFFGLSMLVIFCVYALA,1
3wme,B,382,403,21,FFSAILGFMGVGQAAQVWPDV,1
1xfh,C,13,32,19,QKILIGLILGAIVGLILGH,1
1xfh,C,36,67,31,HAVHTYVKPFGDLFVRLLKMLVMPIVFASLV,1
1xfh,C,79,108,29,RVGVKIVVYYLLTSAFAVTLGIIMARLFN,1
1xfh,C,128,140,12,PLVHILLDIVPT,1
1xfh,C,151,161,10,LPTIFFAIIL,1
1xfh,C,198,222,24,NGVMQYAPIGVFALIAYVMAEQGV,1
1xfh,C,230,254,24,VTAAVYVGLTLQILLVYFVLLKIY,1
1xfh,C,299,321,22,SFTLPLGATINMDGTALYQGVC,1
1xfh,C,390,412,22,AILDMGRTMVNVTGDLTGTAIV,1
2dhh,C,11,25,14,AWVIAIIIMLAGGL,1
2dhh,C,344,357,13,VEAIILVFLVMYL,1
2dhh,C,366,382,16,IPTIAVPVVLLGTFAV,1
2dhh,C,398,411,13,VLAIGLLVDDAIV,1
2dhh,C,443,456,13,GIAMVLSAVFVPM,1
2dhh,C,472,489,17,TIVSAMALSVLVALILT,1
2dhh,C,542,556,14,VLYLIIVVGMAYLF,1
2dhh,C,875,890,15,LYAISLIVVFLCLAA,1
2dhh,C,899,915,16,SVMLVVPLGVIGALLA,1
2dhh,C,929,943,14,GLLTTIGLSAKNAI,1
2dhh,C,976,990,14,MTSLAFILGVMPLV,1
2dhh,C,1005,1019,14,GVMGGMVTATVLAI,1
3w9j,C,12,26,14,WVIALVIMLAGGLS,1
3w9j,C,343,357,14,LGEAILLVFLVMYL,1
3w9j,C,366,383,17,IPTIAVPVVLLGTFGVL,1
3w9j,C,397,410,13,MVLAIGLLVDDAI,1
3w9j,C,442,455,13,VGIAMVLSAVFLP,1
3w9j,C,471,489,18,ITIVSAMALSVIVALILT,1
3w9j,C,541,556,15,LLIYVVIVAGMIWMF,1
3w9j,C,876,893,17,ALSLLVVFLCLAALYES,1
3w9j,C,895,915,20,IPFSVMLVVPLGVIGALLAT,1
3w9j,C,929,943,14,LLTTIGLSAKNAIL,1
3w9j,C,974,989,15,MTSLAFILGVVPLAI,1
3w9j,C,1003,1020,17,GVIGGMVTATVLAIFWV,1
2b2j,C,11,28,17,STALVMLMVPGVGFFYA,1
2b2j,C,40,62,22,ALSFISLIITVLLWIFYGYSVS,1
2b2j,C,91,108,17,YQMMFAAVTIAILTSAI,1
2b2j,C,115,136,21,SFILLSALWLTFVYAPFAHWL,1
2b2j,C,150,170,20,AGGMVVHISSGFAALAVAMT,1
2b2j,C,189,208,19,TLIGAALLWFGWFGFNGGS,1
2b2j,C,220,240,20,VVTNTSAAVAGFVWMVIGWI,1
2b2j,C,247,264,17,GIVSGAIAGLAAITPAA,1
2b2j,C,270,290,20,GAIVIGLVAGIVCYLAMDFR,1
2b2j,C,298,319,21,LDAWAIHGIGGLWGSVAVGIL,1
2b2j,C,342,367,25,IAVASTTAYAFLVTLILAKAVDAAV,1
3ae5,D,42,61,19,WTGERVVSVLLLGLLPAAY,1
3ae5,D,69,88,19,YSLAAALTLHGHWGIGQVV,1
3ae5,D,100,118,18,AKAGLLALSAFTFAGLCY,1
2e76,Q,7,25,18,WVALLVVFTWSIAMVVWG,1
4v1h,I,18,40,22,LIMGGGAIGAGIGDGIAGNALI,1
4v1h,I,55,76,21,PFFITVGLVEAAYFINLAFMA,1
1y8s,A,36,52,16,EWFDFGVYGFVAYALG,1
1y8s,A,67,83,16,ALATFSVPFLIRPLGG,1
1y8s,A,100,116,16,ITIVIMSISTFCIGLI,1
1y8s,A,124,140,16,WAPILLLICKMAQGFS,1
1y8s,A,169,186,17,FGSIAGFVLGAGVVVLI,1
1y8s,A,200,216,16,RIPFFIALPLGIIGLY,1
1y8s,A,264,283,19,IGLVIATNVTYYMLLTYMP,1
1y8s,A,299,316,17,IIIAIMIGMLFVQPVMG,1
1y8s,A,330,346,16,GSVALFVLAIPAFILI,1
1y8s,A,354,372,18,FAGLLMLAVILNCFTGVM,1
1y8s,A,393,410,17,NISVLVAGLTPTLAAWL,1
1y8s,A,417,434,17,MMPAYYLMVVAVVGLIT,1
3fb7,F,31,50,19,ATVLLVIVLLAGSYLAVLA,1
3fb7,F,87,110,23,GRCVAVVVMVAGITSFGLVTAAL,1
4mrn,B,34,58,24,LRRRVVGAILMVLLGKATTLALPF,1
4mrn,B,86,108,22,YALGRFSGVLFDNLRNIVFERV,1
4mrn,B,155,177,22,YFLLFNIAPTVIELTAVIVIFW,1
4mrn,B,183,206,23,LVTATILAVIAYVWTTRTITEWR,1
4mrn,B,263,284,21,SLGLLNIAQALIVNLLMAGAM,1
4mrn,B,303,323,20,VNTYLTQLFRPLDMLGMVYR,1
3qbl,D,37,57,20,LYINIALAGLSILLFVFMTR,1
3qbl,D,66,87,21,IAVSTILVPVVSIASYTGLAS,1
3qbl,D,121,141,20,GRYLTWALSTPMILLALGLL,1
3qbl,D,147,168,21,KLFTAITFDIAMCVTGLAAAL,1
3qbl,D,175,199,24,RWFWYAISCACFIVVLYILLVEWA,1
3qbl,D,211,232,21,STLKLLTVVMWLGYPIVWALG,1
3qbl,D,244,267,23,SWAYSALDIVAKYIFAFLLLNYL,1
3a0h,z,5007,5022,15,ALAALVILSFVMVIG,1
3a0h,z,5041,5055,14,LGSGLWIALVLVVG,1
5u1u,C,36,49,13,VFSYISFALISDK,1
5u1u,C,329,344,15,VIQLAVYIGSVISYF,1
3aec,D,41,61,20,HWTGERVVSVLLLGLLPAAY,1
3aec,D,69,89,20,YSLAAALTLHGHWGIGQVVT,1
3aec,D,99,118,19,AAKAGLLALSAFTFAGLCY,1
5iwn,D,151,170,19,WIALLLLVIFYVFAVMGTK,1
5iwn,D,216,234,18,YFVSFILVSSFTVLNLFI,1
2npe,C,15,32,17,CTALVLFMTIPGIALFY,1
2npe,C,46,64,18,QVTVTFALVCILWVVYGY,1
2npe,C,102,119,17,FQGSFACITVGLIVGAL,1
2npe,C,127,147,20,VLIFVVVWLTLSYIPIAHMV,1
2npe,C,161,178,17,AGGTVVHINAAIAGLVG,1
2npe,C,201,219,18,FTGTAILYIGWFGFNAGS,1
2npe,C,231,249,18,VNTVVATAAAILGWIFGE,1
2npe,C,260,276,16,ACSGAIAGLVGVTPAC,1
2npe,C,282,299,17,GALIIGVVAGLAGLWGV,1
2npe,C,313,332,19,VFGVAGVCGIVGCIMTGIF,1
2npe,C,353,377,24,VQLESIAITIVWSGVVAFIGYKLA,1
1kpl,B,36,61,25,FMAAVVGTLTGLVGVAFEKAVSWVQ,1
1kpl,B,81,102,21,AFILSALLAMVGYFLVRKFAP,1
1kpl,B,125,142,17,RVLPVKFIGGMGTLGAG,1
1kpl,B,144,159,15,LGREGPTVQIGGNLG,1
1kpl,B,215,233,18,KAVFTGVIMSSIVFRIFN,1
1kpl,B,250,277,27,TLWLYLILGIIFGVVGPVFNSLVLRTQ,1
1kpl,B,289,306,17,KWVLMGGAIGGLCGILG,1
1kpl,B,335,351,16,IFITRVVTTLLCFSSG,1
1kpl,B,353,368,15,GGIFAPMLALGTLLG,1
1kpl,B,422,442,20,LPMIITCLGATLLAQFLGGK,1
4xdl,B,77,98,21,VAIFVVVVVYLVTGGLVFRAL,1
4xdl,B,184,208,24,GKIFCILYAIFGIPLFGFLLAGIG,1
4xdl,B,242,263,21,LFILAGCIVFVTIPAVIFKYI,1
4xdl,B,299,321,22,WYKPLVWFWILVGLAYFAAVLS,1
3h5m,B,11,31,20,LIPVTLMVSGNIMGSGVFLL,1
3h5m,B,44,62,18,GWLVTIIGALGLSMVYAK,1
3h5m,B,85,112,27,GYQTNVLYWLACWIGNIAMVVIGVGYL,1
3h5m,B,125,144,19,TITCVVVLWIFVLLNIVGP,1
3h5m,B,146,171,25,ITRVQAVATVLALIPIVGIAVFGWF,1
3h5m,B,197,218,21,NVTLWSFIGVESASVAAGVVK,1
3h5m,B,229,249,20,GGVLIAAVCYVLSTTAIMGM,1
3h5m,B,282,306,24,AAGCLGSLGGWTLLAGQTAKAAAD,1
3h5m,B,324,342,18,AGLIIVGILMTIFQLSSI,1
3h5m,B,350,370,20,GLVSSVSVIFTLVPYLYTCA,1
3h5m,B,386,407,21,YLAVTTIAFLYCIWAVVGSGA,1
3h5m,B,409,426,17,VMWSFVTLMVITAMYAL,1
4tq6,A,16,40,24,YLRLLRPVAWLCFLLPYAVGFGFG,1
4tq6,A,52,71,19,GLLSFAFWMAFSFTINALY,1
4tq6,A,98,119,21,SVREAWLYCIAFLALSLATAA,1
4tq6,A,125,146,21,FLAMLGANIIGYVYSAPPRFK,1
4tq6,A,151,169,18,DVICNALAAVLAFYAGLS,1
4tq6,A,176,194,18,IAIYPAAFFLAATFYIPT,1
4tq6,A,224,241,17,PLSAITVILWAYVFLMA,1
4tq6,A,246,263,17,KVISPLIIAYTLIYTFI,1
4tq6,A,277,294,17,NLILTPFGIISALFIAY,1
4mhw,A,12,31,19,EIAFMAALAFIISLIPNTV,1
4mhw,A,36,49,13,VEIACIPILLLSL,1
4mhw,A,54,73,19,AGLVGGLIWGILSMITGHA,1
4mhw,A,80,97,17,AFLEYLVAPVSLGIAGL,1
4mhw,A,111,128,17,LGTFVAVLLKYFFHFIA,1
4mhw,A,148,169,21,AVNGISGILTAIAAFVILIIF,1
3t1c,E,25,45,20,VLFVLTILTLISGTIFYSTV,1
3t1c,E,75,99,24,GKIFTILYIFIGIGLVFGFIHKLA,1
2lp1,A,686,696,10,KLVFFAEDVG,1
2lp1,A,702,717,15,IGLMVGGVVIATVIV,1
1kju,A,55,73,18,QFEDLLVRILLLAACISF,1
1kju,A,90,107,17,PFVILLILIANAIVGVW,1
1kju,A,260,276,16,SKVISLICVAVWLINI,1
1kju,A,293,311,18,YYFKIAVALAVAAIPEGL,1
1kju,A,762,781,19,YLISSNVGEVVCIFLTAAL,1
1kju,A,786,807,21,LIPVQLLWVNLVTDGLPATAL,1
1kju,A,835,855,20,RYMAIGGYVGAATVGAAAWW,1
1kju,A,898,916,18,MALSVLVTIEMCNALNSL,1
1kju,A,932,950,18,LLGSICLSMSLHFLILYV,1
1kju,A,964,984,20,TQWLMVLKISLPVIGLDEIL,1
2w2e,D,48,66,18,SGEFVGTFLFLWSAFVIA,1
2w2e,D,87,104,17,ISFGFGFGVMVGVFITY,1
2w2e,D,131,148,17,LMAFTQIVAGMAAAGAA,1
2w2e,D,172,189,17,FLEAFGTAILCLTVLML,1
2w2e,D,200,216,16,PFVIGIALLIAHLICI,1
2w2e,D,243,260,17,IYWLGPILGAFLAYSIW,1
4cg6,D,2,17,15,IVSVGSFISVLFIVI,1
3d4s,A,36,59,23,GIVMSLIVLAIVFGNVLVITAIA,1
3d4s,A,69,91,22,YFITSLACADLVMGLAVVPFGA,1
3d4s,A,109,130,21,TSIDVLCVTASIWTLCVIAVD,1
3d4s,A,149,168,19,ARVIILMVWIVSGLTSFLP,1
3d4s,A,201,221,20,ASSIVSFYVPLVIMVFVYSR,1
3d4s,A,275,295,20,GIIMGTFTLCWLPFFIVNIV,1
3d4s,A,310,327,17,LNWIGYVNSGFNPLIYC,1
1u5n,A,54,74,20,ELILNQFDDLLVKILLLAAF,1
1u5n,A,98,116,18,VIVLILILNAAVGVWQEC,1
1u5n,A,264,283,19,GQQLSKIIFVICVTVWIIN,1
1u5n,A,303,321,18,KISVALAVAAIPEGLPAV,1
1u5n,A,972,993,21,IRYLISSNIGEVASIFITALL,1
1u5n,A,998,1020,22,LAPVQLLWVNLVTDGLPATALG,1
1u5n,A,1044,1065,21,TLLRYIIIGTYVGIATVSIFV,1
1u5n,A,1123,1141,18,SLSVLVLIEMFNALNALS,1
1u5n,A,1155,1174,19,YLVLATIGSLLLHVLILYI,1
1u5n,A,1189,1212,23,DWFLVFLWSFPVIILDEIIKFYA,1
4aq9,E,227,243,16,PCVLISSLVVLVYFLP,1
4aq9,E,251,268,17,TLSISVLLAQTIFLFLI,1
4aq9,E,289,308,19,MFVSLVIVTNCVIVLNVSL,1
4aq9,E,449,467,18,CFWIALLLFSLGTLAIFL,1
1wu0,A,12,35,23,GLGALGAGIGNGLIVSRTIEGIA,1
1wu0,A,44,67,23,QTTMFIGVALVEALPIIGVVFSF,1
4j7y,C,8,28,20,AAVTLLGVLLQAYFSLQVIS,1
4j7y,C,51,71,20,AQVNCSEYFPLFLATLWVAG,1
4j7y,C,79,97,18,ALCGLVYLFARLRYFQGY,1
4j7y,C,104,124,20,LAPLYASARALWLLVALAAL,1
2wie,P,11,33,22,IAAALAVGIGSIGPGLGQGQAA,1
2wie,P,55,78,23,LSLAFMEALTIYGLVVALVLLFA,1
4jc7,C,6,28,22,LLAAVTLLGVLLQAYFSLQVIS,1
4jc7,C,51,74,23,AQVNCSEYFPLFLATLWVAGIFF,1
4jc7,C,76,97,21,GAAALCGLVYLFARLRYFQGY,1
4jc7,C,104,131,27,LAPLYASARALALLVALAALGLLAHFL,1
3asn,Z,17,35,18,GLSVTFLSFLLPAGWVLY,1
4m2s,A,39,68,29,RYAGWLDRLYMLVGTLAAIIHGVALPLMM,1
4m2s,A,118,139,21,AGVLIVAYIQVSFWCLAAGRQ,1
4m2s,A,181,204,23,IGDKIGMFFQAMATFFGGFIIGF,1
4m2s,A,211,230,19,LVILAISPVLGLSAGIWAK,1
4m2s,A,290,312,22,ANISMGAAFLLIYASYALAFWY,1
4m2s,A,330,352,22,FFSVLIGAFSVGQASPNIEAFA,1
4m2s,A,706,728,22,FVVGIFCAIINGGLQPAFSVIF,1
4m2s,A,752,773,21,LLFLILGIISFITFFLQGFTF,1
4m2s,A,827,847,20,RLAVIFQNIANLGTGIIISL,1
4m2s,A,855,879,24,LLLAIVPIIAIAGVVEMKMLSGQA,1
4m2s,A,926,950,24,AMKKAHVFGITFSFTQAMMYFSYA,1
4m2s,A,973,994,21,FSAIVFGAMAVGQVSSFAPDY,1
2bs2,F,29,50,21,QSATGLFLGLFMIGHMFFVST,1
2bs2,F,77,99,22,VVSFLAAFVFAVFIAHAFLAMR,1
2bs2,F,125,151,26,WWIQAMTGFAMFFLGSVHLYIMMTQP,1
2bs2,F,167,192,25,MWPLYLVLLFAVELHGSVGLYRLAV,1
2bs2,F,206,231,25,ANLKKLKTLMSAFLIVLGLLTFGAY,1
2y04,A,43,63,20,MSLLMALVVLLIVAGNVLVI,1
2y04,A,82,103,21,LACADLVVGLLVVPFGATLVV,1
2y04,A,108,133,25,WGSFLCELWTSLDVLCVTASIETLC,1
2y04,A,164,183,19,VWAISALVSFLPIMMHWWR,1
2y04,A,200,228,28,FVTNRAYAIASSIISFYIPLLIMIFVAL,1
2y04,A,294,315,21,IMGVFTLCWLPFFLVNIVNVF,1
2y04,A,324,344,20,FVAFNWLGYANSAMNPIIYC,1
3jch,E,296,310,14,IATIFMPLTFIAGI,1
3jch,E,330,343,13,LAVMGVIAVIMVV,1
3ze5,C,33,47,14,EGVAVLLAVVIACW,1
3ze5,C,53,68,15,TRVLLISSVMLVMIV,1
3ze5,C,102,117,15,IAIIDAVITWCILLW,1
1lbn,A,112,132,20,IFFGLSPLLLGAAMASERYL,1
1lbn,A,144,165,21,SQRRAWATVGLVWAAALALGL,1
1lbn,A,202,225,23,LGGLSVGLSFLLNTVSVATLCHV,1
1lbn,A,243,263,20,MAQLLGIMVVASVCWLPLLV,1
3ze4,C,34,48,14,GVAVLLAVVIACWL,1
3ze4,C,53,67,14,TRVLLISSVMLVMI,1
3ze4,C,103,117,14,AIIVAVITWCILLW,1
5gmy,A,12,25,13,HLSVLVIAALISV,1
5gmy,A,117,131,14,VLAILPVYLLTREV,1
5gmy,A,135,148,13,AAVIAAFLIAIVP,1
5gmy,A,165,180,15,EAFWQVSALGTFLLA,1
5gmy,A,199,216,17,YPVIAGITIGLYVLSWG,1
5gmy,A,218,230,12,FIIAPIILAFMF,1
5gmy,A,250,265,15,VVTFAVSALIYLPFA,1
5gmy,A,279,291,12,QLLVLLGSAVIA,1
5gmy,A,325,334,9,LIMGLFFVI,1
5gmy,A,381,396,15,GALFFFGMAGILYSA,1
5gmy,A,410,423,13,LIWAIAMFIALWG,1
5gmy,A,428,444,16,YYFAAVSAVYSALALS,1
5gmy,A,472,486,14,FALLIALAAIYPTY,1
2bs3,F,29,50,21,QSATGLFLGLFMIGHMFFVST,1
2bs3,F,77,99,22,VVSFLAAFVFAVFIAHAFLAMR,1
2bs3,F,125,151,26,WWIQAMTGFAMFFLGSVHLYIMMTQP,1
2bs3,F,167,192,25,MWPLYLVLLFAVQLHGSVGLYRLAV,1
2bs3,F,206,232,26,ANLKKLKTLMSAFLIVLGLLTFGAYV,1
1kf6,P,13,38,25,WGLFGAGGMWSAIIAPVMILLVGIL,1
1kf6,P,62,83,21,GRVFLFLMIVLPLWCGLHRMH,1
1kf6,P,94,116,22,AGKWVFYGLAAILTVVTLIGVV,1
3zdq,B,168,189,21,RRLAAAVGFLTMSSVISMSAP,1
3zdq,B,219,239,20,AVFLCGAAANAIRVYLMQTS,1
3zdq,B,286,308,22,TENLSDGLRAGAQASVGISMMF,1
3zdq,B,316,337,21,FVLSVVPPVSIIAVIYGRYLR,1
3zdq,B,391,413,22,AFARAGFFGATGLSGNLIVLSV,1
3zdq,B,435,455,20,MYAFWVGISIGGLSSFYSEL,1
3jav,D,2273,2295,22,SFWSSISFNLAVLMNLLVAFFY,1
3jav,D,2323,2346,23,VIALPKPHGIRALIASTILRLIF,1
3jav,D,2361,2381,20,VCNKIIFLMSFVGNCGTFTR,1
3jav,D,2408,2428,20,HEFFYSLLLFDLVYREETLL,1
3jav,D,2440,2459,19,IILTAALALILVYLFSIVG,1
3jav,D,2565,2597,32,RVIYDLLFFFMVIIIVLNLIFGVIIDTFADLR,1
3aso,Z,17,37,20,GLSVTFLSFLLPAGWVLYHL,1
4jc6,D,41,58,17,IAEFIATLLFLYITVAT,1
4jc6,D,76,93,17,IAWAFGGMIFVLVYCTA,1
4jc6,D,119,137,18,LVYMIAQCLGAICGVGLV,1
4jc6,D,163,182,19,ALGAEIIGTFVLVYTVFSA,1
4jc6,D,198,214,16,PLPIGFAVFMVHLATI,1
4jc6,D,243,260,17,IFWVGPFIGAAVAAAYH,1
3zeb,A,94,112,18,PVTWVMMIACVVVFIAMQ,1
3zeb,A,148,163,15,MHILFNLLWWWYLGG,1
3zeb,A,172,189,17,KLIVITLISALLSGYVQ,1
3zeb,A,199,213,14,LSGVVYALMGYVWL,1
3zeb,A,228,245,17,LIIFALIWIVAGWFDLF,1
3zeb,A,250,267,17,NGAHIAGLAVGLAMAFV,1
3aqp,A,10,24,14,LLGVFLLALLFVWK,1
3aqp,A,274,289,15,IRSALIGTLAIFLLI,1
3aqp,A,302,319,17,LGLLYTSALILGLLSGL,1
3aqp,A,327,342,15,IAGLVLTLGAAVDGN,1
3aqp,A,375,391,16,DVNIAHLLAAAALYQY,1
3aqp,A,398,414,16,FAVILAIGVVASVFSN,1
3aqp,A,452,468,16,AATLLLAALAAGVVFA,1
3aqp,A,571,587,16,MAVLVGLGLILLYVAF,1
3aqp,A,595,615,20,ASILAVAHDVAIVAGMYSLL,1
3aqp,A,623,638,15,IAALLTIVGYSINDS,1
3aqp,A,675,690,15,SLTTLLPILALLFLG,1
3aqp,A,695,712,17,DFALAIFVGIFVGTYSS,1
3d9b,C,11,25,14,AWVIAIIIMLAGGL,1
3d9b,C,342,357,15,TLVEAIILVFLVMYL,1
3d9b,C,366,383,17,IPTIAVPVVLLGTFAVL,1
3d9b,C,398,411,13,VLAIGLLVDDAIV,1
3d9b,C,442,456,14,VGIAMVLSAVFVPM,1
3d9b,C,472,489,17,TIVSAMALSVLVALILT,1
3d9b,C,542,556,14,VLYLIIVVGMAYLF,1
3d9b,C,876,891,15,YAISLIVVFLCLAAL,1
3d9b,C,899,916,17,SVMLVVPLGVIGALLAA,1
3d9b,C,929,943,14,GLLTTIGLSAKNAI,1
3d9b,C,975,991,16,LMTSLAFILGVMPLVI,1
3d9b,C,1004,1019,15,TGVMGGMVTATVLAI,1
5g54,A,14,38,24,FEFIDHLLTMGVGVHFAALIFFLV,1
5g54,A,50,74,24,TALSCIVMVSAGLILNSQAVMWTD,1
5g54,A,91,112,21,NGYRYVNWMATIPCLLLQLLI,1
5g54,A,121,144,23,FSTATWLILAAWGMIITGYVGQL,1
5g54,A,154,176,22,IWGAVSTAFFVVMNWIVGTKIF,1
5g54,A,191,214,23,KVFWLMMFAWTLYPIAYLVPAFM,1
5g54,A,219,243,24,VVLRQLLFTIADISSKVIYGLMIT,1
4cg7,C,72,83,11,VLVMSLLFIAS,1
1r3i,K,26,50,24,RAAGAATVLLVIVLLAGSYLAVLA,1
1r3i,K,87,111,24,GRCVAVVVMVAGITSFGLVTAALA,1
2lpf,A,29,50,21,QNLFINFALILIFLLLIAIIV,1
1u7g,C,16,33,17,TALVLFMTIPGIALFYG,1
1u7g,C,45,63,18,TQVTVTFALVCILWVVYG,1
1u7g,C,103,120,17,QGSFACITVGLIVGALA,1
1u7g,C,126,144,18,AVLIFVVVWLTLSYIPIA,1
1u7g,C,163,180,17,GTVVHINAAIAGLVGAY,1
1u7g,C,200,216,16,VFTGTAILYIGWFGFN,1
1u7g,C,232,251,19,NTVVATAAAILGWIFGEWA,1
1u7g,C,259,276,17,GACSGAIAGLVGVTPAC,1
1u7g,C,282,302,20,GALIIGVVAGLAGLWGVTML,1
1u7g,C,312,329,17,DVFGVHGVCGIVGCIMT,1
1u7g,C,356,381,25,ESIAITIVWSGVVAFIGYKLADLTV,1
4xph,A,35,57,22,FLLSVIGFAVDLANVWRFPYLC,1
4xph,A,63,82,19,AFLVPYGIMLAVGGIPLFY,1
4xph,A,110,133,23,YAVVLIAFYVGFYYNVIIAWSLR,1
4xph,A,238,255,17,MALCLLIVYLICYFSLW,1
4xph,A,261,281,20,GKVVWFTALFPYAVLLILLI,1
4xph,A,304,328,24,YKAEVWVDAATQVFFSLGPGFGVL,1
4xph,A,345,363,18,LLTSFINSATSFIAGFVI,1
4xph,A,409,430,21,FFMMLATLGLDSSFGGMEAII,1
4xph,A,446,464,18,FVAGLFSLYFVVGLASCT,1
4xph,A,471,492,21,HLLDRYAAGYSILVAVFFEAI,1
4xph,A,522,543,21,WRFVAPIFLLFITVYGLIGYE,1
4xph,A,555,573,18,ANALGWCIAGSSVVMIPA,1
2l0l,A,8,21,13,VALFGVLGAALIG,1
2leg,B,15,31,16,LLMAFTALALELTALW,1
2leg,B,48,66,18,VALFGVLGAALIGAIAPK,1
2leg,B,71,86,15,VAMVIWLYSAFRGVQ,1
2leg,B,147,162,15,GIFIAYLIVAVLVVI,1
1rqk,H,11,31,20,LASLAIYSFWIFLAGLIYYL,1
5ws5,z,8,25,17,LAALVILSFVMVIGVPV,1
5ws5,z,39,54,15,IFLGSGLWIALVLVV,1
1yce,K,11,32,21,AASAVGAGTAMIAGIGPGVGQ,1
1yce,K,63,84,21,AESTGIYSLVIALILLYANPF,1
2npd,C,15,32,17,CTALVLFMTIPGIALFY,1
2npd,C,46,64,18,QVTVTFALVCILWVVYGY,1
2npd,C,102,119,17,FQGSFACITVGLIVGAL,1
2npd,C,127,147,20,VLIFVVVWLTLSYIPIAHMV,1
2npd,C,161,178,17,AGGTVVFINAAIAGLVG,1
2npd,C,202,219,17,TGTAILYIGWFGFNAGS,1
2npd,C,231,249,18,VNTVVATAAAILGWIFGE,1
2npd,C,261,276,15,CSGAIAGLVGVTPAC,1
2npd,C,282,299,17,GALIIGVVAGLAGLWGV,1
2npd,C,313,332,19,VFGVHGVCGIVGCIMTGIF,1
2npd,C,353,377,24,VQLESIAITIVWSGVVAFIGYKLA,1
5iwo,D,154,170,16,LLLLVIFYVFAVMGTK,1
5iwo,D,214,233,19,WIYFVSFILVSSFTVLNLF,1
3mpn,B,13,32,19,LILAMAGNAVGLGNFLRFP,1
3mpn,B,44,63,19,IPYIIAFLLVGIPLMWIEW,1
3mpn,B,90,124,34,KILGVFGLWIPLVVAIYYVYIESWTLGFAIKFLV,1
3mpn,B,167,185,18,AYIVFLITMCINVSILIR,1
3mpn,B,191,212,21,ERFAKIAMPTLFILAVFLVIR,1
3mpn,B,244,266,22,IAAVGQIFFTLSLGFGAIITYA,1
3mpn,B,277,297,20,SGLTAATLNEKAEVILGGSI,1
3mpn,B,340,367,27,GFLWFFLLFFAGLTSSIAIMQPMIAFL,1
3mpn,B,378,396,18,VLWTAAIVFFSAHLVMFL,1
3mpn,B,400,426,26,DEMDFWAGTIGVVFFGLTELIIFFWI,1
3mpn,B,445,469,24,RIYYYVMRYITPAFLAVLLVVWAR,1
3mpn,B,484,502,18,ITRFYIIGLFLFLTFLVF,1
3aeb,D,41,61,20,HWTGERVVSVLLLGLLPAAY,1
3aeb,D,69,89,20,YSLAAALTLHGHWGIGQVVT,1
3aeb,D,99,118,19,AAKAGLLALSAFTFAGLCY,1
5ec1,F,26,50,24,RAAGAATVLLVIVLLAGSYLAVLA,1
5ec1,F,87,111,24,GRLVAVVVMVAGITSFGLVTAALA,1
3fb6,F,28,50,22,AGAATVLLVIVLLAGSYLAVLA,1
3fb6,F,87,111,24,GRCVAVVVMVAGITSFGLVTAALA,1
5itc,C,18,36,18,WLALGTIGMLLGMLYFIA,1
5itc,C,52,69,17,TILIPAIAAASYLSMFF,1
5itc,C,87,103,16,WARYADWLFTTPLLLL,1
5itc,C,118,136,18,LVGIDAFMIVTGLVATLT,1
5itc,C,141,160,19,RYAFWTISTISMVFLLYYL,1
5itc,C,183,200,17,NIILVTWAIYPVAWLVG,1
5itc,C,212,230,18,TLLFMVLDLVAKVGFGFI,1
3ae4,D,42,61,19,WTGERVVSVLLLGLLPAAY,1
3ae4,D,69,89,20,YSLAAALTLHGHWGIGQVVT,1
3ae4,D,97,117,20,QKAAKAGLLALSAFTFAGLC,1
4n7k,M,53,71,18,SLGVLSLFSGLMWFFTIG,1
4n7k,M,118,135,17,SFFMFVAVWSWWGRTYL,1
4n7k,M,145,163,18,TAWAFLSAIWLWMVLGFI,1
4n7k,M,201,221,20,HGLSIAFLYGSALLFAMHGA,1
4n7k,M,266,285,19,RWAIWMAVLVTLTGGIGIL,1
4uv3,I,135,142,7,SGGVGAR,1
4uv3,I,147,154,7,ADTQYQL,1
4uv3,I,183,190,7,YEVQAGV,1
4uv3,I,202,209,7,EVGYTSN,1
5jdl,A,10,27,17,LGLILLYYGSDWFVLGS,1
5jdl,A,40,56,16,IGATVMAIGTSLPEIL,1
5jdl,A,74,92,18,IGSCICNIGLVLGLSAII,1
5jdl,A,105,120,15,LVYLLFVIFAAVIGI,1
5jdl,A,127,143,16,GVVLLILFIIYLRWTV,1
5jdl,A,163,182,19,SLVLLIIGLIGVLVGAELF,1
5jdl,A,207,222,15,GTSLPELMVSLAAAK,1
5jdl,A,229,247,18,LGNVIGSNIADIGGALAV,1
5jdl,A,259,274,15,QMAVLVIMSLLLYLF,1
5jdl,A,283,298,15,QGILFLALYIIAIAS,1
1fnq,H,12,29,17,ASLAIYSFWIFLAGLIY,1
5avu,G,23,39,16,LIVAAVLCVIGIIILL,1
4wmz,A,28,53,25,QRISLIIIIPFIYNIVWQLLYSLRK,1
5aw0,G,23,39,16,LIVAAVLCVIGIIILL,1
3uu6,E,199,218,19,NIILPMLFILFISWTAFWS,1
3uu6,E,222,240,18,ANVTLVVSTLIAHIAFNI,1
3uu6,E,257,275,18,IIFMIYLFYFVAVIEVTV,1
3uu6,E,292,313,21,RASRIAFPVVFLLANIILAFL,1
5t4o,V,17,30,13,GLAAIGAAIGIGI,1
5t4o,V,55,69,14,VMGLVDAIPMIAVG,1
3kss,C,15,32,17,VLMGALFLSIWGTWTII,1
3kss,C,338,355,17,SGKLLEEFIVVAVVCAL,1
3kss,C,362,383,21,ALVAIISLPLGLCIAFIVMHF,1
3kss,C,394,409,15,GIAIAVGAMVDAAIV,1
3kss,C,450,465,15,FISLLIITLSFIPIF,1
3kss,C,479,499,20,FTKTYAMAGAALLAIVVIPI,1
3kss,C,539,555,16,LLVAALSVLTVLWPLN,1
3kss,C,873,889,16,LMVPMTLMIIFVLLYL,1
3kss,C,897,919,22,LLIISSVPFALVGGIWLLWWMG,1
3kss,C,926,943,17,GTGFIALAGVAAEFGVV,1
3kss,C,985,1001,16,MTVAVIIAGLLPILWG,1
3kss,C,1010,1027,17,RIAAPMIGGMITAPLLS,1
2hqf,C,12,24,12,WVIAIIIMLAGG,1
2hqf,C,343,357,14,LVEAIILVFLVMYL,1
2hqf,C,366,382,16,IPTIAVPVVLLGTFAV,1
2hqf,C,399,410,11,LAIGLLVDDAI,1
2hqf,C,442,455,13,VGIAMVLSAVFVP,1
2hqf,C,472,489,17,TIVSAMALSVLVALILT,1
2hqf,C,542,555,13,VLYLIIVVGMAYL,1
2hqf,C,878,890,12,ISLIVVFLCLAA,1
2hqf,C,898,915,17,FSVMLVVPLGVIGALLA,1
2hqf,C,930,943,13,LLTTIGLSAANAI,1
2hqf,C,976,990,14,MTSLAFILGVMPLV,1
2hqf,C,1005,1019,14,GVMGGMVTATVLAI,1
1f50,C,11,32,21,WLALGTALMGLGTLYFLVKGM,1
1f50,C,43,62,19,AITTLVPAIAFTMYLSMLL,1
1f50,C,80,98,18,ARYADWLFTTPLLLLDLA,1
1f50,C,107,127,20,ILALVGADGIMIGTGLVGAL,1
1f50,C,134,153,19,FVWWAISTAAMLYILYVLF,1
1f50,C,174,192,18,RNVTVVLWSAYPVVWLIG,1
1f50,C,204,224,20,TLLFMVLDVSAKVGFGLILL,1
4p19,C,14,29,15,KILIGLILGAIVGLI,1
4p19,C,43,64,21,KPFGDLFVRLLCMLVMPIVFA,1
4p19,C,94,110,16,FAVTLGIIMARLFNPG,1
4p19,C,131,140,9,HILLDIVPT,1
4p19,C,151,161,10,LPTIFFAIIL,1
4p19,C,201,217,16,MQYAPIGVFALIAYVM,1
4p19,C,225,242,17,GELAKVTAAVYVGLTLQ,1
4p19,C,312,327,15,GTALYQGVATFFIAN,1
4p19,C,334,350,16,VGQQLTIVLTAVLASI,1
4p19,C,357,375,18,AGAIMLCMVLHSVGLPLT,1
4p19,C,380,397,17,AAYAMILGIDAILDMGR,1
1zp0,D,42,61,19,WTGERVVSVLLLGLLPAAY,1
1zp0,D,68,89,21,DYSLAAALTLHGHWGIGQVVT,1
1zp0,D,98,118,20,KAAKAGLLALSAFTFAGLCY,1
5hs1,A,28,52,24,QRISLIIIIPFIYNIVWQLLYSLR,1
1jvm,D,27,50,23,AAGAATVLLVIVLLAGSYLAVLA,1
1jvm,D,87,111,24,GRCVAVVVMVAGITSFGLVTAALA,1
5c78,D,12,36,24,DKNFLFFLLVFSVFVSFIETFAIS,1
5c78,D,80,101,21,VFYVFRALLNAYYFHLLARFS,1
5c78,D,147,168,21,SSFLLLMSEIFVVLLLYALML,1
5c78,D,175,197,22,LFLSIFMVLNAFILVKILSPII,1
5c78,D,251,273,22,NESVAAVPRIYLEGIGFCVLVF,1
5c78,D,295,317,22,FVLALYRLMPSANRIITSYHDL,1
2xtv,A,96,111,15,TWVMMIACVVVFIAM,1
2xtv,A,140,163,23,HALMHFSLMHILFNLLWWWYLGG,1
2xtv,A,175,189,14,VITLISALLSGYVQ,1
2xtv,A,199,213,14,LTGVVYALMGYVWL,1
2xtv,A,228,245,17,LIIFALIWIVAGWFDLF,1
2xtv,A,251,266,15,GAHIAGLAVGLAMAF,1
4ymu,C,16,44,28,SGLIMTLKLTFLAVTIGVLMGLFIALMK,1
4ymu,C,49,74,25,PIKLVASSYIEVIRGTPLLVQLLLI,1
4ymu,C,89,107,18,AGVSALAINSSAYVAEII,1
4ymu,C,147,164,17,ALGNEFIVMLKESAIVS,1
4ymu,C,190,208,18,IIAAIYFVMTLTFSKLLS,1
5aym,A,15,31,16,GRLLTRSGDQAWDFVV,1
5aym,A,50,65,15,LIVKIGTFLLTPSSG,1
5aym,A,80,95,15,VWLQFFAILAGMVFF,1
5aym,A,115,135,20,FIALALSGVMASLGSQITDI,1
5aym,A,156,173,17,WLRRIDLATEVGAPILA,1
5aym,A,190,204,14,LIGLWNLVSFVPEY,1
5aym,A,245,261,16,LILSYALLWLSVLSPH,1
5aym,A,286,301,15,GAVFGLISTVSFPYL,1
5aym,A,310,324,14,SRWHLGFQGVTLGI,1
5aym,A,344,359,15,LLSRVGLYGFSNGEF,1
5aym,A,376,391,15,LSSLTTTSATLILFS,1
5aym,A,409,423,14,LAAVLLANVVFIKW,1
4byg,A,85,104,19,WIALMLTIPVVILEMGGHG,1
4byg,A,113,135,22,SSWIQLLLATPVVLWGGWPFFK,1
4byg,A,147,169,22,MFTLIAMGIGVAWIYSMVAVLW,1
4byg,A,185,201,16,VYFEAAAVITTLVLLG,1
4byg,A,340,359,19,GWFVPAVILVAVLSFIVWA,1
4byg,A,371,389,18,IAAVSVLIIACPCALGLA,1
4byg,A,681,700,19,LFFAFIYNVLGVPLAAGVL,1
4byg,A,708,727,19,SPMIAAAAMALSSVSVIIN,1
2c65,A,486,498,12,PSVPGLLRLIGL,1
4lto,D,151,170,19,WIALLLLVIFYVFAVMGTK,1
4lto,D,214,236,22,WIYFVSFILVSSFTVLNLFIGI,1
1okc,A,5,30,25,SFLKDFLAGGVAAAISKTAVAPIER,1
1okc,A,73,99,26,LANVIRYFPTQALNFAFKDKYKQIFL,1
1okc,A,109,138,29,RYFAGNLASGGAAGATSLCFVYPLDFART,1
1okc,A,173,202,29,QGFNVSVQGIIIYRAAYFGVYDTAKGMLP,1
1okc,A,208,235,27,IIVSWMIAQTVTAVAGLVSYPFDTVRR,1
1okc,A,273,293,20,WSNVLRGMGGAFVLVLYDEI,1
4yl0,C,16,35,19,LLCSTLLVIKMYVVAIITG,1
4yl0,C,69,90,21,RAHRNDMETIYPFLFLGFVYS,1
4yl0,C,99,119,20,WMHFLVFLVGRVAHTVAYLG,1
4yl0,C,125,146,21,RSVTYTLAQLPCASMALQILW,1
2mn6,B,4,18,14,SIWQLLIIAVIVVL,1
2mn6,B,25,40,15,GSIGSDLGASIKGFK,1
5tua,B,74,92,18,SLNYFALLFLNFFEQPLW,1
5tua,B,120,136,16,IIYEVITLAILLVHTF,1
5tua,B,155,172,17,KVACVVILFVDVLVDFL,1
5tua,B,185,199,14,IAPYVRVIIFILSI,1
5tua,B,217,239,22,NILALWMLFLLFASWIAFVMFE,1
5tua,B,280,302,22,SSVFFVLYVLIGVYFVTNLILA,1
5tua,B,435,452,17,ISFILIINFIAVVVETT,1
5tua,B,464,483,19,QVAEFVFGWIYVLEMALKI,1
5tua,B,496,516,20,NRFDFLVTWVIVIGETATFI,1
5tua,B,528,545,17,WIRYLLLARMLRLIRLL,1
5tua,B,562,586,24,PSLMPYLGTIFCVLCIYCSIGVQV,1
5tua,B,647,671,24,SITYFVSFYVITILLLLNLVVAFV,1
5hej,E,202,225,23,YYLWSFILPLGLIIAASWSVFWL,1
5hej,E,231,253,22,LQTSFTLMLTVVAYAFYTSNIL,1
5hej,E,260,282,22,VIDQMIIAGYGSIFAAILLIIF,1
5hej,E,297,317,20,QRCRLAFPLGFLAIGCVLVI,1
2x6c,D,46,70,24,PVFITLITGLYLVTNALFALAYLA,1
2x6c,D,112,132,20,VTLEALCGMLGLAVAASLIY,1
3uon,A,25,43,18,IVLVAGSLSLVTIIGNIL,1
3uon,A,65,84,19,ACADLIIGVFSMNLYTLYT,1
3uon,A,95,115,20,CDLWLALDYVVSNASVMNLL,1
3uon,A,146,166,20,AWVLSFILWAPAILFWQFIV,1
3uon,A,177,203,26,IQFFSNAAVTFGTAIAAFYLPVIIMT,1
3uon,A,393,414,21,LAFIITWAPYNVMVLINTFCA,1
3uon,A,417,439,22,PNTVWTIGYWLCYINSTINPAC,1
2zxw,Z,13,35,22,EQAIGLSVTFLSFLLPAGWVLY,1
5hd8,B,40,64,24,VVGTLVGLAAVAFDKGVAWLQNQR,1
5hd8,B,80,96,16,VAFLCSAVLAMFGYFL,1
5hd8,B,129,142,13,VKFFGGLGTLGGG,1
5hd8,B,144,155,11,LGREGPTVQIG,1
5hd8,B,216,233,17,AVFIGVIMSTIMYRIFN,1
5hd8,B,250,273,23,TLWLYLILGIIFGIFGPIFNKWV,1
5hd8,B,292,306,14,LMGGAIGGLCGLLG,1
5hd8,B,335,351,16,IFVARVITTLLCFSSG,1
5hd8,B,353,368,15,GGIFAPMLALGTVLG,1
5hd8,B,390,403,13,IAGMGALLAASIR,1
5hd8,B,405,419,14,LTGIILVLEMTCNY,1
5hd8,B,421,439,18,ILPMIITGLGATLLAQFT,1
3k04,E,26,45,19,LFVLTILTLISGTIFYSTV,1
3k04,E,74,98,24,GKIFTILYIFIGIGLVFGFIHKLA,1
5h1r,H,8,25,17,NSVNALISRVFVQPKGD,1
5h1r,H,27,46,19,DRLNSRVTVVILAVSSALL,1
5h1r,H,110,133,23,VFALQAFLFYIPRFIWKAMIAYS,1
5h1r,H,189,212,23,LFYTLSTVWQAVNAWIQFYILTQ,1
5h1r,H,277,303,26,IFLWFWLVFVAVVSTVNCFKWIYYLC,1
5h2i,C,12,28,16,LALGTALMGLGTLYFL,1
5h2i,C,47,61,14,LVPAIAFTMYLSML,1
5h2i,C,80,94,14,ARYADWLFTTPLLL,1
5h2i,C,111,126,15,VGADGIMIGTGLVGA,1
5h2i,C,135,150,15,VWWAISTAAMLYILY,1
5h2i,C,178,192,14,VVLWSAYPVVWLIG,1
5h2i,C,204,220,16,TLLFMVLDVSAKVGFG,1
5cth,C,11,28,17,AGLAGNIFALALFLSPV,1
5cth,C,47,63,16,YLFSLLNCLICLWYGL,1
5cth,C,72,90,18,VATVNGIGAVFQLAYICL,1
5cth,C,105,122,17,GLLVLVVCGFALVSHAS,1
5cth,C,134,152,18,VGAVSMASLISMFASPLA,1
5cth,C,169,186,17,LSLSTFLMSASFALYGL,1
5cth,C,191,212,21,FIYFPNGLGLILGAMQLALYA,1
2qjy,F,12,31,19,DFLYYATAGAGAVATGAAV,1
4uc2,B,6,24,18,LFLTFLAACGAPATTGAL,1
4uc2,B,40,62,22,PPRWVFPLAWTSLYFLMSLAAM,1
4uc2,B,72,91,19,ALAFYAAQLAFNTLWTPVF,1
4uc2,B,99,119,20,ALAVVMVMWLFVAATMWAFF,1
4uc2,B,125,145,20,GVLFVPYLIWATATTGLNFE,1
5tzy,A,8,32,24,FGLYVAAFALGFPLNVLAIRGATA,1
5tzy,A,42,65,23,VYALNLGCSDLLLTVSLPLKAVE,1
5tzy,A,78,102,24,CPVFAVAHFFPLYAGGGFLAALSA,1
5tzy,A,124,149,25,GVCAAIWALVLCHLGLVFGLEAPGG,1
5tzy,A,179,203,24,GPARFSLSLLLFFLPLAITAFCFV,1
5tzy,A,2224,2250,26,VAGGALLTLLLCVGPYNASNVASFLY,1
5tzy,A,2258,2278,20,KLGLITGAWSVVLNPLVTGY,1
5fgz,A,73,86,13,IVFAVLIAIYGVY,1
4rdq,E,34,55,21,EFLIFISLYFAISLVYRLILS,1
4rdq,E,59,80,21,LMFEKLALYCNSYAELIPVSF,1
4rdq,E,243,260,17,VYSFFLACLIGRQFLDP,1
4rdq,E,265,285,20,GHELDLFVPVFTFLQFFFYA,1
4u4g,D,522,541,19,YEIWMCIVFAYIGVSVVLF,1
4u4g,D,599,621,22,IVGGVWWFFTLIIISSYTANLA,1
4u4g,D,789,810,21,SNVAGVFYILVGGLGLAMLVA,1
5hk7,D,154,168,14,LLLLVIFYVFAVMG,1
5hk7,D,216,233,17,YFVSFILVSSFTVLNLF,1
3b45,A,94,113,19,PVTWVMMIACVVVFIAMQI,1
3b45,A,144,166,22,HFSLMHILFNLLWWWYLGGAVE,1
3b45,A,172,190,18,KLIVITLISALLSGYVQQ,1
3b45,A,198,214,16,GLSGVVYALMGYVWLR,1
3b45,A,228,245,17,LIIFALIWIVAGWFDLF,1
3b45,A,247,268,21,SMANGAHIAGLAVGLAMAFVD,1
4ub6,z,8,24,16,LAALVILSFVMVIGVP,1
4ub6,z,40,55,15,FLGSGLWIALVLVVG,1
5x9r,B,32,45,13,FALITLLLSHFYN,1
5x9r,B,47,69,22,PTDIVGGFAIMFIIGAIFGEIG,1
5x9r,B,81,96,15,APVMIFLVAAYFVYA,1
5x9r,B,103,127,24,IDAISNVMDKSNFLNLFIAVLITG,1
5x9r,B,142,165,23,GYIPTILMGIVGASIFGIAIGLV,1
5x9r,B,216,230,14,TIANIFAIVFAAVL,1
5x9r,B,273,289,16,LSTTCFLLAYVVAKKI,1
5x9r,B,291,311,20,SIGGVAIHYFAWMVLIVAAL,1
5x9r,B,337,351,14,WVLMVGVGVCYTDL,1
5x9r,B,361,381,20,NVVIAAIIVIGAVLGAAIGG,1
5x9r,B,420,438,18,SYAQISSRLGGGIVLVIA,1
2xok,T,13,28,15,ISTIGLLGAGIGIAI,1
2xok,T,54,71,17,FALSEATGLFCLMVSFL,1
2zup,B,15,31,16,LLMAFTALALELTALW,1
2zup,B,48,65,17,VALFGVLGAALIGAIAP,1
2zup,B,71,89,18,VAMVIWLYSAFRGVQLTY,1
2zup,B,146,162,16,LGIFIAYLIVAVLVVI,1
1s6e,A,20,41,21,KAISRALFAEFLATGLYVFFG,1
1s6e,A,55,73,18,LQIAITFNLVTAMAVQVT,1
1s6e,A,99,123,24,AVAYVAAQLVGATVGAALLYGVMP,1
1s6e,A,145,163,18,AVELLLTLQLVLCVFAST,1
1s6e,A,171,189,18,PATMIGISWALGHLIGIL,1
1s6e,A,212,235,23,HWVFWVGPLMGALLASLIYNFVL,1
2cyd,J,18,34,16,MATATIFSGIGSAKGV,1
2cyd,J,61,77,16,PGTQGLYGFVIAFLIF,1
2cyd,J,94,110,16,ASLPIAFTGLFSGIAQ,1
2cyd,J,137,153,16,VETYAILGFVISFLLV,1
2f2m,A,11,28,17,LAEVIGTTLMKFSEGFT,1
2f2m,A,34,55,21,GTIICYCASFWLLAQTLAYIP,1
2f2m,A,59,80,21,YAIWSGVGIVLISLLSWGFFG,1
2f2m,A,87,105,18,IIGMMLICAGVLIINLLS,1
5va2,D,410,429,19,DWLILLLVIYTAVFTPYSA,1
5va2,D,453,471,18,VVDLIVDIMFIVDILINF,1
5va2,D,494,510,16,KGWFLIDMVAAIPFDL,1
5va2,D,523,539,16,LKTARLLRLVRVARKL,1
5va2,D,547,568,21,AVLFLLMCTFALIAHWLACIW,1
5va2,D,640,664,24,SICVMLIGSLMYASIFGNVSAIIQ,1
2a65,B,13,32,19,LILAMAGNAVGLGNFLRFP,1
2a65,B,44,63,19,IPYIIAFLLVGIPLMWIEW,1
2a65,B,90,124,34,KILGVFGLWIPLVVAIYYVYIESWTLGFAIKFLV,1
2a65,B,167,185,18,AYIVFLITMFINVSILIR,1
2a65,B,191,212,21,ERFAKIAMPTLFILAVFLVIR,1
2a65,B,242,265,23,VWIAAVGQIFFTLSLGFGAIITY,1
2a65,B,277,297,20,SGLTAATLNEKAEVILGGSI,1
2a65,B,340,367,27,GFLWFFLLFFAGLTSSIAIMQPMIAFL,1
2a65,B,378,396,18,VLWTAAIVFFSAHLVMFL,1
2a65,B,400,426,26,DEMDFWAGTIGVVFFGLTELIIFFWI,1
2a65,B,445,469,24,RIYYYVMRYITPAFLAVLLVVWAR,1
2a65,B,484,502,18,ITRFYIIGLFLFLTFLVF,1
5a44,C,10,32,22,IWLALGTALMGLGTLYFLVKGM,1
5a44,C,41,62,21,FYAITTLVPAIAFTMYLSMLL,1
5a44,C,80,99,19,ARYADWLFTTPLLLLDLAL,1
5a44,C,106,127,21,TILALVGADGIMIGTGLVGAL,1
5a44,C,134,152,18,FVWWAISTAAMLYILYVL,1
5a44,C,171,192,21,KVLRNVTVVLWSAYPVVWLIG,1
5a44,C,203,225,22,ETLLFMVLDVSAKVGFGLILLR,1
3ir6,F,5,27,22,MFFFDIYPYIAGAVFLIGSWLR,1
3ir6,F,51,73,22,SNLFHIGILGIFVGHFFGMLTP,1
3ir6,F,87,113,26,KMAMFAGGASGVLCLIGGVLLLKRRL,1
3ir6,F,125,145,20,DILILSLLVIQCALGLLTIP,1
3ir6,F,183,204,21,FRLHLVLGMTLFLLFPFSRLI,1
5hkt,D,154,170,16,LLLLVIFYVFAVMGTK,1
5hkt,D,216,233,17,YFVSFILVSSFTVLNLF,1
1c3w,C,11,33,22,WLALGTALMGLGTLYFLVKGMG,1
1c3w,C,41,62,21,FYAITTLVPAIAFTMYLSMLL,1
1c3w,C,80,100,20,ARYADWLFTTPLLLLDLALL,1
1c3w,C,106,127,21,TILALVGADGIMIGTGLVGAL,1
1c3w,C,134,156,22,FVWWAISTAAMLYILYVLFFGF,1
1c3w,C,171,192,21,KVLRNVTVVLWSAYPVVWLIG,1
1c3w,C,204,226,22,TLLFMVLDVSAKVGFGLILLRS,1
4eiy,A,5,25,20,SSVYITVELAIAVLAILGNV,1
4eiy,A,47,68,21,LAAADIAVGVLAIPFAITIST,1
4eiy,A,75,96,21,GCLFIACFVLVLTQSSIFSLL,1
4eiy,A,125,144,19,AICWVLSFAIGLTPMLGWN,1
4eiy,A,172,195,23,PMNYMVYFNFFACVLVPLLLMLG,1
4eiy,A,238,259,21,VGLFALCWLPLHIINCFTFFC,1
4eiy,A,265,286,21,PLWLMYLAIVLSHTNSVVNPF,1
3nya,A,36,57,21,GIVMSLIVLAIVFGNVLVITA,1
3nya,A,71,91,20,ITSLACADLVMGLAVVPFGA,1
3nya,A,109,129,20,TSIDVLCVTASIWTLCVIAV,1
3nya,A,151,170,19,VIILMVWIVSGLTSFLPIQ,1
3nya,A,200,220,20,IASSIVSFYVPLVIMVFVYS,1
3nya,A,275,295,20,GIIMGTFTLCWLPFFIVNIV,1
3nya,A,309,327,18,LLNWIGYVNSGFNPLIYC,1
5h3o,D,124,146,22,TCVVTVAYIYNLLFVIARQVFN,1
5h3o,D,199,220,21,FRMLWVFFDLLMDCVYLIDTF,1
5h3o,D,252,269,17,DGISLIPLDYILGWPIP,1
5h3o,D,274,291,17,GLPILRLNRLIRYKRVR,1
5h3o,D,306,330,24,FRVVVVVWYIVIIIHWNACLYFWI,1
5h3o,D,388,415,27,YAFVTLDLMCGVLIFATIVGNVGSMIS,1
3l74,W,19,40,21,FALTVVLGAVLFERAFDQGAD,1
4yzi,B,91,109,18,NILQWITFALSALCLMFY,1
4yzi,B,120,138,18,EEIYVATIEMIKFIIEYF,1
4yzi,B,156,174,18,WLRYAEWLLTCPVILIHL,1
4yzi,B,188,207,19,MGLLVSDIGGIVWATTAAL,1
4yzi,B,212,232,20,RVIFFLMGLCYGIYTFFNAA,1
4yzi,B,253,272,19,MAWLFFVSWGMFPILFILG,1
4yzi,B,284,304,20,TVGHTIIDLMSKNCWGLLGH,1
2x6a,D,47,71,24,VFITLITGLYLVTNALFALAYLAC,1
2x6a,D,108,129,21,ANTLVTLEALCGMLGLAVAAS,1
5h2k,C,12,28,16,LALGTALMGLGTLYFL,1
5h2k,C,47,61,14,LVPAIAFTMYLSML,1
5h2k,C,80,94,14,ARYADWLFTTPLLL,1
5h2k,C,111,126,15,VGADGIMIGTGLVGA,1
5h2k,C,135,150,15,VWWAISTAAMLYILY,1
5h2k,C,178,192,14,VVLWSAYPVVWLIG,1
5h2k,C,204,220,16,TLLFMVLDVSAKVGFG,1
3eh5,C,5,25,20,KGALAVILVLTLTILVFWLG,1
4gp8,C,7,25,18,ALAVILVLTLTILVFWLG,1
3k06,E,26,45,19,LFVLTILTLISGTIFYSTV,1
3k06,E,74,98,24,GKIFTILYIFIGIGLVFGFIHKLA,1
5heh,E,198,217,19,NIILPMLFILFISWTAFWS,1
5heh,E,221,239,18,ANVTLVVSTLIAHIAFNI,1
5heh,E,255,274,19,AIIFMIYLFYFVAVIEVTV,1
5heh,E,294,312,18,RIAFPVVFLLANIILAFL,1
4ej4,A,49,73,24,IAITALYSAVCAVGLLGNVLVMFG,1
4ej4,A,88,109,21,FNLALADALATSTLPFQSAKY,1
4ej4,A,117,141,24,ELLCKAVLSIDYYNMFTSIFTLTM,1
4ej4,A,170,189,19,CIWVLASGVGVPIMVMAVT,1
4ej4,A,199,230,31,LQFPSPSWYWDTVTKICVFLFAFVVPILIIT,1
4ej4,A,264,288,24,VVVGAFVVCWAPIHIFVIVWTLVD,1
4ej4,A,296,320,24,VAALHLCIALGYANSSLNPVLYAF,1
1m3x,H,12,29,17,ASLAIYSFWIFLAGLIY,1
1s8l,A,11,32,21,WLALGTALMGLGTLYFLVKGM,1
1s8l,A,42,62,20,YAITTLVPAIAFTMYLSMLL,1
1s8l,A,80,100,20,ARYASWLFTTPLLLLDLALL,1
1s8l,A,104,125,21,QGTILALVGADGIMIGTGLVG,1
1s8l,A,137,157,20,WAISTAAMLYILYVLFFGFT,1
1s8l,A,171,190,19,KVLRNVTVVLWSAYPVVWL,1
1s8l,A,204,225,21,TLLFMVLDVSAKVGFGLILLR,1
5ayo,A,12,36,24,LLLGRLLTRSGDQAWDFVVPFALL,1
5ayo,A,44,64,20,VAAFYYLIVKIGTFLLTPSS,1
5ayo,A,78,98,20,WGVWLQFFAILAGMVFFGML,1
5ayo,A,111,134,23,LSVLFIALALSGVMASLGSQITD,1
5ayo,A,158,178,20,RRIDLATEVGAPILAGALFA,1
5ayo,A,187,206,19,GLFLIGLWNLVSFVPEYFL,1
5ayo,A,246,270,24,ILSYALLWLSVLSPHGVLLAAYLK,1
5ayo,A,278,301,23,EIGLFRGLGAVFGLISTVSFPYL,1
5ayo,A,309,329,20,SSRWHLGFQGVTLGIAVTAF,1
5ayo,A,338,358,20,VFLGCILLSRVGLYGFSNGE,1
5ayo,A,379,396,17,LTTTSATLILFSAGSLL,1
5ayo,A,402,424,22,KYLVYVSLAAVLLANVVFIKWS,1
2c73,A,486,499,13,PSVPGLLRLIGLT,1
4ymw,C,4,44,40,FLSMVKYTPLFISGLIMTLKLTFLAVTIGVLMGLFIALMK,1
4ymw,C,49,78,29,PIKLVASSYIEVIRGTPLLVQLLLIYNGL,1
4ymw,C,86,107,21,AFTAGVSALAINSSAYVAEII,1
4ymw,C,149,168,19,GNEFIVMLKESAIVSVIGF,1
4ymw,C,186,207,21,EPYIIIAAIYFVMTLTFSKLL,1
5jje,D,23,38,15,AVFIFVGALTVLFGA,1
5jje,D,65,83,18,GLIILLGINLGLVAATLG,1
5d0y,B,18,33,15,LAMVIAIKVVLGQFK,1
5d0y,B,40,52,12,VGLGFIGSVMLG,1
5d0y,B,61,77,16,AGGALSDLVSSAIFGN,1
5d0y,B,82,96,14,IGFTLTAALESMIY,1
5d0y,B,111,132,21,ASVICVTVICYIGLNTLWVSM,1
5d0y,B,146,167,21,LKEMITPWIHMVVVWFILEGL,1
2c67,A,486,498,12,PSVPGLLRLIGL,1
5azc,A,24,45,21,WYGLMYLVGFIFAMWLATRRA,1
5azc,A,55,79,24,EVENLLYAGFLGVFLGGRIGYVLF,1
5azc,A,100,119,19,SFHGGLIGVIVVMIIFARR,1
5azc,A,124,146,22,FQVSDFIAPLIPFGLGAGRLGN,1
5azc,A,199,219,20,LYELLLEGVVLFIILNLYIR,1
5azc,A,226,244,18,VSGLFLIGYGAFRIIVEF,1
5azc,A,256,281,25,VQYISMGQILSIPMIVAGVIMMVWA,1
2hqd,C,12,25,13,WVIAIIIMLAGGL,1
2hqd,C,343,357,14,LVEAIILVFLVMYL,1
2hqd,C,366,382,16,IPTIAVPVVLLGTFAV,1
2hqd,C,399,410,11,LAIGLLVDAAI,1
2hqd,C,442,455,13,VGIAMVLSAVFVP,1
2hqd,C,472,489,17,TIVSAMALSVLVALILT,1
2hqd,C,541,555,14,LVLYLIIVVGMAYL,1
2hqd,C,878,890,12,ISLIVVFLCLAA,1
2hqd,C,898,915,17,FSVMLVVPLGVIGALLA,1
2hqd,C,930,944,14,LLTTIGLSAKNAIL,1
2hqd,C,975,990,15,LMTSLAFILGVMPLV,1
2hqd,C,1005,1019,14,GVMGGMVTATVLAI,1
5cbg,E,6,19,13,MFKRFFGAVRTSW,1
5cbg,E,28,45,17,LSLAIIVTAATIFYTLA,1
5cbg,E,75,96,21,SKIFTLVYAILVVGLFVTVGG,1
2mof,A,383,403,20,ALAGVLILVLLAYFIGLKHH,1
5t77,A,14,26,12,FFSRILGLFRDV,1
5t77,A,43,56,13,AIMFPFFLRKVFG,1
5t77,A,86,99,13,FSLIILALVILSY,1
5t77,A,126,139,13,ITSPSIYFIFLWA,1
5t77,A,157,168,11,PSISNITIIIG,1
5t77,A,181,194,13,IGFLIGSILMFFS,1
5t77,A,223,237,14,TMVVSQINTVVDMN,1
5t77,A,251,265,14,YASRFYLLPYGLFA,1
5t77,A,298,309,11,IPSMVGLIFLS,1
5t77,A,334,345,11,IAYTLGLPFYG,1
5t77,A,367,380,13,TIVSLSNIILDII,1
5t77,A,390,404,14,ALATSIAGIIGVLY,1
5t77,A,421,435,14,LNSLIMLFVIYLTD,1
5t77,A,442,457,15,FLIQILIGILVYLIF,1
1q5i,C,10,34,24,IWLALGTALMGLGTLYFLVKGMGV,1
1q5i,C,41,62,21,FYAITTLVPAIAFTMYLSMLL,1
1q5i,C,79,100,21,WARYADWLFTTPLLLLDLALL,1
1q5i,C,104,128,24,QGTILALVGADGIMIGTGLVGALT,1
1q5i,C,134,157,23,FVWWAISTAAMLYILYVLFFGFT,1
1q5i,C,171,195,24,KVLRNVTVVLWSAYAVVWLIGSEG,1
1q5i,C,203,226,23,ETLLFMVLDVSAKVGFGLILLRS,1
1msr,B,78,89,11,GVMAGVIGTIL,1
2z5x,A,499,519,20,GLLKIIGFSTSVTALGFVLY,1
3pjs,N,30,48,18,AATVLLVIVLLAGSYLAV,1
3pjs,N,87,107,20,GRLVAVVVMVAGITSFGLVT,1
3iga,F,26,50,24,RAAGAATVLLVIVLLAGSYLAVLA,1
3iga,F,87,112,25,GRCVAVVVMVAGITSFGLVTAALAT,1
5avw,G,23,39,16,LIVAAVLCVIGIIILL,1
1dv6,H,12,29,17,ASLAIYSFWIFLAGLIY,1
3uu4,E,199,218,19,NIILPMLFILFISWTAFWS,1
3uu4,E,222,242,20,ANVTLVVSTLIAHIAFNILV,1
3uu4,E,256,275,19,AIIFMIYLFYFVAVIEVTV,1
3uu4,E,292,313,21,RASRIAFPVVFLLANIILAFL,1
5aw2,G,23,39,16,LIVAAVLCVIGIIILL,1
4yb9,D,28,42,14,SFQYGYNVAAINSP,1
4yb9,D,72,88,16,VTVSMFPFGGFLGSLM,1
4yb9,D,104,119,15,NNIFSIVPALLMGFS,1
4yb9,D,127,143,16,IIVARVLVGICAGLSS,1
4yb9,D,167,182,15,LFITIGILVAQIFGL,1
4yb9,D,194,209,15,LLGLTGIPAVLQLLF,1
4yb9,D,284,301,17,MAGQQLSGVNAIYYYAD,1
4yb9,D,316,332,16,VTAGTGAVNVLITVCA,1
4yb9,D,348,363,15,FSVCFTACCVLTGAL,1
4yb9,D,375,393,18,SIACVISYVIGHALGPSP,1
4yb9,D,417,434,17,VHWLSNFTVGLVFPFIQ,1
4yb9,D,441,454,13,FVIFAVICLLTTV,1
3w9i,C,12,26,14,WVIALVIMLAGGLS,1
3w9i,C,344,357,13,GEAILLVFLVMYL,1
3w9i,C,366,382,16,IPTIAVPVVLLGTFGV,1
3w9i,C,398,410,12,VLAIGLLVDDAI,1
3w9i,C,443,455,12,GIAMVLSAVFLP,1
3w9i,C,471,485,14,ITIVSAMALSVIVA,1
3w9i,C,542,556,14,LIYVVIVAGMIWMF,1
3w9i,C,876,890,14,ALSLLVVFLCLAAL,1
3w9i,C,897,915,18,FSVMLVVPLGVIGALLAT,1
3w9i,C,929,942,13,LLTTIGLSAKNAI,1
3w9i,C,974,989,15,MTSLAFILGVVPLAI,1
3w9i,C,1003,1017,14,GVIGGMVTATVLAI,1
4wo1,A,16,38,22,AGIVVGDLVLTVLIALAVYFLG,1
1o0a,C,11,32,21,WLALGTALMGLGTLYFLVKGM,1
1o0a,C,42,62,20,YAITTLVPAIAFTMYLSMLL,1
1o0a,C,80,98,18,ARYADWLFTTPLLLLDLA,1
1o0a,C,106,127,21,TILALVGADGIMIGTGLVGAL,1
1o0a,C,134,155,21,FVWWAISTAAMLYILYVLFFG,1
1o0a,C,172,192,20,VLRNVTVVLWSAYPVVWLIG,1
1o0a,C,203,225,22,ETLLFMVLDVSAKVGFGLILLR,1
1qla,F,29,50,21,QSATGLFLGLFMIGHMFFVST,1
1qla,F,77,99,22,VVSFLAAFVFAVFIAHAFLAMR,1
1qla,F,125,151,26,WWIQAMTGFAMFFLGSVHLYIMMTQP,1
1qla,F,167,191,24,MWPLYLVLLFAVELHGSVGLYRLA,1
1qla,F,206,232,26,ANLKKLKTLMSAFLIVLGLLTFGAYV,1
5jdn,A,4,24,20,GVGYFLLGLILLYYGSDWFV,1
5jdn,A,40,59,19,IGATVMAIGTSLPEILTSA,1
5jdn,A,72,92,20,NAIGSCICNIGLVLGLSAII,1
5jdn,A,103,120,17,NILVYLLFVIFAAVIGI,1
5jdn,A,127,144,17,GVVLLILFIIYLRWTVK,1
5jdn,A,166,186,20,LLIIGLIGVLVGAELFVDGA,1
5jdn,A,204,222,18,VAFGTSLPELMVSLAAAK,1
5jdn,A,229,248,19,LGNVIGSNIADIGGALAVG,1
5jdn,A,258,275,17,VQMAVLVIMSLLLYLFA,1
5jdn,A,281,299,18,RWQGILFLALYIIAIASL,1
3wmf,B,118,140,22,TMIVIGFIASILEGATLPAFAI,1
3wmf,B,166,188,22,FVGIGVFEFIVAGSRTALFGIA,1
3wmf,B,236,257,21,KLGAVLFNLAQCVVGIIVAFI,1
3wmf,B,264,284,20,VLIALSPLVVLAVVVQMIEM,1
3wmf,B,339,361,22,YISDGLFFGLSMLVIFCVYALA,1
3wmf,B,382,403,21,FFSAILGFMGVGQAAQVWPDV,1
3uub,E,199,218,19,NIILPMLFILFISWTAFWS,1
3uub,E,222,240,18,ANVTLVVSTLIAHIAFNI,1
3uub,E,256,275,19,AIIFMIYLFYFVAVIEVTV,1
3uub,E,292,313,21,RASRIAFPVVFLLANIILAFL,1
4f4l,D,10,28,18,ALLTVVFYIAAVMATNLY,1
4f4l,D,70,89,19,WVFFIPFIMLTTFTVLNLF,1
5uen,B,9,31,22,AAYIGIEVLIALVSVPGNVLVI,1
5uen,B,48,69,21,VSLAVADVAVGALVIPLAILI,1
5uen,B,82,100,18,VACPVLILTQSSILALLA,1
5uen,B,127,146,19,IAGCWILSFVVGLTPMFGW,1
5uen,B,178,199,21,YMVYFNFFVWVLPPLLLMVLI,1
5uen,B,238,256,18,ILFLFALSWLPLHILNCI,1
5uen,B,269,287,18,TYIAIFLTHGNSAMNPIV,1
3v2y,A,44,67,23,IKLTSVVFILICCFIILENIFVL,1
3v2y,A,85,106,21,NLALSDLLAGVAYTANLLLSG,1
3v2y,A,115,137,22,QWFLREGSMFVALSASVFSLLA,1
3v2y,A,162,184,22,LISACWVISLILGGLPIMGWNC,1
3v2y,A,191,219,28,STVLPLYHKHYILFCTTVFTLLLLSIVI,1
3v2y,A,261,283,22,LSVFIACWAPLFILLLLDVGCK,1
3v2y,A,288,310,22,ILFRAEYFLVLAVLNSGTNPII,1
3syp,D,91,113,22,RFNLLIFVMVYTVTWLFFGMIW,1
3syp,D,169,192,23,IILLLIQSVLGSIVNAFMVGCMF,1
1kpx,A,56,81,25,SVWMIFVVTASVFTNGLVLAATMKF,1
1kpx,A,85,111,26,HPLNWILVNLAVADLAETVIASTISI,1
1kpx,A,128,152,24,EGYTVSLCGITGLWSLAIISWERW,1
1kpx,A,167,189,22,LAIVGIAFSWIWSAVWTAPPIF,1
1kpx,A,218,243,25,YMIVLMVTCCIIPLAIIMLCYLQVW,1
1kpx,A,267,290,23,RMVVVMIFAYCVCWGPYTFFACF,1
1kpx,A,306,327,21,PAYFAKSATIYNPVIYVFMNR,1
1pf4,B,26,49,23,LVVSTIALVINAAADTYMISLLK,1
1pf4,B,68,91,23,FMILGLMFVRGLSGFASSYCLSW,1
1pf4,B,144,162,18,SIVREGASIIGLLTLMFW,1
1pf4,B,169,187,18,VLIVVAPVVAFAISFVSK,1
1pf4,B,253,274,21,VIQMIASLALFAVLFLASVDS,1
1pf4,B,279,300,21,TPGTFTVVFSAMFGLMRPLKA,1
3ae6,D,42,61,19,WTGERVVSVLLLGLLPAAY,1
3ae6,D,68,88,20,DYSLAAALTLHGHWGIGQVV,1
3ae6,D,100,119,19,AKAGLLALSAFTFAGLCYF,1
2e75,Q,7,25,18,WVALLVVFTWSIAMVVWG,1
4hmk,B,14,32,18,ILAMAGNAVGLGNFLRFP,1
4hmk,B,44,63,19,IPYIIAFLLVGIPLMWIEW,1
4hmk,B,90,120,30,KILGVFGLWIPLVVAIYYVYIESWTLGFAI,1
4hmk,B,167,184,17,AYIVFLITMFINVSILI,1
4hmk,B,191,212,21,ERFAKIAMPTLFILAVFLVIR,1
4hmk,B,245,265,20,AAVGQIFFTLSLGFGAIITY,1
4hmk,B,278,297,19,GLTAATLNEKASVILGGSI,1
4hmk,B,343,364,21,WFFLLFFAGLTSSIAIMQPMI,1
4hmk,B,378,394,16,VLWTAAIVFFSAHLVM,1
4hmk,B,400,425,25,DEMDFWAGTIGVVFFGLTELIIFFW,1
4hmk,B,446,469,23,IYYYVMRYITPAFLAVLLVVWAR,1
4hmk,B,485,501,16,TRFYIIGLFLFLTFLV,1
2b2i,C,11,28,17,STALVMLMVPGVGFFYA,1
2b2i,C,40,62,22,ALSFISLIITVLLWIFYGYSVS,1
2b2i,C,91,108,17,YQMMFAAVTIAILTSAI,1
2b2i,C,115,136,21,SFILLSALWLTFVYAPFAHWL,1
2b2i,C,150,170,20,AGGMVVHISSGFAALAVAMT,1
2b2i,C,189,208,19,TLIGAALLWFGWFGFNGGS,1
2b2i,C,220,240,20,VVTNTSAAVAGFVWMVIGWI,1
2b2i,C,247,264,17,GIVSGAIAGLAAITPAA,1
2b2i,C,270,290,20,GAIVIGLVAGIVCYLAMDFR,1
2b2i,C,298,319,21,LDAWAIHGIGGLWGSVAVGIL,1
2b2i,C,342,367,25,IAVASTTAYAFLVTLILAKAVDAAV,1
4q4a,B,33,58,25,PHTFTLIMVFVFVTVSSILGVLSPY,1
4q4a,B,84,105,21,TIYALTSLLFWLQGKIMLTLS,1
4q4a,B,151,173,22,GNSIIQFFSGIVTLAGAVIMMF,1
4q4a,B,180,200,20,LVTLSIVPLTVLITQIVSSQ,1
4q4a,B,259,279,20,SGVLPPLMNMVNNLGFALIS,1
4q4a,B,299,320,21,IGYSRQFTRPLNELSNQFNMI,1
1lvi,A,30,49,19,LSACIASFIFGYQVSVLNT,1
1lvi,A,80,97,17,LASVFIGAVLGCGFSGY,1
1lvi,A,104,121,17,LSLLIIYNFFFLVSILT,1
1lvi,A,133,149,16,RLLSGFGIGLVTVSVP,1
1lvi,A,168,185,17,QLFITFGIFVAVMLGLA,1
1lvi,A,212,228,16,PSVISLIGILALVVFF,1
1lvi,A,299,316,17,LLSGLQQFTGINVLVSN,1
1lvi,A,334,351,17,VVMTAVNFLMTFPAIYI,1
1lvi,A,370,384,14,AYLPTAIANEINRN,1
1lvi,A,389,403,14,ILSIVATFVMIISF,1
1lvi,A,427,442,15,ASLASLVNWVCAIIV,1
1lvi,A,448,466,18,IIKKSPSILFIVFSVMSI,1
5b3s,Z,17,37,20,GLSVTFLSFLLPAGWVLYHL,1
5u1v,C,33,46,13,HALVFSYISFALI,1
5u1v,C,331,348,17,QLAVYIGSVISYFGLAT,1
1y9c,A,28,52,24,PLLYTVLFFVGLITNGLAMRIFFQ,1
1y9c,A,59,83,24,IIFLKNTVISDLLMILTFPFKILS,1
1y9c,A,97,123,26,QVTSVIFYFTMYISISFLGLITIDRY,1
1y9c,A,140,166,26,AKILSVVIWAFMFLLSLPNMILTNRQ,1
1y9c,A,189,213,24,VNYICQVIFWINFLIVIVCYTLIT,1
1y9c,A,235,258,23,VKVFIIIAVFFICFVPFHFARIP,1
1y9c,A,281,302,21,STLWLTSLNACLDPFIYFFLC,1
2k9p,A,48,71,23,VTQAILFGVRSGAAALTLIVVWI,1
2k9p,A,78,105,27,PIFIINQVSLFLIILHSALYFKYLLSN,1
2eas,A,58,74,16,LLVRILLLAACISFVL,1
2eas,A,89,107,18,PFVILLILIANAIVGVWQ,1
2eas,A,254,275,21,FGEQLSKVISLICVAVWLINI,1
2eas,A,296,318,22,IAVALAVAAIPEGLPAVITTCL,1
2eas,A,760,781,21,RYLISSNVGEVVCIFLTAALG,1
2eas,A,786,808,22,IPVQLLWVNLVTDGLPATALGF,1
2eas,A,830,854,24,WLFFRYMAIGGYVGAATVGAAAWW,1
2eas,A,898,916,18,ALSVLVTIEMCNALNSLS,1
2eas,A,927,950,23,VNIWLLGSICLSMSLHFLILYVD,1
2eas,A,965,987,22,WLMVLKISLPVIGLDEILKFIA,1
4tpg,B,20,33,13,ELWERFGYYGMQA,1
4tpg,B,55,68,13,ACAALIYVSPAIG,1
4tpg,B,82,95,13,LLGAGILSVGYAL,1
4tpg,B,109,122,13,LGVIVVGNGLFKP,1
4tpg,B,148,161,13,AVNVGSTFSMLLT,1
4tpg,B,183,197,14,VCCVGILVGLGNYA,1
4tpg,B,221,238,17,IVLALAALSVVASAIIL,1
4tpg,B,244,260,16,RVFVYAAGVAVLGIFF,1
4tpg,B,279,295,16,LTVQTVFFFIFYQQMS,1
4tpg,B,325,340,15,QALNPIWIMVLSPVL,1
4tpg,B,359,373,14,FALGFAVVAIGFFI,1
4tpg,B,393,406,13,GYASYSLGELLVS,1
4tpg,B,429,441,12,FVASGISQYLGG,1
4tpg,B,471,484,13,VAAVVCTIIALAV,1
1i15,G,208,224,16,SAFTWLGYVNSAVNPI,1
3oe9,B,40,61,21,LPTIYSIIFLTGIVGNGLVIL,1
3oe9,B,78,98,20,HLSVADLLFVITLPFWAVDA,1
3oe9,B,107,129,22,LCKAVHVIYTVNLYSSVWILAF,1
3oe9,B,157,175,18,VGVWIPALLLTIPDFIFA,1
3oe9,B,195,217,22,VVVFQFQHIMVGLILPGIVILS,1
3oe9,B,244,265,21,ILAFFACWLPYYIGISIDSFI,1
3oe9,B,281,301,20,KWISITEALAFFHCCLNPIL,1
2r9r,E,164,182,18,IAIVSVMVILISIVSFCL,1
2r9r,E,223,242,19,IVETLCIIWFSFEFLVRFF,1
2r9r,E,252,272,20,NIMNIIDIVAIIPYYVTIFL,1
2r9r,E,289,307,18,QIFRIMRILRIFKLSRHS,1
2r9r,E,322,345,23,ELGLLIFFLFIGVILFSSAVYFA,1
2r9r,E,382,402,20,GKIVGSLCAIAGVLTIALPV,1
2wpd,S,6,27,21,AKYIGAGISTIGLLGAGIGIA,1
2wpd,S,56,76,20,LSEATGLFCLMVSFLLLFGV,1
4od4,A,5,19,14,IEHTIFSLPFAYVG,1
4od4,A,34,49,15,MAAAVVGLRMAGMAY,1
4od4,A,82,95,13,VAAGSAIYFASAA,1
4od4,A,102,115,13,LLSPLVLAIALTY,1
4od4,A,125,140,15,HLHLGIVLGSVVFGG,1
4od4,A,162,175,13,YVAAVSLWVAGFD,1
4od4,A,206,221,15,SLAMHAAAVALFIAG,1
4od4,A,234,247,13,TALTALVIILVQA,1
4od4,A,258,273,15,NLNLAVPIIIGAGII,1
5uja,A,330,346,16,FKAVHDLMMFAGPEIL,1
5uja,A,368,384,16,LLFISACLQTLVLHQY,1
5uja,A,443,459,16,IWSAPLQVILALYLLW,1
5uja,A,467,483,16,AGVAVMVLMVPLNAVM,1
5uja,A,545,564,19,AAVGTFTWVCTPFLVALST,1
5uja,A,585,600,15,LALFNILRFPLNILP,1
5uja,A,972,992,20,ISFLSIFLFLCNHVASLVSN,1
5uja,A,1020,1036,16,LGISQGITVFGYSMAV,1
5uja,A,1091,1108,17,MFMGSLFNVIGACIIIL,1
5uja,A,1115,1129,14,VIIPPLGLIYFFVQ,1
5uja,A,1199,1214,15,VRLECVGNCIVLFAS,1
5uja,A,1233,1247,14,SYSLQVTTYLNWLV,1
3h6b,C,17,31,14,MVSGNIMGSGVFLL,1
3h6b,C,44,58,14,GWLVTIIGALGLSM,1
3h6b,C,92,109,17,YWLACWIGNIAMVVIGV,1
3h6b,C,127,140,13,TCVVVLWIFVLLN,1
3h6b,C,148,168,20,RVQAVATVLALIPIVGIAVF,1
3h6b,C,200,213,13,LWSFIGVESASVA,1
3h6b,C,233,248,15,IAAVCYVLSTTAIMG,1
3h6b,C,285,301,16,CLGSLGGWTLLAGQTA,1
3h6b,C,328,342,14,IVGILMTIFQLSSI,1
3h6b,C,350,366,16,GLVSSVSVIFTLVPYL,1
3h6b,C,390,407,17,TTIAFLYCIWAVVGSGA,1
3h6b,C,409,423,14,VMWSFVTLMVITAM,1
4tq5,A,16,39,23,YLRLLRPVAWLCFLLPYAVGFGF,1
4tq5,A,52,71,19,GLLSFAFWMAFSFTINALY,1
4tq5,A,98,119,21,SVREAWLYCIAFLALSLATAA,1
4tq5,A,125,146,21,FLAMLGANIIGYVYSAPPRFK,1
4tq5,A,151,169,18,DVICNALAAVLAFYAGLS,1
4tq5,A,176,192,16,IAIYPAAFFLAATFYI,1
4tq5,A,224,241,17,PLSAITVILWAYVFLMA,1
4tq5,A,246,263,17,KVISPLIIAYTLIYTFI,1
4tq5,A,278,295,17,LILTPFGIISALFIAYG,1
2rn0,A,691,713,22,DILVVLLSVMGAILLIGLAALL,1
2l34,B,5,26,21,PGVLAGIVVGDLVLTVLIALA,1
4zjq,C,14,26,12,IAIIIMLAGGLA,1
4zjq,C,342,355,13,TLVEAIILVFLVM,1
4zjq,C,369,383,14,IAVPVVLLGTFAVL,1
4zjq,C,396,408,12,GMVLAIGLLVDD,1
4zjq,C,444,456,12,IAMVLSAVFVPM,1
4zjq,C,471,484,13,ITIVSAMALSVLV,1
4zjq,C,543,556,13,LYLIIVVGMAYLF,1
4zjq,C,872,886,14,AISLIVVFLCLAAL,1
4zjq,C,894,913,19,SVMLVVPLGVIGALLAATF,1
4zjq,C,925,937,12,LLTTIGLSAKNA,1
4zjq,C,974,986,12,LAFILGVMPLVI,1
4zjq,C,999,1013,14,TGVMGGMVTATVLA,1
4cfg,A,272,295,23,QFDTIYQILLKKKSEIQTLKEEI,1
4cfg,A,312,326,14,KLRGISTQPVYIPE,1
1r3k,L,26,50,24,RAAGAATVLLVIVLLAGSYLAVLA,1
1r3k,L,87,111,24,GRCVAVVVMVAGITSFGLVTAALA,1
4cg5,C,72,82,10,VLVMSLLFIA,1
1nu1,K,22,38,16,LWGAVGAVGLVWATDW,1
2wgm,K,11,32,21,AASAVGAGTAMIAGIGPGVGQ,1
2wgm,K,62,85,23,VAESTGIYSLVIALILLYANPFV,1
2wdv,L,15,35,20,FILVRATAIVLTLYIIYMVG,1
2wdv,L,59,80,21,FTLLALFSILIHAWIGMWQVL,1
2wdv,L,89,109,20,RLMLQLVIVVALVVYVIYGF,1
4mes,A,12,31,19,EIAFMAALAFIISLIPNTV,1
4mes,A,36,51,15,VEIACIPILLLSLRR,1
4mes,A,53,75,22,TAGLVGGLIWGILSMITGHAYI,1
4mes,A,79,98,19,QAFLEYLVAPVSLGIAGLF,1
4mes,A,108,130,22,PVLLGTFVAVLLKYFFHFIAGI,1
4mes,A,148,173,25,AVNGISGILTAIAAFVILIIFVKKF,1
3jac,C,1966,1981,15,HTKYRAATDVYALMF,1
3jac,C,2005,2020,15,DIASSLSDDQVPQAF,1
3jac,C,2032,2046,14,IDRALYLRKTVLGK,1
3jac,C,2063,2077,14,ILPAVTERMFSQNA,1
3jac,C,2083,2096,13,FVKCIYFALSAYQ,1
3jac,C,2199,2213,14,IAIIWFPLLFMSLI,1
3jac,C,2463,2479,16,YGIVGLYVSIVLVVGK,1
1pst,H,13,30,17,SLAIYSFWIFLAGLIYY,1
4hzu,S,114,130,16,VMVIGYCLATTLLFGW,1
4hzu,S,132,142,10,GLASIFGNVV,1
1l6t,A,8,29,21,LYMAAAVMMGLAAIGDAIGIG,1
1l6t,A,55,77,22,VMGLVNAIPMIAVGLGLYVMFA,1
4z3n,A,33,53,20,RMALPMFVGMLTQVTYAIAD,1
4z3n,A,75,94,19,PVGMGLFAIANGIQIGMGS,1
4z3n,A,115,134,19,IIIALFFAIVITVLGYVYA,1
4z3n,A,155,176,21,YYSLLTVFSIMLIGVMMGLFQ,1
4z3n,A,182,202,20,VIMKASLLGALVNIMLDPIM,1
4z3n,A,212,231,19,VALASFLAQLSMVAYFIYT,1
4z3n,A,257,277,20,SVGMAQMLMQLIIAVGIVIY,1
4z3n,A,296,314,18,RIDYFIITPMLAIATALL,1
4z3n,A,334,355,21,AAVALAFSIVLVLAVMHIVLA,1
4z3n,A,376,397,21,RIMALALPFVAISLLASEYYQ,1
4z3n,A,402,424,22,WYSVLLTLMRHVFISVPVVYLL,1
4z3n,A,435,453,18,YFGAMSGTFVAALLAWRL,1
2gmr,H,12,28,16,ASLAIYSFWIFLAGLI,1
5i6c,B,84,105,21,QHALAMLAGVVTPPLIISSSL,1
5i6c,B,110,129,19,LQQYLVSTSLIVCGLLSMV,1
5i6c,B,151,167,16,GVSFSIISVASGAFNQ,1
5i6c,B,187,206,19,AYGALIGTSACCALVEILL,1
5i6c,B,222,246,24,TGPTVMLIGISLIGTGFKDWAGGS,1
5i6c,B,270,289,19,FIGLGFLVFVSIILCERFG,1
5i6c,B,293,315,22,KSCSVVIGLLVGCIVAAACGYF,1
5i6c,B,336,357,21,SVYGPMVLPIIAVFIICACEC,1
5i6c,B,387,400,13,DGINSVVAALATM,1
5i6c,B,426,448,22,CCLILIVAGIFAKFAAAIVAIP,1
5i6c,B,450,469,19,VMGGMKTFLFASVVISGQA,1
5i6c,B,482,500,18,ILTASMALGYGATLVPTW,1
5i6c,B,513,541,28,EGFENAIELVLETGFAVTAFVAMLLNAI,1
1pp9,W,22,39,17,TIVVGALFFERAFDQGA,1
4hyx,A,10,32,22,IWLALGTALMGLGTLYFLVKGM,1
4hyx,A,42,62,20,YAITTLVPAIAFTMYLSMLL,1
4hyx,A,80,99,19,ARYADWLFTTPLLLLDLAL,1
4hyx,A,104,126,22,QGTILALVGADGIMIGTGLVGA,1
4hyx,A,135,157,22,VWWAISTAAMLYILYVLFFGFT,1
4hyx,A,172,192,20,VLRNVTVVLWSAYPVVWLIG,1
4hyx,A,202,224,22,IETLLFMVLDVSAKVGFGLILL,1
4ftp,B,37,57,20,MAAVVGTLVGLAAVAFDKGV,1
4ftp,B,84,97,13,CSAVLAMFGYFLV,1
4ftp,B,129,141,12,VKFFGGLGTLGG,1
4ftp,B,143,156,13,VLGREGPTVQIGG,1
4ftp,B,216,231,15,AVFIGVIMSTIMYRI,1
4ftp,B,253,270,17,LYLILGIIFGIFGPIFN,1
4ftp,B,290,303,13,WVLMGGAIGGLCG,1
4ftp,B,337,351,14,VARVITTLLCFSSG,1
4ftp,B,353,368,15,GGIFAPMLALGTVLG,1
4ftp,B,422,436,14,LPMIITGLGATLLA,1
2wjk,C,10,32,22,IWLALGTALMGLGTLYFLVKGM,1
2wjk,C,41,62,21,FYAITTLVPAIAFTMYLSMLL,1
2wjk,C,80,99,19,ARYADWLFTTPLLLLDLAL,1
2wjk,C,106,127,21,TILALVGADGIMIGTGLVGAL,1
2wjk,C,134,155,21,FVWWAISTAAMLYILYVLFFG,1
2wjk,C,172,192,20,VLRNVTVVLWSAYPVVWLIG,1
2wjk,C,204,225,21,TLLFMVLDVSAKVGFGLILLR,1
1b9u,A,6,30,24,ILGQAIAFVLFVLFCMKYVWPPLM,1
3zev,A,62,83,21,SKVLVTAIYLALFVVGTVGNS,1
3zev,A,109,132,23,ALSDLLILLLAMPVELYNFIWVH,1
3zev,A,136,161,25,FGDAGCRGYYFLRDACTYATALNVV,1
3zev,A,192,210,18,IWLASALLAIPMLFTMGL,1
3zev,A,232,255,23,TLKVVIQVNTFMSFLFPMLVASI,1
3zev,A,313,333,20,VIAFVVCWLPYHVRRLMFCY,1
3zev,A,347,367,20,HYFYMLTNALVYVSAAINPI,1
5etz,D,37,53,16,LYINIALAGLSILLFV,1
5etz,D,72,87,15,LVPVVSIASYTGLAS,1
5etz,D,121,135,14,GRYLTWALSTPMIL,1
5etz,D,153,168,15,TFDIAMCVTGLAAAL,1
5etz,D,175,191,16,RWFWYAISCACFIVVL,1
5etz,D,218,232,14,VVMWLGYPIVWALG,1
5etz,D,244,261,17,SWAYSALDIVAKYIFAF,1
5bqg,B,16,35,19,LLCSTLLVIKMYVVAIITG,1
5bqg,B,69,90,21,RAHRNDMETIYPFLFLGFVYS,1
5bqg,B,99,119,20,WMHFLVFLVGRVAHTVAYLG,1
5bqg,B,125,146,21,RSVTYTLAQLPCASMALQILW,1
4hyo,D,24,41,17,LLVLAVIIYGTAGFHFI,1
4hyo,D,71,92,21,GMYFTCTLIVLGIGTFAVAVE,1
5gli,A,100,124,24,KYINTVVSCLVFVLGIIGNSTLLY,1
5gli,A,140,163,23,ASLALGDLLHIVIAIPINVYKLL,1
5gli,A,173,195,22,CKLVPFIQKASVGITVLSLCAL,1
5gli,A,220,240,20,EIVLIWVVSVVLAVPEAIGF,1
5gli,A,266,291,25,QFYATAKDWWLFSFYFCLPLAITAF,1
5gli,A,327,349,22,LVLVFALCWLPLHLARILKLTL,1
5gli,A,364,386,22,LVLDYIGINMASLNSCANPIAL,1
2ydo,A,9,29,20,ITVELAIAVLAILGNVLVCW,1
2ydo,A,44,64,20,VVSAAAADILVGVLAIPFAI,1
2ydo,A,80,101,21,ACFVLVLTASSIFSLLAIAID,1
2ydo,A,122,138,16,GIIAICWVLSFAIGLT,1
2ydo,A,178,202,24,YFNFFACVLVPLLLMLGVYLRIFL,1
2ydo,A,233,251,18,SLAIIVGLFALCWLPLHI,1
2ydo,A,272,290,18,AIVLSHTNSVVNPFIYAY,1
1r2n,A,9,32,23,WIWLALGTALMGLGTLYFLVKGM,1
1r2n,A,42,66,24,YAITTLVPAIAFTMYLSMLLGYGL,1
1r2n,A,79,99,20,WARYADWLFTTPLLLLDLAL,1
1r2n,A,104,127,23,QGTILALVGADGIMIGTGLVGAL,1
1r2n,A,134,157,23,FVWWAISTAAMLYILYVLFFGFT,1
1r2n,A,172,195,23,VLRNVTVVLWSAYPVVWLIGSEG,1
1r2n,A,199,225,26,PLNIETLLFMVLDVSAKVGFGLILLR,1
5nil,K,270,294,24,RTLLTMLGIIIGIASVVSIVVVGD,1
5nil,K,523,545,22,FLTLVAVISLVVGGIGVMNIML,1
5nil,K,573,601,28,IEAVLVCLVGGALGITLSLLIAFTLQLF,1
5nil,K,608,632,24,FSPLALLLAFLCSTVTGILFGWLP,1
5nj6,A,72,101,29,LTTVFLPIVYTIVFVVALPSNGMALWVFL,1
5nj6,A,113,137,24,MANLALADLLSVIWFPLKIAYHIH,1
5nj6,A,147,171,24,CNVLIGFFYANMYCSILFLTCLSV,1
5nj6,A,190,212,22,AIGISLAIWLLILLVTIPLYVV,1
5nj6,A,239,261,22,FNYFLSLAIGVFLFPAFLTASA,1
5nj6,A,289,313,24,VTVAAMYLICFTPSNLLLVVHYFL,1
5nj6,A,322,344,22,YALYIVALCLSTLNSCIDPFVY,1
3t2m,E,25,45,20,VLFVLTILTLISGTIFYSTV,1
3t2m,E,75,99,24,GKIFTILYIFIGIGLVFGFIHKLA,1
1r3j,L,26,50,24,RAAGAATVLLVIVLLAGSYLAVLA,1
1r3j,L,87,111,24,GRCVAVVVMVAGITSFGLVTAALA,1
3org,A,93,121,28,RLVCFLTLLGVTAALFIFAVDLAVHGLE,1
3org,A,142,160,18,SGVALCLLSTFWCAVLST,1
3org,A,188,203,15,VLFAKALGLICAIGG,1
3org,A,205,221,16,PVGWEGPNVHIACIIA,1
3org,A,244,258,14,AAACAVGLASSFGA,1
3org,A,260,271,11,GGVLYSIETIA,1
3org,A,277,295,18,AFWKGVLSALSGAIVYEL,1
3org,A,321,348,27,LYAILGALMGVLGALFIRCVRSIYELR,1
3org,A,356,371,15,RYFLVGVVALFASAL,1
3org,A,411,424,13,IKFILVALSIGLP,1
3org,A,426,441,15,AGVFVPSFLIGAGFG,1
3org,A,493,511,18,VPVLISVLLAVIVGNAFN,1
5kuf,D,520,547,27,VFSFLNPLSPDIWMYVLLAYLGVSVVL,1
5kuf,D,603,625,22,IVGGIWWFFTLIIISSYTANLA,1
5kuf,D,788,805,17,IGGIFIVLAAGLVLSVF,1
3fyi,B,61,79,18,LVIIAAITIFVTLLILYA,1
3fyi,B,100,116,16,EIAWTIVPIVILVAIG,1
3odj,A,10,28,18,ITLILTALCVLIYIAQQL,1
3odj,A,62,78,16,NLHILFNLSWFFIFGG,1
3odj,A,87,106,19,KLLMLYVVASAITGYVQNY,1
3odj,A,113,128,15,GLSGVVYAVLGYVFI,1
3odj,A,167,182,15,AHISGLIVGLIWGFI,1
4h44,P,7,26,19,AALLSFGLIFVGWALGALL,1
4crt,A,486,501,15,PSVPGLLRLIGLTTI,1
2l0o,A,4,22,18,VAMVIWLYSAFRGVQLTY,1
2l35,B,9,30,21,AGIVVGDLVLTVLIALAVYFL,1
4tq4,A,21,39,18,RPVAWLCFLLPYAVGFGF,1
4tq4,A,52,67,15,GLLSFAFWMAFSFTI,1
4tq4,A,102,119,17,AWLYCIAFLALSLATAA,1
4tq4,A,125,139,14,FLAMLGANIIGYVY,1
4tq4,A,154,169,15,CNALAAVLAFYAGLS,1
4tq4,A,176,191,15,IAIYPAAFFLAATFY,1
4tq4,A,227,241,14,AITVILWAYVFLMA,1
4tq4,A,246,260,14,KVISPLIIAYTLIY,1
4tq4,A,281,295,14,TPFGIISALFIAYG,1
5lg3,E,202,225,23,YYLWSFILPLGLIIAASWSVFWL,1
5lg3,E,230,253,23,RLQTSFTLMLTVVAYAFYTSNIL,1
5lg3,E,260,283,23,VIDQMIIAGYGSIFAAILLIIFA,1
5lg3,E,298,317,19,RCRLAFPLGFLAIGCVLVI,1
5l1b,D,526,543,17,MCIVFAYIGVSVVLFLV,1
5l1b,D,597,614,17,GRIVGGVWWFFTLIIIS,1
5l1b,D,794,810,16,VFYILVGGLGLAMLVA,1
5ws6,z,8,24,16,LAALVILSFVMVIGVP,1
5ws6,z,40,55,15,FLGSGLWIALVLVVG,1
4od5,A,5,22,17,IEHTIFSLPFAYVGALL,1
4od5,A,31,48,17,AILMAAAVVGLRMAGMA,1
4od5,A,82,99,17,VAAGSAIYFASAALLNT,1
4od5,A,101,115,14,LLLSPLVLAIALTY,1
4od5,A,125,144,19,HLHLGIVLGSVVFGGAVAA,1
4od5,A,160,176,16,WLYVAAVSLWVAGFDT,1
4od5,A,206,222,16,SLAMHAAAVALFIAGV,1
4od5,A,231,248,17,TVSTALTALVIILVQAM,1
4od5,A,258,274,16,NLNLAVPIIIGAGIIV,1
3dww,C,16,40,24,LLCSTLLVIKMYVVAIITGQVRLR,1
3dww,C,68,90,22,LRAHRNDMETIYPFLFLGFVYS,1
3dww,C,98,119,21,AWMHFLVFLVGRVAHTVAYLG,1
3dww,C,125,146,21,RSVTYTLAQLPCASMALQILW,1
3o0r,C,10,29,19,RNIYFGGSVFFILLFLALT,1
4qnd,B,15,35,20,LVMGLISPLATMPQLYKLYV,1
4qnd,B,44,64,20,SLTTWLLYSFIALLWTIYGI,1
4qnd,B,70,91,21,IWVGNCLGFLMYVAMVVGIIA,1
3oe8,C,40,60,20,LPTIYSIIFLTGIVGNGLVI,1
3oe8,C,78,98,20,HLSVADLLFVITLPFWAVDA,1
3oe8,C,105,129,24,NFLCKAVHVIYTVNLYSSVWILAF,1
3oe8,C,157,175,18,VGVWIPALLLTIPDFIFA,1
3oe8,C,196,217,21,VVFQFQHIMVGLILPGIVILS,1
3oe8,C,243,264,21,LILAFFACWLPYYIGISIDSF,1
3oe8,C,283,301,18,ISITEALAFFHCCLNPIL,1
3f5w,F,33,50,17,VLLVIVLLAGSYLAVLA,1
3f5w,F,87,106,19,GRCVAVVVMVAGITSFGLV,1
2nr9,A,11,24,13,TLILTALCVLIYI,1
2nr9,A,64,78,14,HILFNLSWFFIFGG,1
2nr9,A,88,104,16,LLMLYVVASAITGYVQ,1
2nr9,A,115,125,10,SGVVYAVLGY,1
2nr9,A,144,157,13,TMLLVGIALGFIS,1
2nr9,A,167,179,12,AHISGLIVGLIW,1
3aea,D,39,61,22,SLHWTGERVVSVLLLGLLPAAY,1
3aea,D,69,89,20,YSLAAALTLHGHWGIGQVVT,1
3aea,D,98,118,20,KAAKAGLLALSAFTFAGLCY,1
5u1w,C,33,47,14,HALVFSYISFALIS,1
5u1w,C,330,348,18,IQLAVYIGSVISYFGLAT,1
2ear,A,58,74,16,LLVRILLLAACISFVL,1
2ear,A,89,109,20,PFVILLILIANAIVGVWQER,1
2ear,A,254,275,21,FGEQLSKVISLICVAVWLINI,1
2ear,A,296,318,22,IAVALAVAAIPEGLPAVITTCL,1
2ear,A,760,781,21,RYLISSNVGEVVCIFLTAALG,1
2ear,A,786,808,22,IPVQLLWVNLVTDGLPATALGF,1
2ear,A,833,854,21,FRYMAIGGYVGAATVGAAAWW,1
2ear,A,898,916,18,ALSVLVTIEMCNALNSLS,1
2ear,A,927,950,23,VNIWLLGSICLSMSLHFLILYVD,1
2ear,A,968,987,19,VLKISLPVIGLDEILKFIA,1
1kpn,A,36,61,25,QAAFMGTVFLIGFPLNAMVLVATLR,1
1kpn,A,69,93,24,NYILVNVSFGGFLLCIFSVFPVFV,1
1kpn,A,107,133,26,ALEGFLGTVAGLVTGWSLAFLAFERY,1
1kpn,A,149,173,24,ALTVVLATWTIGIGVSIPPFFGWS,1
1kpn,A,198,222,24,SYTWFLFIFCFIVPLSLICFSYTQ,1
1kpn,A,249,274,25,MVVVMVGSFCVCYVPYAAFAMYMVN,1
1kpn,A,285,307,22,TIPSFFSKSACIYNPIIYCFMN,1
2npg,C,15,32,17,CTALVLFMTIPGIALFY,1
2npg,C,46,64,18,QVTVTFALVCILWVVYGY,1
2npg,C,102,119,17,FQGSFACITVGLIVGAL,1
2npg,C,127,147,20,VLIFVVVWLTLSYIPIAHMV,1
2npg,C,161,178,17,AGGTVVHINAAIAGLVG,1
2npg,C,201,219,18,FTGTAILYIGWFGFNAGS,1
2npg,C,231,249,18,VNTVVATAAAILGWIFGE,1
2npg,C,260,276,16,ACSGAIAGLVGVTPAC,1
2npg,C,282,299,17,GALIIGVVAGLAGLWGV,1
2npg,C,313,332,19,VFGVFGVCGIVGCIMTGIF,1
2npg,C,353,377,24,VQLESIAITIVWSGVVAFIGYKLA,1
2e74,Q,9,25,16,ALLVVFTWSIAMVVWG,1
3ae7,D,39,61,22,SLHWTGERVVSVLLLGLLPAAY,1
3ae7,D,69,92,23,YSLAAALTLHGHWGIGQVVTDYV,1
3ae7,D,97,117,20,QKAAKAGLLALSAFTFAGLC,1
5ebw,F,29,50,21,GAATVLLVIVLLAGSYLAVLA,1
5ebw,F,87,108,21,GRLVAVVVMVAGITSFGLVTA,1
2b2h,C,11,28,17,STALVMLMVPGVGFFYA,1
2b2h,C,40,62,22,ALSFISLIITVLLWIFYGYSVS,1
2b2h,C,91,108,17,YQMMFAAVTIAILTSAI,1
2b2h,C,115,136,21,SFILLSALWLTFVYAPFAHWL,1
2b2h,C,150,170,20,AGGMVVHISSGFAALAVAMT,1
2b2h,C,189,208,19,TLIGAALLWFGWFGFNGGS,1
2b2h,C,220,238,18,VVTNTSAAVAGFVWMVIG,1
2b2h,C,247,264,17,GIVSGAIAGLAAITPAA,1
2b2h,C,270,290,20,GAIVIGLVAGIVCYLAMDFR,1
2b2h,C,300,319,19,AWAIHGIGGLWGSVAVGIL,1
2b2h,C,342,366,24,IAVASTTAYAFLVTLILAKAVDAA,1
3syq,D,90,116,26,WRFNLLIFVMVYTVTWLFFGMIWWLI,1
3syq,D,168,192,24,GIILLLIQSVLGSIVNAFMVGCMF,1
3fb5,F,30,50,20,AATVLLVIVLLAGSYLAVLA,1
3fb5,F,87,108,21,GRCVAVVVMVAGITSFGLVTA,1
5ec2,F,30,50,20,AATVLLVIVLLAGSYLAVLA,1
5ec2,F,86,107,21,WGRLVAVVVMVAGITSFGLVT,1
1aig,H,16,32,16,IYSFWIFLAGLIYYLQ,1
4uuj,F,30,50,20,AATVLLVIVLLAGSYLAVLA,1
4uuj,F,86,107,21,WGRCVAVVVMVAGITSFGLVT,1
3w9h,C,14,27,13,IAIIIMLAGGLAI,1
3w9h,C,342,357,15,TLVEAIILVFLVMYL,1
3w9h,C,366,386,20,IPTIAVPVVLLGTFAVLAAF,1
3w9h,C,395,410,15,FGMVLAIGLLVDDAI,1
3w9h,C,443,457,14,GIAMVLSAVFVPMA,1
3w9h,C,471,485,14,ITIVSAMALSVLVA,1
3w9h,C,542,556,14,VLYLIIVVGMAYLF,1
3w9h,C,875,891,16,LYAISLIVVFLCLAAL,1
3w9h,C,899,919,20,SVMLVVPLGVIGALLAATFR,1
3w9h,C,928,943,15,VGLLTTIGLSAKNAI,1
3w9h,C,976,991,15,MTSLAFILGVMPLVI,1
3w9h,C,1004,1018,14,TGVMGGMVTATVLA,1
3ncy,B,15,28,13,TLMVSGNIMGSGV,1
3ncy,B,46,58,12,LVTIIGALALSM,1
3ncy,B,92,106,14,YWLACWIGNIAMVV,1
3ncy,B,128,140,12,CVAVLWIFVLLN,1
3ncy,B,147,164,17,TRVQAVATVLALVPIVG,1
3ncy,B,198,209,11,VTLWSFIGVES,1
3ncy,B,229,242,13,GGVLIAAVCYVLS,1
3ncy,B,282,297,15,AAGCLGSLGGWTLLA,1
3ncy,B,328,340,12,IVGVLMTIFQFS,1
3ncy,B,353,366,13,SSVSVIFTLVPYL,1
3ncy,B,390,405,15,TFVAFVYCIWAVIGS,1
3ncy,B,408,423,15,EVMWSFVTLMVITAL,1
3uu5,E,199,218,19,NIILPMLFILFISWTAFWS,1
3uu5,E,222,240,18,ANVTLVVSTLIAHIAFNI,1
3uu5,E,256,275,19,AIIFMIYLFYFVAVIEVTV,1
3uu5,E,292,313,21,RASRIAFPVVFLLANIILAFL,1
5aw3,G,25,40,15,VAAVLCVIGIIILLA,1
5avv,G,23,38,15,LIVAAVLCVIGIIIL,1
2c8k,A,57,77,20,EDLLVRILLLAACISFVLAW,1
2c8k,A,87,104,17,FVEPFVILLILIANAIV,1
2c8k,A,257,279,22,EQLSKVISLICVAVWLINIGHF,1
2c8k,A,293,314,21,YYFKIAVALAVAAIPEGLPAV,1
2c8k,A,761,784,23,RYLISSNVGEVVCIFLTAALGLP,1
2c8k,A,786,807,21,LIPVQLLWVNLVTDGLPATAL,1
2c8k,A,834,852,18,FRYMAIGGYVGAATVGAA,1
2c8k,A,898,916,18,MALSVLVTIEMCNALNSL,1
2c8k,A,926,950,24,PWVNIWLLGSICLSMSLHFLILYV,1
2c8k,A,968,987,19,MVLKISLPVIGLDEILKFI,1
2z5y,A,495,519,24,PSVSGLLKIIGFSTSVTALGFVLY,1
4n4d,A,12,31,19,EIAFMAALAFIISLIPNTV,1
4n4d,A,36,49,13,VEIACIPILLLSL,1
4n4d,A,54,75,21,AGLVGGLIWGILSMITGHAYI,1
4n4d,A,79,96,17,QAFLEYLVAPVSLGIAG,1
4n4d,A,111,130,19,LGTFVAVLLKYFFHFIAGI,1
4n4d,A,148,170,22,AVNGISGILTAIAAFVILIIFV,1
2axt,z,5005,5025,20,QLALAALVILSFVMVIGVPV,1
2axt,z,5039,5056,17,IFLGSGLWIALVLVVGV,1
5tcx,A,10,37,27,KYLLFVFNFVFWLAGGVILGVALWLRH,1
5tcx,A,62,85,23,YILIAVGAVMMFVGFLGCYGAIQ,1
5tcx,A,89,112,23,LLGTFFTCLVILFACEVAAGIWG,1
5tcx,A,204,227,23,IGIAAIVVAVIMIFEMILSMVLS,1
1xji,A,10,32,22,IWLALGTALMGLGTLYFLVKGM,1
1xji,A,42,66,24,YAITTLVPAIAFTMYLSMLLGYGL,1
1xji,A,79,99,20,WARYADWLFTTPLLLLDLAL,1
1xji,A,104,127,23,QGTILALVGADGIMIGTGLVGAL,1
1xji,A,135,157,22,VWWAISTAAMLYILYVLFFGFT,1
1xji,A,172,195,23,VLRNVTVVLWSAYPVVWLIGSEG,1
1xji,A,202,225,23,IETLLFMVLDVSAKVGFGLILLR,1
5cbf,E,6,18,12,MFKRFFGAVRTS,1
5cbf,E,28,45,17,LSLAIIVTAATIFYTLA,1
5cbf,E,75,96,21,SKIFTLVYAILVVGLFVTVGG,1
5azb,A,24,44,20,WYGLMYLVGFIFAMWLATRR,1
5azb,A,58,79,21,NLLYAGFLGVFLGGRIGYVLF,1
5azb,A,101,118,17,FHGGLIGVIVVMIIFAR,1
5azb,A,124,145,21,FQVSDFIAPLIPFGLGAGRLG,1
5azb,A,202,219,17,LLLEGVVLFIILNLYIR,1
5azb,A,225,241,16,AVSGLFLIGYGAFRII,1
5azb,A,263,283,20,QILSIPMIVAGVIMMVWAYR,1
4pe5,D,557,567,10,VWVMMFVMLL,1
4pe5,D,631,644,13,VSVWAFFAVIFLA,1
4pe5,D,822,837,15,YMLGAAMALSLITFI,1
2c66,A,486,501,15,PSVPGLLRLIGLTTI,1
4yl3,C,16,32,16,LLCSTLLVIKMYVVAI,1
4yl3,C,72,90,18,RNDMETIYPFLFLGFVYS,1
4yl3,C,99,115,16,WMHFLVFLVGRVAHTV,1
4yl3,C,127,146,19,VTYTLAQLPCASMALQILW,1
4uxz,C,33,48,15,EGVAVLLCVVIAAWL,1
4uxz,C,53,69,16,TRVLLISSVMLVMIVE,1
4uxz,C,100,117,17,VLIAIIDAVITWAILLW,1
4ymv,C,4,44,40,FLSMVKYTPLFISGLIMTLKLTFLAVTIGVLMGLFIALMK,1
4ymv,C,49,78,29,PIKLVASSYIEVIRGTPLLVQLLLIYNGL,1
4ymv,C,86,107,21,AFTAGVSALAINSSAYVAEII,1
4ymv,C,147,168,21,ALGNEFIVMLKESAIVSVIGF,1
4ymv,C,186,207,21,EPYIIIAAIYFVMTLTFSKLL,1
2c72,A,486,498,12,PSVPGLLRLIGL,1
5ayn,A,14,35,21,LGRLLTRSGDQAWDFVVPFAL,1
5ayn,A,47,65,18,FYYLIVKIGTFLLTPSSG,1
5ayn,A,77,98,21,KWGVWLQFFAILAGMVFFGML,1
5ayn,A,114,138,24,LFIALALSGVMASLGSQITDISVG,1
5ayn,A,156,177,21,WLRRIDLATEVGAPILAGALF,1
5ayn,A,187,206,19,GLFLIGLWNLVSFVPEYFL,1
5ayn,A,245,266,21,LILSYALLWLSVLSPHGVLLA,1
5ayn,A,281,301,20,LFRGLGAVFGLISTVSFPYL,1
5ayn,A,311,331,20,RWHLGFQGVTLGIAVTAFAM,1
5ayn,A,337,359,22,YVFLGCILLSRVGLYGFSNGEF,1
5ayn,A,376,396,20,LSSLTTTSATLILFSAGSLL,1
5ayn,A,403,422,19,YLVYVSLAAVLLANVVFIK,1
2xtu,A,93,110,17,GPVTWVMMIACVVVFIA,1
2xtu,A,148,166,18,MHILFNLLWWWYLGGAVE,1
2xtu,A,172,189,17,KLIVITLISALLSGYVQ,1
2xtu,A,199,214,15,LTGVVYALMGYVWLR,1
2xtu,A,225,245,20,QRGLIIFALIWIVAGWFDLF,1
2xtu,A,249,268,19,ANGAHIAGLAVGLAMAFVD,1
2x72,C,43,63,20,MFLLIMLGFPINFLTLYVTV,1
2x72,C,74,92,18,ILLNLAVADLFMVFGGFT,1
2x72,C,114,133,19,FFATLGGEIALWSLVVLAI,1
2x72,C,154,170,16,MGVAFTWVMALACAAP,1
2x72,C,203,222,19,VIYMFVVHFIIPLIVIFFC,1
2x72,C,255,274,19,IMVIAFLICWLPYAGVAFY,1
2x72,C,291,309,18,AFFAKTSAVYNPVIYIMM,1
3ehb,B,34,54,20,DHFVLYIITAVTIFVCLLLL,1
3ehb,B,82,98,16,LVPVLILVAIGAFSLP,1
4gpo,B,40,64,24,EAGMSLLMALVVLLIVAGNVLVIA,1
4gpo,B,79,103,24,ITSLACADLVVGLLVVPFGATLVV,1
4gpo,B,113,137,24,CELWTSLDVLCVTASIETLCVIAI,1
4gpo,B,159,182,23,VIICTVWAISALVSFLPIMMHWW,1
4gpo,B,207,229,22,AIASSIISFYIPLLIMIFVALR,1
4gpo,B,292,315,23,GIIMGVFTLCWLPFFLVNIVNVF,1
4gpo,B,324,344,20,FVAFNWLGYANSAMNPIIYC,1
4boi,E,221,243,22,IINIIAPCVLISSLVVLVYFLP,1
4boi,E,251,273,22,TLSISVLLAQTIFLFLIAQKVP,1
4boi,E,284,308,24,YLIFVMFVSLVIVTNCVIVLNVSL,1
4boi,E,449,473,24,CFWIALLLFSLGTLAIFLTGHLNQ,1
3prc,H,16,32,16,WYAQWLVIWTVVLLYL,1
5h1q,H,8,22,14,NSVNALISRVFVQP,1
5h1q,H,28,46,18,RLNSRVTVVILAVSSALL,1
5h1q,H,110,128,18,VFALQAFLFYIPRFIWKA,1
5h1q,H,195,212,17,TVWQAVNAWIQFYILTQ,1
5h1q,H,276,296,20,FIFLWFWLVFVAVVSTVNCF,1
3eh4,C,8,22,14,LAVILVLTLTILVF,1
2drd,C,11,27,16,AWVIAIIIMLAGGLAI,1
2drd,C,341,357,16,KTLVEAIILVFLVMYL,1
2drd,C,366,386,20,IPTIAVPVVLLGTFAVLAAF,1
2drd,C,395,410,15,FGMVLAIGLLVDDAI,1
2drd,C,443,458,15,GIAMVLSAVFVPMAF,1
2drd,C,471,489,18,ITIVSAMALSVLVALILT,1
2drd,C,543,557,14,LYLIIVVGMAYLFV,1
2drd,C,874,890,16,SLYAISLIVVFLCLAA,1
2drd,C,902,919,17,LVVPLGVIGALLAATFR,1
2drd,C,927,943,16,QVGLLTTIGLSAKNAI,1
2drd,C,976,991,15,MTSLAFILGVMPLVI,1
2drd,C,1004,1019,15,TGVMGGMVTATVLAI,1
3b8c,A,57,83,26,LLKFLGFMWNPLSWVMEMAAIMAIAL,1
3b8c,A,95,113,18,FVGIICLLVINSTISFIE,1
3b8c,A,242,262,20,IGNFCICSIAIGMVIEIIVM,1
3b8c,A,275,292,17,NLLVLLIGGIPIAMPTV,1
3b8c,A,645,665,20,TIYAVSITIRIVFGFMLIAL,1
3b8c,A,671,690,19,SAFMVLIIAILNDGTIMTI,1
3b8c,A,706,726,20,KEIFATGVVLGGYQAIMTVI,1
3b8c,A,754,771,17,GAVYLQVSIISQALIFV,1
3b8c,A,784,803,19,ALLMIAFLIAQLIATLIAV,1
3b8c,A,821,841,20,VIWLYSIVTYFPLDVFKFAI,1
5h2j,C,12,28,16,LALGTALMGLGTLYFL,1
5h2j,C,47,61,14,LVPAIAFTMYLSML,1
5h2j,C,80,94,14,ARYADWLFTTPLLL,1
5h2j,C,111,126,15,VGADGIMIGTGLVGA,1
5h2j,C,135,150,15,VWWAISTAAMLYILY,1
5h2j,C,178,192,14,VVLWSAYPVVWLIG,1
5h2j,C,204,220,16,TLLFMVLDVSAKVGFG,1
1hzx,C,37,64,27,MLAAYMFLLIMLGFPINFLTLYVTVQH,1
1hzx,C,73,99,26,ILLNLAVADLFMVFGGFTTTLYTSLH,1
1hzx,C,109,133,24,NLEGFFATLGGEIALWSLVVLAIE,1
1hzx,C,154,176,22,GVAFTWVMALACAAPPLVGWSR,1
1hzx,C,199,224,25,ESFVIYMFVVHFIIPLIVIFFCYGQ,1
1hzx,C,254,278,24,IMVIAFLICWLPYAGVAFYIFTHQ,1
1hzx,C,287,309,22,TIPAFFAKTSAVYNPVIYIMMN,1
3k07,C,16,33,17,LMGALFLSIWGTWTIIN,1
3k07,C,339,356,17,GKLLEEFIVVAVVCALF,1
3k07,C,364,384,20,VAIISLPLGLCIAFIVMHFQ,1
3k07,C,393,409,16,GGIAIAVGAMVDAAIV,1
3k07,C,450,466,16,FISLLIITLSFIPIFT,1
3k07,C,478,497,19,AFTKTYAMAGAALLAIVVI,1
3k07,C,539,555,16,LLVAALSVLTVLWPLN,1
3k07,C,873,890,17,LMVPMTLMIIFVLLYLA,1
3k07,C,895,918,23,EALLIISSVPFALVGGIWLLWWM,1
3k07,C,927,943,16,TGFIALAGVAAEFGVV,1
3k07,C,985,1001,16,MTVAVIIAGLLPILWG,1
3k07,C,1010,1030,20,RIAAPMIGGMITAPLLSLFI,1
5tvn,A,54,76,22,HWAALLILMVIIPTIGGNTLVI,1
5tvn,A,93,117,24,MSLAVADLLVGLFVMPIALLTIMF,1
5tvn,A,122,151,29,LPLVLCPAWLFLDVLFSTASIWHLCAISV,1
5tvn,A,175,195,20,ITVVWLISIGIAIPVPIKGI,1
5tvn,A,214,239,25,GDFMLFGSLAAFFTPLAIMIVTYFL,1
5tvn,A,326,350,24,GIVFFLFLLMWCPFFITNITLVLC,1
5tvn,A,359,381,22,MLLEIFVWIGYVSSGVNPLVYT,1
3l75,W,19,36,17,FALTVVLGAVLFERAFD,1
3ei0,E,198,217,19,NIILPMLFILFISWTAFWS,1
3ei0,E,221,240,19,ANVTLVVSTLIAHIAFNIL,1
3ei0,E,255,274,19,AIIFMIYLFYFVAVIEVTV,1
3ei0,E,294,312,18,RIAFPVVFLLANIILAFL,1
2he6,_,69,98,29,RNQKTTVNFLIGNLAFSDILVVLFCSPFT,1
2he6,_,104,128,24,DQWMFGKVMCHIMPFLQCVSVLVS,1
2he6,_,144,167,23,HPISNNLTANHGYFLIATVWTLG,1
2he6,_,186,207,21,FGSALLSSRYLCVESWPSDSY,1
2he6,_,245,266,21,ENRLEENEMINLTLHPSKKSG,1
2he6,_,301,321,20,RPSQENHSRILPENFGSVRS,1
2he6,_,352,375,23,KRSVTRIKKRSRSVFYRLTILIL,1
3ir7,H,5,26,21,MFFFDIYPYIAGAVFLIGSWL,1
3ir7,H,51,73,22,SNLFHIGILGIFVGHFFGMLTP,1
3ir7,H,87,110,23,KMAMFAGGASGVLCLIGGVLLLK,1
3ir7,H,126,145,19,ILILSLLVIQCALGLLTIP,1
3ir7,H,183,204,21,FRLHLVLGMTLFLLFPFSRLI,1
5hku,D,154,170,16,LLLLVIFYVFAVMGTK,1
5hku,D,214,233,19,WIYFVSFILVSSFTVLNLF,1
2abm,D,6,23,17,AECFGTFWLVFGGCGSA,1
2abm,D,38,53,15,VALAFGLTVLTMAFA,1
2abm,D,82,99,17,GYVIAQVVGGIVAAALL,1
2abm,D,135,149,14,VVELVLSAGFLLVI,1
2abm,D,163,178,15,IAIGLALTLIHLISI,1
2abm,D,206,223,17,FFWVVPIVGGIIGGLIY,1
5a45,C,10,31,21,IWLALGTALMGLGTLYFLVKG,1
5a45,C,44,62,18,ITTLVPAIAFTMYLSMLL,1
5a45,C,80,97,17,ARYADWLFTTPLLLLDL,1
5a45,C,109,127,18,ALVGADGIMIGTGLVGAL,1
5a45,C,134,153,19,FVWWAISTAAMLYILYVLF,1
5a45,C,174,192,18,RNVTVVLWSAYPVVWLIG,1
5a45,C,203,223,20,ETLLFMVLDVSAKVGFGLIL,1
3bcc,U,20,43,23,ALTIVVGALLFERAFDQGADAIY,1
4uc1,B,5,26,21,ALFLTFLAACGAPATTGALLK,1
4uc1,B,38,65,27,WNPPRWVFPLAWTSLYFLMSLAAMRVA,1
4uc1,B,72,91,19,ALAFYAAQLAFNTLWTPVF,1
4uc1,B,98,119,21,TALAVVMVMWLFVAATMWAFF,1
4uc1,B,125,145,20,GVLFVPYLIWATATTGLNFE,1
2hh1,H,13,32,19,SLAIYSFWIFLAGLIYYLQ,1
5fgn,A,12,29,17,SALIAFLSLYSSLVLNY,1
5fgn,A,52,72,20,MPVVLFFLSNFVFHVIALPF,1
5fgn,A,74,90,16,KVLIPLILVISAAVSY,1
5fgn,A,122,141,19,YVLWIVCLGVLPALAYIAV,1
5fgn,A,154,172,18,RLVLAAVSFLCALGIAML,1
1s7b,D,6,24,18,LGGAILAEVIGTTLMKFS,1
1s7b,D,34,50,16,GTIICYCASFWLLAQT,1
3b5d,B,7,22,15,GGAILAEVIGTTLMK,1
3b5d,B,34,48,14,GTIICYCASFWLLA,1
3b5d,B,59,75,16,YAIWSGVGIVLISLLS,1
3b5d,B,85,101,16,PAIIGMMLICAGVLII,1
2hit,H,13,31,18,SLAIYSFWIFLAGLIYYL,1
5va3,D,410,430,20,DWLILLLVIYTAVFTPYSAA,1
5va3,D,452,470,18,AVVDLIVDIMFIVDILIN,1
5va3,D,498,510,12,LIDMVAAIPFDL,1
5va3,D,522,539,17,LLKTARLLRLVRVARKL,1
5va3,D,548,568,20,VLFLLMCTFALIAHWLACIW,1
5va3,D,639,663,24,FSICVMLIGSLMYASIFGNVSAII,1
3b5w,B,27,45,18,IVAGVALILNAASDTFML,1
3b5w,B,70,85,15,VIGLMILRGITSYVS,1
3b5w,B,145,161,16,VVREGASIIGLFIMMF,1
3b5w,B,170,186,16,LIVLAPIVSIAIRVVS,1
3b5w,B,249,263,14,ISDPIIQLIASLAL,1
3b5w,B,288,301,13,SSMIALMRPLKSL,1
1orq,F,21,52,31,MEHPLVELGVSYAALLSVIVVVVECTMQLSG,1
1orq,F,57,80,23,LYLVDLILVIILWADYAYRAYKS,1
1orq,F,151,171,20,HLFGAVMLTVLYGAFAIYIV,1
1orq,F,209,236,27,KVIGIAVMLTGISALTLLIGTVSNMFQ,1
5jr0,A,7,29,22,FCSYIIISFLIVVNMYIAIILE,1
1opn,A,31,54,23,LLPPLYSLVFIFGFVGNMLVILI,1
1opn,A,70,91,21,NLAISDLFFLLTVPFWAHYAA,1
1opn,A,99,124,25,MCQLLTGLYFIGFFSGIFFIILLTI,1
1opn,A,151,169,18,TWVVAVFASLPGIIFTRS,1
1opn,A,193,218,25,QTLKIVILGLVLPLLVMVICYSGIL,1
1opn,A,240,262,22,MIVYFLFWAPYNIVLLLNTFQE,1
1opn,A,276,300,24,QAMQVTETLGMTHCCINPIIYAFV,1
1xp5,A,49,74,25,WELVIEQFEDLLVRILLLAACISFV,1
1xp5,A,89,108,19,EPFVILLILIANAIVGVWQ,1
1xp5,A,254,275,21,EFGEQLSKVISLICVAVWLIN,1
1xp5,A,296,318,22,KIAVALAVAAIPEGLPAVITTC,1
1xp5,A,760,781,21,IRYLISSNVGEVVCIFLTAAL,1
1xp5,A,786,808,22,LIPVQLLWVNLVTDGLPATALG,1
1xp5,A,833,851,18,FFRYMAIGGYVGAATVGA,1
1xp5,A,898,917,19,MALSVLVTIEMCNALNSLS,1
1xp5,A,926,950,24,PWVNIWLLGSICLSMSLHFLILYV,1
1xp5,A,966,987,21,WLMVLKISLPVIGLDEILKFI,1
4bbj,A,84,102,18,FWIALMLTIPVVILEMGG,1
4bbj,A,112,135,23,GSSWIQLLLATPVVLWGGWPFFK,1
4bbj,A,147,170,23,MFTLIAMGIGVAWIYSMVAVLWP,1
4bbj,A,185,201,16,VYFEAAAVITTLVLLG,1
4bbj,A,339,359,20,SGWFVPAVILVAVLSFIVWA,1
4bbj,A,368,389,21,YGLIAAVSVLIIACPCALGLA,1
4bbj,A,680,700,20,NLFFAFIYNVLGVPLAAGVL,1
4bbj,A,707,729,22,LSPMIAAAAMALSSVSVIINAL,1
4lmj,D,198,214,16,NIILPMLFILFISWTA,1
4lmj,D,225,241,16,LVVSTLIAHIAFNILV,1
4lmj,D,255,271,16,AIIFMIYLFYFVAVIE,1
4lmj,D,295,312,17,IAFPVVFLLANIILAFL,1
2o9f,A,5,27,22,AAESFGTFWLVFGGSGSAVLAA,1
2o9f,A,35,55,20,FAGVALAFGLTVLTMAFAVG,1
2o9f,A,81,103,22,VGYVIAQVVGGIVAAALLYLIA,1
2o9f,A,132,152,20,SALVVELVLSAGFLLVIHGA,1
2o9f,A,162,181,19,PIAIGLACTLIHLISIPVT,1
2o9f,A,202,223,21,EQLWFFWVVPIVGGIIGGLIY,1
5jrf,A,31,53,22,LTLGYAVMLAGLLYFILTIKNV,1
5jrf,A,58,79,21,MSNILSAVVMVSAFLLLYAQA,1
5jrf,A,106,127,21,GYRYLNWLIDVPMLLFQILFV,1
5jrf,A,137,160,23,VRNQFWFSGAMMIITGYIGQFYE,1
5jrf,A,165,189,24,AFLVWGAISSAFFFHILWVMKKVI,1
5jrf,A,203,228,25,LSNIWILFLISWTLYPGAYLMPYLT,1
5jrf,A,242,266,24,RQLVYTIADVSSKVIYGVLLGNLA,1
4kkl,B,37,60,23,MAAVVGTLVGLAAVAFDKGVAWL,1
4kkl,B,84,97,13,CSAVLAMFGYFLV,1
4kkl,B,128,142,14,PVKFFGGLGTLGGG,1
4kkl,B,144,159,15,LGRAGPTVQIGGNIG,1
4kkl,B,216,232,16,AVFIGVIMSTIMYRIF,1
4kkl,B,253,277,24,LYLILGIIFGIFGPIFNKWVLGMQ,1
4kkl,B,290,305,15,WVLMGGAIGGLCGLL,1
4kkl,B,338,351,13,ARVITTLLCFSSG,1
4kkl,B,353,368,15,GGIFAPMLALGTVLG,1
4kkl,B,423,439,16,PMIITGLGATLLAQFT,1
4u4w,B,40,58,18,SVPCLLLAFCVWMLFSAV,1
4u4w,B,76,96,20,LTALPSVSGALLRVPYSFMV,1
4u4w,B,103,119,16,WTAFSTGILIIPCVWL,1
4u4w,B,135,151,16,ISLLCGFAGANFASSM,1
4u4w,B,170,188,18,GGLGNMGVSVMQLVAPLV,1
4u4w,B,215,233,18,SWIWVPFLAIFTIAAWFG,1
4u4w,B,258,278,20,MSLLYLATFGSFIGFSAGFA,1
4u4w,B,291,308,17,QYAFFGPFIGALARSAG,1
4u4w,B,321,338,17,LVNFILMAIFSGLLFLT,1
4u4w,B,350,370,20,FFAVFLALFLTAGLGSGSTF,1
4u4w,B,408,425,17,FISAIGAIGGFFIPKAF,1
4u4w,B,437,455,18,AMKVFLIFYIACVVITWA,1
2acz,L,16,39,23,ILVRATAIVLTLYIIYMVGFFAT,1
2acz,L,55,80,25,FTKVFTLLALFSILIHAWIGMWQVL,1
2acz,L,89,113,24,RLMLQLVIVVALVVYVIYGFVVVW,1
4ntj,A,28,53,25,PLLYTVLFFVGLITNGLAMRIFFQI,1
4ntj,A,59,81,22,IIFLKNTVISDLLMILTFPFKI,1
4ntj,A,97,122,25,QVTSVIFYFTMYISISFLGLITIDR,1
4ntj,A,140,162,22,AKILSVVIWAFMFLLSLPNMIL,1
4ntj,A,186,210,24,HEIVNYICQVIFWINFLIVIVCYT,1
4ntj,A,237,262,25,VFIIIAVFFICFVPFHFARIPYTLS,1
4ntj,A,279,302,23,KESTLWLTSLNACLNPFIYFFLC,1
4lou,B,37,61,24,MAAVVGTLVGLAAVAFDKGVAWLQ,1
4lou,B,84,97,13,CSAVLAMFGYFLV,1
4lou,B,129,142,13,VKFFGGLGTLGGG,1
4lou,B,144,156,12,LGRQGPTVQIGG,1
4lou,B,216,232,16,AVFIGVIMSTIMYRIF,1
4lou,B,253,277,24,LYLILGIIFGIFGPIFNKWVLGMQ,1
4lou,B,290,305,15,WVLMGGAIGGLCGLL,1
4lou,B,338,351,13,ARVITTLLCFSSG,1
4lou,B,353,368,15,GGIFAPMLALGTVLG,1
4lou,B,423,439,16,PMIITGLGATLLAQFT,1
4ytp,D,42,61,19,WTGERVVSVLLLGLLPAAY,1
4ytp,D,68,92,24,DYSLAAALTLHGHWGIGQVVTDYV,1
4ytp,D,97,117,20,QKVAKAGLLALSAFTFAGLC,1
2fkw,S,19,37,18,RVFLGLALVAHFLAFSAT,1
3ejy,B,37,61,24,MAAVVGTLVGLAAVAFDKGVAWLQ,1
3ejy,B,84,97,13,CSAVLAMFGYFLV,1
3ejy,B,129,142,13,VKFFGGLGTLGGG,1
3ejy,B,144,156,12,LGREGPTVQIGG,1
3ejy,B,216,232,16,AVFIGVIMSTIMYRIF,1
3ejy,B,253,273,20,LYLILGIIFGIFGPIFNKWV,1
3ejy,B,290,305,15,WVLMGGAIGGLCGLL,1
3ejy,B,338,351,13,ARVITTLLCFSSG,1
3ejy,B,353,368,15,GGIFAPMLALGTVLG,1
3ejy,B,423,439,16,PMIITGLGATLLAQFT,1
4lbe,F,25,50,25,WRAAGAATVLLVIVLLAGSYLAVLA,1
4lbe,F,87,114,27,GRLVAVVVMVAGITSFGLVTAALATWF,1
3wta,A,20,43,23,DAQWVVFAVMALAAIVFSIAVQF,1
3wta,A,50,72,22,TYYVNIAICTIAATAYYAMAVN,1
3wta,A,90,110,20,YARYIDWVFTTPLLLLDLVL,1
3wta,A,117,139,22,MIAWIMGADIAMIAFGIIGAFT,1
3wta,A,144,164,20,WFYFVVGCIMLAVLAWGMIN,1
3wta,A,181,205,24,TTLLIYLIVLWVIYPIVWGLGAGG,1
3wta,A,212,235,23,EIIAMGILDLLAKPLYAIGVLIT,1
2zz9,D,38,55,17,TAEFLAMLIFVLLSVGS,1
2zz9,D,72,89,17,ISLCFGLSIATMVQCFG,1
2zz9,D,116,133,17,FYITAQCLGAIIGAGIL,1
2zz9,D,158,177,19,GLLVELIITFQLVFTIFAS,1
2zz9,D,188,205,17,VALAIGFSVAIGHLFAI,1
2zz9,D,231,248,17,IYWVGPIIGAVLAGALY,1
1ja5,A,17,35,18,GAVLGSLQFGYNTGVINA,1
1ja5,A,66,82,16,LSVAIFSVGGMIGSFS,1
1ja5,A,97,113,16,MMNLLAFVSAVLMGFS,1
1ja5,A,123,139,16,LGRFIIGVYCGLTTGF,1
1ja5,A,160,178,18,QLGIVVGILIAQVFGLDS,1
1ja5,A,189,206,17,LSIIFIPALLQCIVLPF,1
1ja5,A,278,294,16,QLSQQLSGINAVFYYS,1
1ja5,A,309,326,17,TIGSGIVNTAFTVVSLF,1
1ja5,A,345,360,15,GCAILMTIALALLEQ,1
1ja5,A,363,378,15,MSYLSIVAIFGFVAF,1
1ja5,A,404,420,16,AVAGFSNWTSNFIVGM,1
1ja5,A,423,438,15,YVEQLCGPYVFIIFT,1
2h2p,B,37,61,24,MAAVVGTLVGLAAVAFDKGVAWLQ,1
2h2p,B,84,97,13,CSAVLAMFGYFLV,1
2h2p,B,129,142,13,VKFFGGLGTLGGG,1
2h2p,B,144,156,12,LGREGPTVQIGG,1
2h2p,B,216,232,16,AVFIGVIMSTIMYRIF,1
2h2p,B,253,277,24,LYLILGIIFGIFGPIFNKWVLGMQ,1
2h2p,B,290,304,14,WVLMGGAIGGLCGL,1
2h2p,B,338,351,13,ARVITTLLCFSSG,1
2h2p,B,353,368,15,GGIFAPMLALGTVLG,1
2h2p,B,423,439,16,PMIITGLGATLLAQFT,1
2dr6,C,11,27,16,AWVIAIIIMLAGGLAI,1
2dr6,C,341,357,16,KTLVEAIILVFLVMYL,1
2dr6,C,366,386,20,IPTIAVPVVLLGTFAVLAAF,1
2dr6,C,395,411,16,FGMVLAIGLLVDDAIV,1
2dr6,C,442,458,16,VGIAMVLSAVFVPMAF,1
2dr6,C,471,489,18,ITIVSAMALSVLVALILT,1
2dr6,C,541,558,17,LVLYLIIVVGMAYLFVR,1
2dr6,C,874,891,17,SLYAISLIVVFLCLAAL,1
2dr6,C,899,919,20,SVMLVVPLGVIGALLAATFR,1
2dr6,C,927,943,16,QVGLLTTIGLSAKNAI,1
2dr6,C,975,992,17,LMTSLAFILGVMPLVIS,1
2dr6,C,1001,1019,18,AVGTGVMGGMVTATVLAI,1
4yxd,D,42,61,19,WTGERVVSVLLLGLLPAAY,1
4yxd,D,68,92,24,DYSLAAALTLHGHWGIGQVVTDYV,1
4yxd,D,98,118,20,KVAKAGLLALSAFTFAGLCY,1
5xan,B,34,49,15,ALLLLLTLLGSLLYI,1
5xan,B,302,315,13,ALVGIGLVFVMLF,1
5xan,B,324,341,17,VGALGLLFSSIIILGIL,1
5xan,B,355,367,12,LVLTIGAAVDGN,1
5xan,B,400,413,13,DVNASHLLSALAL,1
5xan,B,425,443,18,VTLIIGVIASTFSNLVFA,1
5xan,B,478,493,15,TLSVLLALAGAALVA,1
5xan,B,603,617,14,LLGLGLILVYVGFR,1
5xan,B,624,641,17,GSIIAAIHDVAIAMGLF,1
5xan,B,654,668,14,ALLTLIGYSLNDSI,1
5xan,B,703,718,15,TSVSTMLPLISLLIF,1
5xan,B,727,741,14,LILLVGILVGTYSS,1
3l71,W,19,36,17,FALTVVLGAVLFERAFD,1
5o66,O,2,26,24,ELLKSLVFAVIMVPVVMAIILGLI,1
3k03,E,26,45,19,LFVLTILTLISGTIFYSTV,1
3k03,E,74,95,21,GKIFTILYIFIGIGLVFGFIH,1
1dop,D,114,134,20,VALHGAFALIGFMLRQFELA,1
1dop,D,141,160,19,YNAIAFSGPIAVFVSVFLI,1
1dop,D,197,218,21,HMMGVAGVLGAALLCAIHGAT,1
1dop,D,268,289,21,HFFMLFVPVTGLWMSALGVVG,1
3um7,B,30,51,21,TLLALLALVLLYLVSGALVFR,1
3um7,B,142,169,27,RLFCIFYALVGIPLFGILLAGVGDRLG,1
3um7,B,199,220,21,LFLLIGCLLFVLTPTFVFCYM,1
3um7,B,256,280,24,YQPLVWFWILLGLAYFASVLTTIG,1
5xa8,A,54,76,22,EQFEDLLVRILLLAACISFVLA,1
5xa8,A,88,105,17,VEPFVILLILIANAIVG,1
5xa8,A,254,273,19,EFGEQLSKVISLICVAVWL,1
5xa8,A,297,314,17,IAVALAVAAIPEGLPAV,1
5xa8,A,759,777,18,FIRYLISSNVGEVVCIFL,1
5xa8,A,788,807,19,PVQLLWVNLVTDGLPATAL,1
5xa8,A,830,851,21,GWLFFRYMAIGGYVGAATVGA,1
5xa8,A,899,916,17,ALSVLVTIEMCNALNSL,1
5xa8,A,932,954,22,LLGSICLSMSLHFLILYVDPLP,1
5xa8,A,962,988,26,DLTQWLMVLKISLPVIGLDEILKFIA,1
5h2n,C,12,28,16,LALGTALMGLGTLYFL,1
5h2n,C,47,61,14,LVPAIAFTMYLSML,1
5h2n,C,80,94,14,ARYADWLFTTPLLL,1
5h2n,C,111,126,15,VGADGIMIGTGLVGA,1
5h2n,C,135,150,15,VWWAISTAAMLYILY,1
5h2n,C,178,192,14,VVLWSAYPVVWLIG,1
5h2n,C,204,220,16,TLLFMVLDVSAKVGFG,1
4iky,A,27,48,21,LFFTEFWERFSYYGMRAILVY,1
4iky,A,66,88,22,LAIMSIYGALVYMSGIIGGWLA,1
4iky,A,95,114,19,RAVFYGGLLIMAGHIALAI,1
4iky,A,120,140,20,LFVSMALIVLGTGLLKPNVS,1
4iky,A,161,180,19,YMGINLGAFLAPLVVGTAG,1
4iky,A,186,207,21,LGFGLAAVGMFLGLVVFVATR,1
4iky,A,229,249,20,AAAIMAVGAVVIAVLLAILI,1
4iky,A,253,277,24,FTVETFISLVGILGIIIPIIYFVV,1
4iky,A,296,320,24,PLFVASAMFWAIQQQGSTILANYA,1
4iky,A,334,353,19,PAWFQSLNPLFIIILAPVF,1
4iky,A,369,388,19,KFALGLLFAGLSFIVILVP,1
4iky,A,399,420,21,IWLVLSYFIVVLGELCLSPVG,1
4iky,A,438,458,20,LWFLSNAAAQAINAQLVRFY,1
4iky,A,464,485,21,AYFGTIGGAALVLGLILLAIA,1
3p03,C,63,75,12,VPALVIVLATVV,1
3p03,C,99,115,16,GWAFILFGTVFVFFIV,1
3p03,C,144,158,14,MFAAGMGIDLMFYG,1
3p03,C,183,200,17,TTMFHWTLHPWAIYAIV,1
3p03,C,238,258,20,DILAIIATVFGTACSLGLGA,1
3p03,C,284,298,14,VLTLAFIFSAISGV,1
3p03,C,304,322,18,LSNANMVLAALLAIFVFV,1
3p03,C,368,382,14,FYWAWWISWSPFVG,1
3p03,C,402,416,14,LVPAGVSTVWFSIF,1
3p03,C,457,477,20,MILLGTFFITSADSASTVMG,1
3p03,C,491,505,14,TAAWGVATAAIGLT,1
3p03,C,522,537,15,IVAATPFLFVVIGLM,1
1fbb,C,10,28,18,IWLALGTALMGLGTLYFL,1
1fbb,C,48,62,14,VPAIAFTMYLSMLL,1
1fbb,C,79,94,15,WARYADWLFTTPLLL,1
1fbb,C,112,128,16,GADGIMIGTGLVGALT,1
1fbb,C,134,150,16,FVWWAISTAAMLYILY,1
1fbb,C,178,196,18,VVLWSAYPVVWLIGSEGA,1
1fbb,C,204,220,16,TLLFMVLDVSAKVGFG,1
4pd5,C,4,19,15,MSCCGMAVLLGIAVL,1
4pd5,C,33,49,16,GAFAIQFSLGAFILYV,1
4pd5,C,103,118,15,TLIFFSALISVLYYL,1
4pd5,C,179,191,12,GLASIAGGVLAG,1
4pd5,C,202,217,15,VAASFMAAPGGLLFA,1
4pd5,C,243,267,24,NVIDAAAGGASAGLQLALNVGAML,1
4pd5,C,359,375,16,SFALCGFANLSSIAIL,1
4pd5,C,396,415,19,AVIAGTLSNLMAATIAGFF,1
3kp9,A,22,40,18,LAILAGLGSLLTAYLTYT,1
3kp9,A,65,89,24,EFLGIPTAAVGLLGFLGVLALAVL,1
3kp9,A,104,124,20,FGLVSAMTAFEMYMLYLMVA,1
3kp9,A,130,148,18,MYCTTAIILVAGLGLVTV,1
3kp9,A,161,181,20,SYILVAFLTLVTTIGVYANQ,1
2c76,A,491,501,10,LLRLIGLTTI,1
4pi2,C,28,41,13,VLLNVFYLIVRIY,1
4pi2,C,64,77,13,ILWTEIPLELVSG,1
4pi2,C,114,128,14,GIAIYWGASFFTEQ,1
4pi2,C,146,160,14,IIEFYMSYPIYSVI,1
4pi2,C,188,200,12,GPFMIIPNVGLN,1
2avl,A,93,110,17,GRVAMIGFAASLLGEAL,1
2avl,A,128,149,21,EAEPLLLFFILFTLLGAIGAL,1
2avl,A,194,217,23,LFVGRLAQLGIAFSLIGEIITGK,1
2avl,A,231,249,18,QDIEPLVLLNVAFFFFAA,1
4n4w,A,231,254,23,SYIAAFGAVTGLCTLFTLATFVA,1
4n4w,A,264,287,23,VILFYVNACFFVGSIGWLAQFMD,1
4n4w,A,313,340,27,CVIIFVIVYYALMAGVVWFVVLTYAWH,1
4n4w,A,357,378,21,SYFHLLTWSLPFVLTVAILAV,1
4n4w,A,400,424,24,AGFVLAPIGLVLIVGGYFLIRGVM,1
4n4w,A,452,474,22,GIFGFLAFGFVLITFSCHFYDF,1
4n4w,A,517,538,21,EKINLFAMFGTGIAMSTWVWT,1
4n7l,M,55,72,17,GVLSLFSGLMWFFTIGI,1
4n7l,M,117,133,16,ASFFMFVAVWSWWGRT,1
4n7l,M,147,164,17,WAFLSAIWLWMVLGFIR,1
4n7l,M,200,221,21,FHGLSIAFLYGSAHLFAMHGA,1
4n7l,M,269,286,17,IWMAVLVTLTGGIGILL,1
5dhg,A,51,74,23,VTIVGLYLAVCVGGLLGNCLVMY,1
5dhg,A,90,112,22,FNLALADTLVLLTLPFQGTDIL,1
5dhg,A,119,143,24,NALCKTVIAIDYYNMFTSTFTLTA,1
5dhg,A,171,191,20,VAIWALASVVGVPVAIMGSA,1
5dhg,A,209,233,24,YWGPVFAICIFLFSFIVPVLVISV,1
5dhg,A,267,291,24,VVAVFVGCWTPVQVFVLAQGLGVQ,1
5dhg,A,297,321,24,VAILRFCTALGYVNSCLNPILYAF,1
2j1i,D,30,50,20,QIGGLVIAGILFILGILIVL,1
4n6h,A,48,73,25,AIAITALYSAVCAVGLLGNVLVMFG,1
4n6h,A,88,110,22,FNLALADALATSTLPFQSAKYL,1
4n6h,A,115,143,28,FGELLCKAVLSIDYYNMFTSIFTLTMMS,1
4n6h,A,168,189,21,NICIWVLASGVGVPIMVMAVT,1
4n6h,A,199,231,32,LQFPSPSWYWDTVTKICVFLFAFVVPILIITV,1
4n6h,A,264,289,25,VVVGAFVVCWAPIHIFVIVWTLVDI,1
4n6h,A,296,320,24,VAALHLCIALGYANSSLNPVLYAF,1
5jgp,B,11,34,23,ARAFFYIVLLSILSTGIALLTLA,1
5jgp,B,149,171,22,VVAISLAGGIGIFTLVFFTLRR,1
1x0i,1,12,32,20,LALGTALMGLGTLYFLVKGM,1
1x0i,1,41,61,20,FYAITTLVPAIAFTMYLSML,1
1x0i,1,81,99,18,RYADWLFTTPLLLLDLAL,1
1x0i,1,104,123,19,QGTILALVGADGIMIGTGL,1
1x0i,1,137,157,20,WAISTAAMLYILYVLFFGFT,1
1x0i,1,172,190,18,VLRNVTVVLWSAYPVVWL,1
1x0i,1,204,225,21,TLLFMVLDVSAKVGFGLILLR,1
1dv3,H,15,32,17,AIYSFWIFLAGLIYYLQ,1
5avr,G,23,39,16,LIVAAVLCVIGIIILL,1
2m7x,A,127,142,15,QINFLGSLLIAGCIT,1
5aw7,G,22,38,16,GLIVAAVLCVIGIIIL,1
4ycn,A,55,73,18,QFEDLLVRILLLAACISF,1
4ycn,A,89,107,18,EPFVILLILIANAIVGVW,1
4ycn,A,254,276,22,EFGEQLSKVISLICVAVWLINI,1
4ycn,A,296,318,22,KIAVALAVAAIPEGLPAVITTC,1
4ycn,A,760,781,21,IRYLISSNVGEVVCIFLTAAL,1
4ycn,A,787,807,20,IPVQLLWVNLVTDGLPATAL,1
4ycn,A,832,852,20,LFFRYMAIGGYVGAATVGAA,1
4ycn,A,898,916,18,MALSVLVTIEMCNALNSL,1
4ycn,A,927,950,23,WVNIWLLGSICLSMSLHFLILYV,1
4ycn,A,967,987,20,LMVLKISLPVIGLDEILKFI,1
2npc,C,15,31,16,CTALVLFMTIPGIALF,1
2npc,C,48,64,16,TVTFALVCILWVVYGY,1
2npc,C,102,117,15,FQGSFACITVGLIVG,1
2npc,C,129,147,18,IFVVVWLTLSYIPIAHMV,1
2npc,C,161,178,17,AGGTVVAINAAIAGLVG,1
2npc,C,203,219,16,GTAILYIGWFGFNAGS,1
2npc,C,231,248,17,VNTVVATAAAILGWIFG,1
2npc,C,262,276,14,SGAIAGLVGVTPAC,1
2npc,C,282,298,16,GALIIGVVAGLAGLWG,1
2npc,C,315,332,17,GVHGVCGIVGCIMTGIF,1
2npc,C,353,377,24,VQLESIAITIVWSGVVAFIGYKLA,1
5u2h,D,36,49,13,VFSYISFALISDK,1
5u2h,D,330,344,14,IQLAVYIGSVISYF,1
1iij,A,7,31,24,TFIIATVVGVLLFLILVVVVGILI,1
3aee,D,39,60,21,SLHWTGERVVSVLLLGLLPAA,1
3aee,D,69,92,23,YSLAAALTLHGHWGIGQVVTDYV,1
3aee,D,98,117,19,KAAKAGLLALSAFTFAGLC,1
3mra,A,282,298,16,IFVISSIIITVVVINT,1
5kmd,D,1017,1033,16,IIYLIVLNGITMGLET,1
5kmd,D,1043,1061,18,YTTLFNQIVITIFTIEII,1
5kmd,D,1079,1094,15,DFFVVAISLVPTSSG,1
5kmd,D,1096,1112,16,ILRVLRVLRLFRLVTA,1
5kmd,D,1134,1151,17,ALMTLFFYIFAIMATQL,1
5kmd,D,1194,1213,19,YVFFIPFIFVVTFVMINLV,1
4fby,l,7,23,16,ALAALVILSFVMVIGV,1
4fby,l,40,54,14,FLGSGLWIALVLVV,1
5e79,z,8,25,17,LAALVILSFVMVIGVPV,1
5e79,z,40,55,15,FLGSGLWIALVLVVG,1
4a01,B,14,29,15,IPVCAVIGIAFALFQ,1
4a01,B,93,109,16,KYVGIFMVAFAILIFL,1
4a01,B,143,160,17,VSFLLGGVTSLVSGFLG,1
4a01,B,191,209,18,VMGFLLAANGLLVLYIAI,1
4a01,B,228,244,16,GYGLGGSSMALFGRVG,1
4a01,B,289,306,17,GMGSDLFGSYAESSCAA,1
4a01,B,328,345,17,IVSSVGILVCLLTTLFA,1
4a01,B,362,379,17,KQLVISTVLMTIGVAVV,1
4a01,B,406,425,19,CVAVGLWAGLIIGFVTEYY,1
4a01,B,456,473,17,KSVIIPIFAIAISIFVS,1
4a01,B,483,501,18,VAALGMLSTIATGLAIDA,1
4a01,B,537,556,19,AIGKGFAIGSAALVSLALF,1
4a01,B,577,593,16,GLIVGAMLPYWFSAMT,1
4a01,B,641,660,19,MIPPGALVMLTPLVVGILF,1
4a01,B,665,685,20,SGVLAGSLVSGVQIAISASN,1
4a01,B,733,751,18,GPSLNILIKLMAVESLVF,1
3ae3,D,42,62,20,WTGERVVSVLLLGLLPAAYL,1
3ae3,D,68,89,21,DYSLAAALTLHGHWGIGQVVT,1
3ae3,D,98,120,22,KAAKAGLLALSAFTFAGLCYFN,1
5l1f,D,525,543,18,WMCIVFAYIGVSVVLFLV,1
5l1f,D,597,614,17,GRIVGGVWWFFTLIIIS,1
5l1f,D,793,809,16,GVFYILVGGLGLAMLV,1
5e9s,C,19,33,14,WGLVLGAVFGLIAG,1
5e9s,C,38,61,23,GAVKTYIKPFGDLFVRLLKMLVM,1
5e9s,C,89,109,20,YYLATSAMAVFFGLIVGRLF,1
5e9s,C,131,144,13,LVQTLLNIVPTNP,1
5e9s,C,207,223,16,PIGVFALIAYVMAEQG,1
5e9s,C,232,249,17,VVGAVYTGLFLQIVITY,1
5e9s,C,308,324,16,GATINMDGTALYQGVT,1
5e9s,C,394,409,15,AILDMGRTMVNVTGD,1
2l2t,B,53,78,25,IAAGVIGGLFILVIVGLTFAVYVRR,1
4tqq,M,55,71,16,GVLSLFSGLMWFFTIG,1
4tqq,M,118,134,16,SFFMFVAVWSWWGRTY,1
4tqq,M,146,163,17,AWAFLSAIWLWMVLGFI,1
4tqq,M,201,221,20,HGLSIAFLYGSALLFAMHGA,1
4tqq,M,268,283,15,AIWMAVLVTLTGGIG,1
3has,A,10,32,22,IWLALGTALMGLGTLYFLVKGM,1
3has,A,42,66,24,YAITTLVPAIAFTMYLSMLLGYGL,1
3has,A,79,100,21,WARYADWLFTTPLLLLDLALL,1
3has,A,104,127,23,QGTILALVGADGIMIGTGLVGAL,1
3has,A,135,157,22,VWWAISTAAMLYILYVAFFGFT,1
3has,A,171,195,24,KVLRNVTVVLWSAYPVVWLIGSEG,1
3has,A,202,225,23,IETLLFMVLDVSAKVGFGLILLR,1
4qo2,A,92,110,18,AGPVTWVMMIACVVVFIA,1
4qo2,A,140,166,26,HALMHFSLMHILFNLLWWWYLGGAVE,1
4qo2,A,172,189,17,KLIVITLISALLSGYVQ,1
4qo2,A,199,214,15,LSGVVYALMGYVWLR,1
4qo2,A,226,242,16,RGLIIFALIWIVAGWF,1
4qo2,A,250,267,17,NGAHIAGLAVGLAMAFV,1
4tsy,B,7,28,21,VIDGAGLGFDVLKTVLEALGN,1
4xdj,B,77,95,18,VAIFVVVVVYLVTGGLVF,1
4xdj,B,186,208,22,IFCILYAIFGIPLFGFLLAGIG,1
4xdj,B,242,260,18,LFILAGCIVFVTIPAVIF,1
4xdj,B,301,321,20,KPLVWFWILVGLAYFAAVLS,1
5uk6,C,6,26,20,LHWIYVAGMTIGALHFWSLS,1
5uk6,C,36,57,21,YLVAMFIPIWSGLAYMAMAID,1
5uk6,C,69,89,20,YARYIDWMVTTPLLLLSLSW,1
5uk6,C,101,122,21,IGFLMSTQIVVITSGLIADLS,1
5uk6,C,128,149,21,YLWYICGVCAFLIILWGIWNP,1
5uk6,C,166,187,21,KLVTYFTVLWIGYPIVWIIGP,1
3c1h,C,15,31,16,CTALVLFMTIPGIALF,1
3c1h,C,47,64,17,VTVTFALVCILWVVYGY,1
3c1h,C,102,118,16,FQGSAACITVGLIVGA,1
3c1h,C,127,147,20,VLIFVVVWLTLSYIPIAHMV,1
3c1h,C,161,178,17,AGGTVVHINAAIAGLVG,1
3c1h,C,203,219,16,GTAILYIGWFGFNAGS,1
3c1h,C,231,248,17,VNTVVATAAAILGWIFG,1
3c1h,C,261,276,15,CSGAIAGLVGVTPAC,1
3c1h,C,282,299,17,GALIIGVVAGLAGLWGV,1
3c1h,C,314,332,18,FGVHGVCGIVGCIMTGIF,1
3c1h,C,353,377,24,VQLESIAITIVWSGVVAFIGYKLA,1
4zjc,A,44,69,25,YEWVLIAAYVAVFVVALVGNTLVCL,1
4zjc,A,85,108,23,VNLSLADVLVTAICLPASLLVDI,1
4zjc,A,118,141,23,CKVIPYLQAVSVSVAVLTLSFIA,1
4zjc,A,163,183,20,SILGIWAVSLAIMVPQAAVM,1
4zjc,A,211,234,23,PKIYHSCFFIVTYLAPLGLMAMA,1
4zjc,A,302,324,22,VLLVFALCYLPISVLNILKRVF,1
4zjc,A,336,358,22,YACFTFSHWLVYANSAANPIIY,1
3mkt,A,19,36,17,TPVLIASVAQTGMGFVD,1
3mkt,A,58,75,17,LPSILFGVGLLMALVPV,1
3mkt,A,94,111,17,GLILALLVSVPIIAVLF,1
3mkt,A,134,153,19,HAVIFAVPAYLLFQALRSF,1
3mkt,A,161,177,16,PAMVIGFIGLLLNIPL,1
3mkt,A,199,216,17,TAIVYWIMLLLLLFYIV,1
3mkt,A,239,263,24,RLFRLGFPVAAALFFEVTLFAVVA,1
3mkt,A,280,297,17,LNFSSLVFMFPMSIGAA,1
3mkt,A,325,344,19,LATACITALLTVLFREQIA,1
3mkt,A,359,380,21,LLLFAAIYQCMDAVQVVAAGS,1
3mkt,A,389,412,23,IFHRTFISYWVLGLPTGYILGMT,1
3mkt,A,424,440,16,FWLGFIIGLSAAALML,1
4xp9,C,35,57,22,FLLSVIGFAVDLANVWRFPYLC,1
4xp9,C,63,82,19,AFLVPYGIMLAVGGIPLFY,1
4xp9,C,112,133,21,VVLIAFYVDFYYNVIIAWSLR,1
4xp9,C,195,214,19,WDMALCLLIVYLICYFSLW,1
4xp9,C,220,240,20,GKVVWFTALFPYAVLLILLI,1
4xp9,C,264,287,23,KAEVWVDAATQVFFSLGPGFGVL,1
4xp9,C,304,321,17,LLTSFINSATSFIAGFV,1
4xp9,C,368,389,21,FFMMLATLGLDSSFGGSEAII,1
4xp9,C,407,423,16,AGLFSLYFVVGLASCT,1
4xp9,C,427,451,24,YFFHLLDRYAAGYSILVAVFFEAI,1
4xp9,C,481,504,23,WRFVAPIFLLFITVYGLIGYEPL,1
4xp9,C,514,532,18,ANALGWCIAGSSVVMIPA,1
4mjn,N,16,28,12,VGLASIGPGVGQ,1
4mjn,N,57,70,13,AFMEALTIYGLVV,1
3j9j,D,55,74,19,FNFFVYCLYMIIFTAAAYY,1
3j9j,D,93,117,24,RVTGEILSVSGGVYFFFRGIQYFL,1
3j9j,D,132,152,20,EILFFVQSLFMLVSVVLYFS,1
3j9j,D,157,176,19,VASMVFSLAMGWTNMLYYT,1
3j9j,D,193,218,25,LRDLCRFMFVYLVFLFGFSTAVVTL,1
3j9j,D,253,277,24,AVFIILLLAYVILTYILLLQMLIA,1
2yks,E,210,224,14,LGLIIAASWSVFWL,1
2yks,E,229,244,15,RLQTSFTLMLTVVAY,1
2yks,E,265,281,16,IAGYGSIFAAILLIIF,1
2yks,E,297,313,16,RCRLAFPLGFLAIGCV,1
5ktf,A,444,465,21,QYVLLGLGGLLLLVPIICQLR,1
4d6t,W,19,39,20,FALTIVVGALFFERAFDQGA,1
5ng5,J,11,26,15,AWVIAIIIMLAGGLA,1
5ng5,J,341,357,16,KTLVEAIILVFLVMYL,1
5ng5,J,366,383,17,IPTIAVPVVLLGTFAVL,1
5ng5,J,397,411,14,MVLAIGLLVDDAIV,1
5ng5,J,442,457,15,VGIAMVLSAVFVPMA,1
5ng5,J,471,489,18,ITIVSAMALSVLVALILT,1
5ng5,J,542,556,14,VLYLIIVVGMAYLF,1
5ng5,J,875,891,16,LYAISLIVVFLCLAAL,1
5ng5,J,896,918,22,IPFSVMLVVPLGVIGALLAATF,1
5ng5,J,928,943,15,VGLLTTIGLSAKNAI,1
5ng5,J,975,991,16,LMTSLAFILGVMPLVI,1
5ng5,J,1001,1019,18,AVGTGVMGGMVTATVLAI,1
2wit,C,61,76,15,VIVPALVIVLATVVW,1
2wit,C,99,116,17,GWAFILFGTVFVFFIVV,1
2wit,C,143,158,15,MMFAAGMGIGLMFYG,1
2wit,C,183,201,18,TTMFHWTLHPWAIYAIVG,1
2wit,C,237,258,21,IDILAIIATVFGTACSLGLGA,1
2wit,C,284,299,15,VLTLAFIFSAISGVG,1
2wit,C,301,322,21,IQYLSNANMVLAALLAIFVFV,1
2wit,C,368,385,17,FYWAWWISWSPFVGMFL,1
2wit,C,399,416,17,GVLLVPAGVSTVWFSIF,1
2wit,C,456,477,21,AMILLGTFFITSADSASTVMG,1
2wit,C,490,506,16,VTAAWGVATAAIGLTL,1
2wit,C,519,538,19,NVTIVAATPFLFVVIGLMF,1
3ze3,C,36,48,12,AVLLCVVIAAWL,1
3ze3,C,53,65,12,TRVLLISSVMLV,1
3ze3,C,104,117,13,IIDAVITWAILLW,1
3vra,D,58,79,21,FKIERYFAAAMVPLIPAAYFI,1
3vra,D,85,109,24,LCLALALTLHVHWGVWGVVNDYGR,1
3vra,D,116,138,22,LAAAVRVGAYIFTACLLAGLLY,1
4qtn,C,23,35,12,LMFLGIQAVVFV,1
4qtn,C,43,57,14,SVAAVTGILCVVFV,1
4qtn,C,64,76,12,YLFGLISVSLYA,1
4qtn,C,91,104,13,LLVYVPVQFVGFA,1
4qtn,C,132,145,13,LVVAASVVGTSVY,1
4qtn,C,162,175,13,TVVVSIVAQVLMI,1
4qtn,C,182,194,12,ALWIVVNILTIS,1
4qtn,C,209,222,13,LLLMYVMYLCNSV,1
2bs4,F,29,50,21,QSATGLFLGLFMIGHMFFVST,1
2bs4,F,77,99,22,VVSFLAAFVFAVFIAHAFLAMR,1
2bs4,F,125,151,26,WWIQAMTGFAMFFLGSVHLYIMMTQP,1
2bs4,F,167,192,25,MWPLYLVLLFAVILHGSVGLYRLAV,1
2bs4,F,206,232,26,ANLKKLKTLMSAFLIVLGLLTFGAYV,1
3dl8,E,9,25,16,VIIAVVLIISTLLQKG,1
3dl8,E,55,69,14,YWLGALFLVLALLL,1
2y02,A,42,63,21,GMSLLMALVVLLIVAGNVLVI,1
2y02,A,83,103,20,ACADLVVGLLVVPFGATLVV,1
2y02,A,108,133,25,WGSFLCELWTSLDVLCVTASIETLC,1
2y02,A,164,183,19,VWAISALVSFLPIMMHWWR,1
2y02,A,200,225,25,FVTNRAYAIASSIISFYIPLLIMIF,1
2y02,A,294,315,21,IMGVFTLCWLPFFLVNIVNVF,1
2y02,A,324,344,20,FVAFNWLGYANSAMNPIIYC,1
2kyh,A,30,48,18,VSYAALLSVIVVVVEYTM,1
2kyh,A,55,74,19,VRLYLVDLILVIILWADYA,1
2kyh,A,84,110,26,GYVKKTLYEIPALVPAGLLALIEGHL,1
2kyh,A,118,142,24,VRLLRFLRILLIISRGSKFLSAIA,1
2n2a,B,109,130,21,SIISAVVGILLVVVLGVVFGI,1
1ppj,W,19,43,24,FALTIVVGALFFERAFDQGADAIY,1
3jaf,E,240,262,22,IQMYIPSLLIVILSWVSFWINM,1
3jaf,E,265,286,21,PARVGLGITTVLTMTTQSSGS,1
3jaf,E,299,322,23,DIWMAVCLLFVFSALLEYAAVNF,1
3jaf,E,339,363,24,TVSRVAFPLVFLIFNIFYWITYKL,1
3cir,P,13,38,25,WGLFGAGGMWSAIIAPVMILLVGIL,1
3cir,P,62,86,24,GRVFLFLMIVLPLWCGLHRMHHAM,1
3cir,P,94,116,22,AGKWVFYGLAAILTVVTLIGVV,1
4hyj,A,11,33,22,QYMFWVGFVGMAAGTLYFLVER,1
4hyj,A,43,64,21,ATVAALVTFVAAIHYYFMKDA,1
4hyj,A,78,100,22,TEIRYIDWLVTTPLLLVKFPLL,1
4hyj,A,109,131,22,PLLTKLVIADVIMIVGGYIGES,1
4hyj,A,143,166,23,LWSYLIGCFAWIYIIYLLFTNVT,1
4hyj,A,179,201,22,LLKMRLFILIGWAIYPIGYAVT,1
4hyj,A,212,234,22,RELIYNFADLTNKVGFGLIAFF,1
4md2,B,10,32,22,IWLALGTALMGLGTLYFLVKGM,1
4md2,B,43,62,19,AITTLVPAIAFTMYLSMLL,1
4md2,B,80,98,18,ARYADWLFTTPLLLLDLA,1
4md2,B,107,127,20,ILALVGADGIMIGTGLVGAL,1
4md2,B,134,154,20,FVWWAISTAAMLYILYVLFF,1
4md2,B,174,192,18,RNVTVVLWSAYPVVWLIG,1
4md2,B,203,224,21,ETLLFMVLDVSAKVGFGLILL,1
1kgb,C,10,28,18,IWLALGTALMGLGTLYFL,1
1kgb,C,47,62,15,LVPAIAFTMYLSMLL,1
1kgb,C,80,94,14,ARYADWLFTTPLLL,1
1kgb,C,111,127,16,VGADGIMIGTGLVGAL,1
1kgb,C,134,150,16,FVWWAISTAAMLYILY,1
1kgb,C,178,192,14,VVLWSAYPVVWLIG,1
1kgb,C,203,220,17,ETLLFMVLDVSAKVGFG,1
3d9s,D,15,31,16,AEFLATLIFVFFGLGS,1
3d9s,D,44,61,17,IALAFGLAIGTLAQALG,1
3d9s,D,88,105,17,FYVAAQLVGAIAGAGIL,1
3d9s,D,130,149,19,AMVVELILTFQLALCIFAS,1
3d9s,D,160,177,17,PALSIGLSVTLGHLVGI,1
3d9s,D,204,221,17,VFWVGPIVGAVLAAILY,1
4doj,C,61,76,15,VIVPALVIVLATVVW,1
4doj,C,99,116,17,GWAFILFGTVFVFFIVV,1
4doj,C,143,158,15,MMFAAGMGIDLMFYG,1
4doj,C,183,201,18,TTMFHWTLHPWAIYAIVG,1
4doj,C,237,258,21,IDILAIIATVFGTACSLGLGA,1
4doj,C,283,296,13,SVLTLAFIFSAIS,1
4doj,C,301,322,21,IQYLSNANMVLAALLAIFVFV,1
4doj,C,368,385,17,FYWAWWISWSPFVGMFL,1
4doj,C,399,416,17,GVLLVPAGVSTVWFSIF,1
4doj,C,456,477,21,AMILLGTFFITSADSASTVMG,1
4doj,C,490,506,16,VTAAWGVATAAIGLTL,1
4doj,C,519,538,19,NVTIVAATPFLFVVIGLMF,1
4m2t,A,45,69,24,DRLYMLVGTLAAIIHGVALPLMML,1
4m2t,A,115,135,20,GIGAGVLIVAYIQVSFWCLA,1
4m2t,A,182,204,22,GDKIGMFFQAMATFFGGFIIGF,1
4m2t,A,211,232,21,LVILAISPVLGLSAGIWAKIL,1
4m2t,A,287,309,22,AITANISMGAAFLLIYASYALA,1
4m2t,A,330,351,21,FFSVLIGAFSVGQASPNIEAF,1
4m2t,A,704,728,24,PYFVVGIFCAIINGGLQPAFSVIF,1
4m2t,A,754,776,22,FLILGIISFITFFLQGFTFGKA,1
4m2t,A,824,847,23,TGSRLAVIFQNIANLGTGIIISL,1
4m2t,A,855,875,20,LLLAIVPIIAIAGVVEMKML,1
4m2t,A,929,952,23,KAHVFGITFSFTQAMMYFSYAAC,1
4m2t,A,974,994,20,SAIVFGAMAVGQVSSFAPDY,1
2y03,A,42,63,21,GMSLLMALVVLLIVAGNVLVI,1
2y03,A,82,103,21,LACADLVVGLLVVPFGATLVV,1
2y03,A,108,134,26,WGSFLCELWTSLDVLCVTASIETLCV,1
2y03,A,163,183,20,TVWAISALVSFLPIMMHWWR,1
2y03,A,200,225,25,FVTNRAYAIASSIISFYIPLLIMIF,1
2y03,A,294,315,21,IMGVFTLCWLPFFLVNIVNVF,1
2y03,A,323,343,20,LFVAFNWLGYANSAMNPIIY,1
2wjn,M,52,70,18,ASGIAAFAFGSTAILIIL,1
2wjn,M,116,133,17,GLFMTLSLGSWWIRVYS,1
2wjn,M,144,161,17,AWNFAAAIFFVLCIGCI,1
2wjn,M,199,219,20,HGFSIGFAYGCGLLFAAHGA,1
2wjn,M,266,283,17,GWFFSLMVMVSASVGIL,1
1prc,H,16,33,17,WYAQWLVIWTVVLLYLR,1
1l9h,A,39,64,25,AAYMFLLIMLGFPINFLTLYVTVQH,1
1l9h,A,73,98,25,ILLNLAVADLFMVFGGFTTTLYTSL,1
1l9h,A,109,133,24,NLEGFFATLGGEIALWSLVVLAIE,1
1l9h,A,154,176,22,GVAFTWVMALACAAPPLVGWSR,1
1l9h,A,200,224,24,SFVIYMFVVHFIIPLIVIFFCYGQ,1
1l9h,A,253,277,24,IIMVIAFLICWLPYAGVAFYIFTH,1
1l9h,A,287,309,22,TIPAFFAKTSAVYNPVIYIMMN,1
4d6u,W,18,32,14,TFALTIVVGALFFE,1
5lse,H,12,29,17,ASLAIYSFWIFLAGLIY,1
1bct,A,203,225,22,ETLLFMVLDVSAKVGFGLILLR,1
3tdo,E,28,46,18,VSSAFAGLYVGIGILLIF,1
3tdo,E,63,79,16,MGLSFAIALSLVIMTG,1
3tdo,E,105,129,24,KIWAYSWVGNLIGALVLGIIFVGT,1
3tdo,E,154,174,20,ALFFRGILCNILVCVSVLCS,1
3tdo,E,180,197,17,TAKIIMIFLCLFAFITS,1
3tdo,E,227,249,22,YNLVAVTLGNIVGGALFMGLGT,1
2wdr,H,15,36,21,FILVRATAIVLTLYIIYMVGF,1
2wdr,H,57,80,23,KVFTLLALFSILIHAWIGMWQVL,1
2wdr,H,89,110,21,RLMLQLVIVVALVVYVIYGFV,1
1u77,C,15,33,18,CTALVLFMTIPGIALFYG,1
1u77,C,45,64,19,TQVTVTFALVCILWVVYGY,1
1u77,C,103,120,17,QGSFACITVGLIVGALA,1
1u77,C,126,147,21,AVLIFVVVWLTLSYIPIAHMV,1
1u77,C,161,180,19,AGGTVVHINAAIAGLVGAY,1
1u77,C,200,218,18,VFTGTAILYIGWFGFNAG,1
1u77,C,231,251,20,VNTVVATAAAILGWIFGEWA,1
1u77,C,259,276,17,GACSGAIAGLVGVTPAC,1
1u77,C,283,302,19,ALIIGVVAGLAGLWGVTML,1
1u77,C,312,332,20,DVFGVHGVCGIVGCIMTGIF,1
1u77,C,353,380,27,VQLESIAITIVWSGVVAFIGYKLADLT,1
3mku,A,19,41,22,TPVLIASVAQTGMGFVDTIMAG,1
3mku,A,54,75,21,ASIWLPSILFGVGLLMALVPV,1
3mku,A,93,114,21,QGLILALLVSVPIIAVLFQTQ,1
3mku,A,130,153,23,VGYMHAVIFAVPAYLLFQALRSF,1
3mku,A,161,182,21,PAMVIGFIGLLLNIPLNWIFV,1
3mku,A,194,217,23,GCGVATAIVYWIMLLLLLFYIVT,1
3mku,A,239,267,28,RLFRLGFPVAAALFFEVTLFAVVALLVA,1
3mku,A,273,297,24,VAAHQVALNFSSLVFMFPMSIGAA,1
3mku,A,325,348,23,LATACITALLTVLFREQIALLYT,1
3mku,A,354,380,26,ALAMQLLLFAAIYQCMDAVQVVAAGS,1
3mku,A,389,413,24,IFHRTFISYWVLGLPTGYILGMTN,1
3mku,A,415,440,25,TEQPLGAKGFWLGFIIGLSAAALML,1
5nj3,B,393,414,21,ASIAQIIVTVVLGLVIGAIYF,1
5nj3,B,428,448,20,VLFFLTTNQCFSSVSAVELF,1
5nj3,B,471,497,26,GKLLSDLLPMRMLPSIIFTCIVYFML,1
5nj3,B,504,529,25,AFFVMMFTLMMVAYSASSMALAIAA,1
5nj3,B,535,556,21,VATLLMTICFVFMMIFSGLLV,1
5nj3,B,627,648,21,KNHVALACMIVIFLTIAYLKL,1
1bcc,U,20,36,16,ALTIVVGALLFERAFD,1
3c1i,C,15,32,17,CTALVLFMTIPGIALFY,1
3c1i,C,46,64,18,QVTVTFALVCILWVVYGY,1
3c1i,C,102,118,16,FQGSFACITVGLIVGA,1
3c1i,C,127,147,20,VLIFVVVWLTLSYIPIAHMV,1
3c1i,C,161,178,17,AGGTVVHINAAIAGLVG,1
3c1i,C,202,218,16,TGTAILYIGWFGANAG,1
3c1i,C,231,248,17,VNTVVATAAAILGWIFG,1
3c1i,C,261,276,15,CSGAIAGLVGVTPAC,1
3c1i,C,282,299,17,GALIIGVVAGLAGLWGV,1
3c1i,C,314,332,18,FGVHGVCGIVGCIMTGIF,1
3c1i,C,353,377,24,VQLESIAITIVWSGVVAFIGYKLA,1
4hwa,G,35,59,24,AIIIVGLIIARMISNAVNRLMISR,1
4hwa,G,67,87,20,FLSALVRYGIIAFTLIAALG,1
4hwa,G,92,108,16,TASVIAVLGAAGLAVG,1
3tdx,E,25,47,22,KYLVSSAFAGLYVGIGILLIFT,1
3tdx,E,63,79,16,MGLSFAIALSLVIMTG,1
3tdx,E,105,129,24,KIWAYSWVGNLIGALVLGIIFVGT,1
3tdx,E,154,175,21,ALFFRGILCNILVCVSVLCSF,1
3tdx,E,180,197,17,TAKIIMIFLCLFAFITS,1
3tdx,E,227,249,22,YNLVAVTLGNIVGGALFMGLGT,1
3ogc,F,25,50,25,WRAAGAATVLLVIVLLAGSYLAVLA,1
3ogc,F,86,112,26,WGRLVAVVVMVAGITSFGLVTAALAT,1
5en0,A,40,63,23,AAYMFLLIMLGFPINFLTLYVTV,1
5en0,A,75,95,20,LLNLAVADLFMVFGGFTTIL,1
5en0,A,113,133,20,GFFATLGGEIALWSLVVLAI,1
5en0,A,154,172,18,MGVAFTWVMALACAAPPL,1
5en0,A,202,221,19,FVIYMFVVHFIIPLIVIFF,1
5en0,A,255,277,22,IMVIAFLICWLPYAGVAFYIFT,1
5en0,A,289,309,20,IPAFFAKTSAVYNPVIYIMM,1
5kaf,r,6,20,14,VVLLPVLLAAGWAV,1
4ain,C,62,77,15,IVPALVIVLATVVWG,1
4ain,C,99,116,17,GWAFILFGTVFVFFIVV,1
4ain,C,143,158,15,MMFAAGMGIGLMFYG,1
4ain,C,183,200,17,TTMFHWTLHPWAIYAIV,1
4ain,C,238,258,20,DILAIIATVFGTACSLGLGA,1
4ain,C,282,296,14,VSVLTLAFIFSAIS,1
4ain,C,301,322,21,IQYLSNANMVLAALLAIFVFV,1
4ain,C,367,382,15,IFYWAWWISWSPFVG,1
4ain,C,400,416,16,VLLVPAGVSTVWFSIF,1
4ain,C,456,477,21,AMILLGTFFITSADSASTVMG,1
4ain,C,491,506,15,TAAWGVATAAIGLTL,1
4ain,C,519,537,18,NVTIVAATPFLFVVIGLM,1
2l0j,D,25,47,22,LVVAASIIGILHLILWILDRLF,1
3har,A,10,33,23,IWLALGTALMGLGTLYFLVKGMG,1
3har,A,42,66,24,YAITTLVPAIAFTMYLSMLLGYGL,1
3har,A,79,99,20,WARYADWLFTTPLLLLDLAL,1
3har,A,106,128,22,TILALVGADGIMIGTGLVGALT,1
3har,A,134,157,23,FVWWAISTAAMLYVLYVLFFGFT,1
3har,A,171,195,24,KVLRNVTVVLWSAYPVVWLIGSEG,1
3har,A,202,225,23,IETLLFMVLDVSAKVGFGLILLR,1
1y5d,A,41,56,15,SLVFVIGLVGNILVV,1
1y5d,A,74,89,15,NLAISDLLFLFTLPF,1
1y5d,A,113,127,14,YTGLYSEIFFIILL,1
1y5d,A,153,166,13,SIIIWALAILASM,1
1y5d,A,201,219,18,KLNLFGLVLPLLVMIICY,1
1y5d,A,241,256,15,FVIMIIFFLFWTPYN,1
1y5d,A,286,300,14,EVIAYTHCCVNPVI,1
2bk3,A,486,498,12,PSVPGLLRLIGL,1
5l1g,D,525,543,18,WMCIVFAYIGVSVVLFLV,1
5l1g,D,597,614,17,GRIVGGVWWFFTLIIIS,1
5l1g,D,793,810,17,GVFYILVGGLGLAMLVA,1
3v3y,M,53,72,19,SLGVLSLFSGLMWFFTIGI,1
3v3y,M,117,135,18,ASFFMFVAVWSWWGRTYL,1
3v3y,M,145,164,19,TAWAFLSAIWLWMVLGFIR,1
3v3y,M,201,221,20,HGLSIAFLYGSALLFAMHGA,1
3v3y,M,268,286,18,AIWMAVLVTLTGGIGILL,1
5ite,C,18,37,19,WLALGTIGMLLGMLYFIAD,1
5ite,C,51,69,18,ITILIPAIAAASYLSMFF,1
5ite,C,88,104,16,ARYADWLFTTPLLLLD,1
5ite,C,118,136,18,LVGIDAFMIVTGLVATLT,1
5ite,C,142,160,18,YAFWTISTISMVFLLYYL,1
5ite,C,183,200,17,NIILVTWAIYPVAWLVG,1
5ite,C,212,230,18,TLLFMVLDLVAKVGFGFI,1
3ae2,D,39,61,22,SLHWTGERVVSVLLLGLLPAAY,1
3ae2,D,69,89,20,YSLAAALTLHGHWGIGQVVT,1
3ae2,D,99,118,19,AAKAGLLALSAFTFAGLCY,1
5iua,A,6,26,20,SVYITVELAIAVLAILGNVL,1
5iua,A,47,67,20,LAAADILVGVLAIPFAITIS,1
5iua,A,76,96,20,CLFIACFVLVLAQSSIFSLL,1
5iua,A,124,144,20,IAICWVLSFAIGLTPMLGWN,1
5iua,A,172,194,22,PMNYMVYFNFFACVLVPLLLML,1
5iua,A,239,259,20,GLFALCWLPLHIINCFTFFC,1
5iua,A,265,286,21,PLWLMYLAIVLAHTNSVVNPF,1
4a2n,B,5,22,17,WKICFIVMFIIWVFVRK,1
4a2n,B,45,66,21,VFLNFIGMVFLPLTAVFSSYL,1
4a2n,B,77,93,16,RLFALIVTFLNIGLFT,1
4a2n,B,129,145,16,AHLWLWVITQGIILSN,1
4a2n,B,147,162,15,VLIFGIVAWAILYFI,1
3qbk,D,37,57,20,LYINIALAGLSILLFVFMTR,1
3qbk,D,66,86,20,IAVSTILVPVVSIASYTGLA,1
3qbk,D,121,141,20,GRYLTWALSTPMILLALGLL,1
3qbk,D,147,168,21,KLFTAITFDIAMCVTGLAAAL,1
3qbk,D,175,199,24,RWFWYAISCACFIVVLYILLVEWA,1
3qbk,D,211,232,21,STLKLLTVVMWLGYPIVWALG,1
3qbk,D,244,268,24,SWAYSALDIVAKYIFAFLLLNYLT,1
3qap,A,5,27,22,TLFWLGAIGMLVGTLAFAWAGR,1
3qap,A,36,60,24,YVTLVGISGIAAVAYVVMALGVGW,1
3qap,A,69,89,20,APRYIDWILTTPLIVYFLGL,1
3qap,A,97,118,21,FGIVITLNTVVMLAGFAGAMV,1
3qap,A,123,146,23,YALFGMGAVAFLGLVYYLVGPMT,1
3qap,A,160,184,24,VRLRNLTVILWAIYPFIWLLGPPG,1
3qap,A,192,215,23,DVALIVYLDLVTKVGFGFIALDA,1
4age,G,29,59,30,NIVAALAIIIVGLIIARMISNAVNRLMISR,1
4age,G,67,89,22,FLSALVRYGIIAFTLIAALGRV,1
4age,G,91,108,17,QTASVIAVLGAAGLAVG,1
5klv,K,22,38,16,LWGAVGAVGLVWATDW,1
3aed,D,42,62,20,WTGERVVSVLLLGLLPAAYL,1
3aed,D,68,89,21,DYSLAAALTLHGHWGIGQVVT,1
3aed,D,98,118,20,KAAKAGLLALSAFTFAGLCY,1
3zpr,A,42,61,19,GMSLLMALVVLLIVAGNVL,1
3zpr,A,83,103,20,ACADLVVGLLVVPFGATLVV,1
3zpr,A,108,133,25,WGSFLCELWTSLDVLCVTASIETLC,1
3zpr,A,164,183,19,VWAISALVSFLPIMMHWWR,1
3zpr,A,200,225,25,FVTNRAYAIASSIISFYIPLLIMIF,1
3zpr,A,294,315,21,IMGVFTLCWLPFFLVNIVNVF,1
3zpr,A,324,342,18,FVAFNWLGYANSAMNPII,1
1ijp,A,13,36,23,AVMMGLPAIGAAIGIGILGGKFL,1
1ijp,A,48,71,23,LRTQFFIVMGLVDAIAMIAVGLG,1
1kpk,B,40,60,20,VVGTLVGLAAVAFDKGVAWL,1
1kpk,B,84,97,13,CSAVLAMFGYFLV,1
1kpk,B,129,142,13,VKFFGGLGTLGGG,1
1kpk,B,144,155,11,LGREGPTVQIG,1
1kpk,B,217,232,15,VFIGVIMSTIMYRIF,1
1kpk,B,253,273,20,LYLILGIIFGIFGPIFNKWV,1
1kpk,B,290,305,15,WVLMGGAIGGLCGLL,1
1kpk,B,337,351,14,VARVITTLLCFSSG,1
1kpk,B,353,368,15,GGIFAPMLALGTVLG,1
1kpk,B,423,436,13,PMIITGLGATLLA,1
5iu7,A,4,26,22,GSSVYITVELAIAVLAILGNVL,1
5iu7,A,47,68,21,LAAADILVGVLAIPFAITIST,1
5iu7,A,76,97,21,CLFIACFVLVLAQSSIFSLLA,1
5iu7,A,124,144,20,IAICWVLSFAIGLTPMLGWN,1
5iu7,A,172,195,23,PMNYMVYFNFFACVLVPLLLMLG,1
5iu7,A,238,259,21,AGLFALCWLPLHIINCFTFFC,1
5iu7,A,265,286,21,PLWLMYLAIVLAHTNSVVNPF,1
2rcr,H,16,33,17,IYSFWIFLAGLIYYLQT,1
3syc,D,90,117,27,WRFNLLIFVMVYTVTWLFFGMIWWLIA,1
3syc,D,168,195,27,GIILLLIQSVLGSIVNAFMVGCMFVKI,1
4lxj,A,31,51,20,SLIIIIPFIYNIVWQLLYSL,1
5aw6,G,22,39,17,GLIVAAVLCVIGIIILL,1
5aww,G,11,24,13,YLGVAGLLVYLVL,1
5aww,G,55,67,12,TVILGVVFAALA,1
2mc7,A,10,26,16,LIFLLISLLVLCLALW,1
5avs,G,25,40,15,VAAVLCVIGIIILLA,1
4bvn,A,40,64,24,EAGMSLLMALVVLLIVAGNVLVIA,1
4bvn,A,80,103,23,TSLACADLVVGLLVVPFGATLVV,1
4bvn,A,110,136,26,SFLCELWTSLDVLCVTASVETLCVIA,1
4bvn,A,161,183,22,ICTVWAISALVSFLPIMMHWWR,1
4bvn,A,200,228,28,FVTNRAYAIASSIISFYIPLLIMIFVAL,1
4bvn,A,293,315,22,IIMGVFTLCWLPFFLVNIVNVF,1
4bvn,A,324,344,20,FVAFNWLGYANSAMNPIILC,1
2j1h,A,15,37,22,FIIATVEGVLLFLILVVVVGIL,1
3gia,A,15,33,18,MAVGVMIGASIFSIFGVG,1
3gia,A,42,56,14,ETFILSGIYALLVA,1
3gia,A,92,113,21,LWMSYVISIALFAKGFAGYFL,1
3gia,A,126,140,14,ITEIGIVAFFTALN,1
3gia,A,151,170,19,FFIVLVKLLILGLFIFAGL,1
3gia,A,191,206,15,FASAIFFLSYMGFGV,1
3gia,A,226,242,16,ISILIVMFVYVGVAIS,1
3gia,A,275,293,18,ISIGALFSISSAMNATIY,1
3gia,A,324,340,16,YITSALGVLFALLFNM,1
3gia,A,342,357,15,VASITSAVFMVIYLF,1
3gia,A,375,395,20,VIFSFIVVLGVFLLLLYYQW,1
3gia,A,400,415,15,VFYGIIATFIGVLIF,1
2c88,A,61,79,18,VRILLLAACISFVLAWFE,1
2c88,A,85,100,15,TAFVEPFVILLILIA,1
2c88,A,260,277,17,SKVISLICVAVWLINIG,1
2c88,A,292,311,19,IYYFKIAVALAVAAIPEGL,1
2c88,A,763,783,20,LISSNVGEVVCIFLTAALGL,1
2c88,A,785,804,19,ALIPVQLLWVNLVTDGLPA,1
2c88,A,833,852,19,FFRYMAIGGYVGAATVGAA,1
2c88,A,897,916,19,TMALSVLVTIEMCNALNSL,1
2c88,A,932,951,19,LLGSICLSMSLHFLILYVD,1
2c88,A,967,987,20,LMVLKISLPVIGLDEILKFI,1
2xut,A,19,39,20,SEACERFSFYGMRNILTPFL,1
2xut,A,55,74,19,AKDVFHSFVIGVYFFPLLG,1
2xut,A,87,106,19,ILWLSLIYCVGHAFLAIFE,1
2xut,A,111,128,17,FYTGLFLIALGSGGIKP,1
2xut,A,154,172,18,FTINFGSFFASLSMPLLL,1
2xut,A,179,197,18,AFGIPGVLMFVATVFFWL,1
2xut,A,240,255,15,GGVSAAYALVNIPTL,1
2xut,A,257,273,16,VAGLCCAMVLVMGFVG,1
2xut,A,306,326,20,LVTPFWSLFDQKASTWILQA,1
2xut,A,335,352,17,EPAMMQALNPLLVMLLI,1
2xut,A,377,394,17,AGIAITGLSWIVVGTIQ,1
2xut,A,404,423,19,IFWQILPYALLTFGEVLVS,1
2xut,A,445,464,19,WTLSVTVGNLWVLLANVSV,1
2xut,A,483,499,16,QMFFFAGFAILAAIVF,1
3bz2,Z,11,24,13,LVILSFVMVIGVP,1
3bz2,Z,39,53,14,IFLGSGLWIALVLV,1
4kpp,A,6,25,19,KFQLLAISSLTLPWLISLA,1
4kpp,A,37,58,21,LSGLAVVSASFLISWAAETAE,1
4kpp,A,65,84,19,SLAIVALLAVLPEYAVDGY,1
4kpp,A,101,122,21,ANMTGANRLLIGIGWSLVAFI,1
4kpp,A,139,157,18,LEIFFLFLATLYAFTLPL,1
4kpp,A,162,181,19,PFDALVFVSLYAIYIYLST,1
4kpp,A,204,224,20,RRLSVVVLFLFAGFTILMSV,1
4kpp,A,245,264,19,VQWIAPLASESPELIVAIY,1
4kpp,A,275,296,21,NALISSKVNQWTLLIGTIAII,1
4kpp,A,315,332,17,EVLLTAAQSLFAVAILL,1
4kpp,A,337,355,18,WKEASALFLLFIVQLLFP,1
4kpp,A,359,379,20,RYIISAIYIILSLPILFAKR,1
1oja,A,486,498,12,PSVPGLLRLIGL,1
4yms,C,4,44,40,FLSMVKYTPLFISGLIMTLKLTFLAVTIGVLMGLFIALMK,1
4yms,C,49,78,29,PIKLVASSYIEVIRGTPLLVQLLLIYNGL,1
4yms,C,86,107,21,AFTAGVSALAINSSAYVAEII,1
4yms,C,147,168,21,ALGNEFIVMLKESAIVSVIGF,1
4yms,C,186,207,21,EPYIIIAAIYFVMTLTFSKLL,1
5mmt,A,20,37,17,TEMWERFSYYGMRAILL,1
5mmt,A,58,74,16,IMAIYASMVYLSGTIG,1
5mmt,A,88,104,16,FWGGVLIMLGHIVLAL,1
5mmt,A,110,127,17,LFGSIILIIIGTGFLKP,1
5mmt,A,153,169,16,GINLGAFIAPLIVGAA,1
5mmt,A,177,193,16,AFSLAAIGMFIGLLVY,1
5mmt,A,222,240,18,KVSLAVAGFIAIIVVMNL,1
5mmt,A,249,264,15,INLLTIVAIAIPVFY,1
5mmt,A,287,307,20,LFIAAVLFWAIEEQGSVVLA,1
5mmt,A,323,339,16,FQSLNPLFIMLYTPFF,1
5mmt,A,355,372,17,KFAVGLMFAGLSFLLMA,1
5mmt,A,387,403,16,WLVGSWALVILGEMLI,1
5mmt,A,426,442,16,WFLSSSVGSALNAQLV,1
5mmt,A,455,472,17,YFGLGSVVLGIVLVFLS,1
3ij4,C,51,75,24,MGSLALLALVCTNRIQYYFLYPHV,1
3ij4,C,423,445,22,AYEVAGLLGDIGGQMGLFIGAS,1
4ikx,A,26,47,21,TLFFTEFWERFSYYGMRAILV,1
4ikx,A,68,88,20,IMSIYGALVYMSGIIGGWLA,1
4ikx,A,95,114,19,RAVFYGGLLIMAGHIALAI,1
4ikx,A,120,140,20,LFVSMALIVLGTGLLKPNVS,1
4ikx,A,160,180,20,FYMGINLGAFLAPLVVGTAG,1
4ikx,A,188,207,19,FGLAAVGMFLGLVVFVATR,1
4ikx,A,230,249,19,AAIMAVGAVVIAVLLAILI,1
4ikx,A,254,277,23,TVETFISLVGILGIIIPIIYFVV,1
4ikx,A,294,317,23,YIPLFVASAMFWAIQQQGSTILA,1
4ikx,A,336,357,21,WFQSLNPLFIIILAPVFAWMW,1
4ikx,A,368,387,19,QKFALGLLFAGLSFIVILV,1
4ikx,A,400,421,21,WLVLSYFIVVLGELCLSPVGL,1
4ikx,A,438,455,17,LWFLSNAAAQAINAQLV,1
4ikx,A,467,485,18,GTIGGAALVLGLILLAIA,1
3wu2,z,8,25,17,LAALVILSFVMVIGVPV,1
3wu2,z,40,56,16,FLGSGLWIALVLVVGV,1
5h2o,C,12,28,16,LALGTALMGLGTLYFL,1
5h2o,C,47,61,14,LVPAIAFTMYLSML,1
5h2o,C,80,94,14,ARYADWLFTTPLLL,1
5h2o,C,111,126,15,VGADGIMIGTGLVGA,1
5h2o,C,135,150,15,VWWAISTAAMLYILY,1
5h2o,C,178,192,14,VVLWSAYPVVWLIG,1
5h2o,C,204,220,16,TLLFMVLDVSAKVGFG,1
5xa9,A,58,74,16,DLLVRILLLAACISFV,1
5xa9,A,89,103,14,EPFVILLILIANAI,1
5xa9,A,257,273,16,EQLSKVISLICVAVWL,1
5xa9,A,297,311,14,IAVALAVAAIPEGL,1
5xa9,A,764,780,16,ISSNVGEVVCIFLTAA,1
5xa9,A,787,803,16,IPVQLLWVNLVTDGLP,1
5xa9,A,835,851,16,RYMAIGGYVGAATVGA,1
5xa9,A,899,914,15,ALSVLVTIEMCNALN,1
5xa9,A,935,950,15,SICLSMSLHFLILYV,1
5xa9,A,968,984,16,MVLKISLPVIGLDEIL,1
3prq,Z,7,23,16,ALAALVILSFVMVIGV,1
3prq,Z,40,54,14,FLGSGLWIALVLVV,1
3l70,W,19,36,17,FALTVVLGAVLFERAFD,1
3b9b,A,61,78,17,VRILLLAACISFVLAWF,1
3b9b,A,86,101,15,AFVEPFVILLILIAN,1
3b9b,A,258,274,16,QLSKVISLICVAVWLI,1
3b9b,A,296,314,18,KIAVALAVAAIPEGLPAV,1
3b9b,A,761,777,16,RYLISSNVGEVVCIFL,1
3b9b,A,787,806,19,IPVQLLWVNLVTDGLPATA,1
3b9b,A,832,851,19,LFFRYMAIGGYVGAATVGA,1
3b9b,A,899,915,16,ALSVLVTIEMCNALNS,1
3b9b,A,934,951,17,GSICLSMSLHFLILYVD,1
3b9b,A,968,987,19,MVLKISLPVIGLDEILKFI,1
5a8e,A,42,64,22,GMSLLMALVVLLIVAGNVLVIA,1
5a8e,A,80,103,23,TSLACADLVVGLLVVPFGATLVV,1
5a8e,A,108,137,29,WGSFLCELWTSLDVLCVTASVWTLCVIAI,1
5a8e,A,161,183,22,ICTVWAISALVSFLPIMMHWWR,1
5a8e,A,200,232,32,FVTNRAYAIASSIISFYIPLLIMIFVALRVYR,1
5a8e,A,291,314,23,LGIIMGVFTLCWLPFFLVNIVNV,1
5a8e,A,325,346,21,VAFNWLGYANSAMNPIILCRS,1
3k0d,E,26,45,19,LFVLTILTLISGTIFYSTV,1
3k0d,E,74,95,21,GKIFTILYIFIGIGLVFGFIH,1
2o7l,A,96,113,17,TWVMMIACVVVFIAMQI,1
2o7l,A,148,163,15,MHILFNLLWWWYLGG,1
2o7l,A,173,190,17,LIVITLISALLSGYVQQ,1
2o7l,A,198,213,15,GLSGVVYALMGYVWL,1
2o7l,A,229,244,15,IIFALIWIVAGWFDL,1
2o7l,A,251,267,16,GAHIAGLAVGLAMAFV,1
4ww3,A,37,57,20,GIFIGICGIIGCGGNGIVIY,1
4ww3,A,73,94,21,INLAFSDFTFSLVNGFPLMTI,1
4ww3,A,108,130,22,KVYGFIGGIFGFMSIMTMAMIS,1
4ww3,A,155,172,17,IIFVWLWSVLWAIGPIF,1
4ww3,A,200,221,21,ILCMFILGFFGPILIIFFCYF,1
4ww3,A,263,282,19,IVIVSQFLLSWSPYAVVAL,1
4ww3,A,300,317,17,VMFAKASAIHNPMIYSV,1
2occ,Z,16,34,18,IGLSVTFLSFLLPAGWVL,1
2mv6,A,19,41,22,LSLILVVILVLLTVLALLSHRR,1
4yt0,D,54,78,24,HGTLFKIERYFAAAMVPLIPAAYF,1
4yt0,D,85,108,23,LCLALALTLHVHWGVWGVVNDYG,1
4yt0,D,117,139,22,AAAVRVGAYIFTACLLAGLLYF,1
2v50,C,13,25,12,VIALVIMLAGGL,1
2v50,C,344,357,13,GEAILLVFLVMYL,1
2v50,C,367,382,15,PTIAVPVVLLGTFGV,1
2v50,C,398,409,11,VLAIGLLVDDA,1
2v50,C,443,455,12,GIAMVLSAVFLP,1
2v50,C,472,485,13,TIVSAMALSVIVA,1
2v50,C,542,555,13,LIYVVIVAGMIWM,1
2v50,C,877,890,13,LSLLVVFLCLAAL,1
2v50,C,898,914,16,SVMLVVPLGVIGALLA,1
2v50,C,930,942,12,LTTIGLSAKNAI,1
2v50,C,974,988,14,MTSLAFILGVVPLA,1
2v50,C,1003,1016,13,GVIGGMVTATVLA,1
4nv5,A,21,38,17,ILAILAGLGSLLTAYLT,1
4nv5,A,71,90,19,TAAVGLLGFLGVLALAVLP,1
4nv5,A,103,124,21,LFGLVSAMTAFEMYMLYLMVA,1
4nv5,A,130,148,18,MYCTTAIILVAGLGLVTV,1
4nv5,A,161,180,19,SYILVAFLTLVTTIGVYAN,1
2o9g,D,5,22,17,AAESFGTFWLVFGGSGS,1
2o9g,D,38,55,17,VALAFGLTVLTMAFAVG,1
2o9g,D,82,99,17,GYVIAQVVGGIVAAALL,1
2o9g,D,135,152,17,VVELVLSAGFLLVIHGA,1
2o9g,D,162,178,16,PIAIGLACTLIHLISI,1
2o9g,D,206,223,17,FFWVVPIVGGIIGGLIY,1
1xqf,C,15,32,17,CTALVLFMTIPGIALFY,1
1xqf,C,46,64,18,QVTVTFALVCILWVVYGY,1
1xqf,C,102,118,16,FQGSFACITVGLIVGA,1
1xqf,C,127,147,20,VLIFVVVWLTLSYIPIAHMV,1
1xqf,C,161,178,17,AGGTVVHINAAIAGLVG,1
1xqf,C,202,219,17,TGTAILYIGWFGFNAGS,1
1xqf,C,231,248,17,VNTVVATAAAILGWIFG,1
1xqf,C,261,276,15,CSGAIAGLVGVTPAC,1
1xqf,C,282,299,17,GALIIGVVAGLAGLWGV,1
1xqf,C,314,332,18,FGVHGVCGIVGCIMTGIF,1
1xqf,C,353,377,24,VQLESIAITIVWSGVVAFIGYKLA,1
4lmk,D,197,214,17,PNIILPMLFILFISWTA,1
4lmk,D,225,241,16,LVVSTLIAHIAFNILV,1
4lmk,D,254,271,17,GAIIFMIYLFYFVAVIE,1
4lmk,D,295,312,17,IAFPVVFLLANIILAFL,1
5hi9,D,396,411,15,FACYLVYMFIFTVVA,1
5hi9,D,437,453,16,HILILLGGIYLLLGQL,1
5hi9,D,475,489,14,FLLQALLTVLSQVL,1
5hi9,D,500,515,15,LVLSLVLGWLNLLYY,1
5hi9,D,538,555,17,RFLLVYLVFLFGFAVAL,1
5hi9,D,621,640,19,VLLLLLAYVLLTYVLLLNM,1
3llq,A,4,22,18,LLAEFFGTFWLVFGGCGS,1
3llq,A,39,58,19,ALAFGLTVLTMAYAVGGIS,1
3llq,A,82,99,17,PYVIAQVAGAIVAAAAL,1
3llq,A,130,151,21,SALLIEIILTAFFLIVILGST,1
3llq,A,159,176,17,APIAIGLALTLIHLISI,1
3llq,A,201,221,20,QLWLFWLAPIVGGAAGAVIW,1
5hk1,A,12,33,21,ALLLAVAAVLTQVVWLWLGTQ,1
3b4r,A,18,32,14,ITFILFLVVIIGLS,1
3b4r,A,41,57,16,VLFILLFVSVVLHELG,1
3b4r,A,97,113,16,GPLVSFIIGIVLLIVS,1
3b4r,A,126,147,21,YTLSLLNLMLGGFNLIPAFPM,1
3b4r,A,170,186,16,ANIGKSLALIMLLFGL,1
3b4r,A,191,205,14,ILILVSLFVYFGAE,1
3kj6,A,39,59,20,MSLIVLAIVFGNVLVITAIA,1
3kj6,A,70,88,18,FITSLACADLVMGLAVVP,1
3kj6,A,112,130,18,DVLCVTASIETLCVIAVD,1
3kj6,A,150,164,14,RVIILMVWIVSGLT,1
3kj6,A,204,221,17,IVSFYVPLVIMVFVYSR,1
3kj6,A,275,291,16,GIIMGTFTLCWLPFFI,1
3kj6,A,311,327,16,NWIGYVNSGFNPLIYC,1
4res,G,28,44,16,GGLIFAALAFIVGLII,1
2qfi,A,18,36,18,MASLLLLIKIFAWWYTGS,1
2qfi,A,42,57,15,LVDSLVDIGASLTNL,1
2qfi,A,83,102,19,LAQSMFISGSALFLFLTGI,1
2qfi,A,122,139,17,VALICTIILVSFQRWVV,1
2qfi,A,147,165,18,RADMLHYQSDVMMNGAIL,1
2qfi,A,178,199,21,DALFALGIGIYILYSALRMGY,1
4kk9,B,37,61,24,MAAVVGTLVGLAAVAFDKGVAWLQ,1
4kk9,B,84,97,13,CSAVLAMFGYFLV,1
4kk9,B,128,142,14,PVKFFGGLGTLGGG,1
4kk9,B,144,156,12,LGRAGPTVQIGG,1
4kk9,B,216,232,16,AVFIGVIMSTIMYRIF,1
4kk9,B,253,277,24,LYLILGIIFGIFGPIFNKWVLGMQ,1
4kk9,B,290,305,15,WVLMGGAIGGLCGLL,1
4kk9,B,338,351,13,ARVITTLLCFSSG,1
4kk9,B,353,368,15,GGIFAPMLALGTVLG,1
4kk9,B,423,439,16,PMIITGLGATLLAQFT,1
5vb8,D,1015,1032,17,KFIIYLIVLNGITMGLE,1
5vb8,D,1045,1064,19,TLFNQIVITIFTIEIILRI,1
5vb8,D,1076,1089,13,SLFDFFVVAISLV,1
5vb8,D,1098,1113,15,RVLRVLRLFRLVTAV,1
5vb8,D,1131,1148,17,SVIALMTLFFYIFAIMA,1
5vb8,D,1196,1214,18,FFIPFIFVVTFVMINLVV,1
1zhd,A,0,20,20,VGLGITTVLTLTTQSSGSRA,1
1zhd,A,27,50,23,VKAIDIWLAVCLLFVFSALLEYA,1
4r1i,B,24,40,16,HPVTLFIIFIVLLLIA,1
4r1i,B,90,109,19,TGFAPLGTVLVSLLGVGIA,1
4r1i,B,183,203,20,SANLFLGTIDPLLAGITQQA,1
4r1i,B,214,231,17,PEANWFFMAASTFVIAL,1
4r1i,B,277,289,12,VVFIALSALLAW,1
4r1i,B,315,329,14,VVFIFLLFALPGIV,1
4r1i,B,351,368,17,STLGLYLVIIFFAAQFV,1
4r1i,B,397,412,15,LFIGFILICAFINLM,1
4r1i,B,414,428,14,SASAQWAVTAPIFV,1
4r1i,B,440,452,12,IQAAYRIGDSVT,1
4r1i,B,493,504,11,IAWIALFCIWV,1
5v5z,A,26,44,18,LGVPFVYNLVWQYLYSLR,1
4u4t,A,39,61,22,ISVPCLLLAFCVWMLFSAVAVN,1
4u4t,A,73,96,23,LFMLTALPSVSGALLRVPYSFMV,1
4u4t,A,102,123,21,RWTAFSTGILIIPCVWLGFAV,1
4u4t,A,131,152,21,VFIIISLLCGFAGANFASSMA,1
4u4t,A,168,191,23,LNGGLGNMGVSVMQLVAPLVVSL,1
4u4t,A,212,234,22,ANASWIWVPFLAIFTIAAWFGM,1
4u4t,A,255,282,27,LWIMSLLYLATFGSFIGFSAGFAMLSK,1
4u4t,A,290,312,22,LQYAFFGPFIGALARSAGGALS,1
4u4t,A,318,339,21,RVTLVNFILMAIFSGLLFLTL,1
4u4t,A,348,373,25,MAFFAVFLALFLTAGLGSGSTFQMI,1
4u4t,A,408,429,21,FISAIGAIGGFFIPKAFGSSL,1
4u4t,A,436,457,21,GAMKVFLIFYIACVVITWAVY,1
3wxv,A,138,158,20,WTHLLGFVLFLFLGILTMLR,1
3wxv,A,171,190,19,VFGMFFLGAVLCLSFSWLF,1
3wxv,A,204,223,19,SKLDYSGIALLIMGSFVPW,1
3wxv,A,239,259,20,SIVCVLGISAIIVAQWDRFA,1
3wxv,A,264,280,16,QTRAGVFLGLGLSGVV,1
3wxv,A,301,321,20,WFFLMAVMYITGAGLYAARI,1
3wxv,A,337,356,19,QIFHVLVVAAAFVHFYGVS,1
2o9e,D,2,27,25,RKLAAESFGTFWLVFGGSGSAVLAA,1
2o9e,D,35,58,23,FAGVALAFGLTVLTMAFAVGHIS,1
2o9e,D,78,103,25,KEVVGYVIAQVVGGIVAAALLYLIA,1
2o9e,D,132,154,22,SALVVELVLSAGFLLVIHGATD,1
2o9e,D,161,181,20,APIAIGLALTLIHLISIPVT,1
2o9e,D,202,228,26,EQLWFFWVVPIVGGIIGGLIYRTLLE,1
2hg9,H,16,32,16,IYSFWIFLAGLIYYLQ,1
5tta,A,166,178,12,PPQDIISMFEKQ,1
5tta,A,185,200,15,NWLKEWKQMEKEYAK,1
5xam,A,35,52,17,LLLLLTLLGSLLYIWRP,1
5xam,A,300,317,17,IAALVGIGLVFVMLFAY,1
5xam,A,324,344,20,VGALGLLFSSIIILGILGGF,1
5xam,A,352,368,16,IAGLVLTIGAAVDGNV,1
5xam,A,400,416,16,DVNASHLLSALALYNY,1
5xam,A,422,443,21,GFAVTLIIGVIASTFSNLVFA,1
5xam,A,477,495,18,TTLSVLLALAGAALVATR,1
5xam,A,600,617,17,YAVLLGLGLILVYVGFR,1
5xam,A,624,644,20,GSIIAAIHDVAIAMGLFSLL,1
5xam,A,653,669,16,AALLTLIGYSLNDSII,1
5xam,A,702,718,16,MTSVSTMLPLISLLIF,1
5xam,A,724,744,20,DFSLILLVGILVGTYSSIYI,1
4ekw,F,1018,1034,16,IYLIVLNGITMGLETS,1
4ekw,F,1042,1061,19,VYTTLFNQIVITIFTIEII,1
4ekw,F,1079,1094,15,DFFVVAISLVPTSSG,1
4ekw,F,1096,1111,15,ILRVLRVLRLFRLVT,1
4ekw,F,1134,1151,17,ALMTLFFYIFAIMATQL,1
4ekw,F,1194,1213,19,WVFFIPFIFVVTFVMINLV,1
2h2s,B,40,61,21,VVGTLVGLAAVAFDKGVAWLQ,1
2h2s,B,81,96,15,AFLCSAVLAMFGYFL,1
2h2s,B,129,142,13,VKFFGGLGTLGGG,1
2h2s,B,144,155,11,LGRAGPTVQIG,1
2h2s,B,217,232,15,VFIGVIMSTIMYRIF,1
2h2s,B,253,273,20,LYLILGIIFGIFGPIFNKWV,1
2h2s,B,292,306,14,LMGGAIGGLCGLLG,1
2h2s,B,335,351,16,IFVARVITTLLCFSSG,1
2h2s,B,353,368,15,GGIFAPMLALGTVLG,1
2h2s,B,422,436,14,LPMIITGLGATLLA,1
4ri3,B,37,56,19,LFVGRVAMIGFAASLLGEG,1
4ri3,B,79,97,18,LLLFFILFTLLGAIGALG,1
4ri3,B,141,158,17,LFVGRLAQLGFAFSLIG,1
4ri3,B,182,198,16,PLVLLNVVFFFIAAIN,1
1s8j,A,11,31,20,WLALGTALMGLGTLYFLVKG,1
1s8j,A,42,62,20,YAITTLVPAIAFTMYLSMLL,1
1s8j,A,80,99,19,ARYASWLFTTPLLLLDLAL,1
1s8j,A,104,125,21,QGTILALVGADGIMIGTGLVG,1
1s8j,A,137,157,20,WAISTAAMLYILYVLFFGFT,1
1s8j,A,171,191,20,KVLRNVTVVLWSAYPVVWLI,1
1s8j,A,204,225,21,TLLFMVLDVSAKVGFGLILLR,1
4bon,E,221,243,22,IINIIAPCVLISSLVVLVYFLP,1
4bon,E,251,273,22,TLSISVLLAQTIFLFLIAQKVP,1
4bon,E,284,309,25,YLIFVMFVSLVIVTNCVIVLNVSLR,1
4bon,E,447,473,26,KACFWIALLLFSLGTLAIFLTGHLNQ,1
3ejz,B,37,61,24,MAAVVGTLVGLAAVAFDKGVAWLQ,1
3ejz,B,84,97,13,CSAVLAMFGYFLV,1
3ejz,B,129,142,13,VKFFGGLGTLGGG,1
3ejz,B,144,156,12,LGREGPTVQIGG,1
3ejz,B,216,232,16,AVFIGVIMSTIMYRIF,1
3ejz,B,253,277,24,LYLILGIIFGIFGPIFNKWVLGMQ,1
3ejz,B,290,305,15,WVLMGGAIGGLCGLL,1
3ejz,B,338,351,13,ARVITTLLCFSSG,1
3ejz,B,353,368,15,GGIFAPMLALGTVLG,1
3ejz,B,423,439,16,PMIITGLGATLLAQFT,1
3b9w,C,19,36,17,SINILAMLLVGFGFLMV,1
3b9w,C,45,63,18,TTGTYLVVATGLPLYILL,1
3b9w,C,82,99,17,YAEFAVATGLIAMGAVL,1
3b9w,C,105,122,17,QYALLALFIVPVYLLNE,1
3b9w,C,141,159,18,SIAIHAFGAYFGLGVSIA,1
3b9w,C,179,195,16,SMLGSMVLWLFWPSFA,1
3b9w,C,209,228,19,NTLLALCGATLATYFLSAL,1
3b9w,C,237,254,17,DMANAALAGGVAIGSVC,1
3b9w,C,260,277,17,GAFVIGLLGGAISVVGF,1
3b9w,C,293,313,20,CGVHNLHGLPGLLGGFSAIL,1
3b9w,C,323,347,24,TGIGITLALALIGGVIAGALIKLT,1
3eh3,C,5,27,22,KGALAVILVLTLTILVFWLGVY,1
4lcu,F,31,50,19,ATVLLVIVLLAGSYLAVLA,1
4lcu,F,87,107,20,GRLVAVVVMVAGITSFGLVT,1
5h2m,C,12,28,16,LALGTALMGLGTLYFL,1
5h2m,C,47,61,14,LVPAIAFTMYLSML,1
5h2m,C,80,94,14,ARYADWLFTTPLLL,1
5h2m,C,111,126,15,VGADGIMIGTGLVGA,1
5h2m,C,135,150,15,VWWAISTAAMLYILY,1
5h2m,C,178,192,14,VVLWSAYPVVWLIG,1
5h2m,C,204,220,16,TLLFMVLDVSAKVGFG,1
5dqq,B,74,90,16,SLNYFALLFLNFFEQP,1
5dqq,B,122,137,15,YEVITLAILLVHTFF,1
5dqq,B,154,169,15,VKVACVVILFVDVLV,1
5dqq,B,185,203,18,IAPYVRVIIFILSIRELR,1
5dqq,B,217,237,20,NILALWMLFLLFASWIAFVM,1
5dqq,B,281,304,23,SVFFVLYVLIGVYFVTNLILAVV,1
5dqq,B,434,449,15,AISFILIINFIAVVV,1
5dqq,B,467,484,17,EFVFGWIYVLEMALKIY,1
5dqq,B,496,513,17,NRFDFLVTWVIVIGETA,1
5dqq,B,531,545,14,YLLLARMLRLIRLL,1
5dqq,B,562,582,20,PSLMPYLGTIFCVLCIYCSI,1
5dqq,B,650,672,22,YFVSFYVITILLLLNLVVAFVL,1
2zzl,C,11,29,18,WLALGTALMGLGTLYFLV,1
2zzl,C,45,62,17,TTLVPAIAFTMYLSMLL,1
2zzl,C,80,95,15,ARYADWLFTTPLLLL,1
2zzl,C,110,127,17,LVGADGIMIGTGLVGAL,1
2zzl,C,134,152,18,FVWWAISTAAMLYILYVL,1
2zzl,C,175,192,17,NVTVVLWSAYPVVWLIG,1
2zzl,C,204,222,18,TLLFMVLDVSAKVGFGLI,1
3l72,W,20,36,16,ALTVVLGAVLFERAFD,1
4pd6,C,6,19,13,CCGMAVLLGIAVL,1
4pd6,C,33,46,13,GAFAIQFSLGAFI,1
4pd6,C,103,118,15,TLIFFSALISVLYYL,1
4pd6,C,178,191,13,GGLASIAGGVLAG,1
4pd6,C,203,217,14,AASFMAAPGGLLFA,1
4pd6,C,243,274,31,NVIDAAAGGASAGLQLALNVGAMLIAFIGLI,1
4pd6,C,362,375,13,LCGFANLSSIAIL,1
4pd6,C,396,412,16,AVIAGTLSNLMAATIA,1
1dxz,A,243,264,21,TLSISVLLSLTVFLLVIVELI,1
5c6n,A,20,43,23,SLSIPAMIGMFVMALYNVVNTIF,1
5c6n,A,57,78,21,IAFPIMMIMMSMAGALGIGGA,1
5c6n,A,101,123,22,TVILVLSVIGFISAFTLLGPAL,1
5c6n,A,137,162,25,DYLFPILLGSIFFFFAFAANNIIRS,1
5c6n,A,166,188,22,TFAMVTMIVPAVLNILLDVLFI,1
5c6n,A,196,216,20,GASIATVIAQASVTGLVLRY,1
5c6n,A,242,263,21,LVGLPAFVQQSSASLMMIAIN,1
5c6n,A,279,300,21,LVQRIMMFVMMPMMGIMQAMQ,1
5c6n,A,323,345,22,KVATIFSIGIFALLMLFPEALL,1
5c6n,A,360,384,24,AMHILFCVTFLIGAQIVAGGLYQS,1
5c6n,A,389,410,21,QALILSLSRQIIFLIPLVLIL,1
5c6n,A,418,438,20,VWWAFPIADVLSFILTVVLL,1
1f6n,H,12,31,19,ASLAIYSFWIFLAGLIYYL,1
4ikz,A,27,46,19,LFFTEFWERFSYYGMRAIL,1
4ikz,A,69,88,19,MSIYGALVYMSGIIGGWLA,1
4ikz,A,95,112,17,RAVFYGGLLIMAGHIAL,1
4ikz,A,123,140,17,SMALIVLGTGLLKPNVS,1
4ikz,A,161,177,16,YMGINLGAFLAPLVVG,1
4ikz,A,189,207,18,GLAAVGMFLGLVVFVATR,1
4ikz,A,229,245,16,AAAIMAVGAVVIAVLL,1
4ikz,A,259,277,18,ISLVGILGIIIPIIYFVV,1
4ikz,A,296,317,21,PLFVASAMFWAIQQQGSTILA,1
4ikz,A,337,353,16,FQSLNPLFIIILAPVF,1
4ikz,A,369,386,17,KFALGLLFAGLSFIVIL,1
4ikz,A,401,418,17,LVLSYFIVVLGELCLSP,1
4ikz,A,438,454,16,LWFLSNAAAQAINAQL,1
4ikz,A,467,484,17,GTIGGAALVLGLILLAI,1
1dze,C,12,28,16,LALGTALMGLGTLYFL,1
1dze,C,47,61,14,LVPAIAFTMYLSML,1
1dze,C,80,94,14,ARYADWLFTTPLLL,1
1dze,C,112,126,14,GADGIMIGTGLVGA,1
1dze,C,135,149,14,VWWAISTAAMLYIL,1
1dze,C,178,192,14,VVLWSAYPVVWLIG,1
1dze,C,204,220,16,TLLFMVLDVSAKVGFG,1
5m8j,A,41,55,14,GALVAVGYMDPGNW,1
5m8j,A,70,85,15,SIIVISSLLAMLLQN,1
5m8j,A,113,137,24,FWILTELAIMATDIAEVIGAAIAL,1
5m8j,A,147,162,15,AVVITVLDVFLLLLL,1
5m8j,A,170,187,17,EALVVCLIFVILFVFLY,1
5m8j,A,223,241,18,ASLGIIGATIMPANLFLH,1
5m8j,A,268,284,16,SNIQLSLAMVVNALLL,1
5m8j,A,332,351,19,AVALLASGQNSTITGTITG,1
5m8j,A,366,382,16,LRRLVTRLIAIIPVVV,1
5m8j,A,403,419,16,NNSQVFLALALPFSIV,1
5m8j,A,444,465,21,GWLTVIILTLLNLISISSQIA,1
5m8j,A,480,497,17,QVISIGIILAMIGLLIW,1
1afo,B,74,99,25,LIIFGVMAGVIGTILLISYGIRRLI,1
2c75,A,486,498,12,PSVPGLLRLIGL,1
1ojc,A,491,501,10,LLRLIGLTTI,1
5jdh,A,4,21,17,GVGYFLLGLILLYYGSD,1
5jdh,A,43,58,15,TVMAIGTSLPEILTS,1
5jdh,A,74,91,17,IGSCICNIGLVLGLSAI,1
5jdh,A,104,118,14,ILVYLLFVIFAAVI,1
5jdh,A,128,142,14,VVLLILFIIYLRWT,1
5jdh,A,169,186,17,IGLIGVLVGAELFVDGA,1
5jdh,A,205,219,14,AFGTSLPELMVSLA,1
5jdh,A,230,247,17,GNVIGSNIADIGGALAV,1
5jdh,A,261,275,14,AVLVIMSLLLYLFA,1
5jdh,A,283,297,14,QGILFLALYIIAIA,1
5aw4,G,25,42,17,VAAVLCVIGIIILLAGK,1
4ycm,A,55,73,18,QFEDLLVRILLLAACISF,1
4ycm,A,89,107,18,EPFVILLILIANAIVGVW,1
4ycm,A,254,276,22,EFGEQLSKVISLICVAVWLINI,1
4ycm,A,296,318,22,KIAVALAVAAIPEGLPAVITTC,1
4ycm,A,760,781,21,IRYLISSNVGEVVCIFLTAAL,1
4ycm,A,787,808,21,IPVQLLWVNLVTDGLPATALG,1
4ycm,A,833,852,19,FFRYMAIGGYVGAATVGAA,1
4ycm,A,898,916,18,MALSVLVTIEMCNALNSL,1
4ycm,A,927,950,23,WVNIWLLGSICLSMSLHFLILYV,1
4ycm,A,967,987,20,LMVLKISLPVIGLDEILKFI,1
2qpd,C,6,23,17,GALAVILVLTLTILVFW,1
5avq,G,23,39,16,LIVAAVLCVIGIIILL,1
2c8l,A,60,76,16,LVRILLLAACISFVLA,1
2c8l,A,88,103,15,VEPFVILLILIANAI,1
2c8l,A,258,276,18,QLSKVISLICVAVWLINI,1
2c8l,A,296,314,18,KIAVALAVAAIPEGLPAV,1
2c8l,A,761,780,19,RYLISSNVGEVVCIFLTAA,1
2c8l,A,786,807,21,LIPVQLLWVNLVTDGLPATAL,1
2c8l,A,834,851,17,FRYMAIGGYVGAATVGA,1
2c8l,A,900,916,16,LSVLVTIEMCNALNSL,1
2c8l,A,931,948,17,WLLGSICLSMSLHFLIL,1
2c8l,A,971,987,16,KISLPVIGLDEILKFI,1
4lz6,A,21,41,20,LSIPAMIGMFVMALYNVVDT,1
4lz6,A,57,78,21,IAFPIMMIMMSMAGALGIGGA,1
4lz6,A,98,119,21,NILTVILVLSVIGFISAFTLL,1
4lz6,A,140,162,22,FPILLGSIFFFFAFAANNIIRS,1
4lz6,A,166,187,21,TFAMVTMIVPAVLNILLDVLF,1
4lz6,A,198,217,19,SIATVIAQASVTGLVLRYF,1
4lz6,A,242,262,20,LVGLPAFVQQSSASLMMIAI,1
4lz6,A,279,300,21,LVQRIMMFVMMPMMGIMQAMQ,1
4lz6,A,323,344,21,KVATIFSIGIFALLMLFPEAL,1
4lz6,A,361,383,22,MHILFCVTFLIGAQIVAGGLYQ,1
4lz6,A,389,410,21,QALILSLSRQIIFLIPLVLIL,1
4lz6,A,418,438,20,VWWAFPIADVLSFILTVVLL,1
4n7x,A,5,21,16,TRLFPVWALLLSVAAY,1
4n7x,A,30,47,17,GPYVGPLLMLIMFAMGV,1
4n7x,A,62,82,20,PVAAATFLHYLIMPLTAWIL,1
4n7x,A,97,115,18,LVGSVASGTASNVMIYLA,1
4n7x,A,120,140,20,LSVTISAVSTLVGVFATPLL,1
4n7x,A,152,171,19,VVGMLKSILQIVVIPITAG,1
4n7x,A,189,205,16,PAMSMVCILAIISAVV,1
4n7x,A,221,241,20,AVILHNGIGLLSGYWGGKLF,1
4n7x,A,249,264,15,TLAIAVGMQNSGLAA,1
4n7x,A,279,296,17,ALFSVWHNLSGSLLAGY,1
3utw,A,10,33,23,IWLALGTALMGLGTLYFLVKGMG,1
3utw,A,41,62,21,FYAITTLVAAIAFTMFLSMLL,1
3utw,A,80,99,19,ARYADWLFTTPLLLLDLAL,1
3utw,A,104,126,22,QGTILALVGADGIMIGTGLVGA,1
3utw,A,135,157,22,VWWAISTAAMLYILYVLFFGFT,1
3utw,A,172,192,20,VLRNVTVVLWSAYPVVWLIG,1
3utw,A,202,225,23,IETLLFMVLDVSAKVGFGLILLR,1
3aef,D,41,60,19,HWTGERVVSVLLLGLLPAA,1
3aef,D,69,89,20,YSLAAALTLHGHWGIGQVVT,1
3aef,D,99,118,19,AAKAGLLALSAFTFAGLCY,1
5iwk,D,327,349,22,FCVLGAIYVLYIICFTMCCVYR,1
5iwk,D,383,408,25,RLVGELVSIVGAVIILLVEIPDIFR,1
5iwk,D,422,444,22,PFHVIIVTYAFMVLVTMVMRLT,1
5iwk,D,449,470,21,VVPMSFALVLGWCNVMYFARG,1
5iwk,D,487,511,24,DLMRFCWQMAVVILGFASAFYIIF,1
5iwk,D,552,576,24,MYSITYAAFAIIATLLMLNLLIAM,1
2eau,A,55,73,18,FEDLLVRILLLAACISFV,1
2eau,A,90,108,18,FVILLILIANAIVGVWQE,1
2eau,A,254,276,22,FGEQLSKVISLICVAVWLINIG,1
2eau,A,296,318,22,IAVALAVAAIPEGLPAVITTCL,1
2eau,A,760,781,21,RYLISSNVGEVVCIFLTAALG,1
2eau,A,786,808,22,IPVQLLWVNLVTDGLPATALGF,1
2eau,A,830,852,22,WLFFRYMAIGGYVGAATVGAAA,1
2eau,A,898,916,18,ALSVLVTIEMCNALNSLS,1
2eau,A,927,948,21,VNIWLLGSICLSMSLHFLILY,1
2eau,A,967,987,20,MVLKISLPVIGLDEILKFIA,1
3sya,D,90,116,26,WRFNLLIFVMVYTVTWLFFGMIWWLI,1
3sya,D,168,195,27,GIILLLIQSVLGSIVNAFMVGCMFVKI,1
4fa7,C,7,24,17,ALAVILVLTLTILVFWL,1
5b34,A,10,31,21,IWLALGTALMGLGTLYFLVKG,1
5b34,A,43,66,23,AITTLVPAIAFTMYLSMLLGYGL,1
5b34,A,79,99,20,WARYADWLFTTPLLLLDLAL,1
5b34,A,104,127,23,QGTILALVGADGIMIGTGLVGAL,1
5b34,A,136,158,22,WWAISTAAMLYILYVLFFGFTS,1
5b34,A,171,192,21,KVLRNVTVVLWSAYPVVWLIG,1
5b34,A,203,225,22,ETLLFMVLDVSAKVGFGLILLR,1
2r4s,A,44,59,15,LAIVFGNVLVITAIA,1
2r4s,A,70,83,13,FITSLACADLVMG,1
2r4s,A,117,130,13,TASIETLCVIAVD,1
2r4s,A,150,161,11,RVIILMVWIVS,1
2r4s,A,207,221,14,FYVPLVIMVFVYSR,1
2r4s,A,274,286,12,LGIIMGTFTLCW,1
2r4s,A,318,328,10,SGFNPLIYCR,1
3qbi,D,37,57,20,LYINIALAGLSILLFVFMTR,1
3qbi,D,66,87,21,IAVSTILVPVVSIASYTGLAS,1
3qbi,D,121,142,21,GRYLTWALSTPMILLALGLLA,1
3qbi,D,147,168,21,KLFTAITFDIAMCVTGLAAAL,1
3qbi,D,175,199,24,RWFWYAISCACFIVVLYILLVEWA,1
3qbi,D,211,232,21,STLKLLTVVMWLGYPIVWALG,1
3qbi,D,244,268,24,SWAYSALDIVAKYIFAFLLLNYLT,1
4zr0,A,200,215,15,VPVAWLPVVVYHMGV,1
4zr0,A,227,247,20,LFCVGVFVWTLIEYGLHRFL,1
4zr0,A,284,302,18,PTLFVILCAPFYKLVFAL,1
4zr0,A,309,325,16,AGFAGGLFGYVCYDEC,1
2lkh,A,19,39,20,FDKICKIGTESVEAGRLIEL,1
2lkh,A,46,67,21,GGPLYFVVNVIEPCKKFSELT,1
2lkh,A,81,102,21,TESKSVLKSLTEKLKKIVELI,1
2lkh,A,109,129,20,PLIGKYMLFTKEFVESSIKI,1
4faa,C,7,28,21,ALAVILVLTLTILVFWLGVYA,1
4fbz,C,10,28,18,WLWIGTIGMTLGTLYFVG,1
4fbz,C,45,61,16,TFITTIAAAMYFAMAT,1
4fbz,C,78,93,15,WARYADWLFTTPLLL,1
4fbz,C,110,127,17,IGLDVFMIGTGMIAAFA,1
4fbz,C,133,149,16,IAWWGISTGALLALLY,1
4fbz,C,175,191,16,LVIVLWLLYPVVWILG,1
4fbz,C,204,221,17,TAAFMVLDLSAKVGFGV,1
5ec5,I,55,65,10,ATHSIGSTIS,1
5ec5,I,76,86,10,VSYSHSHQKS,1
4tq3,A,16,39,23,YLRLLRPVAWLCFLLPYAVGFGF,1
4tq3,A,52,70,18,GLLSFAFWMAFSFTINAL,1
4tq3,A,99,119,20,VREAWLYCIAFLALSLATAA,1
4tq3,A,125,143,18,FLAMLGANIIGYVYSAPP,1
4tq3,A,152,168,16,VICNALAAVLAFYAGL,1
4tq3,A,176,191,15,IAIYPAAFFLAATFY,1
4tq3,A,226,241,15,SAITVILWAYVFLMA,1
4tq3,A,246,261,15,KVISPLIIAYTLIYT,1
4tq3,A,279,294,15,ILTPFGIISALFIAY,1
3hap,A,10,32,22,IWLALGTALMGLGTLYFLVKGM,1
3hap,A,42,66,24,YAITTLVPAIAFTMYLSMLLGYGL,1
3hap,A,79,99,20,WARYADWLFTTPLLLLDLAL,1
3hap,A,104,127,23,QGTILAAVGADGIMIGTGLVGAL,1
3hap,A,135,157,22,VWWAISTAAMLYILYVLFFGFT,1
3hap,A,172,195,23,VLRNVTVVLWSAYPVVWLIGSEG,1
3hap,A,202,225,23,IETLLFMVLDVSAKVGFGLILLR,1
3x3c,B,28,52,24,SHILTLGYAVMLAGLLYFILTIKN,1
3x3c,B,59,80,21,SNILSAVVMVSAFLLLYAQAQ,1
3x3c,B,106,127,21,GYRYLNWLIDVPMLLFQILFV,1
3x3c,B,137,160,23,VRNQFWFSGAMMIITGYIGQFYE,1
3x3c,B,166,189,23,FLVWGAISSAFFFHILWVMKKVI,1
3x3c,B,204,228,24,SNIWILFLISWTLYPGAYLMPYLT,1
3x3c,B,240,265,25,MARQLVYTIADVSSKVIYGVLLGNL,1
5l1e,D,525,543,18,WMCIVFAYIGVSVVLFLV,1
5l1e,D,597,614,17,GRIVGGVWWFFTLIIIS,1
5l1e,D,793,810,17,GVFYILVGGLGLAMLVA,1
3jyc,D,78,104,26,WRYMLLLFSLAFLVSWLLFGLIFWLI,1
3jyc,D,156,181,25,LAVFMVVVQSIVGCIIDSFMIGAIM,1
2kb7,P,27,50,23,NLQNLFINFALILIFLLLIAIIV,1
2kbv,A,449,470,21,FIIAYGGLRGAIAFSLGYLLD,1
5gth,z,8,25,17,LAALVILSFVMVIGVPV,1
5gth,z,40,55,15,FLGSGLWIALVLVVG,1
4qnc,B,5,25,20,GYVAAFLTTVSFLPQVLRVV,1
4qnc,B,34,52,18,RNMYIMFFLGVVLWFVYG,1
4qnc,B,60,80,20,ILANVVTLFFVTIILYYKLT,1
5nik,K,270,294,24,RTLLTMLGIIIGIASVVSIVVVGD,1
5nik,K,523,545,22,FLTLVAVISLVVGGIGVMNIML,1
5nik,K,573,601,28,IEAVLVCLVGGALGITLSLLIAFTLQLF,1
5nik,K,608,632,24,FSPLALLLAFLCSTVTGILFGWLP,1
3or6,F,26,50,24,RAAGAATVLLVIVLLAGSYLAVLA,1
3or6,F,87,111,24,GRCVAVVVMVAGITSFGLVTAALA,1
4cdi,F,2,25,23,ELLKSLVFAVIMVPVVMAIILGL,1
2exw,B,37,61,24,MAAVVGTLVGLAAVAFDKGVAWLQ,1
2exw,B,84,97,13,CSAVLAMFGYFLV,1
2exw,B,128,142,14,PVKFFGGLGTLGGG,1
2exw,B,144,159,15,LGREGPTVQIGGNIG,1
2exw,B,216,232,16,AVFIGVIMSTIMYRIF,1
2exw,B,253,277,24,LYLILGIIFGIFGPIFNKWVLGMQ,1
2exw,B,290,305,15,WVLMGGAIGGLCGLL,1
2exw,B,337,351,14,VARVITTLLCFSSG,1
2exw,B,353,368,15,GGIFAPMLALGTVLG,1
2exw,B,422,439,17,LPMIITGLGATLLAQFT,1
5njg,B,393,414,21,ASIAQIIVTVVLGLVIGAIYF,1
5njg,B,428,448,20,VLFFLTTNQCFSSVSAVELF,1
5njg,B,471,497,26,GKLLSDLLPMRMLPSIIFTCIVYFML,1
5njg,B,504,529,25,AFFVMMFTLMMVAYSASSMALAIAA,1
5njg,B,535,556,21,VATLLMTICFVFMMIFSGLLV,1
5njg,B,627,648,21,KNHVALACMIVIFLTIAYLKL,1
5kte,A,44,63,19,GPAVIASIAYMDPGNFATN,1
5kte,A,76,92,16,VILAANLMAMVIQNLS,1
5kte,A,113,142,29,PLVWFYWIQAELVAMATDLAEFLGAALAI,1
5kte,A,151,165,14,WGAVVTGVVTFWLL,1
5kte,A,177,192,15,AVGAFVLMIGVAYLV,1
5kte,A,222,236,14,GIIGATVMPHVIYL,1
5kte,A,262,278,16,DVIAAMGLAGLINMSM,1
5kte,A,315,339,24,FAVALLASGLSSSAVGTMAGDVIM,1
5kte,A,354,363,9,ITMLPAFIV,1
5kte,A,375,394,19,LSQVILCFGVPFALVPLLL,1
5kte,A,406,421,15,TRRSFTVIGWVIAVI,1
1u7c,C,15,33,18,CTALVLFMTIPGIALFYG,1
1u7c,C,45,64,19,TQVTVTFALVCILWVVYGY,1
1u7c,C,103,120,17,QGSFACITVGLIVGALA,1
1u7c,C,126,147,21,AVLIFVVVWLTLSYIPIAHMV,1
1u7c,C,161,180,19,AGGTVVHINAAIAGLVGAY,1
1u7c,C,200,218,18,VFTGTAILYIGWFGFNAG,1
1u7c,C,231,251,20,VNTVVATAAAILGWIFGEWA,1
1u7c,C,259,276,17,GACSGAIAGLVGVTPAC,1
1u7c,C,282,302,20,GALIIGVVAGLAGLWGVTML,1
1u7c,C,312,332,20,DVFGVHGVCGIVGCIMTGIF,1
1u7c,C,353,380,27,VQLESIAITIVWSGVVAFIGYKLADLT,1
2y01,A,42,63,21,GMSLLMALVVLLIVAGNVLVI,1
2y01,A,82,103,21,LACADLVVGLLVVPFGATLVV,1
2y01,A,108,133,25,WGSFLCELWTSLDVLCVTASIETLC,1
2y01,A,164,183,19,VWAISALVSFLPIMMHWWR,1
2y01,A,200,225,25,FVTNRAYAIASSIISFYIPLLIMIF,1
2y01,A,294,315,21,IMGVFTLCWLPFFLVNIVNVF,1
2y01,A,324,343,19,FVAFNWLGYANSAMNPIIY,1
3vrb,D,56,79,23,TLFKIERYFAAAMVPLIPAAYFI,1
3vrb,D,85,109,24,LCLALALTLHVHWGVWGVVNDYGR,1
3vrb,D,117,139,22,AAAVRVGAYIFTACLLAGLLYF,1
4m1m,A,35,68,33,LTMFRYAGWLDRLYMLVGTLAAIIHGVALPLMM,1
4m1m,A,116,139,23,IGAGVLIVAYIQVSFWCLAAGRQ,1
4m1m,A,180,204,24,GIGDKIGMFFQAMATFFGGFIIGF,1
4m1m,A,212,232,20,VILAISPVLGLSAGIWAKIL,1
4m1m,A,289,309,20,TANISMGAAFLLIYASYALA,1
4m1m,A,331,352,21,FSVLIGAFSVGQASPNIEAFA,1
4m1m,A,705,728,23,YFVVGIFCAIINGGLQPAFSVIF,1
4m1m,A,753,774,21,LFLILGIISFITFFLQGFTFG,1
4m1m,A,824,847,23,TGSRLAVIFQNIANLGTGIIISL,1
4m1m,A,855,879,24,LLLAIVPIIAIAGVVEMKMLSGQA,1
4m1m,A,926,952,26,AMKKAHVFGITFSFTQAMMYFSYAAA,1
4m1m,A,973,995,22,FSAIVFGAMAVGQVSSFAPDYA,1
3ar9,A,48,73,25,WELVIEQFEDLLVRILLLAACISFV,1
3ar9,A,90,110,20,FVILLILIANAIVGVWQERN,1
3ar9,A,253,274,21,EFGEQLSKVISLICVAVWLIN,1
3ar9,A,297,318,21,AVALAVAAIPEGLPAVITTCL,1
3ar9,A,760,781,21,RYLISSNVGEVVCIFLTAALG,1
3ar9,A,786,808,22,IPVQLLWVNLVTDGLPATALGF,1
3ar9,A,830,852,22,WLFFRYMAIGGYVGAATVGAAA,1
3ar9,A,898,916,18,ALSVLVTIEMCNALNSLS,1
3ar9,A,931,950,19,LLGSICLSMSLHFLILYVD,1
3ar9,A,965,987,22,WLMVLKISLPVIGLDEILKFIA,1
1rhz,C,31,49,18,HVIGVTVAFVIIEAILTY,1
2wjl,C,11,33,22,WLALGTALMGLGTLYFLVKGMG,1
2wjl,C,41,62,21,FYAITTLVPAIAFTMYLSMLL,1
2wjl,C,80,100,20,ARYADWLFTTPLLLLDLALL,1
2wjl,C,106,127,21,TILALVGADGIMIGTGLVGAL,1
2wjl,C,134,156,22,FVWWAISTAAMLYILYVLFFGF,1
2wjl,C,171,192,21,KVLRNVTVVLWSAYPVVWLIG,1
2wjl,C,204,225,21,TLLFMVLDVSAKVGFGLILLR,1
1bl8,D,25,50,25,WRAAGAATVLLVIVLLAGSYLAVLA,1
1bl8,D,87,112,25,GRCVAVVVMVAGITSFGLVTAALAT,1
4ck0,C,33,48,15,EGVAVLLAVVIACWL,1
4ck0,C,53,67,14,TRVLLISSVMLVMI,1
4ck0,C,103,117,14,AIIDAVITWCILLW,1
5bps,J,13,26,13,ISTIGLLGAGIGI,1
5bps,J,57,71,14,SEATGLFCLMVSFL,1
3jae,E,240,260,20,IQMYIPSLLIVILSWVSFWI,1
3jae,E,266,287,21,ARVGLGITTVLTMTTQSSGSR,1
3jae,E,299,319,20,DIWMAVCLLFVFSALLEYAA,1
3jae,E,340,363,23,VSRVAFPLVFLIFNIFYWITYKL,1
3tij,C,3,20,17,FMSLIGMAVLLGIAVLL,1
3tij,C,32,47,15,GGAFAIQFSLGAFIL,1
3tij,C,103,118,15,TLIFFSALISVLYYL,1
3tij,C,176,192,16,MCGGLASIAGGVLAGY,1
3tij,C,201,217,16,LVAASFMAAPGGLLFA,1
3tij,C,242,252,10,ANVIDAAAGG,1
3tij,C,254,274,20,AGLQLALNVGAMLIAFIGLI,1
3tij,C,359,375,16,SFALCGFANLSSIAIL,1
3tij,C,395,415,20,KAVIAGTLSNLMAATIAGFF,1
5bq6,J,13,33,20,ISTIGLLGAGIGIAIVFAAL,1
5bq6,J,49,71,22,MAILGFALSEATGLFCLMVSFL,1
2brd,C,10,28,18,WLALGTALMGLGTLYFLV,1
2brd,C,47,64,17,VPAIAFTMYLSMLLGYG,1
2brd,C,78,94,16,WARYADWLFTTPLLLL,1
2brd,C,112,128,16,ADGIMIGTGLVGALTK,1
2brd,C,134,150,16,VWWAISTAAMLYILYV,1
2brd,C,177,196,19,VVLWSAYPVVWLIGSEGAG,1
2brd,C,203,220,17,TLLFMVLDVSAKVGFGL,1
5ndz,A,73,97,24,TTVFLPIVYTIVFVVALPSNGMAL,1
5ndz,A,116,136,20,LALADLLSVIWFPLKIAYHI,1
5ndz,A,144,167,23,EALCNVLIGFFYANMYCSILFLT,1
5ndz,A,195,214,19,LAIWLLILLVTIPLYVVKQ,1
5ndz,A,236,259,23,GDMFNYFLSLAIGVFLFPAFLTA,1
5ndz,A,291,313,22,VAAMYLICFTPSNLLLVVHYFL,1
5ndz,A,323,343,20,ALYIVALCLSTLNSCIDPFV,1
3jad,E,238,260,22,YLIQMYIPSLLIVILSWVSFWI,1
3jad,E,266,288,22,ARVGLGITTVLTMTTQSSGSRA,1
3jad,E,299,321,22,DIWMAVCLLFVFSALLEYAAVN,1
3jad,E,339,362,23,TVSRVAFPLVFLIFNIFYWITYK,1
4md1,B,10,32,22,IWLALGTALMGLGTLYFLVKGM,1
4md1,B,43,62,19,AITTLVPAIAFTMYLSMLL,1
4md1,B,80,98,18,ARYADWLFTTPLLLLDLA,1
4md1,B,107,127,20,ILALVGADGIMIGTGLVGAL,1
4md1,B,134,154,20,FVWWAISTAAMLYILYVLFF,1
4md1,B,174,192,18,RNVTVVLWSAYPVVWLIG,1
4md1,B,203,224,21,ETLLFMVLDVSAKVGFGLILL,1
3j7t,A,51,71,20,LVIEQFEDLLVRILLLAACI,1
3j7t,A,91,110,19,FVILLILIANAIVGVWQER,1
3j7t,A,257,275,18,EQLSKVISLICVAVWLIN,1
3j7t,A,294,314,20,YFKIAVALAVAAIPEGLPAV,1
3j7t,A,760,781,21,IRYLISSNVGEVVCIFLTAAL,1
3j7t,A,786,807,21,LIPVQLLWVNLVTDGLPATAL,1
3j7t,A,832,852,20,LFFRYMAIGGYVGAATVGAA,1
3j7t,A,898,916,18,MALSVLVTIEMCNALNSL,1
3j7t,A,926,950,24,PWVNIWLLGSICLSMSLHFLILYV,1
3j7t,A,965,987,22,QWLMVLKISLPVIGLDEILKFI,1
4hz3,B,24,41,17,LLVLAVIIYGTAGFHFI,1
4hz3,B,71,92,21,GMYFTCTLIVLGIGTFAVAVE,1
1pss,H,13,30,17,SLAIYSFWIFLAGLIYY,1
2wjm,M,52,70,18,ASGIAAFAFGSTAILIIL,1
2wjm,M,116,133,17,GLFMTLSLGSWWIRVYS,1
2wjm,M,143,161,18,IAWNFAAAIFFVLCIGCI,1
2wjm,M,198,218,20,WHGFSIGFAYGCGLLFAAHG,1
2wjm,M,266,284,18,GWFFSLMVMVSASVGILL,1
5kzo,A,1730,1754,24,PAQLHFMYVAAAAFVLLFFVGCGV,1
5bqa,J,13,26,13,ISTIGLLGAGIGI,1
5bqa,J,57,71,14,SEATGLFCLMVSFL,1
2y00,A,42,63,21,GMSLLMALVVLLIVAGNVLVI,1
2y00,A,82,103,21,LACADLVVGLLVVPFGATLVV,1
2y00,A,108,133,25,WGSFLCELWTSLDVLCVTASIETLC,1
2y00,A,164,183,19,VWAISALVSFLPIMMHWWR,1
2y00,A,200,225,25,FVTNRAYAIASSIISFYIPLLIMIF,1
2y00,A,294,315,21,IMGVFTLCWLPFFLVNIVNVF,1
2y00,A,324,343,19,FVAFNWLGYANSAMNPIIY,1
4j4q,A,40,65,25,AAYMFLLIMLGFPINFLTLYVTVQH,1
4j4q,A,69,96,27,TPLNYILLNLAVADLFMVFGGFTTTLY,1
4j4q,A,113,137,24,GFFATLGGEIALWSLVVLAIERYV,1
4j4q,A,151,173,22,HAIMGVAFTWVMALACAAPPLV,1
4j4q,A,203,228,25,VIYMFVVHFIIPLIVIFFCYGQLVF,1
4j4q,A,250,274,24,TRMVIIMVIAFLICWLPYAGVAFY,1
4j4q,A,290,314,24,PAFFAKTSAVYNPVIYIMMNKQFR,1
3ar8,A,55,73,18,FEDLLVRILLLAACISFV,1
3ar8,A,90,111,21,FVILLILIANAIVGVWQERNA,1
3ar8,A,251,274,23,LDEFGEQLSKVISLICVAVWLIN,1
3ar8,A,296,321,25,IAVALAVAAIPEGLPAVITTCLALG,1
3ar8,A,758,781,23,FIRYLISSNVGEVVCIFLTAALG,1
3ar8,A,787,809,22,PVQLLWVNLVTDGLPATALGFN,1
3ar8,A,829,852,23,GWLFFRYMAIGGYVGAATVGAAA,1
3ar8,A,898,918,20,ALSVLVTIEMCNALNSLSEN,1
3ar8,A,927,949,22,VNIWLLGSICLSMSLHFLILYV,1
3ar8,A,965,987,22,WLMVLKISLPVIGLDEILKFIA,1
1rg5,H,15,31,16,AIYSFWIFLAGLIYYL,1
3or7,F,25,50,25,WRAAGAATVLLVIVLLAGSYLAVLA,1
3or7,F,87,113,26,GRCVAVVVMVAGITSFGLVTAALATW,1
4fy0,B,14,35,21,ILAMAGNAVGLGNFLRFPVQA,1
4fy0,B,42,63,21,FMIPYIIAFLLVGIPLMWIEW,1
4fy0,B,89,124,35,AKILGVFGLWIPLVVAIYYVYIESWTLGFAIKFLV,1
4fy0,B,167,185,18,AYIVFLITMFINVSILIR,1
4fy0,B,191,214,23,ERFAKIAMPTLFILAVFLVIRVF,1
4fy0,B,242,265,23,VWIAAVGQIFATLSLGFGAIITY,1
4fy0,B,278,298,20,GLTAATLNEKAEVILGGSIS,1
4fy0,B,340,367,27,GFLWFFLLFFAGLTSSIAIMQPMIAFL,1
4fy0,B,377,396,19,AVLWTAAIVFFSAHLVMFL,1
4fy0,B,400,425,25,DEMDFWAGTIGVVFFGLTELIIFFW,1
4fy0,B,445,472,27,RIYYYVMRYITPAFLAVLLVVWAREYI,1
4fy0,B,484,502,18,ITRFYIIGLFLFLTFLVF,1
1r3l,L,26,50,24,RAAGAATVLLVIVLLAGSYLAVLA,1
1r3l,L,87,112,25,GRCVAVVVMVAGITSFGLVTAALAT,1
3c1j,C,18,32,14,LVLFMTIPGIALFY,1
3c1j,C,46,61,15,QVTVTFALVCILWVV,1
3c1j,C,106,118,12,AACITVGLIVGA,1
3c1j,C,127,143,16,VLIFVVVWLTLSYIPI,1
3c1j,C,164,178,14,TVVHINAAIAGLVG,1
3c1j,C,202,215,13,TGTAILYIGWFGA,1
3c1j,C,235,248,13,VATAAAILGWIFG,1
3c1j,C,261,274,13,CSGAIAGLVGVTP,1
3c1j,C,285,299,14,IIGVVAGLAGLWGV,1
3c1j,C,314,328,14,FGVHGVCGIVGCIM,1
3c1j,C,357,377,20,SIAITIVWSGVVAFIGYKLA,1
2wdq,L,16,35,19,ILVRATAIVLTLYIIYMVG,1
2wdq,L,57,80,23,KVFTLLALFSILIHAWIGMWQVL,1
2wdq,L,89,110,21,RLMLQLVIVVALVVYVIYGFV,1
4f8h,E,199,218,19,NIILPMLFILFISWTAFWS,1
4f8h,E,222,240,18,ANVTLVVSTLIAHIAFNI,1
4f8h,E,256,275,19,AIIFMIYLFYFVAVIEVTV,1
4f8h,E,293,313,20,ASRIAFPVVFLLANIILAFL,1
5gti,z,8,25,17,LAALVILSFVMVIGVPV,1
5gti,z,40,55,15,FLGSGLWIALVLVVG,1
2wsx,C,15,27,12,FPPLIIVGILCW,1
2wsx,C,51,64,13,GWAFEWYMVVMLF,1
2wsx,C,96,108,12,ASCTSAAVLFWG,1
2wsx,C,136,150,14,YSLFHWGPLPWATY,1
2wsx,C,192,212,20,DNFYLVALIFAMGTSLGLAT,1
2wsx,C,236,249,13,TCWIILNAICVAC,1
2wsx,C,255,275,20,RIASDVRSYLSFLMLGWVFI,1
2wsx,C,317,331,14,VFYWAWWVIYAIQM,1
2wsx,C,353,366,13,GLTASTWILWTVL,1
2wsx,C,410,431,21,FFILCFIATVTLVNACSYTLA,1
2wsx,C,447,460,13,VRIGWSILVGIIG,1
2wsx,C,473,488,15,TAIIAGGCPLFFVNI,1
3x2q,Z,17,37,20,GLSVTFLSFLLPAGWVLYHL,1
2rmz,A,692,714,22,ILVVLLSVMGAILLIGLAALLI,1
3x3b,B,28,52,24,SHILTLGYAVMLAGLLYFILTIKN,1
3x3b,B,59,80,21,SNILSAVVMVSAFLLLYAQAQ,1
3x3b,B,106,127,21,GYRYLNWLIDVPMLLFQILFV,1
3x3b,B,137,160,23,VRNQFWFSGAMMIITGYIGQFYE,1
3x3b,B,165,189,24,AFLVWGAISSAFFFHILWVMKKVI,1
3x3b,B,204,228,24,SNIWILFLISWTLYPGAYLMPYLT,1
3x3b,B,240,265,25,MARQLVYTIADVSSKVIYGVLLGNL,1
3vhz,C,10,29,19,IWLALGTALMGLGTLYFLV,1
3vhz,C,46,62,16,TLVPAIAFTMYLSMLL,1
3vhz,C,79,94,15,WARYADWLFTTPLAL,1
3vhz,C,111,128,17,VGADGIMIGTGLVGALT,1
3vhz,C,134,150,16,FVWWAISTAAMLYILY,1
3vhz,C,177,192,15,TVVLWSAYPVVWLIG,1
3vhz,C,203,221,18,ETLLFMVLDVSAKVGFGL,1
4qo0,B,93,112,19,GPVTWVMMIACVVVFIAMQ,1
4qo0,B,149,166,17,HILFNLLWWWYLGGAVE,1
4qo0,B,172,191,19,KLIVITLISALLSGYVQQK,1
4qo0,B,198,216,18,GLSGVVYALMGYVWLRGE,1
4qo0,B,225,242,17,QRGLIIFALIWIVAGWF,1
4qo0,B,250,268,18,NGAHIAGLAVGLAMAFVD,1
3haq,A,10,33,23,IWLALGTALMGLGTLYFLVKGMG,1
3haq,A,41,62,21,FYAITTLVPAIAFTMYLSMLL,1
3haq,A,80,99,19,ARYADWLFTTPLLLLDLAL,1
3haq,A,104,126,22,QGTILALVGADGIMIGTGLVGA,1
3haq,A,135,157,22,VWWAISTAAMLYALYVLFFGFT,1
3haq,A,171,192,21,KVLRNVTVVLWSAYPVVWLIG,1
3haq,A,202,225,23,IETLLFMVLDVSAKVGFGLILLR,1
4zr1,A,201,216,15,PVAWLPVVVYHMGVA,1
4zr1,A,227,248,21,LFCVGVFVWTLIEYGLHRFLF,1
4zr1,A,286,302,16,LFVILCAPFYKLVFAL,1
4zr1,A,309,325,16,AGFAGGLFGYVCYDEC,1
4agf,G,36,59,23,IIIVGLIIARMISNAVNRLMISR,1
4agf,G,67,87,20,FLSALVRYGIIAFTLIAALG,1
4agf,G,92,108,16,TASVIAVLGAAGLAVG,1
5iub,A,6,29,23,SVYITVELAIAVLAILGNVLVCW,1
5iub,A,44,67,23,VVSLAAADILVGVLAIPFAITIS,1
5iub,A,76,100,24,CLFIACFVLVLAQSSIFSLLAIAI,1
5iub,A,122,144,22,GIIAICWVLSFAIGLTPMLGWN,1
5iub,A,172,198,26,PMNYMVYFNFFACVLVPLLLMLGVYL,1
5iub,A,234,259,25,AAIIAGLFALCWLPLHIINCFTFFC,1
5iub,A,266,290,24,LWLMYLAIVLAHTNSVVNPFIYAY,1
3f7y,F,30,50,20,AATVLLVIVLLAGSYLAVLA,1
3f7y,F,87,108,21,GRCVAVVVMVAGITSFGLVTA,1
3zry,S,13,34,21,ISTIGLLGAGIGIAIVFAALI,1
3zry,S,49,71,22,MAILGFALSEATGLFCLMVSFL,1
1ijd,S,19,36,17,TRVFLVIAAIAHFLAFT,1
2r4r,A,43,59,16,VLAIVFGNVLVITAIA,1
2r4r,A,65,84,19,TVTNYFITSLACADLVMGL,1
2r4r,A,116,134,18,VTASIETLCVIAVDRYFA,1
2r4r,A,144,162,18,LTKNKARVIILMVWIVSG,1
2r4r,A,207,225,18,FYVPLVIMVFVYSRVFQE,1
2r4r,A,271,287,16,LKTLGIIMGTFTLCWL,1
2r4r,A,316,333,17,VNSGFNPLIYCRSPDFR,1
5koy,A,35,68,33,LTMFRYAGWLDRLYMLVGTLAAIIHGVALPLMM,1
5koy,A,116,139,23,IGAGVLIVAYIQVSFWCLAAGRQ,1
5koy,A,180,204,24,GIGDKIGMFFQAMATFFGGFIIGF,1
5koy,A,212,233,21,VILAISPVLGLSAGIWAKILS,1
5koy,A,288,310,22,ITANISMGAAFLLIYASYALAF,1
5koy,A,331,355,24,FSVLIGAFSVGQASPNIEAFANAR,1
5koy,A,705,728,23,YFVVGIFCAIINGGLQPAFSVIF,1
5koy,A,753,774,21,LFLILGIISFITFFLQGFTFG,1
5koy,A,824,847,23,TGSRLAVIFQNIANLGTGIIISL,1
5koy,A,855,879,24,LLLAIVPIIAIAGVVEMKMLSGQA,1
5koy,A,926,952,26,AMKKAHVFGITFSFTQAMMYFSYAAC,1
5koy,A,973,995,22,FSAIVFGAMAVGQVSSFAPDYA,1
3ae1,D,42,62,20,WTGERVVSVLLLGLLPAAYL,1
3ae1,D,68,89,21,DYSLAAALTLHGHWGIGQVVT,1
3ae1,D,100,120,20,AKAGLLALSAFTFAGLCYFN,1
4q54,z,8,22,14,LAALVILSFVMVIG,1
4q54,z,43,55,12,SGLWIALVLVVG,1
3v3z,M,55,72,17,GVLSLFSGLMWFFTIGI,1
3v3z,M,117,134,17,ASFFMFVAVWSWWGRTY,1
3v3z,M,146,163,17,AWAFLSAIWLWMVLGFI,1
3v3z,M,201,221,20,HGLSIAFLYGSALLFAMHGA,1
3v3z,M,268,285,17,AIWMAVLVTLTGGIGIL,1
2knc,A,965,988,23,IWWVLVGVLGGLLLLTILVLAMW,1
5b35,A,10,32,22,IWLALGTALMGLGTLYFLVKGM,1
5b35,A,42,66,24,YAITTLVPAIAFTMYLSMLLGYGL,1
5b35,A,79,99,20,WARYADWLFTTPLLLLDLAL,1
5b35,A,104,127,23,QGTILALVGADGIMIGTGLVGAL,1
5b35,A,135,157,22,VWWAISTAAMLYILYVLFFGFT,1
5b35,A,172,195,23,VLRNVTVVLWSAYPVVWLIGSEG,1
5b35,A,202,225,23,IETLLFMVLDVSAKVGFGLILLR,1
4hod,B,13,32,19,LILAMAGNAVGLGNFLRFP,1
4hod,B,44,63,19,IPYIIAFLLVGIPLMWIEW,1
4hod,B,89,124,35,AKILGVFGLWIPLVVAIYYVYIESWTLGFAIKFLV,1
4hod,B,167,185,18,AYIVFLITMFINVSILIR,1
4hod,B,191,212,21,ERFAKIAMPTLFILAVFLVIR,1
4hod,B,244,266,22,IAAVGQIFFTLSLGFGAIITYA,1
4hod,B,277,297,20,SGLTAATLNEKASVILGGSI,1
4hod,B,340,367,27,GFLWFFLLFFAGLTSSIAIMQPMIAFL,1
4hod,B,378,396,18,VLWTAAIVFFSAHLVMFL,1
4hod,B,400,426,26,DEMDFWAGTIGVVFFGLTELIIFFWI,1
4hod,B,445,469,24,RIYYYVMRYITPAFLAVLLVVWAR,1
4hod,B,484,502,18,ITRFYIIGLFLFLTFLVF,1
5iu4,A,6,29,23,SVYITVELAIAVLAILGNVLVCW,1
5iu4,A,45,67,22,VSLAAADILVGVLAIPFAITIS,1
5iu4,A,75,97,22,GCLFIACFVLVLAQSSIFSLLA,1
5iu4,A,125,145,20,AICWVLSFAIGLTPMLGWNN,1
5iu4,A,172,195,23,PMNYMVYFNFFACVLVPLLLMLG,1
5iu4,A,237,259,22,IAGLFALCWLPLHIINCFTFFC,1
5iu4,A,266,288,22,LWLMYLAIVLAHTNSVVNPFIY,1
3aeg,D,39,60,21,SLHWTGERVVSVLLLGLLPAA,1
3aeg,D,71,89,18,LAAALTLHGHWGIGQVVT,1
3aeg,D,98,117,19,KAAKAGLLALSAFTFAGLC,1
4dxw,D,16,30,14,TVVSIIILNAVLIG,1
4dxw,D,37,56,19,PLFLETIHLLDYGITIFFV,1
4dxw,D,81,94,13,TVIVAISLIPIPN,1
4dxw,D,98,116,18,LVLRLLRIFRVLRLISVI,1
4dxw,D,134,154,20,FVSLLLFIILYIYATMGAIL,1
4dxw,D,195,212,17,SWVYFFSFIIICSITIL,1
3zpq,A,42,63,21,GMSLLMALVVLLIVAGNVLVI,1
3zpq,A,81,103,22,SLACADLVVGLLVVPFGATLVV,1
3zpq,A,108,134,26,WGSFLCELWTSLDVLCVTASIETLCV,1
3zpq,A,163,183,20,TVWAISALVSFLPIMMHWWR,1
3zpq,A,200,228,28,FVTNRAYAIASSIISFYIPLLIMIFVAL,1
3zpq,A,294,315,21,IMGVFTLCWLPFFLVNIVNVF,1
3zpq,A,324,343,19,FVAFNWLGYANSAMNPIIY,1
2eat,A,58,73,15,LLVRILLLAACISFV,1
2eat,A,90,107,17,FVILLILIANAIVGVWQ,1
2eat,A,254,275,21,FGEQLSKVISLICVAVWLINI,1
2eat,A,296,318,22,IAVALAVAAIPEGLPAVITTCL,1
2eat,A,760,782,22,RYLISSNVGEVVCIFLTAALGL,1
2eat,A,787,808,21,PVQLLWVNLVTDGLPATALGF,1
2eat,A,833,852,19,FRYMAIGGYVGAATVGAAA,1
2eat,A,898,916,18,ALSVLVTIEMCNALNSLS,1
2eat,A,927,950,23,VNIWLLGSICLSMSLHFLILYVD,1
2eat,A,965,987,22,WLMVLKISLPVIGLDEILKFIA,1
2kog,A,93,113,20,KMMIILGVICAIILIIIIVY,1
2qpe,C,6,23,17,GALAVILVLTLTILVFW,1
3utv,A,7,29,22,PEWIWLALGTALMGLGTLYFLV,1
3utv,A,43,67,24,AITTLVPAIAFTMFLSMLLGYGLT,1
3utv,A,79,99,20,WARYADWLFTTPLLLLDLAL,1
3utv,A,104,127,23,QGTILALVGADGIMIGTGLVGAL,1
3utv,A,135,158,23,VWWAISTAAMLYILYVLFFGFTS,1
3utv,A,172,195,23,VLRNVTVVLWSAYPVVWLIGSEG,1
3utv,A,200,224,24,LNIETLLFMVLDVSAKVGFGLILL,1
1x0k,1,11,33,22,WLALGTALMGLGTLYFLVKGMG,1
1x0k,1,41,62,21,FYAITTLVPAIAFTMYLSMLL,1
1x0k,1,79,100,21,WARYADWLFTTPLLLLDLALL,1
1x0k,1,106,128,22,TILALVGADGIMIGTGLVGALT,1
1x0k,1,134,157,23,FVWWAISTAAMLYILYVLFFGFT,1
1x0k,1,171,192,21,KVLRNVTVVLWSAYPVVWLIG,1
1x0k,1,204,226,22,TLLFMVLDVSAKVGFGLILLRS,1
3uu3,E,203,218,15,PMLFILFISWTAFWS,1
3uu3,E,222,238,16,ANVTLVVSTLIAHIAF,1
3uu3,E,259,275,16,FMIYLFYFVAVIEVTV,1
3uu3,E,292,310,18,RASRIAFPVVFLLANIIL,1
4ycl,A,61,78,17,VRILLLAACISFVLAWF,1
4ycl,A,86,104,18,AFVEPFVILLILIANAIV,1
4ycl,A,260,280,20,SKVISLICVAVWLINIGHFN,1
4ycl,A,292,314,22,IYYFKIAVALAVAAIPEGLPAV,1
4ycl,A,761,784,23,RYLISSNVGEVVCIFLTAALGLP,1
4ycl,A,786,807,21,LIPVQLLWVNLVTDGLPATAL,1
4ycl,A,835,854,19,RYMAIGGYVGAATVGAAAW,1
4ycl,A,897,916,19,TMALSVLVTIEMCNALNSL,1
4ycl,A,926,950,24,PWVNIWLLGSICLSMSLHFLILYV,1
4ycl,A,968,987,19,MVLKISLPVIGLDEILKFI,1
5aw5,G,22,38,16,GLIVAAVLCVIGIIIL,1
2m6i,E,225,248,23,QLYIPSLLIVILSWISFWINLDA,1
2m6i,E,250,267,17,ARVGLGITTVLTLTTQS,1
2m6i,E,283,306,23,DIWLAVCLLFVFSALLEYAAVNF,1
2m6i,E,397,420,23,ISRIGFPLAFLIFNLFYWIIYKI,1
2dhl,A,6,23,17,STIGDLVKWIIDTVNKF,1
2vv5,G,35,59,24,AIIIVGLIIARMISNAVNRLMISR,1
2vv5,G,67,87,20,FLSALVRYGIIAFTLIAALG,1
2vv5,G,92,108,16,TASVIAVLGAAGLVVG,1
4pi0,B,35,50,15,FAVLGGYHVHFMLTA,1
4pi0,B,68,81,13,VPILGVTFCAASQ,1
4pi0,B,92,108,16,GAVFAALGLLIGEWIN,1
4pi0,B,126,140,14,SALIVPAIWLDVIL,1
4pi0,B,147,161,14,ITAVVGSLGWGLLF,1
4pi0,B,222,240,18,FFSGFVSMMVYFLWWFMG,1
4phu,A,7,28,21,SFGLYVAAFALGFPLNVLAIR,1
4phu,A,44,66,22,ALNLGCSDLLLTVSLPLKAVEA,1
4phu,A,78,102,24,CPVFAVAHFAPLYAGGGFLAALSA,1
4phu,A,125,146,21,VCAAIWALVLCHLGLVFGLEA,1
4phu,A,179,203,24,GPARFSLSLLLFFLPLAITAFCFV,1
4phu,A,2225,2249,24,AGGALLTLLLCVGPYNASNVASFL,1
4phu,A,2258,2277,19,KLGLITGAWSVVLNPLVTG,1
3bvd,C,7,24,17,ALAVILVLTLTILVFWL,1
1ojb,A,490,501,11,GLLRLIGLTTI,1
3ux4,C,2,20,18,GLVLLYVGIVLISNGICG,1
3ux4,C,29,48,19,AVMNFFVGGLSIVCNVVVI,1
3ux4,C,77,95,18,PATGLLFGFTYLYAAINH,1
3ux4,C,102,120,18,PYSWYSLFVAINTVPAAI,1
3ux4,C,142,159,17,AIIWLAWGVLWLTAFIE,1
3ux4,C,168,188,20,FTPWLAIIEGILTAWIPAWL,1
4pda,C,9,25,16,MAVLLGIAVLLSSNRK,1
4pda,C,27,42,15,NLRTVGGAFAIQFSL,1
4pda,C,103,118,15,TLIFFSALISVLYYL,1
4pda,C,172,189,17,LFAVMCGGLASIAGGVL,1
4pda,C,206,223,17,FMAAPGGLLFAKLMMPE,1
4pda,C,242,270,28,ANVIDAAAGGASAGLQLALNVGAMLIAF,1
4pda,C,363,380,17,CGFANLSSIAILLGGLG,1
4pda,C,391,408,17,RMGVKAVIAGTLSNLMA,1
5m8k,A,43,58,15,LVAVGYMDPGNWSTS,1
5m8k,A,68,84,16,LLSIIVISSLLAMLLQ,1
5m8k,A,113,137,24,FWILTELAIMATDIAQVIGAAIAL,1
5m8k,A,147,162,15,AVVITVLDVFLLLLL,1
5m8k,A,170,190,20,EALVVCLIFVILFVFLYQII,1
5m8k,A,223,240,17,ASLGIIGATIMPHNLFL,1
5m8k,A,269,285,16,NIQLSLAMVVNALLLI,1
5m8k,A,332,351,19,AVALLASGQNSTITGTITG,1
5m8k,A,366,382,16,LRRLVTRLIAIIPVVV,1
5m8k,A,403,419,16,NNSQVFLALALPFSIV,1
5m8k,A,444,465,21,GWLTVIILTLLNLISISSQIA,1
5m8k,A,480,497,17,QVISIGIILAMIGLLIW,1
3bz1,Z,8,26,18,LAALVILSFVMVIGVPVA,1
3bz1,Z,37,56,19,QLIFLGSGLWIALVLVVGV,1
1vf5,U,5,26,21,LGWVALLVVFTWSIAMVVWGR,1
2hqc,C,12,25,13,WVIAIIIMLAGGL,1
2hqc,C,342,356,14,TLVEAIILVFLVMY,1
2hqc,C,366,382,16,IPTIAVPVVLLGTFAV,1
2hqc,C,399,410,11,LAIGLLVADAI,1
2hqc,C,441,455,14,LVGIAMVLSAVFVP,1
2hqc,C,472,489,17,TIVSAMALSVLVALILT,1
2hqc,C,541,556,15,LVLYLIIVVGMAYLF,1
2hqc,C,877,890,13,AISLIVVFLCLAA,1
2hqc,C,898,915,17,FSVMLVVPLGVIGALLA,1
2hqc,C,930,943,13,LLTTIGLSAKNAI,1
2hqc,C,976,992,16,MTSLAFILGVMPLVIS,1
2hqc,C,1005,1019,14,GVMGGMVTATVLAI,1
5azd,D,14,37,23,VFNMLSLTIAGMLAAFVFFLLAR,1
5azd,D,45,67,22,IALYLSALIVFIAGYHYLRIFE,1
5azd,D,90,111,21,YRYADWLLTVPLLLLELILVL,1
5azd,D,118,140,22,WNLSIKLVVASVLMLALGYVGE,1
5azd,D,149,172,23,LWGALSSIPFFYILYVLWVELGQ,1
5azd,D,186,207,21,LGATRLVLLMSWGFYPIAYAL,1
5azd,D,220,243,23,IQIGYSLADLIAKPIYGLLVFAI,1
5c6o,A,24,44,20,PAMIGMFVMALYNVVDTIFI,1
5c6o,A,57,78,21,IAFPIMMIMMSMAGALGIGGA,1
5c6o,A,100,119,19,LTVILVLSVIGFISAFTLL,1
5c6o,A,139,161,22,LFPILLGSIFFFFAFAANNIIR,1
5c6o,A,167,191,24,FAMVTMIVPAVLNILLDVLFIFGL,1
5c6o,A,196,215,19,GASIATVIAQASVTGLVLR,1
5c6o,A,242,263,21,LVGLPAFVQQSSASLMMIAIN,1
5c6o,A,279,298,19,LVQRIMMFVMMPMMGIMQA,1
5c6o,A,323,345,22,KVATIFSIGIFALLMLFPEALL,1
5c6o,A,360,383,23,AMHILFCVTFLIGAQIVAGGLYQ,1
5c6o,A,389,410,21,QALILSLSRQIIFLIPLVLIL,1
5c6o,A,419,438,19,WWAFPIADVLSFILTVVLL,1
4pd7,C,4,21,17,MSLIGMAVLLGIAVLLS,1
4pd7,C,30,47,17,TVGGAFAIQFSLGAFIL,1
4pd7,C,103,118,15,TLIFFSALISVLYYL,1
4pd7,C,176,192,16,MCGGLASIAGGVLAGY,1
4pd7,C,202,220,18,VAASFMAAPGGLLFAKLM,1
4pd7,C,242,274,32,ANVIDAAAGGASAGLQLALNVGAMLIAFIGLI,1
4pd7,C,359,379,20,SFALCGFANLSSIAILLGGL,1
4pd7,C,395,415,20,KAVIAGTLSNLMAATIAGFF,1
4y9h,A,10,32,22,IWLALGTALMGLGTLYFLVKGM,1
4y9h,A,42,66,24,YAITTLVPAIAFTMYLSMLLGYGL,1
4y9h,A,79,99,20,WARYADWLFTTPLLLLDLAL,1
4y9h,A,104,127,23,QGTILALVGADGIMIGTGLVGAL,1
4y9h,A,135,157,22,VWWAISTAAMLYILYVLFFGFT,1
4y9h,A,172,195,23,VLRNVTVVLWSAYPVVWLIGSEG,1
4y9h,A,202,224,22,IETLLFMVLDVSAKVGFGLILL,1
5t5n,E,33,53,20,SEFLIFISLYFAISLVYRLI,1
5t5n,E,62,82,20,EKLALYCNSYAELAPVSAVL,1
5t5n,E,240,258,18,TVAVYSFFLACLIGRQFL,1
5t5n,E,265,287,22,GHELDLFVPVFTFLQFFFYAGW,1
4pdv,E,25,45,20,VLFVLTILTLISGTIFYSTV,1
4pdv,E,75,99,24,GKIFTILYIFIGIGLVFGFIHKLA,1
4uyo,C,34,48,14,GVAVLLCVVIAAWL,1
4uyo,C,53,67,14,TRVLLISSVMLVMI,1
4uyo,C,103,117,14,AIIDAVITWAILLW,1
3prr,Z,5011,5024,13,LVILSFVMVIGVP,1
3prr,Z,5039,5052,13,IFLGSGLWIALVL,1
3l73,W,20,39,19,ALTVVLGAVLFERAFDQGA,1
5h2l,C,12,28,16,LALGTALMGLGTLYFL,1
5h2l,C,47,61,14,LVPAIAFTMYLSML,1
5h2l,C,80,94,14,ARYADWLFTTPLLL,1
5h2l,C,111,126,15,VGADGIMIGTGLVGA,1
5h2l,C,135,150,15,VWWAISTAAMLYILY,1
5h2l,C,178,192,14,VVLWSAYPVVWLIG,1
5h2l,C,204,220,16,TLLFMVLDVSAKVGFG,1
3b8e,H,30,48,18,LIFAALAFIVGLIIILSK,1
4ri2,B,37,56,19,LFVGRVAMIGFAASLLGEG,1
4ri2,B,78,97,19,PLLLFFILFTLLGAIGALG,1
4ri2,B,141,158,17,LFVGRLAQLGFAFSLIG,1
4ri2,B,182,198,16,PLVLLNVVFFFIAAIN,1
2zxe,G,23,38,15,LIVAAVLCVIGIIIL,1
5heo,E,211,222,11,LGLIIAASWSV,1
5heo,E,233,246,13,TSFTLMLTVVAYA,1
5heo,E,266,279,13,IAGYGSIFAAILL,1
5heo,E,303,315,12,FPLGFLAIGCVL,1
4grv,A,63,87,24,KVLVTAIYLALFVVGTVGNSVTLF,1
4grv,A,107,130,23,SLALSDLLILLLAMPVELYNFIW,1
4grv,A,136,164,28,FGDAGCRGYYFLRDACTYATALNVASLS,1
4grv,A,191,210,19,AIWLASALLAIPMLFTMGL,1
4grv,A,226,258,32,PIVDTATVKVVIQVNTFMSFLFPMLVISILNT,1
4grv,A,309,335,26,ARAVVIAFVVCWLPYHVRRLMFCYIS,1
4grv,A,347,370,23,HYFYMLTNALAYASSAINPILYN,1
3kg2,D,524,543,19,IWMCIVFAYIGVSVVLFLV,1
3kg2,D,597,617,20,GRIVGGVWWFFTLIIISSYT,1
3kg2,D,793,813,20,GVFYILVGGLGLAMLVALIE,1
4boo,E,221,243,22,IINIIAPCVLISSLVVLVYFLP,1
4boo,E,251,273,22,TLSISVLLAQTIFLFLIAQKVP,1
4boo,E,284,308,24,YLIFVMFVSLVIVTNCVIVLNVSL,1
4boo,E,449,473,24,CFWIALLLFSLGTLAIFLTGHLNQ,1
1j7f,L,18,40,22,LAAIGAAIGIGILGGKFLEGAA,1
1j7f,L,48,68,20,LRTQFFIVMGLVDAIPMIAV,1
2qjk,F,13,31,18,FLYYATAGAGAVATGAAV,1
3k0g,E,26,45,19,LFVLTILTLISGTIFYSTV,1
3k0g,E,74,95,21,GKIFTILYIFIGIGLVFGFIH,1
3wxw,A,146,167,21,GNIWTHLLGCVFFLCLGIFYM,1
3wxw,A,183,203,20,FGLFFLGAILCLSFSWLFHT,1
3wxw,A,215,235,20,SKLDYSGIALLIMGSFVPWL,1
3wxw,A,248,266,18,YLIVICVLGIAAIIVSQW,1
3wxw,A,275,294,19,GVRAGVFLGLGLSGIIPTL,1
3wxw,A,314,334,20,MLMASLYITGAALYAARIPE,1
3wxw,A,344,365,21,FHSHQLFHIFVVAGAFVHFHG,1
4nv6,A,21,42,21,ILAILAGLGSLLTAYLTYTKL,1
4nv6,A,65,89,24,EFLGIPTAAVGLLGFLGVLALAVL,1
4nv6,A,103,124,21,LFGLVSAMTAFEMYMLYLMVA,1
4nv6,A,130,149,19,MYCTTAIILVAGLGLVTVL,1
4nv6,A,160,181,21,FSYILVAFLTLVTTIGVYANQ,1
2o9d,A,5,22,17,AAESFGTFWLVFGGSGS,1
2o9d,A,38,55,17,VALAFGLTVLTMAFAVG,1
2o9d,A,81,99,18,VGYVIAQVVGGIVAAALL,1
2o9d,A,136,153,17,VELVLSAGFLLVIHGAT,1
2o9d,A,162,177,15,PIAIGLALTLIHLIS,1
2o9d,A,206,227,21,FFWVVPIVGGIIGGLIYRTLL,1
1xqe,C,15,31,16,CTALVLFMTIPGIALF,1
1xqe,C,48,64,16,TVTFALVCILWVVYGY,1
1xqe,C,102,118,16,FQGSFACITVGLIVGA,1
1xqe,C,129,147,18,IFVVVWLTLSYIPIAHMV,1
1xqe,C,161,178,17,AGGTVVHINAAIAGLVG,1
1xqe,C,203,219,16,GTAILYIGWFGFNAGS,1
1xqe,C,231,248,17,VNTVVATAAAILGWIFG,1
1xqe,C,262,276,14,SGAIAGLVGVTPAC,1
1xqe,C,282,298,16,GALIIGVVAGLAGLWG,1
1xqe,C,314,332,18,FGVHGVCGIVGCIMTGIF,1
1xqe,C,353,377,24,VQLESIAITIVWSGVVAFIGYKLA,1
3rfu,A,85,104,19,WIALMLTIPVVILEMGGHG,1
3rfu,A,114,132,18,SWIQLLLATPVVLWGGWP,1
3rfu,A,149,168,19,TLIAMGIGVAWIYSMVAVL,1
3rfu,A,186,199,13,YFEAAAVITTLVL,1
3rfu,A,341,359,18,WFVPAVILVAVLSFIVWA,1
3rfu,A,371,386,15,IAAVSVLIIACPCAL,1
3rfu,A,684,701,17,AFIYNVLGVPLAAGVLY,1
3rfu,A,707,723,16,LSPMIAAAAMALSSVS,1
2jp3,A,14,37,23,ESLQLGGLIFGGLLCIAGIALAL,1
4ki0,G,15,32,17,THLLLLLFIAAIMFPLL,1
4ki0,G,86,107,21,NSVKVAGISAIGIVALSTTCA,1
4ki0,G,117,133,16,KATLLKGMLIFQMFPA,1
4ki0,G,160,179,19,GVIFAYLGGIALHVWTIKG,1
4ki0,G,213,229,16,ILAVVFILSFIAAITE,1
4ki0,G,269,285,16,SALPITIVFLLAQRWL,1
5hkd,D,157,173,16,LVIFYVFAVMGTKLFA,1
5hkd,D,212,230,18,WAWIYFVSFILVSSFTVL,1
3lnm,G,165,181,16,AIVSVMVILISIVSFC,1
3lnm,G,225,239,14,ETLCIIWWSFEFLV,1
3lnm,G,257,271,14,IDIVAIIPYYVTIF,1
3lnm,G,292,304,12,RIMRILRIFKLS,1
3lnm,G,325,342,17,LLIFFLFIGVILFSSAV,1
3lnm,G,385,399,14,VGSLCAIAGVLTIA,1
4kk8,B,40,61,21,VVGTLVGLAAVAFDKGVAWLQ,1
4kk8,B,84,97,13,CSAVLAMFGYFLV,1
4kk8,B,129,142,13,VKFFGGLGTLGGG,1
4kk8,B,144,156,12,LGRQGPTVQIGG,1
4kk8,B,216,232,16,AVFIGVIMSTIMYRIF,1
4kk8,B,253,273,20,LYLILGIIFGIFGPIFNKWV,1
4kk8,B,291,304,13,VLMGGAIGGLCGL,1
4kk8,B,338,351,13,ARVITTLLCFSSG,1
4kk8,B,353,368,15,GGIFAPMLALGTVLG,1
4kk8,B,423,439,16,PMIITGLGATLLAQFT,1
5jqh,A,1032,1057,25,VVGMGIVMSLIVLAIVFGNVLVITA,1
5jqh,A,1070,1095,25,FITSLACADLVMGLAVVPFGAAHIL,1
5jqh,A,1105,1129,24,CEFWTSIDVLCVTASIETLCVIAV,1
5jqh,A,1151,1174,23,VIILMVWIVSGLTSFLPIQMHWY,1
5jqh,A,1196,1220,24,QAYAIASSIVSFYVPLVIMVFVYS,1
5jqh,A,1275,1299,24,GIIMGTFTLCWLPFFIVNIVHVIQ,1
5jqh,A,1303,1327,24,RKEVYILLNWIGYVNSGFNPLIYC,1
5a43,B,6,23,17,AVIIGGSVGCTLRWLLS,1
5a43,B,34,48,14,PGTLVVNLLAGLII,1
5a43,B,69,84,15,TTGLCGGLSTFSTFS,1
5a43,B,101,114,13,SVLVHVIGSLIMT,1
1ors,C,27,50,23,ELGVSYAALLSVIVVVVEYTMQL,1
1ors,C,55,75,20,VRLYLVDLILVIILWADYAY,1
1ors,C,88,107,19,KTLYEIPALVPAGLLALIE,1
1ors,C,118,142,24,VRLLRFLRILLIISRGSKFLSAIA,1
3rey,A,8,29,21,YITVELAIAVLAILGNVLVCW,1
3rey,A,44,67,23,VVSLAAADILVGVLAIPFAITIS,1
3rey,A,76,100,24,CLFIACFVLVLAQSSIFSLLAIAI,1
3rey,A,121,144,23,AGIIAICWVLSFAIGLTPMLGWN,1
3rey,A,173,198,25,MNYMVYFNFFACVLVPLLLMLGVYL,1
3rey,A,236,259,23,IIAGLFALCWLPLHIINCFTFFC,1
3rey,A,265,288,23,PLWLMYLAIVLAHTNSVVNPFIY,1
5abb,Z,35,48,13,VTAALLASTVFFF,1
5abb,Z,66,79,13,LVTGIAFWHYMYM,1
1s5l,z,2008,2024,16,LAALVILSFVMVIGVP,1
1s5l,z,2039,2053,14,IFLGSGLWIALVLV,1
1fx8,D,11,28,17,IAEFLGTGLLIFFGVGC,1
1fx8,D,43,60,17,ISVIWGLGVAMAIYLTA,1
1fx8,D,86,104,18,IPFIVSQVAGAFCAAALV,1
1fx8,D,149,167,18,AVEMVITAILMGLILALT,1
1fx8,D,179,195,16,PLLIGLLIAVIGASMG,1
1fx8,D,234,255,21,VPLFGPIVGAIVGAFAYRKLI,1
5hk2,A,10,31,21,WAALLLAVAAVLTQVVWLWLG,1
